GeographyCode,WP403EW0001,WP403EW0002,WP403EW0003,WP403EW0004,WP403EW0005,WP403EW0006,WP403EW0007,WP403EW0008,WP403EW0009,WP403EW0010,WP403EW0011,WP403EW0012,WP403EW0013,WP403EW0014
K04000001,26249664,18426201,5265417,13160784,221690,2607690,1370932,1236758,4762276,4333031,95567,263242,70436,231807
E92000001,24931010,17429242,4952322,12476920,216954,2491297,1303203,1188094,4574196,4166166,92673,247544,67813,219321
W92000004,1318654,996959,313095,683864,4736,116393,67729,48664,188080,166865,2894,15698,2623,12486
E12000001,1119539,831662,213406,618256,3488,131708,88028,43680,144000,128783,2002,11286,1929,8681
E12000002,3206793,2395641,669676,1725965,15253,296275,128666,167609,476612,433766,5046,32425,5375,23012
E12000003,2401226,1773732,498280,1275452,9204,213421,146503,66918,384284,346088,7075,25022,6099,20585
E12000004,2044428,1511354,436974,1074380,14214,174549,110608,63941,327850,296595,6531,20093,4631,16461
E12000005,2502854,1845193,549826,1295367,17659,257636,144914,112722,361645,327951,6533,22152,5009,20721
E12000006,2633507,1875676,544636,1331040,23269,271139,136066,135073,439161,395735,12498,23450,7478,24262
E12000007,4484169,2577485,710806,1866679,60750,574799,307179,267620,1230906,1164216,10192,44340,12158,40229
E12000008,4030818,2837175,790684,2046491,51180,366117,151599,214518,736609,656247,26527,38589,15246,39737
E12000009,2507676,1781324,538034,1243290,21937,205653,89640,116013,473129,416785,16269,30187,9888,25633
E06000001,34155,26104,6570,19534,118,3819,1800,2019,3867,3466,42,306,53,247
E06000002,62660,47213,11775,35438,260,6333,3141,3192,8308,7342,135,705,126,546
E06000003,45791,35578,9755,25823,196,4074,2170,1904,5577,4924,99,486,68,366
E06000004,86054,67824,16615,51209,257,7166,3924,3242,10258,9137,91,910,120,549
E06000005,51980,39323,9921,29402,129,3941,2726,1215,8198,7271,142,678,107,389
E06000006,57325,43463,11026,32437,363,7266,1625,5641,5963,5451,33,410,69,270
E06000007,114365,88414,22426,65988,674,10399,4622,5777,14302,13029,110,1027,136,576
E06000008,64343,50025,15786,34239,289,4808,1650,3158,8685,7730,115,701,139,536
E06000009,61384,46076,12078,33998,253,2836,1479,1357,11809,10726,104,901,78,410
E06000010,124045,88360,21480,66880,343,13282,10577,2705,21370,19751,118,1299,202,690
E06000011,132647,102377,30862,71515,369,7941,6185,1756,20538,18480,428,1305,325,1422
E06000012,70942,55112,14172,40940,226,3962,1497,2465,11221,10096,175,828,122,421
E06000013,76670,59105,16061,43044,201,5628,2764,2864,11072,9877,269,791,135,664
E06000014,101639,71377,20761,50616,640,8344,5033,3311,20364,18464,437,1106,357,914
E06000015,123301,91508,25421,66087,828,11117,7015,4102,19095,17611,144,1140,200,753
E06000016,162317,114202,34355,79847,1083,16747,10628,6119,29170,27086,319,1448,317,1115
E06000017,17335,12294,3888,8406,199,1340,505,835,3271,2489,408,156,218,231
E06000018,172889,117713,30977,86736,943,18812,12976,5836,34346,31910,244,1925,267,1075
E06000019,86401,59904,22450,37454,978,8006,2298,5708,16104,14078,758,950,318,1409
E06000020,82793,60024,15409,44615,409,8913,3900,5013,12870,11566,280,839,185,577
E06000021,113919,85695,24563,61132,402,12804,8860,3944,14210,12843,175,1010,182,808
E06000022,89082,63865,19476,44389,532,6992,2017,4975,16917,15487,294,924,212,776
E06000023,234961,158100,41751,116349,1768,20662,13935,6727,52864,49248,479,2762,375,1567
E06000024,83243,62644,17337,45307,599,4946,2367,2579,14441,13121,192,1009,119,613
E06000025,141489,106122,27426,78696,831,9468,4134,5334,24093,21962,465,1363,303,975
E06000026,121216,83829,21124,62705,1119,12330,5660,6670,23258,20038,1004,1581,635,680
E06000027,51737,37226,10769,26457,594,2372,310,2062,11171,10147,111,837,76,374
E06000028,80548,52211,13736,38475,682,5239,2528,2711,21870,20295,234,1189,152,546
E06000029,78478,55215,15171,40044,774,5711,2904,2807,16228,14662,383,967,216,550
E06000030,108420,78782,18187,60595,1345,9310,6025,3285,18414,16729,329,1097,259,569
E06000031,100435,69955,17488,52467,997,9093,3392,5701,19663,17758,503,1022,380,727
E06000032,89787,62452,15838,46614,661,7810,4818,2992,18369,17188,148,815,218,495
E06000033,71916,51889,14130,37759,413,5061,2608,2453,14029,13048,132,751,98,524
E06000034,64086,45953,11403,34550,389,7895,6197,1698,9518,8858,78,478,104,331
E06000035,97845,72475,18835,53640,1194,7437,2255,5182,16043,14378,412,919,334,696
E06000036,58356,42778,9759,33019,693,5468,1898,3570,8894,7623,517,493,261,523
E06000037,86543,61423,16429,44994,1204,8304,1173,7131,14440,12777,681,681,301,1172
E06000038,88441,59543,15063,44480,1497,7818,3994,3824,19049,17718,270,831,230,534
E06000039,74498,48426,11990,36436,1038,8051,4011,4040,16534,15571,173,625,165,449
E06000040,75291,52284,14769,37515,707,6822,1578,5244,14220,12364,839,582,435,1258
E06000041,68533,52114,13855,38259,837,4214,2309,1905,10833,9726,393,491,223,535
E06000042,143682,97111,22058,75053,6975,13542,7035,6507,25297,23502,244,1320,231,757
E06000043,133534,80147,21347,58800,1317,11082,7205,3877,39883,37653,211,1782,237,1105
E06000044,108332,73569,18426,55143,977,10562,6378,4184,22563,19325,1077,1482,679,661
E06000045,111934,71956,18423,53533,1203,12901,8483,4418,25187,23496,254,1212,225,687
E06000046,55784,40418,13432,26986,440,3775,400,3375,10632,9548,148,819,117,519
E06000047,195494,151036,42067,108969,423,19387,12608,6779,23070,20715,293,1808,254,1578
E06000048,122682,88814,26221,62593,378,14207,8526,5681,17223,14897,674,1212,440,2060
E06000049,181411,142111,40938,101173,797,11852,3936,7916,25306,22969,347,1644,346,1345
E06000050,157818,120703,33885,86818,1095,13177,6852,6325,21612,19373,461,1436,342,1231
E06000051,142722,103034,35871,67163,947,12459,4866,7593,24325,20984,1246,1494,601,1957
E06000052,233557,166347,59897,106450,2122,18149,8307,9842,44071,37999,1310,3959,803,2868
E06000053,1234,420,257,163,10,214,139,75,446,299,66,20,61,144
E06000054,215923,148601,43618,104983,1927,22175,6384,15791,40179,30030,4960,2036,3153,3041
E06000055,74244,53564,15268,38296,912,7269,1200,6069,11896,10825,212,657,202,603
E06000056,97672,71425,19658,51767,1071,9607,3968,5639,14824,12857,686,779,502,745
E07000004,74861,54586,15332,39254,874,7199,2220,4979,11451,9917,562,656,316,751
E07000005,35403,26421,8892,17529,414,3447,822,2625,4739,4265,176,224,74,382
E07000006,32963,23232,7087,16145,448,3100,1051,2049,5742,5080,282,252,128,441
E07000007,80388,57570,16776,40794,919,6882,3744,3138,14264,12186,912,632,534,753
E07000008,92545,58107,17812,40295,1580,10464,5925,4539,21477,19807,492,812,366,917
E07000009,31036,21957,6919,15038,436,3054,603,2451,4865,4349,163,282,71,724
E07000010,37854,27564,8197,19367,217,2719,740,1979,7011,6392,112,413,94,343
E07000011,76674,55665,14957,40708,726,6510,1689,4821,13177,11764,450,690,273,596
E07000012,73687,52192,15811,36381,1093,7529,4072,3457,12146,10642,596,537,371,727
E07000026,40065,30444,11437,19007,188,4679,778,3901,4256,3610,121,412,113,498
E07000027,31211,25752,7085,18667,47,1513,1139,374,3669,3215,69,334,51,230
E07000028,56382,43440,13928,29512,218,3988,768,3220,8217,7204,236,622,155,519
E07000029,34445,28406,8705,19701,47,2836,1061,1775,2902,2504,70,271,57,254
E07000030,28469,20395,8535,11860,278,2024,382,1642,5149,4485,191,391,82,623
E07000031,50875,37471,14272,23199,283,3597,2217,1380,8724,7650,324,622,128,800
E07000032,54953,43438,13589,29849,194,4145,2337,1808,6810,6123,70,512,105,366
E07000033,29289,21867,6399,15468,81,2789,2226,563,4336,3916,39,331,50,216
E07000034,51681,38317,11554,26763,130,6584,5742,842,6328,5687,60,485,96,322
E07000035,35925,26999,10743,16256,235,2840,1385,1455,5209,4535,157,384,133,642
E07000036,42905,33794,9833,23961,195,3117,1479,1638,5509,5046,40,377,46,290
E07000037,35592,27535,8919,18616,197,2773,2017,756,4735,4177,51,417,90,352
E07000038,31371,23826,7952,15874,90,3942,3369,573,3279,2902,50,253,74,234
E07000039,33858,26144,7468,18676,158,2406,1508,898,4834,4323,144,310,57,316
E07000040,52907,37907,13530,24377,389,4447,2775,1672,9500,8279,321,707,193,664
E07000041,82571,57405,16195,41210,786,6748,3863,2885,17098,15740,202,1004,152,534
E07000042,30259,21412,7877,13535,334,2524,1596,928,5509,4896,189,358,66,480
E07000043,46821,33796,11673,22123,411,2805,792,2013,9234,7866,412,709,247,575
E07000044,42780,30419,10704,19715,520,3575,898,2677,7801,6816,245,590,150,465
E07000045,49722,36531,11865,24666,527,3262,933,2329,8945,7958,186,706,95,457
E07000046,24526,18266,7350,10916,240,1460,367,1093,4143,3618,115,370,40,417
E07000047,21252,15742,6409,9333,168,1484,475,1009,3533,3103,101,286,43,325
E07000048,20628,14881,4614,10267,224,1679,355,1324,3683,3410,42,204,27,161
E07000049,33857,25690,8173,17517,165,2462,605,1857,5123,4539,160,305,119,417
E07000050,29352,20108,6882,13226,270,3026,409,2617,5401,4177,638,284,302,547
E07000051,19890,13642,4675,8967,211,1815,444,1371,3885,3060,429,209,187,337
E07000052,51708,35941,13225,22716,545,5039,650,4389,9174,8038,393,609,134,1009
E07000053,20887,14345,4433,9912,150,2145,777,1368,4041,3616,71,281,73,206
E07000061,43683,28993,8176,20817,311,3762,2249,1513,10303,9491,218,508,86,314
E07000062,36707,24299,7021,17278,213,2699,405,2294,9216,8517,116,487,96,280
E07000063,39907,29036,8739,20297,343,3024,2029,995,7078,6403,108,478,89,426
E07000064,31971,22836,7817,15019,212,2357,571,1786,6151,5559,172,355,65,415
E07000065,55300,41777,13163,28614,513,3770,1921,1849,8408,7505,214,566,123,832
E07000066,82736,61311,15920,45391,753,10189,6232,3957,10084,9271,129,612,72,399
E07000067,57521,41650,11727,29923,403,6274,1804,4470,8674,7814,234,504,122,520
E07000068,33777,25883,7597,18286,244,3130,2155,975,4251,3843,120,227,61,269
E07000069,25368,20777,6110,14667,86,1347,842,505,3028,2737,23,235,33,130
E07000070,82347,63055,17912,45143,555,7083,1744,5339,11050,10020,231,661,138,604
E07000071,81836,58565,16692,41873,393,6748,3716,3032,15557,13289,760,912,596,573
E07000072,47546,34699,10429,24270,337,5728,4078,1650,6333,5789,169,299,76,449
E07000073,39766,26418,6232,20186,417,7379,5919,1460,5378,4999,54,280,45,174
E07000074,22933,18139,5662,12477,108,1738,271,1467,2735,2433,75,185,42,213
E07000075,26613,21522,6313,15209,110,1500,567,933,3278,2967,50,218,43,203
E07000076,44200,33649,11032,22617,161,2554,1544,1010,7419,6651,134,548,86,417
E07000077,39877,28405,8596,19809,472,3792,2131,1661,6820,6067,272,312,169,388
E07000078,62999,43949,12150,31799,575,4436,2484,1952,13576,12629,153,666,128,463
E07000079,42898,28640,9676,18964,577,4602,852,3750,7856,6686,554,401,215,1223
E07000080,30156,23165,8278,14887,182,2345,561,1784,4132,3498,181,319,134,332
E07000081,63670,47721,12892,34829,598,4530,2305,2225,10430,9458,163,676,133,391
E07000082,49939,37078,11945,25133,378,4508,3130,1378,7515,6810,175,433,97,460
E07000083,45797,33692,9608,24084,439,3544,1130,2414,7738,6695,363,452,228,384
E07000084,84561,59847,14774,45073,1279,10192,965,9227,12356,11133,399,675,149,887
E07000085,47822,34113,10644,23469,536,5154,1236,3918,7330,6142,507,428,253,689
E07000086,64109,47116,12091,35025,703,6060,2226,3834,9824,8969,141,622,92,406
E07000087,50800,38615,9805,28810,450,3887,2144,1743,7543,6341,429,542,231,305
E07000088,26585,19171,4730,14441,259,2490,1318,1172,4477,3475,450,317,235,188
E07000089,39103,28983,7531,21452,484,2750,462,2288,6530,4951,813,307,459,356
E07000090,46491,33904,8845,25059,333,5676,2891,2785,6309,5537,125,565,82,269
E07000091,75141,54372,17556,36816,628,6876,3975,2901,12419,10863,558,751,247,846
E07000092,48565,33910,7973,25937,707,4541,1014,3527,9107,6775,1066,463,803,300
E07000093,57214,39526,11294,28232,581,6260,2383,3877,10033,8090,998,511,434,814
E07000094,74732,53281,14891,38390,812,6837,3947,2890,12855,10984,769,729,373,947
E07000095,38832,28660,7782,20878,406,4094,1560,2534,5432,5076,52,259,45,240
E07000096,65913,45469,12582,32887,528,10041,7407,2634,9391,8606,219,466,100,484
E07000097,57968,43006,12498,30508,599,6026,2058,3968,7650,6970,212,358,110,687
E07000098,46191,31581,9074,22507,594,5608,1718,3890,7927,7320,183,314,110,481
E07000099,52340,36527,10578,25949,554,7724,3355,4369,7072,6419,152,381,120,463
E07000100,61222,43551,13125,30426,457,6893,4400,2493,9854,9034,238,468,114,467
E07000101,44758,29993,7494,22499,529,7648,5401,2247,6359,5798,55,455,51,229
E07000102,35211,25233,7042,18191,281,3499,1442,2057,5881,5048,379,272,182,317
E07000103,51352,34545,9253,25292,595,6180,2293,3887,9680,9049,135,404,92,352
E07000104,68081,44175,11284,32891,802,10675,7301,3374,11963,11273,180,409,101,466
E07000105,54546,39274,10784,28490,751,4760,2834,1926,9281,8316,179,657,129,480
E07000106,65876,45830,13839,31991,636,4838,2981,1857,13818,12365,386,755,312,754
E07000107,54755,38878,9798,29080,669,5896,3287,2609,9019,8376,105,432,106,293
E07000108,43129,30620,9300,21320,277,3625,2282,1343,8152,7218,223,575,136,455
E07000109,31969,23104,6824,16280,296,3331,2354,977,5002,4560,78,281,83,236
E07000110,75968,56327,15354,40973,976,6230,1431,4799,11782,10389,442,683,268,653
E07000111,46302,33744,11056,22688,832,4763,1008,3755,6339,5636,260,357,86,624
E07000112,43917,30036,8970,21066,289,3086,1841,1245,10073,8759,328,606,380,433
E07000113,51980,38033,10318,27715,566,4294,813,3481,8641,7830,168,530,113,446
E07000114,47428,32555,9098,23457,163,3434,1736,1698,10877,9892,210,646,129,399
E07000115,59958,43506,11776,31730,971,6385,1041,5344,8555,7624,307,511,113,541
E07000116,54745,37527,11561,25966,672,5565,758,4807,10275,9427,278,465,105,706
E07000117,37407,29365,8728,20637,100,2160,723,1437,5500,4966,32,450,52,282
E07000118,41137,32948,9804,23144,176,3003,881,2122,4738,4216,47,408,67,272
E07000119,42662,34016,9137,24879,158,1614,450,1164,6546,5770,158,493,125,328
E07000120,31114,24320,7464,16856,72,1809,620,1189,4674,4203,29,387,55,239
E07000121,57969,43895,13667,30228,369,2818,1708,1110,10319,9246,171,811,91,568
E07000122,34532,26972,8918,18054,89,1866,871,995,5313,4816,51,397,49,292
E07000123,86184,65965,18261,47704,470,6481,1413,5068,12673,11481,164,894,134,595
E07000124,29680,23460,7458,16002,129,1357,359,998,4432,3836,156,343,97,302
E07000125,24229,19122,5886,13236,75,1725,741,984,3152,2787,23,315,27,155
E07000126,48934,38718,10927,27791,228,3685,690,2995,6040,5458,74,448,60,263
E07000127,49338,38580,11264,27316,232,3892,2910,982,6340,5762,69,436,73,294
E07000128,37549,30162,9392,20770,219,1644,391,1253,5167,4598,112,408,49,357
E07000129,51833,40968,10624,30344,343,3152,1800,1352,7124,6534,65,454,71,246
E07000130,67188,51609,15721,35888,474,4846,3119,1727,9758,8859,164,612,123,501
E07000131,41871,31709,9297,22412,450,2962,1270,1692,6370,5784,134,375,77,380
E07000132,42393,33619,9972,23647,253,2883,1832,1051,5365,4818,81,362,104,273
E07000133,22033,16300,5170,11130,192,1584,1105,479,3704,3337,106,191,70,253
E07000134,53555,41162,11602,29560,404,4315,3006,1309,7343,6693,84,502,64,331
E07000135,20986,16450,5163,11287,150,1482,990,492,2765,2558,23,146,38,139
E07000136,30932,21265,6521,14744,309,2677,1081,1596,6446,5899,156,284,107,235
E07000137,50484,36807,13267,23540,443,3090,980,2110,9473,8007,615,615,236,671
E07000138,54226,38777,10249,28528,387,4720,3594,1126,9968,9017,173,684,94,374
E07000139,44981,33137,9202,23935,296,3000,2172,828,8069,6346,875,453,395,479
E07000140,38798,27119,8509,18610,362,2913,2020,893,8073,7302,308,357,106,331
E07000141,57025,41375,11910,29465,496,4812,3424,1388,9685,8727,286,503,169,657
E07000142,30897,23233,7441,15792,264,2144,793,1351,4740,4043,268,330,99,516
E07000143,49843,34642,11213,23429,410,4610,1091,3519,9413,8240,460,553,160,768
E07000144,47152,35091,11272,23819,381,4423,1881,2542,6834,6114,163,487,70,423
E07000145,39820,29121,9314,19807,146,3653,2705,948,6569,5826,165,446,132,331
E07000146,62507,45334,14645,30689,423,4676,1217,3459,11129,9244,818,637,430,945
E07000147,39354,27295,10891,16404,211,3918,985,2933,7128,6326,273,458,71,802
E07000148,88715,59110,16876,42234,778,10943,7159,3784,17298,15839,176,1165,118,586
E07000149,54182,40495,13540,26955,555,4450,1863,2587,8028,7165,211,581,71,654
E07000150,30827,21514,4692,16822,190,3386,2575,811,5595,5195,53,303,44,142
E07000151,38366,27501,7503,19998,455,3552,1393,2159,6515,5962,96,342,115,343
E07000152,30949,22907,6359,16548,229,2708,713,1995,4786,4291,156,293,46,319
E07000153,42134,31527,7958,23569,342,3121,1829,1292,6853,6307,70,435,41,291
E07000154,118466,84221,19637,64584,1558,10069,6510,3559,21945,20329,141,1272,203,673
E07000155,34193,25574,7055,18519,439,2430,832,1598,5165,4648,143,264,110,585
E07000156,34276,24901,6451,18450,350,3174,1163,2011,5611,5125,61,382,43,240
E07000163,27069,20362,7280,13082,106,1383,483,900,4788,4268,124,299,97,430
E07000164,47482,33919,11502,22417,225,3833,820,3013,8759,6992,853,471,443,746
E07000165,80932,57372,18010,39362,478,4821,2563,2258,17147,15047,727,918,455,1114
E07000166,23924,15270,5211,10059,120,1964,1035,929,6102,3711,1241,295,855,468
E07000167,25810,17838,7111,10727,115,1990,362,1628,5182,4527,299,255,101,685
E07000168,45462,32389,11228,21161,224,3077,744,2333,9215,8338,160,546,171,557
E07000169,35384,27096,8101,18995,182,2767,1870,897,5003,4552,116,273,62,336
E07000170,53019,41090,11516,29574,210,4475,3342,1133,6920,6225,65,564,66,324
E07000171,51478,39113,11851,27262,201,4179,3218,961,7391,6663,163,463,102,594
E07000172,38548,29447,8597,20850,177,2856,2036,820,5778,5089,193,368,128,290
E07000173,36846,28523,8402,20121,191,2833,1633,1200,5035,4531,62,381,61,264
E07000174,40900,31348,9019,22329,138,3521,2519,1002,5615,5081,33,442,59,278
E07000175,50347,37634,11497,26137,242,3901,2765,1136,8103,7310,147,545,101,467
E07000176,45461,34887,10691,24196,336,3152,1707,1445,6733,6110,84,433,106,353
E07000177,71191,50908,13900,37008,717,6011,1596,4415,12789,11498,383,639,269,766
E07000178,97275,59790,18339,41451,1576,10086,5568,4518,24576,22677,554,925,420,1247
E07000179,60643,43160,13861,29299,670,5506,1266,4240,10403,8484,933,506,480,904
E07000180,61274,43254,12695,30559,706,5675,1339,4336,10713,8796,986,442,489,926
E07000181,46983,32539,9803,22736,668,4470,773,3697,8507,6521,1037,390,559,799
E07000187,48846,36088,12440,23648,454,3626,1004,2622,7991,7181,193,540,77,687
E07000188,46456,34281,10698,23583,300,3728,2053,1675,7692,6832,148,599,113,455
E07000189,76621,55667,17494,38173,694,7091,2384,4707,12147,10299,665,861,322,1022
E07000190,59158,42064,12724,29340,419,5769,3878,1891,10304,9253,209,667,175,602
E07000191,14088,9532,3775,5757,78,1435,210,1225,2726,2311,134,207,74,317
E07000192,38738,30092,8345,21747,200,3850,2278,1572,4388,3982,49,318,39,208
E07000193,58889,44673,13091,31582,319,4592,1932,2660,8819,8001,159,555,104,486
E07000194,44441,34244,10061,24183,268,4020,1202,2818,5574,4989,145,362,78,335
E07000195,48924,36829,11043,25786,154,5397,2576,2821,6173,5529,75,460,109,371
E07000196,36229,27806,8850,18956,175,3708,1494,2214,4171,3671,126,303,71,369
E07000197,66353,50761,15099,35662,311,5641,2361,3280,9109,7973,319,591,226,531
E07000198,34675,28006,9844,18162,119,2358,1192,1166,3846,3363,80,333,70,346
E07000199,30239,22944,5770,17174,162,3270,2107,1163,3715,3384,27,271,33,148
E07000200,35540,25492,8668,16824,194,3683,2322,1361,5623,4872,283,307,161,548
E07000201,31935,18355,5578,12777,379,3226,1154,2072,8839,7882,444,307,206,1136
E07000202,71343,50428,13844,36584,453,7291,4533,2758,12708,11789,177,640,102,463
E07000203,40886,30169,10354,19815,356,3446,2263,1183,6424,5263,587,342,232,491
E07000204,57355,40208,11737,28471,552,5861,2658,3203,10004,8642,487,590,285,730
E07000205,53745,39334,13079,26255,323,4417,1052,3365,8979,7910,470,416,183,692
E07000206,44806,33066,11210,21856,229,3681,2033,1648,7394,6662,156,506,70,436
E07000207,56175,40261,11593,28668,586,4346,1572,2774,10449,9563,289,472,125,533
E07000208,30074,22164,6336,15828,304,2317,634,1683,5030,4565,158,259,48,259
E07000209,76132,53076,15476,37600,1242,6813,4216,2597,14213,12279,801,641,492,788
E07000210,46282,33651,10260,23391,463,3937,921,3016,7675,6850,254,394,177,556
E07000211,67433,49216,13146,36070,847,6141,2164,3977,10680,9855,203,501,121,549
E07000212,49433,34851,9325,25526,640,4149,2114,2035,9321,8521,312,332,156,472
E07000213,40876,29025,7942,21083,605,3965,1291,2674,6926,6413,127,307,79,355
E07000214,43348,32081,8347,23734,510,3431,818,2613,6991,5725,585,363,318,335
E07000215,32731,24206,7295,16911,350,3123,1734,1389,4618,4029,307,212,70,434
E07000216,51573,37270,11736,25534,671,4932,3095,1837,7809,6812,440,400,157,891
E07000217,44126,31191,8484,22707,564,4102,2438,1664,7864,7172,210,359,123,405
E07000218,39502,29756,8040,21716,273,3811,2474,1337,5399,4901,92,330,76,263
E07000219,45210,34883,9845,25038,276,3781,2552,1229,6030,5401,70,477,82,240
E07000220,47004,34904,9824,25080,447,3956,2175,1781,7375,6527,271,403,174,322
E07000221,62993,45732,14561,31171,704,5529,1245,4284,10356,9322,289,564,181,672
E07000222,77431,57257,16567,40690,768,6391,3821,2570,12453,11426,207,699,121,562
E07000223,22148,16220,4557,11663,136,2020,1255,765,3562,3254,48,235,25,210
E07000224,48226,34501,10671,23830,459,3658,1661,1997,9118,8319,193,502,104,490
E07000225,60448,40983,13407,27576,621,6047,1428,4619,11807,10202,677,599,329,990
E07000226,79234,54690,12444,42246,1031,8818,5711,3107,14291,13310,149,714,118,404
E07000227,55972,41016,12364,28652,487,5118,1147,3971,8564,7639,347,471,107,787
E07000228,60284,43886,12836,31050,761,5103,1016,4087,9719,8832,226,540,121,815
E07000229,49305,35970,9666,26304,367,3203,1184,2019,9460,8675,110,583,92,305
E07000234,38915,30205,9012,21193,294,3227,1559,1668,4876,4396,110,327,43,313
E07000235,31014,22333,7921,14412,329,2969,589,2380,4944,4457,109,312,66,439
E07000236,38967,28928,7689,21239,216,4548,3136,1412,5084,4644,53,348,39,191
E07000237,52969,38794,10891,27903,551,4484,1591,2893,8778,8048,96,561,73,362
E07000238,53818,39058,12312,26746,373,5365,1110,4255,8440,7594,249,471,126,582
E07000239,37299,28526,9342,19184,247,3165,1491,1674,5071,4603,53,358,57,290
E08000001,114707,86471,24775,61696,480,12061,8584,3477,14885,13436,87,1183,179,810
E08000002,73220,55908,15293,40615,241,6504,4024,2480,10095,9133,64,792,106,472
E08000003,316925,203360,50004,153356,1913,37660,16254,21406,71797,67352,341,3527,577,2195
E08000004,88833,67076,19014,48062,357,9889,5064,4825,10832,9626,77,970,159,679
E08000005,78995,59231,16245,42986,255,8743,5804,2939,10167,9108,72,858,129,599
E08000006,113273,79215,19708,59507,574,14034,8428,5606,18675,17332,132,1029,182,775
E08000007,125607,96552,26478,70074,812,10683,5998,4685,16797,15317,119,1188,173,763
E08000008,79346,59455,15812,43643,237,9062,2895,6167,10070,9032,89,822,127,522
E08000009,129182,93438,24125,69313,709,12964,5325,7639,21273,19757,107,1249,160,798
E08000010,117505,90827,25175,65652,361,12585,10336,2249,12975,11738,93,1009,135,757
E08000011,57123,43697,10388,33309,198,7193,2814,4379,5719,5197,34,432,56,316
E08000012,234001,161222,41314,119908,1183,29108,6122,22986,41160,38350,260,2108,442,1328
E08000013,64764,49767,14014,35753,246,7461,2669,4792,6903,6210,63,537,93,387
E08000014,102450,79420,22649,56771,413,8277,2500,5777,13712,12468,115,1003,126,628
E08000015,112034,85779,23675,62104,425,9022,3583,5439,16064,14625,126,1157,156,744
E08000016,82826,63149,18461,44688,241,8806,7457,1349,9986,9000,113,745,128,644
E08000017,126775,96995,26528,70467,327,10529,8932,1597,18040,16211,233,1432,164,884
E08000018,107591,82524,22551,59973,285,11270,9348,1922,12787,11509,117,982,179,725
E08000019,260022,187076,51176,135900,871,29672,21208,8464,40492,36948,350,2579,615,1911
E08000020,91737,66205,16027,50178,289,13660,10664,2996,11020,9955,77,862,126,563
E08000021,168879,118369,28297,90072,676,21378,16779,4599,27456,25120,180,1856,300,1000
E08000022,84119,61592,14559,47033,283,10753,8334,2419,10967,9895,82,912,78,524
E08000023,50163,36260,9148,27112,177,8770,6781,1989,4700,4188,55,394,63,256
E08000024,125825,93344,22451,70893,302,18220,10575,7645,13356,11873,132,1157,194,603
E08000025,485507,344453,98716,245737,4362,54112,33352,20760,78332,72653,610,4224,845,4248
E08000026,147275,108419,30304,78115,929,11479,4325,7154,25497,23460,213,1562,262,951
E08000027,123023,94437,29070,65367,726,14681,11902,2779,12361,11153,159,865,184,818
E08000028,125323,89964,26939,63025,818,17951,14017,3934,15698,14459,149,886,204,892
E08000029,99745,77951,21521,56430,774,8010,5806,2204,12426,11464,111,739,112,584
E08000030,104858,76998,22656,54342,603,14273,7342,6931,12322,11244,108,819,151,662
E08000031,107678,78583,24220,54363,525,14886,11361,3525,12899,11836,145,721,197,785
E08000032,212992,162165,47026,115139,967,14429,6819,7610,33562,30518,296,2361,387,1869
E08000033,94581,72985,20581,52404,404,6345,2816,3529,14135,12691,141,1121,182,712
E08000034,166274,127089,38298,88791,570,12939,9871,3068,24281,21936,224,1818,303,1395
E08000035,407523,288249,71942,216307,1746,43732,33513,10219,70816,65620,457,4147,592,2980
E08000036,150636,112923,29938,82985,564,16707,12606,4101,19424,17552,197,1451,224,1018
E09000001,356304,228275,55128,173147,3555,18348,9326,9022,103814,99176,466,3519,653,2312
E09000002,58329,36251,8891,27360,651,10511,8155,2356,10577,9863,81,500,133,339
E09000003,128806,77482,25774,51708,1392,14191,8158,6033,33749,32015,297,1054,383,1992
E09000004,74581,54574,14424,40150,765,8854,2892,5962,9932,9090,99,619,124,456
E09000005,114936,59233,18890,40343,1588,16235,7275,8960,36838,35071,223,1096,448,1042
E09000006,111161,79866,22869,56997,1139,13318,3790,9528,15988,14746,228,834,180,850
E09000007,271015,146608,41947,104661,4160,34531,19736,14795,83220,78877,557,3064,722,2496
E09000008,120112,76738,20509,56229,1487,15924,8079,7845,24976,23457,232,1029,258,987
E09000009,131854,73187,22011,51176,2067,15647,8484,7163,39684,37652,279,1319,434,1269
E09000010,105297,66974,19716,47258,1112,13851,8542,5309,22404,21161,204,769,270,956
E09000011,85416,47803,12430,35373,1197,17809,10263,7546,17944,16624,260,755,305,663
E09000012,103364,45532,12252,33280,1871,21036,10875,10161,33983,32310,137,1244,292,942
E09000013,123930,61018,17386,43632,2031,19179,9528,9651,40441,38403,293,1438,307,1261
E09000014,80767,39035,11551,27484,1096,14458,8645,5813,25378,24318,153,670,237,800
E09000015,73658,48349,15698,32651,763,6030,3131,2899,17760,16676,250,583,251,756
E09000016,84606,63346,17604,45742,630,9667,7066,2601,10515,9783,107,548,77,448
E09000017,163669,110535,28990,81545,2507,16377,9049,7328,33126,30675,652,1216,583,1124
E09000018,128467,76221,20467,55754,2325,15290,8537,6753,33722,31837,337,1145,403,909
E09000019,166557,86295,23173,63122,2559,27159,15532,11627,49099,46581,289,1839,390,1445
E09000020,115730,54042,18750,35292,1867,17267,7917,9350,40406,38185,379,1406,436,2148
E09000021,71894,46846,13592,33254,802,6665,3706,2959,16976,15882,220,690,184,605
E09000022,137176,66628,16914,49714,2177,26660,14470,12190,40451,38119,405,1494,433,1260
E09000023,78719,41077,10558,30519,1074,17045,8585,8460,18832,17543,126,983,180,691
E09000024,75029,44007,12509,31498,794,8986,3866,5120,20572,19481,169,738,184,670
E09000025,103677,49643,13156,36487,1529,17823,10177,7646,33835,32333,142,991,369,847
E09000026,78775,53002,15654,37348,902,7344,4556,2788,16852,15863,118,707,164,675
E09000027,77902,49265,15467,33798,957,7809,3215,4594,19047,17756,315,746,230,824
E09000028,182839,95029,23212,71817,3082,33448,20579,12869,49622,46844,377,1940,461,1658
E09000029,72074,50341,13505,36836,742,8057,4340,3717,12483,11657,142,585,99,451
E09000030,234283,129626,29966,99660,3271,29529,13985,15544,70270,67124,316,2232,598,1587
E09000031,79081,42800,12264,30536,942,11684,6220,5464,23028,21962,160,697,209,627
E09000032,117347,60287,18030,42257,1662,18898,10632,8266,35414,33447,336,1299,332,1086
E09000033,576814,317570,87519,230051,8054,55169,27868,27301,189968,179705,1843,6591,1829,6053
W06000001,24182,17868,6826,11042,61,2330,1889,441,3511,2904,144,334,129,412
W06000002,57042,41106,16793,24313,178,6059,3245,2814,8738,7538,226,793,181,961
W06000003,44576,33018,10996,22022,321,3269,1428,1841,7444,6663,106,553,122,524
W06000004,41132,30982,9895,21087,342,3257,2032,1225,6050,5329,133,514,74,501
W06000005,71918,56001,15593,40408,426,5913,3930,1983,9055,8084,93,773,105,523
W06000006,60669,44154,12860,31294,269,7479,6070,1409,8244,7432,110,611,91,523
W06000008,31906,23199,10563,12636,110,1852,638,1214,6198,5570,87,419,122,547
W06000009,52289,38831,15332,23499,123,5085,3335,1750,7493,6254,311,764,164,757
W06000010,73577,57540,21933,35607,156,5767,4171,1596,9245,7989,165,932,159,869
W06000011,110048,82597,24495,58102,279,11279,7399,3880,14865,13199,133,1393,140,1028
W06000012,51357,40783,12978,27805,81,5388,3670,1718,4747,4124,58,498,67,358
W06000013,60178,48652,12900,35752,138,4126,1410,2716,6866,5956,87,707,116,396
W06000014,44804,34521,9542,24979,97,3244,1850,1394,6592,5559,305,548,180,350
W06000015,198189,142200,36020,106180,810,15020,7599,7421,38759,35677,216,2584,282,1400
W06000016,81901,66608,20201,46407,137,5234,2731,2503,9389,8381,66,856,86,533
W06000018,58566,46526,12912,33614,161,5208,3391,1817,6337,5596,56,610,75,334
W06000019,21978,16644,5229,11415,39,2688,1404,1284,2485,2229,21,198,37,122
W06000020,38800,29929,8140,21789,175,4569,2032,2537,3927,3501,36,330,60,200
W06000021,37839,29123,9922,19201,170,3294,1162,2132,4797,4175,125,422,75,455
W06000022,73232,54705,13984,40721,416,7232,3673,3559,10411,9448,82,763,118,468
W06000023,59679,43228,20208,23020,198,5223,3222,2001,9970,8582,300,878,210,1060
W06000024,24792,18744,5773,12971,49,2877,1448,1429,2957,2675,34,218,30,165
E02000001,356304,228275,55128,173147,3555,18348,9326,9022,103814,99176,466,3519,653,2312
E02000002,1130,654,181,473,9,268,202,66,188,177,1,10,0,11
E02000003,3616,2430,626,1804,27,448,334,114,678,629,7,31,11,33
E02000004,1501,1119,309,810,13,179,129,50,182,169,1,10,2,8
E02000005,1538,979,212,767,10,247,202,45,285,265,0,14,6,17
E02000007,3647,2315,630,1685,38,818,687,131,460,423,5,23,9,16
E02000008,2349,1483,345,1138,30,458,386,72,362,332,5,19,6,16
E02000009,1167,607,126,481,30,228,178,50,295,288,2,3,2,7
E02000010,1503,987,208,779,15,247,221,26,247,230,3,12,2,7
E02000011,2772,1904,467,1437,27,408,296,112,419,385,7,23,4,14
E02000012,1899,1349,331,1018,9,171,138,33,357,331,2,21,3,13
E02000013,1286,776,136,640,14,259,218,41,231,210,4,16,1,6
E02000014,1826,1027,215,812,8,440,367,73,338,322,4,6,6,13
E02000015,1328,670,148,522,29,349,281,68,277,261,4,10,2,3
E02000016,7133,4202,1050,3152,103,1268,899,369,1527,1423,10,79,15,33
E02000017,1701,928,228,700,16,192,132,60,553,518,2,28,5,12
E02000018,1205,673,116,557,15,257,211,46,255,234,0,16,5,5
E02000019,4256,2527,581,1946,55,907,673,234,743,710,4,24,5,24
E02000020,4983,2951,756,2195,70,1002,760,242,926,866,4,51,5,34
E02000021,6050,4580,1196,3384,35,676,499,177,735,688,8,32,7,24
E02000022,2415,1166,280,886,52,628,541,87,555,504,1,26,24,14
E02000023,2633,1510,386,1124,23,605,456,149,479,446,2,26,5,16
E02000024,5655,3907,1245,2662,58,568,323,245,1051,987,15,38,11,71
E02000025,1868,1252,394,858,10,206,126,80,380,367,0,12,1,20
E02000026,1100,827,272,555,11,56,31,25,185,172,0,5,8,21
E02000027,4104,2584,828,1756,70,632,397,235,778,716,14,38,10,40
E02000028,2253,1541,451,1090,24,207,123,84,462,437,4,16,5,19
E02000029,2663,1817,594,1223,26,252,151,101,541,518,4,16,3,27
E02000030,2491,1699,606,1093,35,264,159,105,450,432,6,9,3,43
E02000031,3969,2692,923,1769,40,355,203,152,836,768,16,33,19,46
E02000032,1432,1031,354,677,15,59,34,25,304,292,3,8,1,23
E02000033,3970,2650,808,1842,67,487,265,222,737,709,3,23,2,29
E02000034,2040,1292,427,865,17,213,129,84,499,472,3,20,4,19
E02000035,2495,1545,544,1001,17,216,117,99,682,641,9,18,14,35
E02000036,2025,1216,346,870,19,212,107,105,544,516,3,20,5,34
E02000037,2009,1376,482,894,17,218,134,84,371,357,1,13,0,27
E02000038,2797,1648,486,1162,24,306,159,147,773,739,2,28,4,46
E02000039,2848,1968,646,1322,29,258,152,106,556,523,5,20,8,37
E02000040,3996,2104,726,1378,26,479,274,205,930,861,36,18,15,457
E02000041,4507,2663,859,1804,43,516,330,186,1236,1196,9,22,9,49
E02000042,4978,2951,969,1982,44,544,313,231,1377,1296,18,49,14,62
E02000043,1201,801,280,521,8,51,35,16,333,320,0,9,4,8
E02000044,1682,942,269,673,18,266,165,101,448,418,6,22,2,8
E02000045,2479,1419,405,1014,36,369,228,141,616,573,5,25,13,39
E02000046,3088,1670,571,1099,23,321,183,138,1045,998,0,33,14,29
E02000047,3394,1881,536,1345,46,509,342,167,914,873,8,26,7,44
E02000048,2280,1528,525,1003,23,142,69,73,565,532,9,20,4,22
E02000049,2577,1310,418,892,47,609,369,240,587,542,6,31,8,24
E02000050,3082,1738,517,1221,32,365,169,196,912,864,7,29,12,35
E02000051,4873,2947,1071,1876,45,469,232,237,1329,1260,9,51,9,83
E02000052,3358,1937,591,1346,34,344,213,131,1007,965,4,32,6,36
E02000053,6332,4000,1111,2889,128,596,298,298,1561,1467,13,51,30,47
E02000054,2379,1378,480,898,18,169,81,88,793,749,16,25,3,21
E02000055,5781,3288,1118,2170,49,531,310,221,1829,1746,10,47,26,84
E02000056,2673,1719,742,977,21,223,129,94,644,608,4,21,11,66
E02000057,2103,1098,418,680,9,156,79,77,806,783,4,15,4,34
E02000058,3613,2183,854,1329,46,300,157,143,1035,982,5,33,15,49
E02000059,3869,2073,655,1418,51,490,316,174,1226,1185,6,25,10,29
E02000060,2815,1540,578,962,20,178,99,79,1024,977,5,29,13,53
E02000061,3659,1964,771,1193,35,358,176,182,1244,1184,10,33,17,58
E02000062,7587,3954,1352,2602,85,1360,771,589,2121,2024,12,57,28,67
E02000063,1337,663,258,405,13,128,63,65,515,494,2,12,7,18
E02000064,1444,686,294,392,13,209,147,62,503,472,5,22,4,33
E02000065,2873,1740,369,1371,33,418,135,283,665,614,3,39,9,17
E02000066,1626,942,221,721,16,396,68,328,263,241,1,18,3,9
E02000067,3267,2059,504,1555,27,495,191,304,664,614,3,33,14,22
E02000068,4933,3079,797,2282,77,881,306,575,868,800,5,48,15,28
E02000069,1292,977,279,698,12,117,26,91,169,148,5,15,1,17
E02000070,1027,829,250,579,12,73,24,49,106,93,3,8,2,7
E02000071,2016,1521,375,1146,24,234,62,172,221,201,2,12,6,16
E02000072,3509,2299,580,1719,33,688,196,492,475,442,1,22,10,14
E02000073,1520,1332,326,1006,9,80,26,54,96,87,0,7,2,3
E02000074,1554,999,217,782,25,321,95,226,203,189,3,9,2,6
E02000075,1366,1172,316,856,6,82,24,58,96,88,0,7,1,10
E02000077,1402,1149,298,851,8,108,31,77,127,111,0,14,2,10
E02000078,1137,965,241,724,9,84,30,54,77,66,0,10,1,2
E02000079,8196,5919,1613,4306,76,1030,381,649,1119,1016,19,73,11,52
E02000080,3233,2339,621,1718,32,382,154,228,455,412,4,34,5,25
E02000081,2583,2027,451,1576,33,228,65,163,285,250,10,18,7,10
E02000082,2001,1654,427,1227,11,109,28,81,216,196,3,16,1,11
E02000083,5880,4211,1073,3138,56,772,286,486,802,753,6,39,4,39
E02000084,2139,1807,554,1253,20,119,30,89,182,167,2,12,1,11
E02000085,1760,1436,381,1055,10,112,34,78,191,166,2,20,3,11
E02000086,1468,1244,345,899,10,58,21,37,146,136,1,8,1,10
E02000087,2109,1662,474,1188,15,158,62,96,250,227,2,19,2,24
E02000088,1175,1005,280,725,3,35,14,21,127,111,5,8,3,5
E02000089,1202,993,295,698,8,102,30,72,95,85,1,8,1,4
E02000090,6087,4484,1233,3251,80,587,194,393,903,836,10,50,7,33
E02000091,3886,2880,905,1975,35,463,141,322,476,441,5,25,5,32
E02000092,4542,3216,823,2393,79,649,227,422,575,530,3,38,4,23
E02000093,3547,1944,676,1268,36,449,197,252,1084,1049,3,28,4,34
E02000094,3614,2056,646,1410,39,400,205,195,1091,1028,2,45,16,28
E02000095,2886,1675,623,1052,35,253,102,151,898,853,8,25,12,25
E02000096,1925,1326,482,844,13,100,49,51,453,426,11,14,2,33
E02000097,2020,1168,391,777,22,159,77,82,657,624,3,22,8,14
E02000098,1861,964,345,619,12,146,56,90,725,690,2,20,13,14
E02000099,2771,1316,435,881,41,323,142,181,1058,989,10,32,27,33
E02000100,6328,3910,1264,2646,99,785,248,537,1495,1405,13,35,42,39
E02000101,3087,1553,489,1064,46,547,233,314,907,867,3,23,14,34
E02000102,1703,850,331,519,23,182,62,120,640,595,11,23,11,8
E02000103,4953,2714,914,1800,69,675,351,324,1456,1387,6,50,13,39
E02000104,1809,999,336,663,35,188,74,114,570,528,5,27,10,17
E02000105,2005,1013,264,749,28,193,85,108,749,716,2,27,4,22
E02000106,3901,2081,675,1406,55,469,202,267,1275,1219,5,41,10,21
E02000107,2716,1158,415,743,30,369,163,206,1128,1082,6,27,13,31
E02000108,821,416,124,292,11,54,24,30,329,321,0,7,1,11
E02000109,8581,4776,1440,3336,143,1082,522,560,2517,2406,26,61,24,63
E02000110,1356,641,265,376,11,148,47,101,539,525,1,11,2,17
E02000111,3330,1942,566,1376,36,315,134,181,1008,940,11,51,6,29
E02000112,5154,2843,904,1939,99,710,321,389,1457,1390,16,43,8,45
E02000113,3570,1709,521,1188,61,767,393,374,996,949,3,33,11,37
E02000114,2259,923,333,590,23,329,120,209,958,922,5,16,15,26
E02000115,1410,586,235,351,13,201,103,98,589,565,3,13,8,21
E02000116,3115,1299,418,881,77,651,248,403,1058,1024,5,21,8,30
E02000117,2799,1240,385,855,46,662,239,423,820,797,0,12,11,31
E02000118,3314,1771,482,1289,38,379,192,187,1097,1022,10,52,13,29
E02000119,11880,5868,1583,4285,195,1934,877,1057,3798,3619,15,128,36,85
E02000120,2747,1160,386,774,18,468,215,253,1072,1023,2,34,13,29
E02000121,5179,2904,915,1989,55,637,337,300,1527,1425,12,48,42,56
E02000122,1985,1099,395,704,18,273,120,153,570,548,7,12,3,25
E02000123,4141,1609,483,1126,63,889,310,579,1542,1475,5,37,25,38
E02000124,4581,2257,699,1558,46,614,302,312,1623,1559,8,49,7,41
E02000125,1925,974,319,655,16,216,72,144,702,674,1,22,5,17
E02000126,1663,489,151,338,36,668,453,215,450,429,3,7,11,20
E02000127,1412,894,262,632,16,321,87,234,160,145,6,6,3,21
E02000128,1905,1375,375,1000,12,216,62,154,285,263,7,13,2,17
E02000130,3515,2197,577,1620,43,584,194,390,666,633,6,23,4,25
E02000131,2052,986,262,724,18,364,93,271,663,628,3,28,4,21
E02000132,4095,2614,760,1854,37,551,135,416,853,809,5,33,6,40
E02000133,2502,1967,628,1339,21,198,54,144,289,267,1,18,3,27
E02000134,6304,4232,1188,3044,61,850,253,597,1101,1024,12,51,14,60
E02000135,2342,1085,274,811,32,679,133,546,521,483,11,24,3,25
E02000136,1771,1315,408,907,16,221,62,159,190,172,7,9,2,29
E02000137,1368,975,305,670,8,109,37,72,268,242,13,10,3,8
E02000138,2203,1579,519,1060,19,186,61,125,402,376,1,20,5,17
E02000139,1982,1409,398,1011,23,230,58,172,298,281,2,13,2,22
E02000140,3070,2157,554,1603,39,500,132,368,362,335,2,24,1,12
E02000141,1470,1007,256,751,25,181,46,135,249,227,1,20,1,8
E02000142,3997,2773,793,1980,44,562,174,388,589,541,8,32,8,29
E02000144,14679,10319,2731,7588,166,1678,558,1120,2432,2271,16,131,14,84
E02000145,3353,2253,621,1632,61,568,139,429,458,404,23,28,3,13
E02000146,3037,2213,595,1618,39,301,90,211,456,416,5,33,2,28
E02000147,1248,1056,343,713,7,52,17,35,128,120,0,6,2,5
E02000148,2007,1578,478,1100,16,155,43,112,237,220,1,12,4,21
E02000149,3238,2293,573,1720,40,477,127,350,405,371,3,30,1,23
E02000150,3037,2200,574,1626,39,342,129,213,431,399,9,19,4,25
E02000151,1177,1009,346,663,4,52,8,44,105,96,0,9,0,7
E02000152,1831,1333,388,945,12,301,88,213,170,162,1,7,0,15
E02000153,1180,1072,292,780,2,35,5,30,60,56,2,2,0,11
E02000154,5505,4051,1162,2889,63,684,154,530,668,618,7,26,17,39
E02000155,1112,884,262,622,15,104,25,79,105,94,1,9,1,4
E02000156,3693,2924,943,1981,16,307,134,173,414,373,4,25,12,32
E02000157,1459,1244,379,865,7,62,17,45,139,122,1,13,3,7
E02000158,1093,844,264,580,8,142,12,130,93,84,0,9,0,6
E02000159,3075,2305,700,1605,30,323,97,226,388,352,2,17,17,29
E02000160,2784,2157,650,1507,24,222,117,105,357,320,16,17,4,24
E02000161,1475,1241,371,870,12,92,29,63,119,105,5,7,2,11
E02000162,4589,3345,1043,2302,55,565,113,452,595,551,7,31,6,29
E02000163,2864,2232,689,1543,30,295,68,227,290,259,2,19,10,17
E02000165,1538,1322,336,986,9,77,35,42,122,105,7,8,2,8
E02000166,3099,1693,648,1045,29,609,421,188,717,674,12,24,7,51
E02000167,3822,2007,952,1055,31,464,291,173,1255,1192,17,38,8,65
E02000168,5479,2762,880,1882,88,925,523,402,1639,1558,11,62,8,65
E02000169,2073,1157,560,597,27,206,124,82,619,589,3,21,6,64
E02000170,2257,1201,468,733,21,249,135,114,765,731,7,20,7,21
E02000171,2310,1178,472,706,15,450,293,157,639,603,2,25,9,28
E02000172,4954,2279,656,1623,88,1354,867,487,1188,1128,7,45,8,45
E02000173,10698,5589,1740,3849,210,1854,941,913,2924,2772,31,76,45,121
E02000174,3053,1475,498,977,46,660,445,215,841,798,6,27,10,31
E02000175,3934,1772,586,1186,65,712,405,307,1344,1289,5,39,11,41
E02000176,2029,1045,456,589,18,224,105,119,715,682,5,20,8,27
E02000177,2348,954,317,637,34,574,458,116,757,724,4,26,3,29
E02000178,2187,897,293,604,24,508,287,221,725,688,4,22,11,33
E02000179,1478,686,275,411,13,274,209,65,481,459,2,14,6,24
E02000180,2195,933,344,589,29,563,368,195,634,578,0,40,16,36
E02000181,1279,626,266,360,9,189,90,99,439,418,3,8,10,16
E02000182,3568,1745,580,1165,42,605,389,216,1120,1068,11,38,3,56
E02000183,7101,3475,1116,2359,83,858,474,384,2613,2456,20,107,30,72
E02000184,9914,5087,1290,3797,179,1657,981,676,2920,2776,12,108,24,71
E02000185,2531,992,306,686,34,713,479,234,767,729,1,28,9,25
E02000186,24067,13543,3445,10098,388,2971,1691,1280,6969,6570,90,233,76,196
E02000187,7777,3689,1016,2673,129,1682,1038,644,2207,2109,14,57,27,70
E02000188,7883,4377,1093,3284,123,1239,768,471,2088,1988,12,71,17,56
E02000189,5134,2445,683,1762,89,989,545,444,1542,1449,6,70,17,69
E02000190,10028,5375,1487,3888,162,1612,938,674,2745,2606,17,95,27,134
E02000191,40496,22475,6165,16310,626,3679,1945,1734,13407,12700,76,538,93,309
E02000192,30819,17792,4573,13219,491,3027,1598,1429,9310,8810,72,365,63,199
E02000193,68502,39359,10782,28577,1067,5684,2928,2756,21850,20733,107,847,163,542
E02000194,2835,1525,414,1111,36,452,226,226,786,729,11,31,15,36
E02000195,1668,1156,343,813,21,132,66,66,346,325,1,15,5,13
E02000196,1810,1089,279,810,21,209,111,98,482,453,3,20,6,9
E02000197,1821,994,277,717,20,218,125,93,570,545,2,19,4,19
E02000198,1680,1027,277,750,20,254,107,147,373,349,4,12,8,6
E02000199,1225,764,176,588,11,123,44,79,312,291,4,17,0,15
E02000200,2227,1398,327,1071,27,263,104,159,524,496,3,20,5,15
E02000201,1949,1045,224,821,18,349,158,191,517,489,1,23,4,20
E02000202,1367,865,252,613,15,110,57,53,355,336,1,15,3,22
E02000203,2759,1609,449,1160,51,433,212,221,642,608,4,21,9,24
E02000204,1837,1131,313,818,19,202,98,104,462,442,2,18,0,23
E02000206,3792,2209,532,1677,51,690,329,361,819,773,5,35,6,23
E02000207,1914,1264,326,938,34,295,113,182,311,295,0,11,5,10
E02000208,4793,2876,767,2109,110,672,308,364,1101,1048,12,29,12,34
E02000209,2199,1279,317,962,27,323,128,195,559,525,3,19,12,11
E02000210,1366,922,238,684,23,151,58,93,259,245,2,9,3,11
E02000211,1348,1129,286,843,3,90,34,56,121,108,3,9,1,5
E02000212,3697,2098,547,1551,45,644,328,316,885,837,0,38,10,25
E02000213,6990,3896,967,2929,88,1172,594,578,1771,1656,13,79,23,63
E02000214,1447,1075,309,766,21,106,39,67,232,218,2,10,2,13
E02000215,3619,2033,546,1487,58,420,199,221,1061,1008,6,35,12,47
E02000216,1241,762,292,470,8,93,46,47,360,347,1,11,1,18
E02000217,7779,4331,1119,3212,106,1385,684,701,1898,1775,9,96,18,59
E02000218,1023,705,214,491,4,199,129,70,100,91,3,1,5,15
E02000219,1998,1540,485,1055,10,175,81,94,245,233,3,5,4,28
E02000220,16727,10536,2676,7860,239,1944,909,1035,3897,3687,25,149,36,111
E02000221,5339,3323,806,2517,62,831,443,388,1081,986,38,46,11,42
E02000222,2770,1754,496,1258,29,357,178,179,599,567,8,17,7,31
E02000223,756,349,93,256,6,342,261,81,55,51,0,3,1,4
E02000224,2858,1965,557,1408,38,273,119,154,564,529,2,28,5,18
E02000225,1529,1005,254,751,7,368,237,131,142,134,0,8,0,7
E02000226,2088,1678,514,1164,8,160,94,66,226,205,11,9,1,16
E02000227,2107,1568,412,1156,19,239,146,93,266,233,5,27,1,15
E02000228,1580,1268,450,818,8,93,50,43,192,182,5,5,0,19
E02000229,1624,907,225,682,19,459,293,166,220,205,3,11,1,19
E02000230,4049,2789,813,1976,56,385,219,166,778,744,9,24,1,41
E02000231,2061,1619,507,1112,16,148,74,74,264,231,3,19,11,14
E02000232,1301,1031,307,724,6,122,81,41,128,120,4,4,0,14
E02000233,1453,1092,263,829,16,146,80,66,188,171,2,14,1,11
E02000234,3420,2472,616,1856,53,298,161,137,564,527,1,32,4,33
E02000235,1688,1295,348,947,11,134,70,64,245,233,2,9,1,3
E02000236,1554,1278,355,923,17,110,61,49,148,142,2,4,0,1
E02000237,1711,1387,385,1002,17,131,76,55,162,139,12,9,2,14
E02000238,3466,2010,558,1452,32,279,149,130,1115,1071,5,33,6,30
E02000239,1735,877,239,638,15,94,52,42,738,717,4,11,6,11
E02000240,1667,938,237,701,30,289,184,105,403,386,1,12,4,7
E02000241,2090,1287,341,946,26,232,122,110,510,482,6,19,3,35
E02000242,2817,1715,536,1179,38,208,120,88,836,786,2,41,7,20
E02000243,6061,3777,1096,2681,76,633,347,286,1532,1451,16,46,19,43
E02000244,4061,2344,720,1624,52,375,208,167,1259,1183,8,58,10,31
E02000245,1214,606,130,476,28,225,134,91,346,329,1,8,8,9
E02000246,1178,720,205,515,12,198,154,44,234,224,1,6,3,14
E02000247,1921,1004,253,751,37,268,135,133,597,558,5,29,5,15
E02000248,6052,3045,868,2177,102,501,259,242,2347,2237,16,74,20,57
E02000249,3072,1594,501,1093,52,454,286,168,934,893,4,28,9,38
E02000250,1294,865,299,566,6,101,64,37,307,293,1,7,6,15
E02000251,1129,654,190,464,20,63,33,30,376,358,0,17,1,16
E02000252,17849,9091,2562,6529,282,2537,1214,1323,5794,5534,23,185,52,145
E02000253,1462,783,184,599,18,241,190,51,403,385,1,14,3,17
E02000254,1280,811,291,520,21,99,60,39,328,301,2,20,5,21
E02000255,1946,1150,381,769,24,260,157,103,493,472,5,11,5,19
E02000256,6294,3952,1297,2655,128,680,321,359,1485,1403,15,39,28,49
E02000257,7577,3911,1318,2593,104,942,465,477,2539,2436,22,70,11,81
E02000258,1104,546,207,339,12,103,37,66,434,404,0,27,3,9
E02000259,1582,889,254,635,23,149,85,64,512,487,4,13,8,9
E02000260,3403,2116,690,1426,62,344,188,156,839,773,9,28,29,42
E02000261,2387,1075,328,747,70,374,198,176,839,780,6,28,25,29
E02000262,3664,1769,515,1254,75,552,275,277,1239,1177,6,41,15,29
E02000263,2385,1421,510,911,37,293,141,152,591,529,24,19,19,43
E02000264,2518,1260,437,823,39,232,113,119,949,923,2,21,3,38
E02000265,3718,1842,574,1268,59,545,312,233,1228,1192,4,26,6,44
E02000266,9184,5457,1452,4005,185,1220,673,547,2261,2119,13,99,30,61
E02000267,2913,1719,488,1231,42,303,180,123,826,791,4,26,5,23
E02000268,3302,1860,608,1252,52,298,184,114,1055,1005,7,34,9,37
E02000269,3465,2070,600,1470,36,264,131,133,1062,994,11,49,8,33
E02000270,4003,2136,658,1478,68,854,535,319,911,870,3,28,10,34
E02000271,3411,1822,604,1218,56,314,160,154,1189,1153,6,26,4,30
E02000272,2070,1276,377,899,25,199,104,95,543,531,0,11,1,27
E02000274,3789,2141,669,1472,60,416,228,188,1123,1024,12,60,27,49
E02000275,1689,1008,310,698,29,169,81,88,462,424,13,11,14,21
E02000276,1683,925,280,645,16,172,110,62,547,510,9,23,5,23
E02000277,1146,800,214,586,19,115,60,55,199,179,1,14,5,13
E02000278,1303,737,195,542,12,297,218,79,243,233,1,7,2,14
E02000279,3655,2144,513,1631,59,526,296,230,900,853,6,30,11,26
E02000280,3302,2404,755,1649,34,344,229,115,469,433,11,24,1,51
E02000281,2217,1491,409,1082,21,307,207,100,378,360,4,12,2,20
E02000282,1836,1130,304,826,17,346,243,103,337,313,3,15,6,6
E02000283,1625,1056,321,735,13,248,160,88,303,277,1,15,10,5
E02000284,3446,2446,729,1717,31,317,185,132,622,573,8,35,6,30
E02000285,3607,2796,831,1965,42,314,198,116,432,399,7,20,6,23
E02000286,6145,4237,1235,3002,60,600,347,253,1197,1094,36,45,22,51
E02000287,3012,2184,771,1413,29,248,153,95,518,489,10,16,3,33
E02000288,6725,4292,1203,3089,64,1079,677,402,1247,1183,8,45,11,43
E02000289,1156,962,329,633,6,70,47,23,102,91,1,6,4,16
E02000290,6845,4073,1115,2958,87,1174,760,414,1464,1389,12,46,17,47
E02000291,4690,3030,923,2107,42,650,426,224,935,891,5,35,4,33
E02000292,3542,2282,574,1708,43,506,345,161,674,648,0,22,4,37
E02000293,1119,918,331,587,3,50,24,26,127,115,4,4,4,21
E02000294,1667,1108,316,792,18,191,128,63,326,306,3,12,5,24
E02000295,1848,1243,425,818,24,174,93,81,387,371,3,13,0,20
E02000296,6298,3834,1146,2688,71,668,382,286,1676,1601,7,55,13,49
E02000297,2046,1594,546,1048,14,140,89,51,279,263,8,5,3,19
E02000298,2145,1521,500,1021,11,184,110,74,396,372,8,11,5,33
E02000299,1969,1136,354,782,26,287,172,115,497,475,3,11,8,23
E02000300,1337,801,233,568,14,162,85,77,341,326,0,8,7,19
E02000301,2106,1195,331,864,26,403,223,180,460,441,1,12,6,22
E02000302,1747,1144,352,792,13,182,116,66,396,379,1,14,2,12
E02000303,2018,1190,356,834,31,344,222,122,431,403,5,12,11,22
E02000304,1524,1078,391,687,18,74,45,29,334,322,3,7,2,20
E02000305,2842,1737,545,1192,18,266,156,110,805,755,11,26,13,16
E02000306,5028,2821,709,2112,68,1015,595,420,1083,1017,6,46,14,41
E02000307,1471,900,258,642,10,146,86,60,407,382,5,16,4,8
E02000308,2579,1455,452,1003,23,337,199,138,730,699,5,19,7,34
E02000309,3926,1993,526,1467,44,790,524,266,1058,1008,6,33,11,41
E02000311,2216,1302,408,894,23,238,113,125,640,605,2,19,14,13
E02000312,2792,1481,438,1043,30,237,144,93,1010,973,4,20,13,34
E02000313,784,312,50,262,10,317,40,277,142,130,1,7,4,3
E02000314,5926,3202,665,2537,130,1236,518,718,1318,1237,7,62,12,40
E02000315,1545,861,207,654,14,397,279,118,260,244,1,14,1,13
E02000316,11364,6299,1620,4679,222,2551,1376,1175,2236,2098,11,94,33,56
E02000317,1386,515,133,382,15,578,389,189,262,241,3,11,7,16
E02000318,2703,1478,322,1156,21,392,216,176,796,737,2,33,24,16
E02000319,2709,1352,344,1008,37,585,298,287,713,683,1,26,3,22
E02000320,1205,754,177,577,14,218,130,88,213,201,0,11,1,6
E02000321,1475,712,210,502,18,438,320,118,291,275,0,12,4,16
E02000323,2743,1370,368,1002,44,713,477,236,598,561,1,27,9,18
E02000324,1728,901,235,666,13,483,277,206,321,309,2,8,2,10
E02000326,1156,621,165,456,10,247,117,130,274,255,1,10,8,4
E02000327,5661,3102,780,2322,79,1270,754,516,1185,909,148,37,91,25
E02000328,1302,742,234,508,25,249,141,108,280,273,0,7,0,6
E02000329,1011,670,144,526,15,161,78,83,155,137,0,16,2,10
E02000331,1332,725,181,544,10,298,184,114,290,265,0,19,6,9
E02000332,1814,1246,319,927,21,259,126,133,272,251,1,15,5,16
E02000333,1986,1170,393,777,16,254,153,101,524,480,17,23,4,22
E02000334,1095,678,176,502,7,225,162,63,175,166,0,8,1,10
E02000335,939,738,190,548,8,84,36,48,97,89,1,3,4,12
E02000337,1276,710,145,565,14,357,275,82,184,166,1,17,0,11
E02000339,2674,1796,492,1304,18,492,296,196,342,317,4,15,6,26
E02000340,3513,2406,662,1744,41,555,341,214,481,447,5,25,4,30
E02000341,1388,782,213,569,11,388,307,81,194,181,5,8,0,13
E02000342,1649,1190,323,867,32,222,128,94,185,167,3,12,3,20
E02000343,1075,687,184,503,1,211,154,57,165,151,3,10,1,11
E02000344,2047,1387,373,1014,18,250,148,102,381,364,2,13,2,11
E02000345,3248,1313,478,835,59,623,310,313,1216,1169,1,35,11,37
E02000346,1294,433,115,318,22,398,292,106,431,422,1,7,1,10
E02000347,1897,655,254,401,16,430,199,231,773,734,0,36,3,23
E02000348,1414,425,146,279,15,404,198,206,545,517,2,18,8,25
E02000350,2156,738,275,463,46,381,138,243,963,915,4,40,4,28
E02000351,1488,554,190,364,29,255,130,125,622,589,5,27,1,28
E02000352,1346,583,181,402,31,339,162,177,377,350,2,19,6,16
E02000353,2697,1126,340,786,38,522,264,258,984,933,10,39,2,27
E02000354,2184,810,205,605,31,619,338,281,703,654,11,27,11,21
E02000355,1961,834,260,574,32,371,184,187,704,670,3,19,12,20
E02000356,1787,855,266,589,36,380,210,170,497,456,2,34,5,19
E02000357,937,334,91,243,13,379,164,215,198,190,1,6,1,13
E02000358,3311,1390,333,1057,71,737,390,347,1077,1023,7,30,17,36
E02000359,1204,522,148,374,25,255,110,145,385,361,3,14,7,17
E02000360,2156,720,211,509,44,718,273,445,643,609,2,27,5,31
E02000361,6234,2864,677,2187,137,1753,883,870,1445,1379,6,46,14,35
E02000362,2616,1251,282,969,71,610,273,337,671,635,3,29,4,13
E02000363,4847,2086,535,1551,121,1538,820,718,1072,1013,3,42,14,30
E02000364,2872,1164,359,805,51,872,427,445,752,699,2,36,15,33
E02000365,4991,1838,546,1292,67,1190,608,582,1825,1741,5,64,15,71
E02000366,1527,574,158,416,32,514,213,301,385,365,1,16,3,22
E02000367,4691,1938,520,1418,125,1120,508,612,1464,1390,6,60,8,44
E02000368,1520,493,124,369,31,533,368,165,445,415,1,23,6,18
E02000369,4155,1595,444,1151,119,1173,653,520,1238,1176,5,38,19,30
E02000370,3995,1906,499,1407,74,676,451,225,1285,1222,4,51,8,54
E02000371,34300,17713,4343,13370,497,3566,1988,1578,12307,11764,42,426,75,217
E02000372,17100,9089,2310,6779,405,2512,995,1517,4956,4730,29,161,36,138
E02000373,1200,405,108,297,27,467,363,104,284,266,6,10,2,17
E02000374,929,425,141,284,19,191,79,112,283,272,2,7,2,11
E02000375,14304,7145,1820,5325,194,2222,1194,1028,4648,4452,21,136,39,95
E02000376,3343,1336,392,944,48,757,362,395,1162,1108,3,38,13,40
E02000377,1940,832,266,566,42,386,143,243,657,643,2,11,1,23
E02000378,3116,1461,421,1040,39,401,224,177,1180,1114,12,46,8,35
E02000379,1501,737,272,465,32,237,108,129,480,450,4,22,4,15
E02000380,1970,1060,398,662,19,306,115,191,558,525,6,25,2,27
E02000381,4409,2329,710,1619,73,639,272,367,1323,1238,13,56,16,45
E02000382,3871,1855,574,1281,55,510,240,270,1398,1332,17,43,6,53
E02000383,7385,3916,1083,2833,92,788,401,387,2519,2371,21,96,31,70
E02000384,20523,10048,2700,7348,360,2824,1427,1397,7114,6794,49,214,57,177
E02000385,1701,738,240,498,13,236,127,109,680,645,4,27,4,34
E02000386,4437,2651,644,2007,78,786,472,314,882,833,10,38,1,40
E02000387,5069,2295,638,1657,118,1138,453,685,1471,1368,18,70,15,47
E02000388,3610,1553,481,1072,68,668,326,342,1280,1192,17,61,10,41
E02000389,3751,1941,554,1387,48,334,171,163,1382,1321,4,47,10,46
E02000390,1977,837,267,570,25,338,174,164,754,709,3,41,1,23
E02000391,4461,2141,685,1456,43,740,387,353,1482,1395,16,62,9,55
E02000392,4565,2173,666,1507,75,742,426,316,1525,1454,16,48,7,50
E02000393,1185,598,222,376,13,124,72,52,438,415,0,22,1,12
E02000394,4632,2164,666,1498,72,807,431,376,1531,1447,5,69,10,58
E02000395,3928,1824,638,1186,34,534,279,255,1468,1399,10,48,11,68
E02000396,3023,1465,490,975,39,492,287,205,986,930,5,40,11,41
E02000397,1757,797,200,597,14,235,135,100,691,669,3,16,3,20
E02000398,3068,1394,378,1016,39,692,426,266,909,862,2,39,6,34
E02000400,2328,1299,396,903,33,329,198,131,646,617,5,20,4,21
E02000401,1083,466,94,372,12,308,223,85,290,278,5,6,1,7
E02000402,1097,443,101,342,15,305,206,99,321,311,1,4,5,13
E02000403,5778,3124,878,2246,86,998,607,391,1520,1477,5,29,9,50
E02000404,1548,660,193,467,31,270,176,94,573,553,3,11,6,14
E02000405,1649,1069,339,730,18,140,77,63,410,398,3,7,2,12
E02000406,1048,356,105,251,9,201,167,34,471,458,0,8,5,11
E02000407,2065,812,204,608,33,439,239,200,753,724,1,28,0,28
E02000408,2144,941,210,731,39,510,293,217,626,603,0,18,5,28
E02000409,1601,733,172,561,15,448,290,158,388,355,2,22,9,17
E02000410,2019,1187,375,812,11,185,106,79,620,592,12,14,2,16
E02000411,3598,1752,438,1314,36,723,400,323,1057,1019,5,24,9,30
E02000412,5804,2569,741,1828,88,1341,787,554,1761,1679,7,53,22,45
E02000413,1662,994,346,648,21,177,115,62,454,429,2,19,4,16
E02000414,1309,519,152,367,12,207,109,98,557,546,0,7,4,14
E02000415,1781,840,270,570,44,262,147,115,624,588,1,24,11,11
E02000416,2013,919,247,672,33,445,262,183,604,579,4,19,2,12
E02000417,2750,1459,543,916,30,323,189,134,900,856,9,27,8,38
E02000418,1474,1008,335,673,15,138,89,49,302,287,3,8,4,11
E02000419,2445,1092,299,793,20,425,251,174,875,841,12,11,11,33
E02000420,1679,675,192,483,19,283,148,135,690,659,5,11,15,12
E02000421,3809,1799,484,1315,63,858,520,338,1062,1025,2,29,6,27
E02000422,1656,623,199,424,38,378,256,122,597,577,7,10,3,20
E02000423,2810,1445,437,1008,46,399,232,167,897,857,4,18,18,23
E02000424,1865,1053,299,754,32,319,148,171,442,424,0,17,1,19
E02000425,1454,510,145,365,35,216,123,93,678,658,0,10,10,15
E02000426,2692,1546,570,976,22,336,212,124,728,668,28,24,8,60
E02000427,1620,650,220,430,21,291,165,126,645,616,1,22,6,13
E02000428,2208,821,256,565,26,497,340,157,844,816,2,15,11,20
E02000429,1686,940,354,586,21,170,94,76,545,526,5,13,1,10
E02000430,3156,1589,466,1123,35,442,227,215,1056,1021,3,27,5,34
E02000431,1779,958,385,573,13,157,85,72,628,599,5,20,4,23
E02000432,1234,537,174,363,13,281,175,106,394,374,2,13,5,9
E02000433,4400,2998,1037,1961,61,392,185,207,904,846,17,31,10,45
E02000434,2822,1783,614,1169,18,211,105,106,781,698,29,21,33,29
E02000435,1476,1000,355,645,12,142,102,40,309,273,16,9,11,13
E02000436,1316,1060,395,665,4,71,37,34,167,159,4,2,2,14
E02000437,1969,1362,440,922,30,171,111,60,392,362,1,24,5,14
E02000438,2498,1627,535,1092,15,258,154,104,565,535,6,18,6,33
E02000439,2592,1439,425,1014,28,233,155,78,871,830,5,32,4,21
E02000440,1743,1313,439,874,12,60,31,29,340,322,2,11,5,18
E02000441,1259,886,284,602,4,151,102,49,198,187,2,7,2,20
E02000442,1930,1183,401,782,14,84,43,41,623,579,10,27,7,26
E02000443,2626,1708,546,1162,32,258,127,131,615,583,2,19,11,13
E02000444,1477,939,299,640,12,73,35,38,445,424,1,16,4,8
E02000445,3451,2187,712,1475,46,337,150,187,865,819,11,25,10,16
E02000447,1261,941,318,623,11,67,36,31,234,215,5,12,2,8
E02000448,2953,2185,794,1391,17,216,116,100,504,466,11,16,11,31
E02000449,1440,890,335,555,9,93,60,33,429,409,4,10,6,19
E02000451,1313,1033,337,696,8,57,28,29,206,198,3,4,1,9
E02000452,5988,3773,1202,2571,70,539,245,294,1558,1472,18,52,16,48
E02000453,1960,1207,410,797,16,134,61,73,584,557,7,14,6,19
E02000454,1197,989,339,650,6,41,29,12,146,134,1,10,1,15
E02000455,8424,5199,1536,3663,115,889,437,452,2164,2052,10,51,51,57
E02000456,1074,681,207,474,6,78,42,36,297,276,3,18,0,12
E02000457,2960,1874,552,1322,30,255,120,135,781,751,5,21,4,20
E02000459,3110,2058,598,1460,54,249,123,126,715,671,9,27,8,34
E02000460,1037,630,191,439,9,174,53,121,213,196,3,7,7,11
E02000461,3328,2049,675,1374,45,233,132,101,868,777,55,29,7,133
E02000462,1417,856,243,613,7,104,47,57,435,407,4,19,5,15
E02000463,1122,742,222,520,11,116,86,30,239,224,3,11,1,14
E02000464,1073,740,195,545,10,220,190,30,99,94,4,1,0,4
E02000465,1432,992,240,752,12,278,237,41,134,123,1,10,0,16
E02000466,1722,1326,390,936,7,192,156,36,191,170,2,14,5,6
E02000467,2371,1505,339,1166,15,549,462,87,288,268,3,14,3,14
E02000468,1691,1321,391,930,11,183,150,33,166,152,7,7,0,10
E02000469,1401,992,236,756,3,244,207,37,151,141,4,4,2,11
E02000470,6139,4349,1189,3160,46,841,610,231,868,800,17,47,4,35
E02000471,1252,1134,328,806,3,46,31,15,66,60,0,6,0,3
E02000472,1921,1574,421,1153,5,161,109,52,169,157,1,10,1,12
E02000473,2632,2153,613,1540,20,189,131,58,258,246,3,9,0,12
E02000474,1888,1373,356,1017,14,250,177,73,242,219,2,19,2,9
E02000475,2240,1697,496,1201,16,195,146,49,317,300,1,15,1,15
E02000476,14364,10148,2760,7388,150,1861,1340,521,2128,1996,15,100,17,77
E02000477,1556,1329,408,921,5,56,43,13,162,149,1,12,0,4
E02000478,1098,929,342,587,3,67,41,26,93,86,2,5,0,6
E02000479,4843,3613,999,2614,51,514,372,142,640,598,3,33,6,25
E02000480,8675,6204,1639,4565,83,1101,730,371,1255,1171,6,60,18,32
E02000481,1530,1227,364,863,6,137,112,25,148,135,0,10,3,12
E02000482,1637,1369,455,914,11,86,56,30,162,147,3,12,0,9
E02000483,3968,3033,897,2136,20,412,304,108,471,434,5,31,1,32
E02000484,1693,1345,374,971,11,160,115,45,167,147,2,17,1,10
E02000485,3138,2495,744,1751,13,240,171,69,375,352,2,19,2,15
E02000486,1666,1353,375,978,7,122,96,26,178,168,0,8,2,6
E02000487,1744,1479,454,1025,8,109,78,31,129,112,10,6,1,19
E02000488,1905,1586,470,1116,14,129,91,38,168,162,2,4,0,8
E02000489,1256,976,277,699,8,122,96,26,143,131,0,9,3,7
E02000490,1296,1071,288,783,9,96,71,25,114,106,1,7,0,6
E02000491,3580,2504,613,1891,30,521,342,179,509,474,4,29,2,16
E02000492,3401,2468,668,1800,31,393,285,108,497,470,3,21,3,12
E02000493,1494,1061,283,778,8,193,117,76,227,215,3,9,0,5
E02000494,2907,2106,717,1389,32,276,133,143,461,399,24,15,23,32
E02000495,5130,3473,1023,2450,33,449,272,177,1118,1025,30,47,16,57
E02000496,4231,2919,784,2135,58,456,302,154,770,701,26,33,10,28
E02000497,1948,1403,422,981,16,185,126,59,331,305,4,17,5,13
E02000498,1562,1165,308,857,21,146,82,64,213,192,6,8,7,17
E02000499,2003,1518,514,1004,16,152,95,57,305,276,5,16,8,12
E02000500,3539,2541,766,1775,37,315,166,149,615,549,27,22,17,31
E02000501,1827,1416,397,1019,14,123,71,52,262,245,4,11,2,12
E02000502,1890,1256,292,964,21,160,94,66,441,383,19,14,25,12
E02000503,1367,1080,292,788,18,84,39,45,175,149,5,15,6,10
E02000504,1793,1418,440,978,19,105,70,35,233,194,13,18,8,18
E02000506,2401,1863,587,1276,19,191,94,97,315,286,14,10,5,13
E02000507,2223,1396,368,1028,26,367,222,145,400,378,4,12,6,34
E02000508,13300,9005,2582,6423,211,1224,681,543,2766,2605,47,86,28,94
E02000509,12931,8609,2204,6405,200,1208,692,516,2807,2635,33,113,26,107
E02000510,5211,3515,947,2568,93,661,298,363,913,845,16,38,14,29
E02000511,2925,2104,538,1566,37,240,131,109,523,506,5,11,1,21
E02000512,1251,778,194,584,19,203,138,65,242,225,3,10,4,9
E02000513,1656,953,246,707,34,307,203,104,338,324,1,7,6,24
E02000514,1654,1079,286,793,10,129,76,53,415,375,8,17,15,21
E02000515,3962,2560,645,1915,85,573,349,224,724,678,7,30,9,20
E02000516,1045,661,181,480,23,143,40,103,209,199,1,9,0,9
E02000517,1491,895,215,680,29,250,177,73,308,289,3,12,4,9
E02000518,5557,3865,1016,2849,89,629,356,273,947,897,8,32,10,27
E02000519,3358,1950,577,1373,60,554,318,236,769,713,14,28,14,25
E02000520,12476,8116,1964,6152,191,1327,765,562,2767,2608,24,98,37,75
E02000521,2006,1152,239,913,52,343,173,170,449,422,4,20,3,10
E02000522,1846,1102,274,828,31,325,179,146,382,357,5,15,5,6
E02000523,3738,2382,611,1771,77,309,164,145,949,905,8,28,8,21
E02000524,46105,31752,7585,24167,781,3919,1973,1946,9398,8891,68,330,109,255
E02000525,4696,2885,741,2144,91,474,251,223,1205,1131,19,44,11,41
E02000526,5167,2809,925,1884,71,561,315,246,1682,1584,13,72,13,44
E02000528,6357,3519,889,2630,144,873,562,311,1794,1713,11,55,15,27
E02000529,1435,844,284,560,19,197,129,68,369,348,3,12,6,6
E02000530,6443,4143,1060,3083,111,821,466,355,1326,1230,22,53,21,42
E02000531,8860,5441,1391,4050,139,865,526,339,2341,2236,22,59,24,74
E02000532,3098,1805,616,1189,28,377,221,156,857,825,5,23,4,31
E02000533,1829,1089,369,720,15,201,116,85,502,471,10,20,1,22
E02000534,10171,6296,1507,4789,207,847,453,394,2758,2632,19,89,18,63
E02000535,1212,788,275,513,4,77,49,28,330,303,6,15,6,13
E02000536,3584,2313,717,1596,78,409,206,203,760,707,12,32,9,24
E02000537,1626,824,289,535,17,113,59,54,663,635,3,21,4,9
E02000538,5477,3461,875,2586,92,625,353,272,1256,1154,18,51,33,43
E02000539,5759,3390,953,2437,137,935,495,440,1257,1165,11,56,25,40
E02000540,3934,2120,632,1488,81,592,342,250,1114,1058,8,35,13,27
E02000541,2133,1098,343,755,23,278,125,153,715,679,10,13,13,19
E02000542,3692,2156,602,1554,83,369,206,163,1058,1002,8,19,29,26
E02000543,6835,3692,1025,2667,133,861,467,394,2106,1991,27,60,28,43
E02000544,1370,915,247,668,20,84,47,37,346,334,0,9,3,5
E02000545,2805,1594,438,1156,43,503,359,144,638,605,6,18,9,27
E02000546,2930,1771,501,1270,76,357,179,178,708,625,27,27,29,18
E02000547,7533,4825,1219,3606,131,987,557,430,1560,1475,15,54,16,30
E02000548,6412,4399,932,3467,140,561,276,285,1272,1208,6,53,5,40
E02000549,3159,1951,489,1462,54,451,257,194,674,638,9,17,10,29
E02000550,2324,1219,296,923,72,517,300,217,503,480,4,18,1,13
E02000551,4232,2559,619,1940,79,729,395,334,836,789,5,35,7,29
E02000552,4949,3240,815,2425,115,554,256,298,1003,904,24,47,28,37
E02000553,974,638,161,477,15,163,121,42,149,135,4,6,4,9
E02000554,1766,742,230,512,17,590,421,169,403,367,1,30,5,14
E02000555,2274,1106,399,707,41,540,345,195,568,532,1,34,1,19
E02000556,2881,1236,337,899,42,695,400,295,868,834,4,24,6,40
E02000557,6160,2990,864,2126,113,1636,943,693,1368,1310,10,39,9,53
E02000558,2399,939,244,695,37,798,502,296,582,548,8,19,7,43
E02000559,10462,5453,1516,3937,134,2296,1224,1072,2497,2377,12,83,25,82
E02000560,3714,1567,487,1080,51,1104,667,437,939,895,5,30,9,53
E02000561,1822,1020,377,643,20,326,148,178,432,414,3,12,3,24
E02000562,1913,955,337,618,23,403,258,145,507,492,2,11,2,25
E02000563,2355,947,286,661,47,778,492,286,558,526,1,20,11,25
E02000564,4093,1952,638,1314,90,894,511,383,1114,1057,4,43,10,43
E02000565,1748,719,206,513,20,507,337,170,482,452,5,18,7,20
E02000566,4835,2307,726,1581,78,1198,678,520,1202,1133,10,45,14,50
E02000567,1975,842,256,586,30,537,356,181,547,524,3,20,0,19
E02000568,6340,3119,788,2331,117,1531,834,697,1517,1435,17,52,13,56
E02000569,3990,1898,508,1390,74,897,549,348,1059,997,8,41,13,62
E02000570,2498,1190,462,728,19,469,234,235,787,755,6,21,5,33
E02000571,2440,1086,337,749,42,648,416,232,642,605,10,22,5,22
E02000572,3068,1290,358,932,52,845,427,418,863,822,4,30,7,18
E02000573,11307,5704,1606,4098,147,1799,1043,756,3529,3348,22,135,24,128
E02000574,14534,8081,1834,6247,243,1747,967,780,4373,4167,24,147,35,90
E02000575,37865,20602,5214,15388,613,3515,1919,1596,12878,12154,85,544,95,257
E02000576,36118,20550,5163,15387,509,3406,1861,1545,11384,10837,44,419,84,269
E02000577,4533,1715,540,1175,81,1411,679,732,1284,1214,4,49,17,42
E02000578,2852,1171,339,832,95,791,254,537,755,711,3,28,13,40
E02000579,2985,1364,487,877,53,644,244,400,884,835,6,33,10,40
E02000580,3914,1609,618,991,66,945,312,633,1251,1189,7,45,10,43
E02000581,3739,1692,465,1227,64,836,422,414,1111,1034,12,55,10,36
E02000582,4102,1814,747,1067,66,537,234,303,1621,1527,17,56,21,64
E02000583,3022,1441,719,722,31,416,163,253,1055,996,14,37,8,79
E02000584,7975,4004,1451,2553,129,978,498,480,2723,2581,30,84,28,141
E02000585,3165,1490,619,871,36,342,142,200,1217,1152,5,37,23,80
E02000586,9896,5004,1465,3539,141,901,459,442,3635,3440,25,135,35,215
E02000587,4489,2261,825,1436,70,528,267,261,1549,1473,10,47,19,81
E02000588,18674,8734,2741,5993,279,2232,1126,1106,6993,6658,52,227,56,436
E02000589,4446,2012,727,1285,67,611,294,317,1674,1590,12,56,16,82
E02000590,6241,2844,909,1935,85,842,389,453,2352,2227,24,59,42,118
E02000591,2223,877,294,583,39,472,182,290,803,752,2,28,21,32
E02000592,8037,3797,1322,2475,138,922,422,500,3052,2911,24,83,34,128
E02000593,2194,979,390,589,28,332,141,191,803,748,16,34,5,52
E02000594,5462,2569,1023,1546,62,733,367,366,1935,1802,47,72,14,163
E02000595,8225,4187,1445,2742,152,1124,523,601,2623,2440,41,119,23,139
E02000596,6333,3016,1040,1976,148,1151,498,653,1918,1806,17,70,25,100
E02000597,3223,1462,584,878,37,519,301,218,1168,1099,11,52,6,37
E02000598,1684,1227,367,860,30,109,41,68,311,288,6,13,4,7
E02000599,2781,1902,698,1204,26,197,113,84,622,593,12,14,3,34
E02000600,4728,2960,871,2089,52,527,306,221,1142,1063,25,47,7,47
E02000601,3148,1858,565,1293,27,356,200,156,868,821,12,25,10,39
E02000602,5236,3162,882,2280,57,621,387,234,1353,1268,24,51,10,43
E02000603,1691,950,276,674,26,304,185,119,400,378,1,19,2,11
E02000604,5232,3429,991,2438,69,410,187,223,1264,1178,10,61,15,60
E02000605,2149,1505,481,1024,32,158,103,55,440,409,5,18,8,14
E02000606,18090,11305,3263,8042,202,1662,909,753,4798,4530,37,175,56,123
E02000607,1353,849,289,560,13,87,50,37,390,352,15,22,1,14
E02000608,3403,2038,555,1483,27,299,157,142,996,935,17,31,13,43
E02000609,1427,1051,322,729,13,112,71,41,241,216,5,12,8,10
E02000610,2756,1732,553,1179,27,228,105,123,746,697,5,29,15,23
E02000611,1231,1017,305,712,3,51,32,19,150,134,6,10,0,10
E02000612,1612,1188,375,813,10,93,56,37,310,302,1,6,1,11
E02000613,1836,1266,376,890,12,153,84,69,388,365,4,15,4,17
E02000614,5363,3669,985,2684,87,502,282,220,1070,1001,12,42,15,35
E02000615,2558,1879,502,1377,28,218,141,77,412,374,6,29,3,21
E02000616,1808,1280,302,978,16,147,78,69,357,333,2,21,1,8
E02000617,3808,2579,634,1945,45,431,219,212,718,645,15,50,8,35
E02000619,3020,1442,415,1027,54,693,476,217,796,743,4,34,15,35
E02000620,8467,4302,1128,3174,153,1376,811,565,2562,2442,13,87,20,74
E02000621,7768,4009,997,3012,158,1414,710,704,2115,1980,6,103,26,72
E02000622,3315,1576,416,1160,34,657,338,319,1028,963,4,48,13,20
E02000623,1319,436,136,300,14,449,223,226,401,382,0,14,5,19
E02000624,1372,460,127,333,16,491,289,202,391,366,2,16,7,14
E02000625,2619,1015,234,781,41,844,527,317,700,659,1,27,13,19
E02000626,1662,594,148,446,19,654,463,191,385,342,4,32,7,10
E02000627,2276,931,251,680,39,664,328,336,621,594,3,19,5,21
E02000628,5245,2255,464,1791,89,1502,757,745,1339,1257,7,62,13,60
E02000629,2865,1311,371,940,47,460,278,182,1012,957,8,34,13,35
E02000630,3514,1672,503,1169,48,610,370,240,1160,1102,8,44,6,24
E02000631,10535,5147,1270,3877,247,2305,1134,1171,2741,2603,29,82,27,95
E02000632,2134,878,232,646,35,428,223,205,772,729,5,34,4,21
E02000633,4303,1976,450,1526,61,1167,612,555,1050,992,2,41,15,49
E02000634,2771,1215,324,891,53,648,382,266,823,777,10,26,10,32
E02000635,2263,902,261,641,27,614,271,343,694,660,0,27,7,26
E02000636,2485,1224,393,831,25,513,293,220,708,680,5,20,3,15
E02000637,1877,870,234,636,25,379,173,206,583,545,5,29,4,20
E02000638,2692,1151,281,870,44,703,427,276,778,723,8,29,18,16
E02000639,1113,328,83,245,6,428,190,238,333,319,1,6,7,18
E02000640,1826,927,252,675,23,322,173,149,538,518,1,16,3,16
E02000641,1348,475,116,359,14,510,285,225,338,320,1,12,5,11
E02000642,1897,896,263,633,21,470,192,278,495,472,0,17,6,15
E02000643,1826,832,209,623,17,383,238,145,574,541,3,19,11,20
E02000644,1709,822,201,621,18,285,142,143,568,538,6,21,3,16
E02000645,3542,1829,510,1319,48,699,363,336,940,879,6,37,18,26
E02000646,3208,1496,453,1043,27,521,286,235,1139,1085,8,36,10,25
E02000647,1586,870,251,619,27,203,118,85,471,450,0,17,4,15
E02000648,1410,680,156,524,30,384,250,134,312,294,3,8,7,4
E02000649,3464,1523,371,1152,39,555,288,267,1319,1264,5,40,10,28
E02000650,1500,690,139,551,17,325,204,121,439,408,10,18,3,29
E02000651,1777,938,283,655,7,217,99,118,600,585,1,10,4,15
E02000652,1212,543,147,396,25,121,53,68,514,504,0,9,1,9
E02000653,1464,483,122,361,44,518,292,226,402,376,1,19,6,17
E02000654,2317,970,237,733,47,703,449,254,577,525,6,40,6,20
E02000655,2715,1237,322,915,65,658,403,255,742,696,4,36,6,13
E02000657,3539,1661,486,1175,51,698,369,329,1096,1026,6,56,8,33
E02000658,1914,891,271,620,27,472,280,192,504,481,0,16,7,20
E02000659,3165,1906,432,1474,52,567,361,206,614,577,2,31,4,26
E02000660,2056,957,248,709,58,403,221,182,618,568,6,39,5,20
E02000661,2676,1438,466,972,22,482,254,228,708,668,11,25,4,26
E02000662,1966,841,210,631,31,504,329,175,572,448,2,119,3,18
E02000663,1289,646,182,464,9,249,95,154,380,304,4,68,4,5
E02000664,8881,4526,1078,3448,155,2050,1039,1011,2080,1961,14,80,25,70
E02000665,1769,971,274,697,19,326,176,150,441,419,1,17,4,12
E02000666,1346,698,187,511,10,248,113,135,361,338,0,21,2,29
E02000667,1256,701,187,514,17,193,80,113,334,316,0,12,6,11
E02000668,1934,1185,363,822,24,325,166,159,390,355,8,23,4,10
E02000669,1872,902,217,685,19,398,177,221,537,507,0,24,6,16
E02000670,1290,605,143,462,9,302,127,175,363,345,3,12,3,11
E02000671,3017,1691,446,1245,32,530,274,256,738,701,3,27,7,26
E02000672,6351,3437,809,2628,100,1421,674,747,1340,1256,8,60,16,53
E02000673,2195,1134,343,791,18,422,198,224,600,559,13,23,5,21
E02000674,1230,790,193,597,5,189,81,108,239,226,0,10,3,7
E02000675,1553,977,265,712,11,233,64,169,318,291,5,18,4,14
E02000676,1248,669,156,513,19,175,74,101,374,355,3,12,4,11
E02000677,2340,1504,338,1166,17,398,151,247,405,385,0,14,6,16
E02000678,792,473,89,384,5,153,59,94,159,147,3,6,3,2
E02000679,1674,923,238,685,27,324,167,157,387,362,2,21,2,13
E02000680,1576,820,212,608,24,346,180,166,354,338,2,13,1,32
E02000681,1892,986,269,717,22,512,226,286,363,340,4,16,3,9
E02000682,1594,953,243,710,16,352,136,216,262,249,1,11,1,11
E02000683,1038,564,124,440,12,240,78,162,214,202,0,8,4,8
E02000685,1486,782,197,585,12,348,174,174,318,296,0,17,5,26
E02000686,1719,893,243,650,19,482,235,247,308,291,2,14,1,17
E02000687,1933,1051,272,779,16,379,178,201,468,436,6,22,4,19
E02000689,4685,2608,802,1806,65,672,328,344,1295,1232,5,44,14,45
E02000690,2893,1913,735,1178,26,213,99,114,674,620,26,26,2,67
E02000691,4610,2679,739,1940,66,546,261,285,1284,1222,7,42,13,35
E02000692,7957,4676,1409,3267,77,576,246,330,2557,2415,19,98,25,71
E02000693,3181,1502,419,1083,31,500,196,304,1130,1085,7,30,8,18
E02000694,2865,1563,398,1165,27,425,184,241,827,787,5,29,6,23
E02000695,1684,842,277,565,7,126,66,60,687,652,9,22,4,22
E02000696,1889,854,184,670,18,219,85,134,789,752,4,28,5,9
E02000697,7123,3880,1066,2814,75,794,424,370,2311,2197,20,76,18,63
E02000698,1965,1353,482,871,19,144,62,82,431,405,5,16,5,18
E02000699,1887,1201,374,827,21,151,57,94,497,476,4,14,3,17
E02000700,3588,1957,495,1462,51,614,234,380,940,897,5,30,8,26
E02000701,1812,945,256,689,20,279,111,168,548,526,2,19,1,20
E02000702,1024,535,126,409,19,165,53,112,289,278,1,9,1,16
E02000703,1458,1019,364,655,4,96,38,58,329,315,6,8,0,10
E02000704,3717,2239,655,1584,31,411,200,211,997,930,12,43,12,39
E02000705,1444,895,243,652,14,105,42,63,425,410,1,11,3,5
E02000706,1978,986,254,732,19,460,155,305,487,464,0,15,8,26
E02000707,1082,635,155,480,14,193,27,166,233,220,4,7,2,7
E02000708,2979,1974,561,1413,32,223,119,104,729,688,5,29,7,21
E02000709,1079,868,262,606,1,48,21,27,157,145,1,11,0,5
E02000710,5822,3556,901,2655,70,869,397,472,1295,1222,8,55,10,32
E02000711,4044,2467,637,1830,42,584,236,348,921,863,11,33,14,30
E02000712,2014,1212,316,896,21,350,122,228,408,369,1,25,13,23
E02000713,2249,1648,399,1249,24,223,103,120,332,311,1,18,2,22
E02000714,1567,649,177,472,26,235,120,115,644,617,1,9,17,13
E02000715,1270,559,156,403,15,200,133,67,484,460,1,20,3,12
E02000716,1247,530,167,363,15,179,94,85,502,470,8,16,8,21
E02000717,1821,891,266,625,14,264,140,124,636,599,5,25,7,16
E02000718,1053,552,148,404,8,212,145,67,273,262,2,8,1,8
E02000719,1859,640,160,480,33,348,152,196,821,795,2,16,8,17
E02000720,1426,692,232,460,13,154,85,69,554,529,0,12,13,13
E02000721,3169,1585,428,1157,49,394,191,203,1107,1057,4,31,15,34
E02000722,2343,983,300,683,37,314,127,187,991,958,1,24,8,18
E02000723,2521,1326,415,911,23,251,129,122,889,825,20,27,17,32
E02000724,1429,682,224,458,19,126,60,66,589,554,3,23,9,13
E02000725,8818,4450,1086,3364,213,1631,868,763,2459,2345,6,82,26,65
E02000726,7066,3426,851,2575,118,1105,638,467,2374,2292,5,60,17,43
E02000727,1901,893,308,585,17,176,95,81,800,762,4,23,11,15
E02000728,998,475,166,309,9,51,26,25,455,427,0,25,3,8
E02000729,1207,442,140,302,10,129,47,82,614,589,3,19,3,12
E02000730,2340,1146,386,760,9,283,151,132,881,840,7,24,10,21
E02000731,4038,1998,574,1424,31,526,299,227,1450,1392,3,43,12,33
E02000732,1840,830,233,597,27,401,272,129,568,559,1,6,2,14
E02000733,2372,1017,258,759,30,491,339,152,813,779,5,23,6,21
E02000734,1088,341,94,247,30,268,178,90,438,425,0,7,6,11
E02000735,1953,985,317,668,25,277,153,124,652,629,1,13,9,14
E02000736,2052,1002,264,738,23,351,257,94,662,633,0,19,10,14
E02000737,2891,1489,400,1089,48,618,399,219,705,667,0,30,8,31
E02000738,1364,617,166,451,18,127,68,59,582,560,2,13,7,20
E02000739,1697,774,195,579,22,325,185,140,564,528,2,25,9,12
E02000740,2670,1199,285,914,26,618,374,244,799,764,2,26,7,28
E02000741,5615,2941,681,2260,110,1058,531,527,1472,1410,7,43,12,34
E02000742,1224,578,145,433,7,180,126,54,448,421,0,16,11,11
E02000743,2735,1111,284,827,45,694,445,249,853,802,12,23,16,32
E02000744,1687,709,155,554,15,258,156,102,693,672,1,19,1,12
E02000745,1180,417,93,324,9,208,106,102,533,525,0,6,2,13
E02000746,7465,3710,959,2751,80,1660,890,770,1960,1851,11,73,25,55
E02000747,5862,2780,693,2087,122,1255,775,480,1665,1605,4,39,17,40
E02000748,5088,3034,741,2293,99,693,382,311,1234,1177,6,39,12,28
E02000749,2590,1057,213,844,57,573,348,225,876,837,2,26,11,27
E02000750,6231,3133,796,2337,77,1190,693,497,1795,1716,11,58,10,36
E02000751,3298,2421,842,1579,29,245,149,96,555,524,8,16,7,48
E02000752,3251,2268,633,1635,35,479,359,120,444,419,2,21,2,25
E02000753,690,471,104,367,7,88,64,24,118,111,0,7,0,6
E02000754,1134,781,234,547,11,89,60,29,243,229,2,11,1,10
E02000755,1398,970,237,733,10,170,123,47,239,222,3,11,3,9
E02000756,4029,2905,827,2078,34,288,208,80,760,708,2,41,9,42
E02000757,4018,2713,851,1862,55,347,204,143,866,808,14,37,7,37
E02000758,1144,912,266,646,7,78,59,19,142,131,2,9,0,5
E02000759,2794,1860,501,1359,24,277,185,92,606,579,2,22,3,27
E02000760,1573,1081,294,787,16,163,98,65,305,281,2,21,1,8
E02000762,978,703,219,484,7,62,35,27,201,185,6,10,0,5
E02000763,2020,1415,457,958,28,193,126,67,357,341,0,13,3,27
E02000764,3627,2353,767,1586,40,334,204,130,852,806,9,34,3,48
E02000765,1471,1010,333,677,18,109,62,47,322,302,4,12,4,12
E02000767,2567,1715,521,1194,47,230,144,86,556,518,7,28,3,19
E02000768,962,694,239,455,2,82,41,41,178,157,8,11,2,6
E02000769,2763,1935,471,1464,46,249,132,117,500,465,1,25,9,33
E02000770,1439,970,270,700,15,93,54,39,350,325,1,12,12,11
E02000772,5228,3541,1016,2525,68,593,365,228,991,925,3,54,9,35
E02000773,2305,1516,453,1063,36,205,126,79,525,506,1,13,5,23
E02000774,1343,833,251,582,5,69,44,25,431,407,1,20,3,5
E02000776,1933,1248,398,850,10,154,85,69,504,476,5,18,5,17
E02000777,878,605,205,400,2,79,60,19,176,166,1,7,2,16
E02000779,3070,1746,536,1210,31,328,175,153,942,904,5,26,7,23
E02000780,8297,5403,1556,3847,100,853,517,336,1870,1758,11,82,19,71
E02000781,2500,1709,454,1255,21,192,121,71,566,526,3,15,22,12
E02000782,2953,1785,527,1258,51,337,182,155,761,725,1,27,8,19
E02000783,1007,528,160,368,10,110,50,60,346,323,0,22,1,13
E02000784,3093,1759,727,1032,19,343,136,207,915,801,63,37,14,57
E02000785,4666,2772,1019,1753,48,431,174,257,1358,1283,16,50,9,57
E02000786,3767,2188,776,1412,42,488,199,289,1011,953,10,34,14,38
E02000787,3702,2136,650,1486,64,540,234,306,924,880,7,31,6,38
E02000788,3029,1805,581,1224,28,368,171,197,790,739,5,31,15,38
E02000789,2310,1336,410,926,21,286,76,210,642,610,10,18,4,25
E02000790,2068,1339,435,904,27,127,46,81,531,502,1,23,5,44
E02000791,9158,5154,1539,3615,101,852,373,479,2937,2759,41,110,27,114
E02000792,2035,1275,436,839,17,132,55,77,591,564,6,17,4,20
E02000793,1861,1243,362,881,23,193,77,116,385,306,29,25,25,17
E02000794,2790,1859,556,1303,40,303,146,157,571,525,7,25,14,17
E02000795,1999,1360,516,844,20,162,64,98,411,379,5,17,10,46
E02000796,1840,1276,379,897,21,240,92,148,289,264,2,19,4,14
E02000797,7531,4815,1322,3493,140,716,279,437,1809,1705,23,68,13,51
E02000798,2505,1728,509,1219,16,288,132,156,457,426,9,18,4,16
E02000799,2232,1548,542,1006,22,174,71,103,464,439,5,18,2,24
E02000800,851,535,176,359,17,122,47,75,165,151,1,11,2,12
E02000801,4074,2687,742,1945,57,391,174,217,910,853,9,42,6,29
E02000802,2608,1747,467,1280,21,257,111,146,565,514,12,29,10,18
E02000803,2516,1668,547,1121,42,357,137,220,412,389,5,15,3,37
E02000804,5776,3850,1153,2697,81,437,176,261,1378,1297,17,49,15,30
E02000805,3149,2126,676,1450,29,237,97,140,721,675,11,28,7,36
E02000806,4342,3059,947,2112,61,365,148,217,811,742,21,31,17,46
E02000807,1785,847,227,620,57,333,157,176,534,514,0,12,8,14
E02000808,55575,33162,7783,25379,899,5282,2821,2461,15876,15010,159,585,122,356
E02000809,34901,19335,4579,14756,503,3366,1877,1489,11406,10835,43,446,82,291
E02000810,2689,1167,301,866,97,836,562,274,567,535,2,24,6,22
E02000812,6627,3285,792,2493,121,1481,916,565,1673,1561,28,65,19,67
E02000813,2951,1026,273,753,54,1062,739,323,774,726,14,24,10,35
E02000814,2306,1072,289,783,45,554,296,258,612,584,0,22,6,23
E02000815,3686,1768,464,1304,76,847,551,296,887,833,14,28,12,108
E02000816,2992,1167,272,895,85,917,586,331,788,745,0,37,6,35
E02000817,2257,920,227,693,36,751,499,252,533,508,0,19,6,17
E02000818,2371,791,191,600,41,927,579,348,593,556,3,20,14,19
E02000819,2319,890,232,658,55,845,515,330,515,478,0,25,12,14
E02000820,2725,1228,278,950,51,713,463,250,709,673,5,25,6,24
E02000821,2331,692,161,531,33,1049,793,256,533,504,1,22,6,24
E02000822,1648,545,125,420,29,716,527,189,342,332,0,8,2,16
E02000823,2087,819,209,610,30,735,539,196,478,462,1,13,2,25
E02000824,3589,1403,348,1055,51,1383,968,415,720,683,1,25,11,32
E02000825,1616,531,112,419,49,709,493,216,312,292,0,10,10,15
E02000826,2302,966,202,764,27,756,510,246,520,491,2,24,3,33
E02000827,4015,1380,306,1074,70,1577,988,589,941,889,6,35,11,47
E02000828,2824,1041,241,800,49,1074,735,339,636,604,5,19,8,24
E02000829,1854,719,161,558,32,549,365,184,536,515,4,15,2,18
E02000830,5163,2639,677,1962,78,962,543,419,1437,1348,7,69,13,47
E02000831,2882,1378,345,1033,42,755,433,322,673,603,1,41,28,34
E02000832,1883,773,190,583,50,634,392,242,403,385,1,15,2,23
E02000833,1546,604,164,440,18,561,410,151,314,289,2,18,5,49
E02000834,2417,1239,318,921,27,458,219,239,657,620,1,32,4,36
E02000835,1151,640,164,476,14,234,159,75,254,240,0,12,2,9
E02000836,2475,1400,366,1034,29,445,274,171,575,532,14,19,10,26
E02000837,2660,1687,592,1095,19,351,221,130,579,553,8,13,5,24
E02000838,1655,918,227,691,16,306,148,158,393,364,6,20,3,22
E02000839,2366,1385,443,942,25,427,284,143,495,437,33,22,3,34
E02000840,1302,762,186,576,12,321,225,96,191,181,0,8,2,16
E02000841,4819,3144,838,2306,84,777,493,284,794,758,4,26,6,20
E02000842,2868,2144,583,1561,21,252,143,109,441,408,2,30,1,10
E02000843,2639,1835,459,1376,34,309,190,119,450,411,4,23,12,11
E02000844,1672,1194,259,935,18,227,141,86,227,213,1,12,1,6
E02000845,2165,1588,439,1149,17,165,95,70,379,349,2,20,8,16
E02000846,1539,1132,281,851,10,117,68,49,272,242,10,18,2,8
E02000847,2588,2080,635,1445,19,140,70,70,330,323,1,5,1,19
E02000848,2443,1944,565,1379,14,159,80,79,313,290,1,20,2,13
E02000849,1589,1146,303,843,18,176,104,72,243,223,3,15,2,6
E02000850,7332,4746,1160,3586,97,1090,526,564,1369,1276,15,71,7,30
E02000851,11468,7592,2033,5559,146,1542,838,704,2102,1965,13,106,18,86
E02000852,1947,1355,327,1028,17,185,109,76,383,362,0,17,4,7
E02000853,1694,1256,325,931,9,170,106,64,253,240,1,11,1,6
E02000854,2564,1903,530,1373,11,217,111,106,411,383,6,21,1,22
E02000855,2909,2212,599,1613,25,174,95,79,472,436,14,21,1,26
E02000856,3873,2652,707,1945,40,451,214,237,710,658,9,37,6,20
E02000857,2498,1586,453,1133,22,229,131,98,645,607,14,19,5,16
E02000858,1874,1116,300,816,30,450,140,310,270,250,3,17,0,8
E02000859,2017,1499,445,1054,17,220,104,116,266,250,5,9,2,15
E02000860,3756,2409,564,1845,33,256,114,142,1030,973,6,44,7,28
E02000861,3195,2457,714,1743,21,199,110,89,485,467,4,14,0,33
E02000863,1607,1262,378,884,12,134,84,50,188,150,19,13,6,11
E02000864,2503,1069,297,772,39,775,328,447,597,566,1,22,8,23
E02000865,2956,1260,324,936,64,820,408,412,785,743,5,29,8,27
E02000866,2108,944,279,665,40,496,188,308,605,577,2,26,0,23
E02000867,3515,1674,420,1254,77,824,352,472,913,876,2,30,5,27
E02000868,2502,1096,316,780,46,643,321,322,692,652,8,28,4,25
E02000869,1827,752,226,526,26,430,241,189,606,557,4,33,12,13
E02000870,2379,1202,268,934,48,569,286,283,534,492,7,26,9,26
E02000871,2293,930,197,733,35,755,297,458,539,505,6,23,5,34
E02000872,2640,1029,318,711,28,612,346,266,943,892,0,38,13,28
E02000873,5319,2767,808,1959,85,949,491,458,1483,1386,6,50,41,35
E02000874,1298,507,160,347,19,466,258,208,297,284,0,7,6,9
E02000875,2962,1479,300,1179,55,784,340,444,617,578,1,33,5,27
E02000876,3289,1340,345,995,54,963,517,446,902,851,3,41,7,30
E02000877,2696,1239,326,913,39,756,321,435,639,603,3,27,6,23
E02000878,23493,12885,3012,9873,291,2346,1164,1182,7822,7436,37,284,65,149
E02000879,1608,662,195,467,23,511,248,263,389,356,4,15,14,23
E02000880,3694,1710,428,1282,78,874,469,405,998,939,9,32,18,34
E02000881,1548,665,174,491,29,488,188,300,358,329,2,21,6,8
E02000882,1919,727,201,526,71,755,319,436,353,329,0,14,10,13
E02000883,1717,626,135,491,41,663,268,395,377,359,3,8,7,10
E02000884,14712,9115,2287,6828,198,2009,957,1052,3308,3133,22,120,33,82
E02000885,2024,815,209,606,58,637,262,375,497,468,1,18,10,17
E02000886,1629,731,234,497,23,383,226,157,473,441,5,24,3,19
E02000887,3150,1549,334,1215,76,789,378,411,708,662,4,32,10,28
E02000888,1751,717,205,512,26,472,240,232,506,488,2,12,4,30
E02000889,7915,4554,1107,3447,122,769,397,372,2409,2301,7,86,15,61
E02000890,7009,4211,1041,3170,100,604,315,289,2021,1926,33,48,14,73
E02000891,14577,8178,1714,6464,240,2181,1018,1163,3882,3724,11,124,23,96
E02000893,1216,510,123,387,23,354,107,247,321,307,3,5,6,8
E02000894,1414,551,145,406,20,231,68,163,588,559,1,17,11,24
E02000895,1789,1313,357,956,17,215,132,83,235,217,11,4,3,9
E02000896,2740,2019,619,1400,20,274,142,132,397,372,9,13,3,30
E02000897,1689,1141,335,806,21,279,197,82,239,225,2,10,2,9
E02000898,1440,1043,304,739,18,183,93,90,185,178,0,7,0,11
E02000899,2358,1638,465,1173,16,270,139,131,420,388,5,21,6,14
E02000900,2621,1685,491,1194,27,406,191,215,479,445,6,25,3,24
E02000901,3568,2193,593,1600,30,542,345,197,777,733,6,35,3,26
E02000902,1339,833,216,617,22,169,106,63,298,288,1,6,3,17
E02000903,1817,994,243,751,18,333,209,124,457,434,0,15,8,15
E02000904,2780,1689,461,1228,40,357,184,173,675,640,2,26,7,19
E02000905,3452,1912,550,1362,43,509,251,258,966,933,3,20,10,22
E02000906,1963,975,284,691,27,253,127,126,697,672,1,20,4,11
E02000907,2776,1476,401,1075,37,513,356,157,722,675,7,26,14,28
E02000908,4520,2281,600,1681,61,690,401,289,1447,1382,8,45,12,41
E02000909,2504,1350,418,932,32,384,230,154,712,666,19,18,9,26
E02000910,3299,1719,486,1233,36,360,180,180,1157,1109,6,28,14,27
E02000911,4469,2142,611,1531,65,795,438,357,1432,1379,13,36,4,35
E02000912,1783,934,286,648,20,242,117,125,574,543,2,25,4,13
E02000913,5709,3223,906,2317,89,765,382,383,1591,1511,9,53,18,41
E02000914,3164,1436,469,967,40,497,239,258,1163,1112,4,34,13,28
E02000915,2142,1040,337,703,25,295,118,177,757,733,3,15,6,25
E02000916,4926,2469,719,1750,42,860,448,412,1514,1457,9,33,15,41
E02000917,2051,942,257,685,20,197,83,114,879,843,2,29,5,13
E02000918,3539,1777,497,1280,90,609,331,278,1042,988,6,42,6,21
E02000919,1627,607,195,412,10,124,50,74,872,847,7,10,8,14
E02000920,4467,2112,619,1493,44,839,401,438,1440,1369,10,42,19,32
E02000921,2348,919,286,633,20,477,214,263,916,881,5,24,6,16
E02000922,2201,938,259,679,12,247,116,131,985,942,4,35,4,19
E02000923,4183,2044,634,1410,60,415,246,169,1608,1525,4,63,16,56
E02000924,11078,5288,1391,3897,199,2365,1417,948,3163,2993,14,125,31,63
E02000925,1618,691,229,462,29,446,331,115,432,414,1,15,2,20
E02000926,4489,2232,653,1579,61,636,370,266,1518,1419,20,62,17,42
E02000927,1789,796,238,558,14,441,176,265,526,504,4,16,2,12
E02000928,2421,1448,566,882,14,218,135,83,717,667,21,24,5,24
E02000929,919,339,92,247,16,329,277,52,223,215,0,4,4,12
E02000930,4716,2211,603,1608,60,804,464,340,1593,1498,16,70,9,48
E02000931,1621,892,314,578,19,171,75,96,517,489,0,24,4,22
E02000932,10487,5257,1444,3813,152,1544,907,637,3444,3248,30,130,36,90
E02000933,2917,1697,591,1106,48,291,184,107,855,811,7,28,9,26
E02000934,6216,3225,933,2292,114,1232,584,648,1597,1520,19,53,5,48
E02000935,3066,1650,556,1094,52,459,332,127,872,819,8,33,12,33
E02000936,2233,1157,405,752,32,269,163,106,741,688,12,33,8,34
E02000937,1934,1109,402,707,19,208,96,112,572,548,5,15,4,26
E02000938,2177,1126,363,763,37,402,281,121,592,571,3,8,10,20
E02000939,1803,1091,424,667,15,197,104,93,470,445,7,13,5,30
E02000940,4546,1990,547,1443,80,1080,664,416,1370,1301,9,44,16,26
E02000941,2490,1423,488,935,26,406,198,208,620,594,3,16,7,15
E02000942,2045,1251,426,825,23,165,94,71,579,534,21,14,10,27
E02000943,3470,1703,529,1174,48,590,309,281,1082,1014,7,47,14,47
E02000944,1617,703,190,513,19,315,225,90,569,513,23,26,7,11
E02000945,2006,880,268,612,22,401,300,101,687,661,9,14,3,16
E02000946,2866,1491,383,1108,50,475,254,221,824,773,7,33,11,26
E02000947,2642,1456,432,1024,46,309,176,133,815,765,5,35,10,16
E02000948,1494,756,242,514,16,190,90,100,518,495,0,22,1,14
E02000949,5056,2960,806,2154,64,737,371,366,1257,1172,21,53,11,38
E02000950,1565,798,259,539,13,229,183,46,509,482,4,19,4,16
E02000951,1494,773,245,528,11,193,72,121,497,477,4,16,0,20
E02000952,1245,626,190,436,16,219,93,126,376,354,1,16,5,8
E02000953,2068,1204,340,864,18,311,158,153,507,488,2,11,6,28
E02000954,1387,719,242,477,14,189,89,100,456,424,6,19,7,9
E02000955,1264,618,225,393,15,206,138,68,407,381,5,21,0,18
E02000956,9837,5370,1368,4002,156,1544,644,900,2697,2539,28,105,25,70
E02000957,3727,1749,497,1252,49,578,282,296,1301,1251,3,36,11,50
E02000958,1531,927,304,623,15,155,81,74,423,403,6,14,0,11
E02000959,1330,637,211,426,20,179,69,110,480,452,1,22,5,14
E02000960,4065,1969,723,1246,72,492,254,238,1440,1321,46,44,29,92
E02000961,2228,1085,429,656,21,411,212,199,647,616,10,17,4,64
E02000962,2932,1423,541,882,50,447,221,226,935,863,32,28,12,77
E02000963,1571,637,217,420,28,514,301,213,376,357,4,12,3,16
E02000964,2340,804,264,540,33,705,264,441,768,718,6,37,7,30
E02000965,2267,1084,358,726,31,360,173,187,756,722,1,23,10,36
E02000966,2496,1191,492,699,28,352,155,197,864,822,7,34,1,61
E02000967,14299,7755,2259,5496,178,1190,615,575,4996,4758,27,171,40,180
E02000968,5726,2690,755,1935,106,1351,730,621,1513,1422,11,62,18,66
E02000969,3426,1370,344,1026,74,1014,535,479,928,876,8,27,17,40
E02000970,49509,26826,7850,18976,663,5039,2468,2571,16382,15527,131,576,148,599
E02000971,15578,7544,2084,5460,214,1964,1005,959,5665,5397,40,172,56,191
E02000972,130243,67768,17666,50102,1773,11587,5978,5609,48027,45757,237,1690,343,1088
E02000973,3703,1638,637,1001,44,567,243,324,1386,1318,7,50,11,68
E02000974,17176,9252,2516,6736,276,2053,962,1091,5400,5152,32,151,65,195
E02000975,11546,6283,1588,4695,131,907,465,442,4139,3972,35,102,30,86
E02000976,5971,2425,804,1621,62,825,444,381,2529,2400,35,67,27,130
E02000977,153765,86891,24182,62709,2030,11600,6040,5560,51809,48717,692,1763,637,1435
E02000978,24407,12190,3928,8262,354,1935,914,1021,9410,8739,184,332,155,518
E02000979,86773,56898,14382,42516,1324,7390,3655,3735,20415,19298,222,770,125,746
E02000980,10892,6143,1732,4411,210,1274,680,594,3174,2993,16,135,30,91
E02000981,4393,2077,712,1365,62,708,315,393,1477,1400,6,57,14,69
E02000982,19370,10752,2737,8015,258,2031,998,1033,6179,5840,48,252,39,150
E02000983,2138,875,319,556,32,453,241,212,753,720,6,19,8,25
E02000984,1834,1536,442,1094,6,66,43,23,212,190,0,16,6,14
E02000985,2248,1824,538,1286,7,163,126,37,246,228,2,15,1,8
E02000986,1433,1172,337,835,7,56,49,7,183,157,0,25,1,15
E02000987,2324,1752,465,1287,12,244,178,66,297,266,2,20,9,19
E02000988,3433,2576,730,1846,8,359,272,87,466,425,0,29,12,24
E02000989,1247,1060,323,737,5,67,42,25,103,96,0,4,3,12
E02000990,7963,6053,1610,4443,37,694,462,232,1131,1035,3,82,11,48
E02000991,1503,1233,351,882,5,102,61,41,153,136,0,15,2,10
E02000992,1597,1248,382,866,4,137,107,30,204,182,2,19,1,4
E02000993,3006,2249,565,1684,16,362,278,84,361,326,4,28,3,18
E02000994,1821,1303,435,868,8,234,156,78,256,225,3,23,5,20
E02000995,1193,889,266,623,6,148,130,18,138,122,3,7,6,12
E02000996,1695,1155,301,854,4,343,285,58,184,166,1,16,1,9
E02000997,6673,5090,1292,3798,30,551,378,173,973,893,10,69,1,29
E02000998,3625,2711,839,1872,21,349,239,110,522,479,5,31,7,22
E02000999,18021,13522,4043,9479,75,2055,1406,649,2264,2054,8,186,16,105
E02001000,2214,1531,463,1068,15,305,191,114,342,314,0,24,4,21
E02001001,1752,1293,410,883,9,167,125,42,267,248,3,14,2,16
E02001002,1965,1508,380,1128,12,219,160,59,211,181,0,28,2,15
E02001003,1718,1458,463,995,6,80,50,30,160,149,0,10,1,14
E02001004,3438,2440,845,1595,10,479,335,144,461,418,3,33,7,48
E02001005,10539,7493,2058,5435,56,1316,917,399,1595,1460,3,119,13,79
E02001006,2488,1875,656,1219,4,253,162,91,332,283,12,27,10,24
E02001007,1817,1449,450,999,9,156,120,36,188,165,2,21,0,15
E02001008,1033,666,240,426,8,190,143,47,150,139,0,7,4,19
E02001009,1932,1454,448,1006,9,193,125,68,252,222,0,20,10,24
E02001010,2088,1502,416,1086,11,291,203,88,267,238,1,25,3,17
E02001011,1931,1574,440,1134,8,107,74,33,234,202,0,30,2,8
E02001012,5855,4736,1242,3494,11,475,355,120,598,530,2,55,11,35
E02001013,1149,879,267,612,4,126,98,28,136,119,0,15,2,4
E02001014,5544,3953,1090,2863,20,675,509,166,862,794,6,56,6,34
E02001015,4058,2989,878,2111,18,510,391,119,505,437,7,51,10,36
E02001016,1025,713,194,519,8,177,136,41,119,109,1,9,0,8
E02001017,3363,2566,660,1906,9,353,243,110,417,366,3,41,7,18
E02001018,1182,1019,256,763,2,59,35,24,96,82,1,13,0,6
E02001019,3137,2507,740,1767,9,203,136,67,391,332,6,40,13,27
E02001020,1141,999,301,698,0,49,37,12,86,78,2,5,1,7
E02001021,2363,1985,570,1415,7,101,67,34,243,216,1,24,2,27
E02001022,1784,1342,410,932,8,187,153,34,223,199,0,21,3,24
E02001023,1390,1109,305,804,3,110,88,22,158,146,0,12,0,10
E02001024,1415,1181,303,878,3,56,37,19,163,139,2,20,2,12
E02001025,5305,4055,1061,2994,14,518,343,175,690,620,5,62,3,28
E02001026,12194,9006,2327,6679,51,1215,791,424,1848,1673,13,142,20,74
E02001027,3012,2204,624,1580,13,273,180,93,505,454,4,40,7,17
E02001028,1142,991,325,666,2,47,30,17,93,78,1,14,0,9
E02001029,7068,5657,1639,4018,22,543,298,245,810,719,6,77,8,36
E02001030,1590,1275,366,909,5,145,101,44,151,132,0,17,2,14
E02001031,6162,4523,1095,3428,25,564,314,250,1020,954,1,60,5,30
E02001032,1091,889,228,661,4,68,48,20,126,108,2,16,0,4
E02001033,1878,1385,379,1006,6,197,119,78,286,262,3,14,7,4
E02001034,3056,2243,569,1674,13,384,232,152,397,353,2,38,4,19
E02001035,1387,1133,346,787,2,76,39,37,167,154,1,12,0,9
E02001036,1652,1212,352,860,7,190,136,54,227,202,4,17,4,16
E02001037,1929,1469,435,1034,2,166,96,70,278,250,1,24,3,14
E02001038,2705,2046,515,1531,5,262,143,119,378,353,0,20,5,14
E02001039,1111,768,171,597,1,200,79,121,137,125,1,11,0,5
E02001040,3478,2616,718,1898,18,304,181,123,519,483,2,28,6,21
E02001041,1596,1199,295,904,6,150,96,54,224,202,1,17,4,17
E02001042,2597,1866,565,1301,5,244,126,118,466,425,5,30,6,16
E02001043,1004,709,215,494,6,139,77,62,146,140,0,6,0,4
E02001044,2033,1539,439,1100,4,113,77,36,363,336,1,25,1,14
E02001045,1731,1185,282,903,16,306,219,87,214,193,2,16,3,10
E02001046,1848,1220,315,905,21,310,211,99,289,262,2,21,4,8
E02001047,1694,1153,281,872,11,321,237,84,198,175,2,19,2,11
E02001048,1153,779,246,533,6,144,70,74,211,194,2,15,0,13
E02001049,1411,1039,256,783,8,191,133,58,158,144,0,12,2,15
E02001050,5922,4105,1049,3056,44,785,483,302,941,875,8,47,11,47
E02001051,1896,1288,355,933,9,219,141,78,363,342,0,15,6,17
E02001052,3990,2488,732,1756,19,560,277,283,887,826,1,50,10,36
E02001053,2512,1599,414,1185,19,417,246,171,456,420,4,26,6,21
E02001055,4903,3342,866,2476,24,798,441,357,691,627,10,46,8,48
E02001056,1552,956,249,707,10,350,149,201,224,206,0,18,0,12
E02001057,3330,2030,479,1551,12,501,244,257,759,709,2,43,5,28
E02001059,7668,5008,1227,3781,45,1290,493,797,1286,1205,4,64,13,39
E02001061,3849,2397,641,1756,12,730,232,498,677,630,2,34,11,33
E02001062,16855,10584,2841,7743,79,1848,812,1036,4231,4006,11,174,40,113
E02001063,8453,5277,1389,3888,47,1022,320,702,2047,1904,6,115,22,60
E02001064,5140,3202,799,2403,30,1034,412,622,848,780,2,53,13,26
E02001065,1357,858,199,659,6,178,74,104,309,287,2,17,3,6
E02001066,11370,7484,1658,5826,72,1249,476,773,2479,2339,17,106,17,86
E02001067,1438,734,183,551,13,354,146,208,328,304,1,21,2,9
E02001068,1554,809,209,600,6,437,146,291,284,256,0,16,12,18
E02001069,2460,1241,401,840,10,450,118,332,726,670,9,42,5,33
E02001070,3873,2480,695,1785,26,515,220,295,816,756,2,50,8,36
E02001071,2288,1233,373,860,19,340,82,258,659,605,1,42,11,37
E02001072,1892,1032,289,743,11,264,61,203,559,525,5,24,5,26
E02001073,3751,2404,676,1728,15,418,152,266,890,835,10,38,7,24
E02001074,2402,1491,403,1088,7,368,168,200,520,470,4,45,1,16
E02001075,2264,1358,368,990,20,305,90,215,557,518,4,32,3,24
E02001076,2399,1183,356,827,13,266,86,180,914,877,1,28,8,23
E02001077,2411,1541,461,1080,12,255,88,167,589,560,0,21,8,14
E02001078,1877,1269,363,906,11,214,79,135,368,343,2,21,2,15
E02001079,1168,659,188,471,10,198,68,130,293,284,0,8,1,8
E02001080,1866,912,241,671,6,264,98,166,663,636,1,19,7,21
E02001081,1389,923,271,652,8,137,51,86,315,285,9,14,7,6
E02001082,4406,2823,781,2042,19,461,190,271,1068,1011,2,48,7,35
E02001083,4170,2668,607,2061,26,398,143,255,1036,969,8,51,8,42
E02001084,1637,966,280,686,10,218,92,126,433,405,4,23,1,10
E02001085,1870,1199,332,867,10,371,162,209,267,239,4,17,7,23
E02001086,2189,1276,307,969,12,390,165,225,491,463,3,22,3,20
E02001087,2933,1911,542,1369,13,202,64,138,766,713,7,36,10,41
E02001088,1513,1012,204,808,6,312,138,174,172,147,2,15,8,11
E02001089,5495,3790,969,2821,37,359,134,225,1271,1204,4,57,6,38
E02001090,4278,2931,709,2222,30,630,243,387,649,607,2,36,4,38
E02001091,1959,1395,299,1096,14,263,104,159,280,267,0,13,0,7
E02001092,2074,1342,252,1090,13,431,207,224,274,255,2,17,0,14
E02001093,4200,2640,628,2012,21,809,295,514,703,653,8,38,4,27
E02001094,3159,1795,366,1429,16,833,294,539,485,451,3,26,5,30
E02001095,10447,7266,1770,5496,81,1518,632,886,1539,1412,30,77,20,43
E02001096,5037,3582,777,2805,31,526,197,329,872,824,4,41,3,26
E02001097,18065,13120,3008,10112,131,1962,864,1098,2773,2579,13,167,14,79
E02001098,1178,980,317,663,7,83,53,30,103,90,0,12,1,5
E02001099,2705,1936,619,1317,11,406,220,186,329,298,0,24,7,23
E02001100,2761,1958,591,1367,12,386,218,168,389,355,2,30,2,16
E02001101,739,628,187,441,3,49,31,18,49,41,0,6,2,10
E02001102,1381,1119,292,827,8,87,55,32,154,129,2,22,1,13
E02001103,1664,1342,470,872,5,115,60,55,188,159,3,16,10,14
E02001104,1157,915,196,719,5,121,80,41,110,92,0,16,2,6
E02001105,2487,1880,527,1353,14,237,127,110,331,294,0,33,4,25
E02001106,3710,2807,713,2094,7,434,229,205,448,400,1,45,2,14
E02001107,1075,842,259,583,3,87,60,27,127,103,3,17,4,16
E02001108,3346,2452,677,1775,17,459,254,205,404,350,2,45,7,14
E02001109,1585,1206,317,889,7,192,109,83,158,141,0,8,9,22
E02001110,2100,1674,538,1136,9,113,53,60,283,254,5,18,6,21
E02001111,8442,6288,1748,4540,35,1036,552,484,1035,925,6,95,9,48
E02001112,3880,3093,836,2257,16,321,204,117,432,390,3,39,0,18
E02001113,6305,4772,1305,3467,25,730,366,364,733,653,7,68,5,45
E02001114,4228,3224,883,2341,15,419,240,179,540,485,11,35,9,30
E02001115,1471,1116,318,798,6,173,82,91,169,140,1,24,4,7
E02001116,2129,1560,453,1107,10,225,131,94,308,278,0,22,8,26
E02001117,1782,1449,458,991,8,113,55,58,202,172,5,22,3,10
E02001118,1145,949,278,671,2,48,23,25,137,118,2,16,1,9
E02001119,3428,2557,840,1717,14,405,173,232,402,361,2,34,5,50
E02001121,7191,5292,1501,3791,24,860,370,490,955,874,4,71,6,60
E02001123,879,641,175,466,6,132,73,59,96,84,0,10,2,4
E02001124,1331,962,258,704,7,181,100,81,169,150,2,14,3,12
E02001125,6038,4537,1165,3372,26,678,370,308,765,688,3,65,9,32
E02001126,2442,1737,465,1272,13,367,136,231,298,259,3,32,4,27
E02001127,1115,764,210,554,3,225,47,178,114,100,1,8,5,9
E02001128,3440,2687,744,1943,10,324,161,163,393,344,2,41,6,26
E02001129,2899,2055,520,1535,11,413,223,190,408,365,3,34,6,12
E02001130,1194,911,254,657,4,122,63,59,148,122,2,15,9,9
E02001131,774,619,171,448,2,63,32,31,86,74,0,8,4,4
E02001132,2746,2087,522,1565,4,231,179,52,406,369,10,22,5,18
E02001133,999,803,226,577,2,72,55,17,111,98,5,8,0,11
E02001134,1439,1123,311,812,3,96,75,21,198,172,1,21,4,19
E02001135,1849,1312,323,989,9,254,192,62,260,233,0,25,2,14
E02001136,2496,1905,500,1405,12,256,175,81,301,278,0,18,5,22
E02001137,1079,902,301,601,2,39,26,13,119,104,1,11,3,17
E02001138,1756,1479,453,1026,4,95,75,20,169,151,2,13,3,9
E02001139,3461,2597,787,1810,12,380,230,150,440,396,3,35,6,32
E02001140,2619,1951,550,1401,6,285,221,64,362,318,3,37,4,15
E02001141,13066,9836,2861,6975,44,1448,1038,410,1636,1457,11,156,12,102
E02001142,909,721,236,485,3,62,49,13,117,107,1,9,0,6
E02001143,3216,2303,621,1682,10,443,320,123,423,383,2,36,2,37
E02001144,2178,1702,443,1259,7,174,131,43,286,257,3,24,2,9
E02001145,1643,1289,405,884,5,115,77,38,210,190,1,13,6,24
E02001146,4116,2999,908,2091,18,456,292,164,595,533,3,50,9,48
E02001147,1699,1237,337,900,7,261,221,40,178,161,1,16,0,16
E02001148,4253,3184,872,2312,14,466,324,142,567,515,2,43,7,22
E02001149,5295,3876,1015,2861,20,683,395,288,677,612,5,54,6,39
E02001150,4466,3188,741,2447,13,542,282,260,700,625,2,50,23,23
E02001151,4650,3514,917,2597,17,490,319,171,605,536,3,65,1,24
E02001152,3831,2808,734,2074,5,488,295,193,503,453,7,36,7,27
E02001153,1345,920,242,678,7,263,105,158,145,128,0,12,5,10
E02001154,2693,2029,471,1558,4,285,185,100,361,323,2,32,4,14
E02001155,5848,4327,1114,3213,22,750,471,279,717,636,4,65,12,32
E02001156,1343,1139,355,784,5,109,72,37,81,73,0,7,1,9
E02001157,1776,1185,288,897,2,382,270,112,194,172,5,16,1,13
E02001158,2005,1383,394,989,7,374,275,99,228,209,1,18,0,13
E02001159,2051,1476,386,1090,11,270,182,88,283,258,1,17,7,11
E02001160,2025,1512,371,1141,10,243,174,69,249,223,0,25,1,11
E02001161,2021,1446,360,1086,7,248,164,84,302,277,4,15,6,18
E02001162,1599,1183,276,907,3,164,113,51,239,213,6,19,1,10
E02001163,2383,1892,506,1386,11,181,129,52,284,252,3,26,3,15
E02001164,3242,2381,527,1854,16,361,225,136,467,437,3,25,2,17
E02001165,3519,2653,650,2003,10,398,269,129,442,403,2,35,2,16
E02001166,1895,1155,330,825,5,203,84,119,515,476,0,34,5,17
E02001167,1017,670,204,466,3,125,82,43,201,190,4,6,1,18
E02001168,5670,4239,1087,3152,31,681,441,240,689,630,5,47,7,30
E02001169,2179,1776,498,1278,7,106,75,31,274,254,10,9,1,16
E02001170,2225,1793,491,1302,4,138,89,49,274,249,3,20,2,16
E02001171,1521,1295,293,1002,3,71,49,22,147,131,3,13,0,5
E02001172,2656,1312,395,917,14,579,258,321,721,672,7,36,6,30
E02001173,4968,3154,803,2351,28,889,519,370,860,804,1,46,9,37
E02001174,1486,1094,299,795,4,169,94,75,207,196,1,7,3,12
E02001175,878,628,151,477,3,122,76,46,118,103,4,4,7,7
E02001176,5371,3759,974,2785,26,714,450,264,834,775,3,55,1,38
E02001177,14601,10184,2392,7792,83,1761,1047,714,2490,2331,10,131,18,83
E02001178,12698,8743,2413,6330,77,1422,794,628,2363,2212,13,108,30,93
E02001179,966,617,172,445,16,134,64,70,191,177,4,6,4,8
E02001180,1207,756,187,569,7,249,176,73,188,175,1,11,1,7
E02001181,1613,1176,305,871,7,216,134,82,201,189,0,11,1,13
E02001182,1958,1308,308,1000,16,376,248,128,247,229,0,14,4,11
E02001183,1735,1184,282,902,11,219,110,109,297,272,2,18,5,24
E02001184,19388,12812,2859,9953,117,2218,1247,971,4111,3863,23,191,34,130
E02001185,1976,1455,336,1119,4,273,168,105,233,212,3,14,4,11
E02001186,6644,4994,1171,3823,31,748,422,326,826,748,10,52,16,45
E02001187,956,765,193,572,6,67,40,27,108,100,0,8,0,10
E02001188,1898,1400,364,1036,17,199,107,92,267,237,0,27,3,15
E02001189,2893,2234,617,1617,16,238,153,85,393,352,4,31,6,12
E02001190,835,514,130,384,11,230,208,22,66,55,1,9,1,14
E02001191,1040,871,274,597,9,81,51,30,75,62,2,9,2,4
E02001192,3535,2575,705,1870,9,338,160,178,585,534,4,44,3,28
E02001193,5285,3996,1028,2968,37,499,280,219,720,665,1,50,4,33
E02001194,1747,1265,420,845,5,177,105,72,288,267,3,18,0,12
E02001195,7011,5234,1310,3924,34,756,411,345,958,866,8,76,8,29
E02001196,1879,1509,459,1050,13,130,77,53,211,187,2,16,6,16
E02001197,3986,2957,771,2186,27,338,217,121,641,592,2,43,4,23
E02001198,1850,1406,401,1005,14,213,105,108,205,191,0,14,0,12
E02001199,3180,2366,698,1668,10,272,128,144,512,465,4,37,6,20
E02001200,16868,12450,3402,9048,148,1725,926,799,2457,2255,15,165,22,88
E02001201,1118,888,244,644,6,71,39,32,141,129,1,7,4,12
E02001202,4954,3548,906,2642,46,604,349,255,735,681,5,38,11,21
E02001203,1086,951,353,598,1,33,24,9,88,71,0,8,9,13
E02001204,2776,2028,526,1502,27,276,175,101,429,392,2,30,5,16
E02001205,4932,3767,956,2811,39,407,222,185,695,628,4,55,8,24
E02001206,2866,2297,677,1620,17,197,106,91,343,302,2,35,4,12
E02001207,1600,1296,344,952,7,130,74,56,149,136,1,12,0,18
E02001208,6796,5167,1358,3809,33,583,302,281,975,913,9,47,6,38
E02001209,1932,1451,421,1030,11,151,104,47,302,274,1,25,2,17
E02001210,1027,805,220,585,4,130,79,51,82,72,0,10,0,6
E02001211,1532,1239,335,904,7,116,49,67,152,142,2,7,1,18
E02001212,2235,1597,380,1217,11,311,216,95,306,274,0,31,1,10
E02001213,6437,5060,1343,3717,40,434,241,193,876,819,6,43,8,27
E02001214,2107,1655,496,1159,7,166,101,65,259,242,0,17,0,20
E02001215,1545,1197,371,826,4,129,84,45,203,174,6,13,10,12
E02001216,2633,2121,600,1521,12,164,96,68,320,283,5,26,6,16
E02001217,4166,3150,858,2292,34,321,203,118,627,570,6,46,5,34
E02001218,916,779,245,534,4,49,16,33,79,75,0,3,1,5
E02001219,2761,2229,615,1614,17,139,77,62,371,344,2,24,1,5
E02001220,2270,1902,594,1308,26,129,59,70,197,171,3,19,4,16
E02001221,1095,939,284,655,5,46,25,21,103,93,2,8,0,2
E02001222,3873,3059,765,2294,29,209,77,132,548,505,6,31,6,28
E02001223,1383,1176,370,806,10,54,30,24,134,125,0,7,2,9
E02001224,1442,1197,393,804,11,64,36,28,158,145,2,8,3,12
E02001225,3518,2881,731,2150,16,196,100,96,404,361,3,34,6,21
E02001226,1804,1405,343,1062,16,142,55,87,224,190,2,32,0,17
E02001227,1026,904,297,607,1,31,20,11,83,79,0,4,0,7
E02001228,2814,2322,681,1641,15,138,71,67,328,299,3,21,5,11
E02001229,2511,1938,592,1346,8,195,60,135,347,305,4,31,7,23
E02001230,1306,1053,302,751,3,101,31,70,140,126,3,9,2,9
E02001231,1017,798,212,586,4,118,32,86,93,85,0,7,1,4
E02001232,1094,747,183,564,3,166,51,115,164,151,1,10,2,14
E02001233,1196,902,246,656,3,149,54,95,127,114,1,10,2,15
E02001234,1204,835,227,608,1,209,64,145,156,143,1,10,2,3
E02001235,5891,4569,1189,3380,14,504,158,346,780,709,4,62,5,24
E02001236,1576,1149,299,850,3,237,100,137,176,163,2,8,3,11
E02001237,1538,1100,294,806,4,188,70,118,232,202,1,22,7,14
E02001238,2242,1747,491,1256,7,178,66,112,293,260,1,21,11,17
E02001239,1760,1348,364,984,3,155,44,111,234,207,2,22,3,20
E02001240,721,566,137,429,4,48,9,39,94,80,0,14,0,9
E02001241,16650,12154,3173,8981,47,2082,632,1450,2276,2062,20,168,26,91
E02001242,1231,971,302,669,4,107,35,72,144,125,3,14,2,5
E02001243,3623,2795,781,2014,14,401,144,257,395,349,7,37,2,18
E02001244,1179,946,284,662,2,121,42,79,104,84,3,15,2,6
E02001245,4796,3521,907,2614,16,625,191,434,610,535,6,62,7,24
E02001246,1565,1176,275,901,3,187,70,117,187,161,2,24,0,12
E02001247,2865,2189,575,1614,13,288,88,200,348,311,4,32,1,27
E02001248,4001,2897,725,2172,12,482,152,330,590,530,4,49,7,20
E02001249,2148,1546,384,1162,5,266,77,189,318,286,3,24,5,13
E02001250,2132,1636,440,1196,0,252,96,156,231,211,1,19,0,13
E02001251,1276,996,330,666,4,118,49,69,149,139,2,3,5,9
E02001252,1198,1005,260,745,5,58,19,39,121,114,0,7,0,9
E02001253,4703,3527,875,2652,18,501,167,334,627,580,7,34,6,30
E02001254,631,480,138,342,2,71,24,47,69,59,2,7,1,9
E02001255,1441,1070,201,869,4,247,70,177,115,97,0,17,1,5
E02001256,5167,3754,1049,2705,24,711,232,479,645,580,3,57,5,33
E02001257,1223,881,230,651,4,193,31,162,128,105,2,13,8,17
E02001258,1461,1159,347,812,3,104,37,67,177,159,0,14,4,18
E02001259,8684,6378,1311,5067,43,909,346,563,1299,1203,10,72,14,55
E02001260,23809,16452,3948,12504,110,2661,1349,1312,4462,4171,14,253,24,124
E02001261,9766,6705,1697,5008,65,967,387,580,1975,1841,4,114,16,54
E02001262,4709,3326,768,2558,34,417,177,240,904,835,1,59,9,28
E02001263,4005,3028,851,2177,20,347,157,190,592,556,0,31,5,18
E02001264,10731,7544,1880,5664,53,1220,591,629,1854,1729,5,109,11,60
E02001265,1465,1202,289,913,5,100,50,50,143,136,0,6,1,15
E02001266,2848,2078,535,1543,15,345,169,176,396,367,1,24,4,14
E02001267,3271,2413,678,1735,16,368,136,232,443,416,4,23,0,31
E02001268,1530,1203,339,864,3,118,41,77,196,174,3,18,1,10
E02001269,3103,2117,616,1501,15,427,176,251,516,487,2,25,2,28
E02001270,4888,3685,911,2774,29,404,154,250,741,689,5,45,2,29
E02001271,1391,1071,282,789,7,167,51,116,135,119,5,10,1,11
E02001272,2342,1832,480,1352,9,190,79,111,295,268,1,24,2,16
E02001273,6992,5050,1327,3723,34,626,216,410,1247,1154,8,71,14,35
E02001274,1576,1254,397,857,9,142,39,103,162,146,0,16,0,9
E02001275,2866,2033,518,1515,16,394,102,292,403,360,2,32,9,20
E02001276,865,673,179,494,3,100,58,42,87,77,4,5,1,2
E02001277,4030,2804,693,2111,37,511,157,354,656,604,6,42,4,22
E02001278,2771,2145,576,1569,18,188,65,123,404,371,5,26,2,16
E02001279,1271,1107,360,747,2,53,14,39,102,92,0,9,1,7
E02001280,1165,821,222,599,7,224,56,168,103,98,1,3,1,10
E02001281,1653,1385,459,926,4,88,36,52,167,149,2,16,0,9
E02001282,6330,4483,1142,3341,45,650,244,406,1123,1059,3,59,2,29
E02001283,8860,6256,1706,4550,67,864,316,548,1598,1486,9,79,24,75
E02001284,1813,1475,460,1015,7,58,12,46,256,237,2,16,1,17
E02001285,4334,3267,956,2311,25,278,96,182,727,669,5,46,7,37
E02001286,2114,1651,545,1106,11,148,51,97,287,264,5,16,2,17
E02001287,1069,866,257,609,2,80,67,13,107,91,0,16,0,14
E02001288,2731,2199,664,1535,8,222,181,41,286,252,2,25,7,16
E02001289,2042,1737,528,1209,5,109,95,14,179,163,2,14,0,12
E02001290,1123,907,305,602,3,90,82,8,113,103,2,8,0,10
E02001291,1619,1227,313,914,6,210,186,24,163,140,1,16,6,13
E02001292,5742,4554,1255,3299,14,478,394,84,662,595,18,40,9,34
E02001293,1291,1047,305,742,5,129,105,24,104,93,0,8,3,6
E02001294,11037,8611,2390,6221,36,1110,915,195,1218,1110,17,85,6,62
E02001295,1947,1439,420,1019,7,277,235,42,204,178,3,19,4,20
E02001296,4012,2809,716,2093,11,630,547,83,542,507,1,30,4,20
E02001297,3543,2860,855,2005,5,377,326,51,287,262,1,18,6,14
E02001298,4298,2929,843,2086,13,734,599,135,588,546,2,37,3,34
E02001299,3537,2769,788,1981,8,344,289,55,384,346,1,30,7,32
E02001300,2787,2115,611,1504,7,327,274,53,327,282,1,31,13,11
E02001301,9584,7266,1907,5359,26,1122,921,201,1114,1020,5,80,9,56
E02001302,962,762,204,558,2,130,121,9,63,55,1,7,0,5
E02001303,1740,1181,297,884,5,327,286,41,215,195,3,16,1,12
E02001304,2359,1962,618,1344,3,174,155,19,200,185,0,14,1,20
E02001305,2221,1769,522,1247,3,220,188,32,215,192,2,17,4,14
E02001306,1158,982,289,693,1,90,75,15,78,70,0,8,0,7
E02001307,3169,2641,796,1845,4,248,192,56,267,240,4,22,1,9
E02001308,2197,1698,477,1221,8,228,190,38,247,218,3,25,1,16
E02001309,2819,2143,589,1554,2,320,261,59,321,285,0,32,4,33
E02001310,1733,1289,333,956,6,199,161,38,224,210,0,10,4,15
E02001311,1891,1477,397,1080,9,187,147,40,204,184,2,14,4,14
E02001312,2214,1732,444,1288,9,202,165,37,262,235,0,26,1,9
E02001313,2220,1567,389,1178,12,347,308,39,276,255,3,18,0,18
E02001314,1065,872,235,637,7,92,82,10,90,80,1,9,0,4
E02001315,3261,2510,628,1882,16,342,260,82,366,330,1,28,7,27
E02001316,5639,4058,1126,2932,27,676,546,130,843,771,4,63,5,35
E02001317,3810,2977,800,2177,19,418,352,66,367,333,0,31,3,29
E02001318,3968,3216,840,2376,10,378,291,87,350,320,0,26,4,14
E02001319,1073,775,217,558,4,115,93,22,168,153,1,11,3,11
E02001320,3412,2602,731,1871,10,378,306,72,400,353,4,42,1,22
E02001321,1128,945,243,702,2,68,53,15,106,94,0,10,2,7
E02001322,2692,2182,644,1538,3,223,168,55,262,231,0,28,3,22
E02001323,1686,1321,367,954,11,150,122,28,194,174,0,16,4,10
E02001324,3990,3002,791,2211,25,449,312,137,488,455,6,23,4,26
E02001325,1941,1584,463,1121,1,134,95,39,210,177,0,32,1,12
E02001326,2795,2245,578,1667,6,251,191,60,281,255,2,24,0,12
E02001327,2027,1526,331,1195,2,292,134,158,198,182,1,14,1,9
E02001328,1156,978,193,785,1,76,37,39,96,90,0,4,2,5
E02001329,3530,2593,541,2052,9,561,227,334,344,307,0,27,10,23
E02001330,958,718,143,575,3,122,61,61,107,98,0,8,1,8
E02001331,12857,9738,2459,7279,54,1636,601,1035,1348,1229,6,99,14,81
E02001332,922,591,129,462,12,232,47,185,81,72,0,9,0,6
E02001333,3935,2835,671,2164,15,591,286,305,469,427,7,30,5,25
E02001334,953,656,150,506,2,204,93,111,84,76,0,8,0,7
E02001335,6691,5269,1268,4001,17,624,257,367,759,700,4,50,5,22
E02001336,981,700,139,561,4,158,85,73,108,97,0,9,2,11
E02001337,1956,1533,324,1209,8,201,72,129,206,181,1,23,1,8
E02001338,949,702,152,550,1,143,58,85,95,86,1,8,0,8
E02001339,1131,881,218,663,10,145,68,77,83,74,0,9,0,12
E02001340,1531,1228,318,910,4,156,48,108,136,128,0,7,1,7
E02001341,4544,3417,821,2596,8,657,229,428,444,405,1,36,2,18
E02001342,3580,2850,709,2141,11,369,134,235,327,295,5,24,3,23
E02001343,3753,3019,817,2202,11,375,155,220,323,282,8,28,5,25
E02001344,737,543,134,409,7,117,38,79,68,64,0,1,3,2
E02001345,875,722,173,549,3,58,24,34,89,78,0,11,0,3
E02001346,4057,3198,698,2500,16,476,160,316,354,326,0,27,1,13
E02001347,6457,4882,1204,3678,24,688,176,512,837,751,25,48,13,26
E02001348,2215,1688,404,1284,8,198,42,156,305,279,2,19,5,16
E02001349,1638,1259,320,939,4,138,35,103,222,205,2,11,4,15
E02001350,3101,1885,422,1463,7,634,180,454,561,531,2,25,3,14
E02001351,4183,3121,778,2343,14,517,125,392,515,471,8,32,4,16
E02001352,2455,1725,432,1293,11,332,76,256,370,345,2,18,5,17
E02001353,859,728,137,591,8,37,10,27,82,72,4,4,2,4
E02001354,2886,2040,640,1400,15,533,145,388,285,266,1,16,2,13
E02001355,1612,1139,301,838,6,202,42,160,254,233,0,20,1,11
E02001356,1094,690,173,517,3,285,68,217,108,102,0,5,1,8
E02001357,1208,781,219,562,2,285,72,213,130,120,0,8,2,10
E02001358,1852,1181,307,874,9,315,47,268,338,313,2,21,2,9
E02001359,867,631,160,471,6,101,24,77,121,109,2,9,1,8
E02001360,4468,3134,829,2305,24,649,186,463,636,580,4,47,5,25
E02001361,864,586,146,440,3,159,24,135,111,105,0,6,0,5
E02001362,888,652,173,479,6,119,40,79,105,98,1,5,1,6
E02001363,738,451,118,333,3,173,39,134,104,96,2,6,0,7
E02001364,1204,690,184,506,5,226,29,197,279,268,1,6,4,4
E02001365,1501,925,270,655,5,209,30,179,347,326,0,18,3,15
E02001366,2320,1663,453,1210,8,282,60,222,354,313,5,34,2,13
E02001367,2728,2085,552,1533,10,273,65,208,336,312,2,16,6,24
E02001368,4340,2984,775,2209,24,725,175,550,588,554,4,23,7,19
E02001369,3689,2486,663,1823,22,516,96,420,643,596,3,36,8,22
E02001370,2290,1456,375,1081,7,468,74,394,345,315,4,19,7,14
E02001371,949,618,134,484,4,194,51,143,125,116,0,5,4,8
E02001372,8459,6501,1509,4992,46,817,213,604,1068,976,8,70,14,27
E02001373,4394,3211,897,2314,13,547,101,446,594,554,0,32,8,29
E02001374,5166,3546,924,2622,25,609,133,476,947,889,2,44,12,39
E02001375,1370,982,271,711,8,184,47,137,181,164,0,15,2,15
E02001376,1997,1198,330,868,16,291,58,233,470,452,1,17,0,22
E02001377,11649,8069,1963,6106,71,1452,246,1206,2019,1888,5,105,21,38
E02001378,1925,1332,341,991,9,274,59,215,301,281,1,18,1,9
E02001380,1358,1069,303,766,3,128,37,91,152,136,0,12,4,6
E02001381,3084,1995,524,1471,12,320,44,276,749,711,1,32,5,8
E02001382,893,759,218,541,1,50,12,38,79,74,0,5,0,4
E02001383,3650,1902,523,1379,33,663,110,553,1010,932,12,45,21,42
E02001384,2255,1213,347,866,9,289,36,253,730,678,4,42,6,14
E02001385,1456,706,214,492,12,421,66,355,304,278,6,16,4,13
E02001386,2220,1452,395,1057,13,475,94,381,264,240,0,21,3,16
E02001387,2204,1684,461,1223,9,158,40,118,337,318,3,13,3,16
E02001388,2277,1502,386,1116,8,209,35,174,543,501,1,32,9,15
E02001389,1602,817,243,574,10,312,40,272,451,421,8,16,6,12
E02001390,2157,1282,326,956,21,491,77,414,348,316,0,24,8,15
E02001391,735,468,112,356,3,173,34,139,86,76,4,3,3,5
E02001392,1080,864,245,619,4,68,13,55,128,108,7,12,1,16
E02001393,4444,3384,887,2497,17,288,53,235,719,659,17,33,10,36
E02001394,3280,2047,639,1408,18,483,68,415,711,665,6,33,7,21
E02001395,1790,1340,390,950,5,152,27,125,286,267,1,15,3,7
E02001396,3695,2588,706,1882,20,400,70,330,667,623,2,35,7,20
E02001397,2063,1497,451,1046,9,249,42,207,289,263,2,17,7,19
E02001398,1662,1002,289,713,12,279,48,231,353,329,3,13,8,16
E02001399,1244,1005,314,691,3,81,12,69,143,129,3,10,1,12
E02001400,1380,1044,263,781,4,154,38,116,167,151,0,14,2,11
E02001401,4405,3179,846,2333,21,622,189,433,562,525,4,29,4,21
E02001402,2228,1639,487,1152,6,229,49,180,335,315,2,16,2,19
E02001403,1882,1266,320,946,9,317,63,254,279,260,0,14,5,11
E02001404,15900,10906,2626,8280,66,2076,532,1544,2788,2617,15,133,23,64
E02001405,1938,1219,284,935,10,467,91,376,231,217,0,12,2,11
E02001406,3049,2466,818,1648,10,224,86,138,322,265,20,19,18,27
E02001407,1049,876,289,587,1,64,25,39,98,86,0,9,3,10
E02001408,1117,959,291,668,0,73,45,28,78,69,1,7,1,7
E02001409,1395,1098,306,792,2,168,62,106,118,107,1,7,3,9
E02001410,7707,5668,1419,4249,31,968,481,487,1006,914,4,77,11,34
E02001411,1169,909,247,662,4,132,58,74,115,100,0,13,2,9
E02001412,2098,1721,535,1186,7,171,55,116,189,171,3,13,2,10
E02001413,1211,957,302,655,3,137,42,95,107,90,0,14,3,7
E02001414,1162,920,304,616,3,138,56,82,95,88,0,6,1,6
E02001415,1026,812,187,625,7,112,39,73,89,83,0,4,2,6
E02001416,946,682,187,495,8,143,46,97,99,86,2,9,2,14
E02001417,8259,6260,1767,4493,42,1056,326,730,852,769,8,63,12,49
E02001418,2301,1662,448,1214,11,349,135,214,270,249,2,19,0,9
E02001419,10722,8333,2419,5914,43,1239,404,835,1052,950,7,89,6,55
E02001420,3078,2352,591,1761,11,353,108,245,344,316,2,24,2,18
E02001421,2282,1807,516,1291,14,209,54,155,238,214,1,19,4,14
E02001422,1316,900,241,659,0,228,77,151,181,158,0,22,1,7
E02001423,1251,1006,287,719,3,114,40,74,116,109,2,5,0,12
E02001424,6500,4782,1219,3563,21,823,301,522,837,765,5,55,12,37
E02001425,1658,1219,401,818,1,230,62,168,192,165,1,22,4,16
E02001426,1025,828,237,591,4,80,32,48,105,99,0,6,0,8
E02001427,2925,2271,608,1663,15,350,103,247,274,246,4,20,4,15
E02001428,1518,1279,395,884,5,100,32,68,126,111,0,15,0,8
E02001429,1361,1111,369,742,4,51,16,35,193,182,0,11,0,2
E02001430,1985,1671,544,1127,4,63,14,49,232,208,2,21,1,15
E02001431,1595,1159,374,785,9,96,22,74,315,292,1,16,6,16
E02001432,11405,8268,2462,5806,54,608,170,438,2399,2231,15,137,16,76
E02001433,1605,1248,386,862,6,73,16,57,270,239,4,25,2,8
E02001434,2660,2022,591,1431,8,133,41,92,472,425,4,39,4,25
E02001435,3394,2619,828,1791,4,145,28,117,597,548,4,40,5,29
E02001436,5400,4282,1219,3063,35,243,75,168,813,736,1,73,3,27
E02001437,2938,2358,819,1539,9,93,22,71,465,424,5,32,4,13
E02001438,1630,1383,394,989,5,53,21,32,181,160,3,16,2,8
E02001439,1417,1165,320,845,1,78,27,51,163,138,4,17,4,10
E02001440,1014,840,289,551,1,67,19,48,98,77,10,5,6,8
E02001441,1600,1327,471,856,6,59,27,32,186,167,5,9,5,22
E02001442,2419,2018,660,1358,8,90,33,57,273,256,1,15,1,30
E02001443,1148,1018,342,676,3,32,11,21,87,78,0,9,0,8
E02001444,2061,1690,549,1141,6,94,35,59,255,214,10,22,9,16
E02001445,1071,942,276,666,0,45,12,33,78,68,1,7,2,6
E02001446,2658,2262,592,1670,12,134,47,87,238,218,1,18,1,12
E02001447,1530,1309,389,920,4,74,29,45,129,112,0,17,0,14
E02001448,2742,2268,614,1654,6,194,71,123,264,230,5,29,0,10
E02001449,2679,2081,586,1495,11,270,114,156,301,274,1,24,2,16
E02001450,2309,1882,582,1300,5,136,40,96,276,254,3,17,2,10
E02001451,911,667,163,504,6,147,65,82,88,78,0,9,1,3
E02001452,866,598,142,456,3,189,79,110,70,64,1,4,1,6
E02001453,2705,2171,627,1544,12,223,71,152,289,266,0,20,3,10
E02001454,1430,1194,302,892,3,95,40,55,131,114,3,11,3,7
E02001455,4048,3113,853,2260,16,421,109,312,480,434,8,35,3,18
E02001456,1600,1255,367,888,7,104,31,73,219,198,2,17,2,15
E02001457,4525,3382,768,2614,25,556,187,369,541,494,0,44,3,21
E02001458,2688,2078,573,1505,7,214,58,156,365,334,0,25,6,24
E02001459,1313,997,235,762,4,155,63,92,151,139,0,12,0,6
E02001460,3630,2674,714,1960,15,458,131,327,462,414,4,36,8,21
E02001461,2839,2298,556,1742,14,239,67,172,273,246,4,22,1,15
E02001462,1638,1122,310,812,12,288,62,226,207,189,2,15,1,9
E02001463,2563,1855,496,1359,14,386,144,242,294,264,1,26,3,14
E02001464,1953,1278,310,968,13,344,67,277,304,289,2,12,1,14
E02001465,10185,7597,2011,5586,50,1304,337,967,1194,1094,8,83,9,40
E02001466,2935,2218,566,1652,11,323,99,224,359,320,0,33,6,24
E02001467,1326,941,262,679,5,60,15,45,311,278,5,22,6,9
E02001468,1483,1098,308,790,4,77,26,51,290,255,4,26,5,14
E02001469,1949,1562,460,1102,4,78,30,48,291,254,5,24,8,14
E02001470,1879,1457,427,1030,4,82,29,53,322,287,4,29,2,14
E02001471,1427,1025,271,754,1,90,29,61,301,277,1,22,1,10
E02001472,1541,1216,322,894,6,137,39,98,161,141,2,14,4,21
E02001473,3399,2576,701,1875,14,223,82,141,570,531,1,33,5,16
E02001474,2357,1733,461,1272,9,227,60,167,380,344,1,32,3,8
E02001475,1974,1492,416,1076,3,261,100,161,208,188,1,17,2,10
E02001476,3542,2593,753,1840,18,397,163,234,524,483,2,39,0,10
E02001477,2418,1622,444,1178,9,446,219,227,331,310,1,18,2,10
E02001478,2646,2000,521,1479,7,240,117,123,377,332,3,40,2,22
E02001479,1291,1089,313,776,1,54,26,28,140,120,0,18,2,7
E02001480,3067,2327,663,1664,9,174,60,114,524,454,17,45,8,33
E02001481,1897,1474,445,1029,5,144,72,72,252,231,1,16,4,22
E02001482,15907,11743,3009,8734,86,1518,492,1026,2489,2283,12,177,17,71
E02001483,1175,975,267,708,6,56,24,32,130,115,0,12,3,8
E02001484,2506,1947,532,1415,15,218,98,120,315,281,5,28,1,11
E02001485,662,444,96,348,2,115,51,64,92,85,0,7,0,9
E02001486,2028,1408,452,956,10,172,68,104,411,375,5,27,4,27
E02001487,3656,2635,754,1881,22,386,111,275,598,551,1,39,7,15
E02001488,2000,1440,381,1059,8,165,49,116,366,343,3,20,0,21
E02001489,1439,1220,370,850,3,54,21,33,145,132,3,10,0,17
E02001490,2423,1966,498,1468,12,136,68,68,296,271,1,23,1,13
E02001491,6243,4766,1172,3594,24,553,272,281,864,800,4,47,13,36
E02001492,2887,2253,678,1575,11,169,75,94,434,377,7,42,8,20
E02001493,2013,1336,333,1003,9,290,123,167,359,333,2,21,3,19
E02001494,1540,1340,444,896,3,38,16,22,148,131,2,15,0,11
E02001495,1349,1037,273,764,6,121,44,77,175,161,0,13,1,10
E02001496,1015,834,247,587,2,62,30,32,110,98,1,11,0,7
E02001497,1809,1225,357,868,15,278,106,172,277,243,5,24,5,14
E02001498,1359,1075,295,780,1,93,46,47,171,159,1,11,0,19
E02001499,1172,982,312,670,2,56,21,35,116,102,0,8,6,16
E02001500,1490,1276,396,880,8,70,35,35,127,117,0,7,3,9
E02001501,1487,1201,351,850,3,99,32,67,167,152,1,12,2,17
E02001502,7645,5906,1495,4411,27,593,236,357,1071,990,3,69,9,48
E02001503,3500,2820,884,1936,7,187,86,101,469,426,4,33,6,17
E02001504,4320,3484,1009,2475,16,248,125,123,534,491,7,30,6,38
E02001505,5791,4535,1146,3389,19,462,182,280,750,697,5,46,2,25
E02001506,1627,1401,518,883,4,45,28,17,164,148,5,10,1,13
E02001507,781,677,215,462,1,24,15,9,77,73,0,4,0,2
E02001508,2014,1648,424,1224,4,124,62,62,227,206,1,16,4,11
E02001509,1210,970,300,670,2,116,106,10,110,99,0,10,1,12
E02001510,3431,2615,763,1852,12,435,382,53,343,317,1,25,0,26
E02001511,1083,861,244,617,1,97,85,12,115,108,0,7,0,9
E02001512,1938,1436,459,977,3,214,182,32,265,238,6,17,4,20
E02001513,2182,1750,495,1255,1,188,169,19,225,210,2,9,4,18
E02001514,2115,1550,444,1106,3,247,197,50,297,281,0,15,1,18
E02001515,2781,2038,514,1524,12,439,390,49,276,249,5,20,2,16
E02001516,1943,1311,345,966,6,207,178,29,403,378,2,22,1,16
E02001517,1387,1061,298,763,2,160,141,19,151,135,5,10,1,13
E02001518,3574,2739,850,1889,8,409,351,58,389,341,3,41,4,29
E02001519,1745,1319,338,981,7,242,203,39,170,141,3,25,1,7
E02001520,7323,5898,1614,4284,21,552,469,83,804,732,2,61,9,48
E02001521,13364,10200,2971,7229,51,1268,1045,223,1745,1570,15,136,24,100
E02001522,1953,1445,455,990,8,258,164,94,231,206,3,21,1,11
E02001523,4923,3793,1085,2708,12,548,470,78,542,496,3,40,3,28
E02001524,1799,1474,574,900,12,106,81,25,194,162,5,19,8,13
E02001525,1610,1168,331,837,1,207,159,48,215,195,1,15,4,19
E02001526,1012,699,164,535,4,158,141,17,141,125,3,12,1,10
E02001527,2415,1796,484,1312,1,242,207,35,360,325,5,23,7,16
E02001528,1672,1266,395,871,3,186,161,25,198,181,3,13,1,19
E02001529,1821,1363,414,949,3,263,238,25,175,156,0,19,0,17
E02001530,2672,1973,527,1446,6,314,269,45,360,332,6,21,1,19
E02001531,2663,2015,571,1444,11,320,277,43,302,275,1,20,6,15
E02001532,2731,2221,766,1455,10,208,147,61,258,230,3,19,6,34
E02001533,1008,748,211,537,2,105,94,11,148,134,3,10,1,5
E02001534,2978,2047,554,1493,8,417,358,59,486,451,1,29,5,20
E02001535,2359,1881,715,1166,10,154,132,22,287,244,18,13,12,27
E02001536,3879,3106,852,2254,14,332,280,52,395,349,8,36,2,32
E02001537,1327,1004,294,710,5,142,134,8,161,139,0,12,10,15
E02001538,1928,1402,434,968,2,272,247,25,240,201,6,25,8,12
E02001539,1503,1127,321,806,8,156,136,20,205,179,1,24,1,7
E02001540,2830,2229,688,1541,5,222,205,17,338,300,8,25,5,36
E02001541,4240,3300,920,2380,18,377,316,61,515,448,9,52,6,30
E02001542,1861,1418,484,934,2,214,184,30,214,185,6,22,1,13
E02001543,2861,2220,605,1615,6,281,245,36,338,306,3,29,0,16
E02001544,1591,1227,317,910,7,133,123,10,203,170,1,30,2,21
E02001545,2976,2342,694,1648,4,223,185,38,388,344,3,38,3,19
E02001546,3387,2783,780,2003,8,202,176,26,368,318,11,33,6,26
E02001547,2240,1705,478,1227,6,222,193,29,284,238,8,36,2,23
E02001548,1679,1275,369,906,5,207,176,31,181,168,5,8,0,11
E02001549,2028,1626,478,1148,4,144,122,22,244,218,5,16,5,10
E02001550,1745,1375,395,980,4,146,133,13,217,185,8,22,2,3
E02001551,2310,1722,485,1237,9,204,167,37,357,309,11,34,3,18
E02001552,3777,2530,614,1916,7,341,287,54,871,828,5,33,5,28
E02001553,5279,3935,971,2964,13,503,443,60,802,736,5,54,7,26
E02001554,1484,1243,386,857,3,74,63,11,147,129,1,17,0,17
E02001555,842,721,209,512,2,40,38,2,76,68,0,8,0,3
E02001556,6690,5317,1394,3923,11,474,420,54,850,735,20,89,6,38
E02001557,6941,5184,1293,3891,22,501,403,98,1192,1070,15,95,12,42
E02001558,3559,2542,731,1811,9,315,256,59,662,620,13,23,6,31
E02001559,1952,1556,420,1136,6,92,83,9,287,257,3,23,4,11
E02001560,23137,17503,4729,12774,60,1903,1580,323,3509,3218,21,244,26,162
E02001561,1202,853,231,622,1,137,125,12,202,186,5,11,0,9
E02001562,1004,765,213,552,8,107,101,6,117,108,1,8,0,7
E02001563,2582,1919,572,1347,2,277,218,59,363,328,2,31,2,21
E02001564,2271,1860,598,1262,8,102,69,33,289,247,6,34,2,12
E02001565,2093,1615,427,1188,2,100,85,15,364,328,5,30,1,12
E02001566,10789,8391,1944,6447,36,731,595,136,1569,1428,9,121,11,62
E02001567,1800,1375,376,999,3,177,148,29,235,207,3,23,2,10
E02001568,1577,1176,374,802,2,206,190,16,178,150,7,16,5,15
E02001569,2690,2010,614,1396,4,317,275,42,345,310,2,28,5,14
E02001570,2144,1588,411,1177,8,292,257,35,236,212,4,17,3,20
E02001571,1970,1566,472,1094,1,138,119,19,249,228,0,19,2,16
E02001572,2325,1695,442,1253,7,248,222,26,362,319,9,29,5,13
E02001573,1285,1018,287,731,1,110,99,11,148,128,0,16,4,8
E02001574,1102,891,201,690,2,68,54,14,133,100,7,21,5,8
E02001575,1507,1130,312,818,2,187,173,14,172,153,4,14,1,16
E02001576,2836,2221,656,1565,12,194,130,64,386,349,4,30,3,23
E02001577,2686,2042,637,1405,9,164,138,26,444,401,3,29,11,27
E02001578,3919,2973,744,2229,12,463,387,76,453,410,2,36,5,18
E02001579,11434,8322,2036,6286,43,1257,1044,213,1754,1598,11,138,7,58
E02001580,2951,2240,667,1573,7,331,284,47,353,310,10,27,6,20
E02001581,595,472,120,352,1,67,65,2,52,48,0,4,0,3
E02001582,973,731,203,528,1,135,118,17,104,93,1,8,2,2
E02001583,1253,928,255,673,5,171,150,21,140,123,1,14,2,9
E02001584,1322,1045,349,696,1,86,59,27,166,148,2,7,9,24
E02001585,4286,3098,812,2286,10,654,548,106,496,437,3,48,8,28
E02001586,3058,2227,569,1658,8,466,411,55,345,309,1,29,6,12
E02001587,1153,837,258,579,0,182,165,17,121,106,3,8,4,13
E02001588,838,591,136,455,0,177,171,6,59,53,0,6,0,11
E02001589,1054,899,235,664,4,45,37,8,99,81,4,10,4,7
E02001590,1328,909,237,672,1,275,248,27,135,116,3,14,2,8
E02001591,3846,2853,784,2069,11,515,412,103,436,403,5,26,2,31
E02001592,1679,1304,371,933,8,186,149,37,159,139,1,18,1,22
E02001593,5545,3924,1194,2730,14,807,645,162,760,698,6,52,4,40
E02001594,14311,10977,3036,7941,40,1547,1273,274,1647,1485,6,115,41,100
E02001595,5762,4624,1239,3385,15,468,383,85,609,550,10,36,13,46
E02001596,1607,1249,359,890,2,119,96,23,222,211,0,11,0,15
E02001597,2574,1948,612,1336,6,288,203,85,301,257,3,30,11,31
E02001598,1600,1273,360,913,7,134,116,18,166,147,3,15,1,20
E02001599,2016,1664,411,1253,5,106,88,18,222,188,4,28,2,19
E02001600,7203,5904,1663,4241,15,509,401,108,745,668,14,61,2,30
E02001601,919,717,223,494,2,74,62,12,119,103,4,11,1,7
E02001602,5887,4742,1234,3508,15,486,409,77,618,558,3,50,7,26
E02001603,1903,1494,417,1077,6,156,139,17,235,221,2,8,4,12
E02001604,3358,2529,649,1880,8,346,288,58,446,408,4,26,8,29
E02001605,3589,2835,748,2087,15,254,205,49,462,408,1,43,10,23
E02001606,2241,1803,521,1282,4,147,118,29,271,249,7,13,2,16
E02001607,1674,1356,428,928,3,132,105,27,181,159,0,18,4,2
E02001608,3299,2501,654,1847,7,313,262,51,459,421,0,33,5,19
E02001609,2446,1982,587,1395,3,210,171,39,240,220,1,17,2,11
E02001610,1968,1573,440,1133,6,164,136,28,212,184,2,22,4,13
E02001611,2548,2121,619,1502,4,182,137,45,224,203,2,18,1,17
E02001612,952,778,223,555,1,69,60,9,94,89,0,5,0,10
E02001613,1568,1258,332,926,1,159,144,15,133,125,0,7,1,17
E02001614,6424,5155,1377,3778,18,534,417,117,681,633,4,39,5,36
E02001615,3977,2972,875,2097,13,551,400,151,424,376,5,35,8,17
E02001616,1432,1146,278,868,8,150,125,25,125,112,2,9,2,3
E02001617,699,480,111,369,0,152,47,105,65,54,0,9,2,2
E02001618,2349,1875,573,1302,4,193,139,54,253,215,5,19,14,24
E02001619,1414,959,270,689,3,324,296,28,114,94,3,17,0,14
E02001620,1769,1086,256,830,6,357,201,156,303,275,4,21,3,17
E02001621,734,483,129,354,1,159,123,36,84,75,1,8,0,7
E02001622,1682,1143,302,841,0,365,302,63,166,153,3,6,4,8
E02001623,1903,1328,342,986,7,402,297,105,155,139,2,12,2,11
E02001624,4064,3027,809,2218,16,466,320,146,531,490,4,32,5,24
E02001625,2203,1535,353,1182,4,452,357,95,207,184,7,11,5,5
E02001626,1148,880,256,624,2,106,56,50,149,135,1,9,4,11
E02001627,7885,5715,1517,4198,20,1109,826,283,1015,913,8,82,12,26
E02001628,19033,13432,3463,9969,60,2148,1524,624,3299,3015,14,220,50,94
E02001629,1923,1258,318,940,7,426,337,89,217,205,0,12,0,15
E02001630,1991,1341,504,837,9,339,229,110,267,244,3,13,7,35
E02001631,1361,1049,289,760,3,148,84,64,151,129,3,13,6,10
E02001632,19814,14371,4027,10344,86,2627,1817,810,2627,2409,10,177,31,103
E02001633,1836,1501,483,1018,5,168,124,44,149,125,5,15,4,13
E02001634,1719,1249,371,878,3,117,80,37,340,310,2,21,7,10
E02001635,703,557,164,393,0,95,86,9,46,39,1,4,2,5
E02001636,7666,5218,1439,3779,29,833,596,237,1539,1424,14,79,22,47
E02001637,7150,5100,1471,3629,39,1029,685,344,950,871,8,64,7,32
E02001638,991,545,160,385,13,70,48,22,342,306,3,32,1,21
E02001639,1088,676,235,441,3,92,63,29,301,272,1,24,4,16
E02001640,13666,9561,2558,7003,53,1095,738,357,2886,2694,26,133,33,71
E02001642,5327,4023,1172,2851,15,614,434,180,651,595,3,47,6,24
E02001643,1516,1179,404,775,2,89,61,28,225,206,3,10,6,21
E02001646,5254,3529,1035,2494,13,384,258,126,1294,1190,19,41,44,34
E02001647,1701,1232,307,925,6,265,146,119,187,159,2,24,2,11
E02001648,2419,1815,599,1216,6,153,103,50,421,373,8,19,21,24
E02001649,2643,1818,497,1321,6,529,255,274,281,249,5,25,2,9
E02001650,5691,3937,982,2955,21,569,407,162,1131,1039,9,71,12,33
E02001651,1731,1437,504,933,1,102,76,26,176,152,2,19,3,15
E02001652,7878,5076,1241,3835,24,902,635,267,1812,1679,13,83,37,64
E02001653,3108,2132,609,1523,8,537,375,162,427,380,6,33,8,4
E02001654,1394,1125,281,844,2,148,116,32,112,104,1,6,1,7
E02001655,1225,886,211,675,2,211,135,76,122,109,1,10,2,4
E02001656,2475,1743,515,1228,3,151,111,40,558,507,2,41,8,20
E02001657,2091,1648,524,1124,10,104,73,31,312,288,2,22,0,17
E02001658,1325,841,236,605,6,337,272,65,130,116,0,11,3,11
E02001659,1653,1155,320,835,4,276,235,41,206,184,6,11,5,12
E02001660,2990,2126,694,1432,12,246,175,71,579,540,1,37,1,27
E02001661,2104,1415,430,985,10,420,329,91,247,219,5,19,4,12
E02001662,1477,1149,301,848,6,166,123,43,146,127,3,14,2,10
E02001663,3170,2349,657,1692,9,262,187,75,511,459,1,45,6,39
E02001664,1073,812,207,605,3,123,103,20,120,105,0,14,1,15
E02001665,3481,2952,1006,1946,5,121,84,37,376,340,9,21,6,27
E02001666,2649,1989,427,1562,4,374,290,84,270,233,3,28,6,12
E02001669,3344,2390,658,1732,16,364,283,81,552,495,4,46,7,22
E02001670,520,330,88,242,0,135,118,17,51,43,2,3,3,4
E02001671,2612,1937,436,1501,7,318,238,80,338,321,1,15,1,12
E02001672,874,705,158,547,2,78,63,15,85,73,2,9,1,4
E02001673,3489,2717,725,1992,9,379,303,76,361,325,4,29,3,23
E02001674,2750,2228,725,1503,15,237,181,56,257,221,8,23,5,13
E02001675,2899,2164,580,1584,5,442,362,80,275,237,4,30,4,13
E02001676,1399,1162,340,822,5,96,83,13,130,112,1,13,4,6
E02001678,2649,2158,779,1379,5,147,115,32,309,269,14,22,4,30
E02001679,927,660,187,473,4,167,155,12,88,70,7,8,3,8
E02001680,990,621,151,470,3,262,245,17,98,94,0,4,0,6
E02001681,1142,949,286,663,1,94,72,22,90,77,4,8,1,8
E02001682,1749,1324,368,956,3,254,202,52,150,137,0,11,2,18
E02001683,1673,1332,372,960,4,143,127,16,185,157,3,15,10,9
E02001684,5504,3960,872,3088,9,886,703,183,631,570,1,49,11,18
E02001685,1055,709,157,552,7,249,222,27,81,72,1,8,0,9
E02001686,4758,3499,901,2598,21,692,558,134,525,473,7,34,11,21
E02001688,17967,13248,2928,10320,57,2509,1914,595,2060,1885,5,155,15,93
E02001689,2623,1591,442,1149,12,535,396,139,460,418,3,32,7,25
E02001690,9831,6488,1471,5017,34,1625,1284,341,1630,1487,13,114,16,54
E02001691,1508,953,286,667,3,169,114,55,370,335,10,24,1,13
E02001692,586,362,94,268,5,151,93,58,64,50,4,10,0,4
E02001693,946,644,137,507,3,206,170,36,84,74,3,7,0,9
E02001694,1393,1020,246,774,3,214,179,35,144,122,0,22,0,12
E02001695,1622,1192,282,910,2,290,235,55,132,116,0,15,1,6
E02001696,1239,874,176,698,2,263,205,58,85,74,0,8,3,15
E02001697,5280,4124,972,3152,15,639,510,129,480,444,3,30,3,22
E02001698,1739,1427,385,1042,7,137,119,18,150,139,0,10,1,18
E02001699,941,698,167,531,4,151,114,37,84,72,1,8,3,4
E02001700,2258,1681,434,1247,6,267,203,64,276,251,2,20,3,28
E02001701,1766,1367,357,1010,1,229,181,48,156,136,1,19,0,13
E02001702,1103,697,168,529,3,295,240,55,104,92,0,10,2,4
E02001703,870,706,219,487,6,96,87,9,60,54,1,5,0,2
E02001704,819,517,127,390,2,235,206,29,54,45,0,8,1,11
E02001705,1320,985,362,623,5,159,142,17,155,141,2,12,0,16
E02001706,4552,3283,771,2512,11,648,509,139,577,532,3,39,3,33
E02001707,5099,3966,1049,2917,13,623,434,189,468,420,3,40,5,29
E02001708,5412,3954,842,3112,23,696,545,151,707,643,1,58,5,32
E02001709,3476,2635,641,1994,10,329,258,71,482,447,7,26,2,20
E02001710,2612,1811,406,1405,9,495,435,60,287,262,3,20,2,10
E02001711,4834,3390,771,2619,17,796,656,140,606,545,7,49,5,25
E02001712,3268,2392,644,1748,5,415,365,50,425,386,3,28,8,31
E02001713,10722,8112,1807,6305,45,1032,795,237,1482,1335,19,122,6,51
E02001714,9459,7254,1734,5520,44,867,674,193,1245,1131,5,97,12,49
E02001715,3173,2115,489,1626,16,593,495,98,424,376,3,41,4,25
E02001718,1285,980,212,768,2,185,166,19,111,96,6,8,1,7
E02001719,1906,1354,406,948,8,221,196,25,304,279,3,22,0,19
E02001720,1877,1093,299,794,12,141,100,41,608,575,0,27,6,23
E02001721,3655,2681,668,2013,14,559,458,101,381,350,5,22,4,20
E02001722,1695,1178,246,932,4,323,286,37,173,149,2,21,1,17
E02001723,1168,800,204,596,3,218,195,23,138,129,0,6,3,9
E02001724,4041,2661,692,1969,16,374,283,91,958,897,1,52,8,32
E02001725,3707,2244,550,1694,14,615,475,140,805,736,7,57,5,29
E02001726,2757,1939,478,1461,8,459,397,62,330,283,0,35,12,21
E02001727,2138,1662,438,1224,9,271,225,46,186,167,2,17,0,10
E02001728,4009,3083,647,2436,22,449,362,87,434,367,10,55,2,21
E02001729,3448,2227,591,1636,9,477,284,193,711,652,13,39,7,24
E02001730,10821,7429,1779,5650,53,1154,869,285,2129,1974,10,124,21,56
E02001731,54441,37323,8805,28518,236,5977,4455,1522,10601,9761,47,638,155,304
E02001732,1858,1325,327,998,3,310,269,41,211,193,0,18,0,9
E02001733,8198,5467,1395,4072,23,1567,1288,279,1097,999,5,83,10,44
E02001734,2632,1845,491,1354,7,447,350,97,317,287,3,24,3,16
E02001735,845,483,101,382,2,282,252,30,73,69,1,2,1,5
E02001736,10970,7685,1820,5865,46,1425,1070,355,1753,1617,12,112,12,61
E02001737,2656,1857,412,1445,11,460,381,79,309,266,3,38,2,19
E02001738,772,664,180,484,2,34,23,11,56,52,0,4,0,16
E02001739,1716,1304,334,970,7,243,189,54,158,148,0,9,1,4
E02001740,919,753,223,530,4,49,41,8,101,89,2,8,2,12
E02001741,1916,1517,372,1145,4,182,148,34,196,160,3,29,4,17
E02001742,952,778,220,558,4,47,30,17,117,109,2,6,0,6
E02001743,3209,2281,599,1682,12,384,305,79,503,449,5,42,7,29
E02001744,1515,1154,290,864,6,169,135,34,171,153,3,13,2,15
E02001745,4861,3655,855,2800,11,718,584,134,452,411,0,38,3,25
E02001746,2358,1736,465,1271,12,266,226,40,317,280,1,33,3,27
E02001747,796,636,175,461,1,64,54,10,80,73,1,4,2,15
E02001748,5176,3816,835,2981,24,635,496,139,682,618,5,54,5,19
E02001749,1009,761,181,580,4,130,90,40,102,85,1,15,1,12
E02001750,4195,3329,781,2548,21,363,272,91,466,419,5,37,5,16
E02001751,1618,1191,294,897,7,219,169,50,192,174,0,18,0,9
E02001752,11414,8329,1778,6551,32,1325,1006,319,1674,1511,4,150,9,54
E02001753,2370,1625,494,1131,10,302,198,104,403,365,10,28,0,30
E02001754,1108,832,219,613,2,104,82,22,159,144,1,12,2,11
E02001755,5008,3667,899,2768,8,739,598,141,574,517,6,51,0,20
E02001756,9008,6191,1266,4925,25,1184,902,282,1555,1428,7,106,14,53
E02001757,1037,792,195,597,3,134,110,24,104,85,4,15,0,4
E02001758,1336,1033,248,785,7,157,137,20,134,121,0,12,1,5
E02001759,5186,3785,915,2870,20,696,518,178,653,589,3,57,4,32
E02001760,3683,2576,581,1995,15,631,511,120,442,403,1,36,2,19
E02001761,887,650,161,489,2,140,126,14,88,74,0,14,0,7
E02001762,527,435,126,309,6,35,28,7,43,40,0,3,0,8
E02001763,1049,741,163,578,4,185,152,33,114,102,0,11,1,5
E02001764,2930,2022,458,1564,10,487,335,152,395,352,4,34,5,16
E02001765,1953,1340,311,1029,5,319,248,71,284,255,3,26,0,5
E02001766,2838,2024,495,1529,7,383,289,94,410,387,2,19,2,14
E02001767,2773,1975,446,1529,8,429,332,97,342,302,9,28,3,19
E02001768,4643,3361,893,2468,29,750,591,159,480,436,6,33,5,23
E02001769,7746,5326,1339,3987,35,1477,1111,366,871,762,11,88,10,37
E02001770,1490,1103,319,784,6,164,107,57,203,179,6,13,5,14
E02001771,630,450,123,327,3,138,108,30,38,31,1,6,0,1
E02001772,1575,1220,319,901,5,189,139,50,156,146,0,10,0,5
E02001773,1060,856,256,600,1,110,87,23,80,70,1,8,1,13
E02001774,5064,3494,859,2635,14,1081,871,210,457,410,2,42,3,18
E02001775,875,577,155,422,3,225,168,57,56,47,1,8,0,14
E02001776,3242,2379,606,1773,14,545,401,144,285,257,2,23,3,19
E02001777,2055,1525,363,1162,9,346,292,54,167,150,1,12,4,8
E02001778,3565,2710,666,2044,9,479,358,121,355,318,10,25,2,12
E02001779,4210,2937,709,2228,14,847,653,194,400,373,2,21,4,12
E02001780,493,341,85,256,4,115,63,52,31,26,0,4,1,2
E02001781,642,415,104,311,2,190,173,17,31,30,0,1,0,4
E02001782,1876,1403,328,1075,5,332,278,54,127,105,1,20,1,9
E02001783,713,508,100,408,1,162,142,20,39,33,3,3,0,3
E02001784,816,587,138,449,1,178,165,13,47,45,0,2,0,3
E02001785,1027,812,214,598,4,115,83,32,89,66,1,11,11,7
E02001786,751,541,142,399,3,159,145,14,41,31,1,9,0,7
E02001787,1443,1033,283,750,7,259,207,52,138,122,2,10,4,6
E02001788,2251,1608,413,1195,4,432,314,118,196,176,1,17,2,11
E02001789,1078,882,247,635,2,102,66,36,81,74,0,4,3,11
E02001790,2918,2192,487,1705,2,375,259,116,332,301,3,24,4,17
E02001791,1578,1308,364,944,1,111,60,51,144,132,2,7,3,14
E02001792,1594,1169,322,847,5,212,120,92,199,178,2,16,3,9
E02001793,1053,735,148,587,3,238,129,109,69,57,4,5,3,8
E02001794,1130,763,175,588,1,265,165,100,98,76,1,16,5,3
E02001795,6897,5060,1240,3820,15,1020,575,445,775,681,8,76,10,27
E02001796,3863,2806,762,2044,12,528,285,243,480,425,3,43,9,37
E02001797,10700,7973,1466,6507,20,1529,976,553,1146,1028,4,99,15,32
E02001798,4860,3652,754,2898,14,678,392,286,495,438,6,44,7,21
E02001799,4553,3154,703,2451,6,878,562,316,496,453,2,35,6,19
E02001800,3173,2310,576,1734,12,534,321,213,312,290,1,19,2,5
E02001801,5813,4400,1098,3302,16,667,383,284,702,621,23,46,12,28
E02001802,1742,1259,299,960,3,315,172,143,152,135,3,10,4,13
E02001803,15905,11360,2871,8489,37,2301,1270,1031,2120,1903,12,175,30,87
E02001804,2010,1428,334,1094,6,394,240,154,174,153,4,12,5,8
E02001805,1117,836,213,623,1,148,77,71,126,108,6,7,5,6
E02001806,3747,2566,700,1866,15,629,347,282,512,450,7,44,11,25
E02001807,7440,5679,1297,4382,11,1125,701,424,596,547,4,44,1,29
E02001808,1533,1240,336,904,6,110,65,45,172,150,3,19,0,5
E02001809,5326,3949,1016,2933,10,890,573,317,457,401,1,48,7,20
E02001810,1986,1490,368,1122,4,302,200,102,185,162,1,16,6,5
E02001811,1800,1346,312,1034,2,285,171,114,148,122,0,23,3,19
E02001812,2721,2206,586,1620,7,240,135,105,246,223,3,14,6,22
E02001813,2039,1471,337,1134,3,400,187,213,154,133,2,17,2,11
E02001814,3106,2307,635,1672,5,486,252,234,297,264,1,29,3,11
E02001815,2670,2115,568,1547,8,357,220,137,180,161,5,11,3,10
E02001816,1433,1037,253,784,5,257,147,110,124,115,2,6,1,10
E02001817,1141,841,264,577,4,186,85,101,107,92,1,11,3,3
E02001818,1847,1423,334,1089,4,257,157,100,151,130,5,13,3,12
E02001819,8729,6650,1292,5358,27,947,482,465,1080,945,9,119,7,25
E02001820,1605,1282,300,982,0,204,109,95,106,91,1,11,3,13
E02001821,696,576,114,462,0,56,23,33,57,48,2,6,1,7
E02001822,1838,1401,387,1014,6,234,139,95,186,164,1,19,2,11
E02001823,1355,1001,275,726,7,214,110,104,124,106,1,16,1,9
E02001824,2700,2131,594,1537,8,352,198,154,198,172,0,21,5,11
E02001825,5076,3674,945,2729,12,694,432,262,672,617,2,49,4,24
E02001826,1049,746,213,533,6,177,115,62,116,102,0,11,3,4
E02001827,918,757,260,497,11,40,17,23,104,92,3,8,1,6
E02001828,2831,2298,707,1591,21,154,94,60,338,306,5,21,6,20
E02001829,1462,1271,397,874,4,60,23,37,121,106,6,9,0,6
E02001830,4094,3343,1008,2335,30,232,131,101,450,407,2,37,4,39
E02001831,2182,1698,423,1275,27,211,134,77,230,212,6,9,3,16
E02001832,5437,4252,1153,3099,42,393,237,156,713,651,19,41,2,37
E02001833,1318,1077,296,781,5,106,56,50,119,107,1,11,0,11
E02001834,1451,1093,325,768,9,157,134,23,176,159,3,14,0,16
E02001835,5563,4270,1182,3088,33,406,247,159,808,748,4,48,8,46
E02001836,3284,2624,768,1856,15,259,165,94,360,323,4,31,2,26
E02001837,1347,907,228,679,6,241,205,36,178,167,1,9,1,15
E02001838,1863,1543,487,1056,16,92,53,39,192,177,0,9,6,20
E02001839,2177,1771,579,1192,10,141,110,31,235,218,0,16,1,20
E02001840,1549,1034,284,750,15,258,180,78,224,207,4,11,2,18
E02001841,1158,965,367,598,7,71,41,30,102,92,4,3,3,13
E02001842,942,762,210,552,4,34,23,11,135,127,1,5,2,7
E02001843,1888,1404,401,1003,6,193,131,62,268,243,3,20,2,17
E02001844,3156,2300,691,1609,28,304,186,118,505,464,5,28,8,19
E02001845,1346,1084,279,805,5,74,44,30,172,158,1,11,2,11
E02001846,1042,704,181,523,8,148,111,37,170,158,1,11,0,12
E02001847,4440,3274,896,2378,33,488,276,212,621,560,3,46,12,24
E02001848,1751,1286,381,905,13,194,125,69,242,225,3,10,4,16
E02001849,4235,2914,844,2070,40,517,328,189,745,700,6,37,2,19
E02001850,3288,2384,771,1613,23,323,187,136,530,503,4,20,3,28
E02001851,2598,1879,463,1416,9,354,194,160,330,307,2,19,2,26
E02001852,1919,1441,389,1052,14,189,120,69,261,241,0,15,5,14
E02001854,8272,5956,1514,4442,72,911,531,380,1291,1196,14,77,4,42
E02001855,6644,4759,1267,3492,59,1105,419,686,689,653,1,32,3,32
E02001856,1974,1397,386,1011,13,164,94,70,381,354,6,19,2,19
E02001857,5206,3517,939,2578,53,623,368,255,964,911,4,45,4,49
E02001858,1290,823,271,552,9,154,56,98,290,261,5,22,2,14
E02001859,8483,6091,1854,4237,81,823,491,332,1406,1329,9,64,4,82
E02001860,1122,671,262,409,7,146,65,81,279,254,0,11,14,19
E02001861,1582,987,390,597,11,266,89,177,292,273,1,13,5,26
E02001862,2635,1721,608,1113,24,379,192,187,470,422,5,32,11,41
E02001863,5965,4324,1249,3075,60,649,381,268,872,807,4,51,10,60
E02001864,613,383,99,284,6,149,123,26,66,63,0,3,0,9
E02001865,3274,2215,827,1388,24,384,179,205,598,515,12,61,10,53
E02001866,1769,1119,395,724,8,329,127,202,286,252,10,9,15,27
E02001867,1753,1163,355,808,14,306,173,133,240,223,0,15,2,30
E02001868,1477,1075,344,731,9,176,120,56,201,187,6,8,0,16
E02001869,7331,5002,1386,3616,80,1126,737,389,1081,1001,8,57,15,42
E02001870,2376,1685,543,1142,12,295,203,92,352,331,1,18,2,32
E02001871,787,517,129,388,33,164,123,41,70,66,1,3,0,3
E02001872,1356,933,211,722,22,269,201,68,118,108,2,6,2,14
E02001873,7289,5112,1475,3637,50,857,439,418,1200,1125,1,61,13,70
E02001874,2353,1556,498,1058,25,337,192,145,407,380,4,19,4,28
E02001875,5834,4044,1300,2744,45,814,517,297,881,807,6,56,12,50
E02001876,33932,24830,6681,18149,308,3198,1954,1244,5374,5048,28,254,44,222
E02001877,2594,1734,610,1124,19,352,195,157,458,427,0,22,9,31
E02001878,5626,3825,1159,2666,52,839,517,322,844,757,9,70,8,66
E02001879,3162,2097,678,1419,20,495,290,205,522,490,6,16,10,28
E02001880,1153,782,178,604,20,230,195,35,112,107,1,3,1,9
E02001881,1678,1131,335,796,10,240,193,47,263,243,2,11,7,34
E02001882,2459,1771,512,1259,22,320,239,81,326,300,0,24,2,20
E02001883,2480,1740,502,1238,23,425,346,79,277,254,3,17,3,15
E02001884,2944,2066,693,1373,27,383,254,129,444,404,1,34,5,24
E02001886,2414,1615,546,1069,25,267,164,103,483,450,8,22,3,24
E02001888,1176,837,228,609,4,181,151,30,145,129,0,14,2,9
E02001889,2549,1711,501,1210,19,333,229,104,460,424,2,19,15,26
E02001890,8908,6293,1729,4564,102,795,434,361,1648,1532,16,84,16,70
E02001892,5928,4289,1073,3216,57,665,478,187,871,815,2,45,9,46
E02001893,1502,1103,298,805,7,178,131,47,195,169,1,23,2,19
E02001895,4154,2975,824,2151,26,608,443,165,527,482,7,36,2,18
E02001896,3288,2249,705,1544,22,378,214,164,607,559,4,35,9,32
E02001897,4660,3021,1011,2010,44,811,482,329,722,669,6,36,11,62
E02001898,719,614,145,469,2,36,27,9,61,50,2,9,0,6
E02001899,2686,1990,618,1372,21,230,143,87,404,369,1,28,6,41
E02001900,3987,2881,829,2052,36,413,245,168,631,585,7,34,5,26
E02001901,3536,2408,755,1653,26,384,253,131,658,603,6,43,6,60
E02001902,1133,891,236,655,5,86,61,25,143,129,4,8,2,8
E02001903,2203,1517,589,928,14,308,145,163,323,288,1,20,14,41
E02001904,7181,5183,1504,3679,54,861,593,268,1030,959,5,46,20,53
E02001905,11762,7934,2470,5464,95,760,428,332,2867,2707,32,102,26,106
E02001906,1923,1440,428,1012,6,178,144,34,278,251,2,24,1,21
E02001907,4903,3784,1011,2773,42,466,335,131,571,526,4,36,5,40
E02001908,1468,1040,452,588,8,154,76,78,243,223,1,16,3,23
E02001909,2425,1605,573,1032,18,341,154,187,427,388,2,34,3,34
E02001910,1362,858,370,488,9,251,116,135,216,199,2,12,3,28
E02001911,983,616,166,450,9,228,195,33,117,107,2,6,2,13
E02001913,9320,6536,1639,4897,115,962,582,380,1638,1513,26,72,27,69
E02001914,1462,914,308,606,8,196,108,88,313,295,2,12,4,31
E02001915,3804,2647,741,1906,40,477,345,132,607,559,4,37,7,33
E02001916,3478,2607,734,1873,29,335,256,79,479,453,3,20,3,28
E02001918,4276,2838,887,1951,31,495,207,288,883,835,3,32,13,29
E02001919,802,532,198,334,7,65,38,27,189,181,0,5,3,9
E02001920,2941,2217,602,1615,26,309,247,62,374,333,1,32,8,15
E02001921,1081,720,241,479,12,168,133,35,171,161,1,8,1,10
E02001922,4319,2638,813,1825,35,463,260,203,1124,1052,19,36,17,59
E02001923,3195,2425,773,1652,27,233,138,95,470,432,4,30,4,40
E02001924,1376,1071,295,776,14,106,80,26,174,165,0,8,1,11
E02001925,1936,1255,366,889,19,269,141,128,359,325,9,22,3,34
E02001926,2763,1906,583,1323,24,302,163,139,503,461,2,33,7,28
E02001927,1421,932,252,680,15,294,220,74,170,148,2,16,4,10
E02001928,1349,929,261,668,9,229,196,33,167,153,1,10,3,15
E02001929,870,611,151,460,2,141,128,13,101,91,0,10,0,15
E02001930,3570,2473,744,1729,30,434,299,135,581,547,3,28,3,52
E02001931,1286,1033,365,668,3,92,62,30,150,134,0,13,3,8
E02001932,1446,1018,267,751,42,197,134,63,168,152,1,12,3,21
E02001933,1875,1346,374,972,18,219,142,77,277,256,5,14,2,15
E02001934,1530,1150,377,773,10,114,82,32,239,225,1,10,3,17
E02001935,1574,1088,345,743,19,271,136,135,180,159,2,15,4,16
E02001936,1521,1166,373,793,11,147,92,55,180,159,5,13,3,17
E02001937,1342,910,272,638,21,212,173,39,178,161,2,13,2,21
E02001938,2854,1964,584,1380,29,373,206,167,460,421,4,31,4,28
E02001939,2911,2164,573,1591,34,349,145,204,343,314,4,23,2,21
E02001941,900,622,157,465,6,147,127,20,116,107,1,7,1,9
E02001942,1891,1246,350,896,32,290,176,114,307,284,7,14,2,16
E02001943,1251,878,235,643,22,147,103,44,193,175,4,14,0,11
E02001944,1570,1152,314,838,41,186,136,50,173,157,2,13,1,18
E02001945,1086,713,190,523,16,222,178,44,125,106,0,16,3,10
E02001946,2448,1738,479,1259,19,367,237,130,302,283,3,15,1,22
E02001947,1195,803,187,616,10,248,205,43,122,108,1,11,2,12
E02001948,1821,1327,404,923,20,265,220,45,202,182,2,17,1,7
E02001949,3528,2531,605,1926,50,447,304,143,488,454,2,29,3,12
E02001950,2292,1722,433,1289,29,249,164,85,275,254,1,20,0,17
E02001951,1131,717,156,561,10,256,197,59,128,118,1,8,1,20
E02001952,1415,911,228,683,24,295,198,97,165,148,2,13,2,20
E02001953,2595,1960,553,1407,29,328,235,93,261,234,3,21,3,17
E02001954,1038,671,166,505,11,236,204,32,110,102,1,7,0,10
E02001955,1769,1320,336,984,25,216,143,73,200,182,1,13,4,8
E02001956,2941,2019,453,1566,39,410,285,125,451,419,4,26,2,22
E02001957,1042,804,212,592,6,105,66,39,112,103,0,9,0,15
E02001958,3685,2721,703,2018,24,282,106,176,635,585,8,32,10,23
E02001959,3149,2120,564,1556,24,321,135,186,674,647,1,24,2,10
E02001961,947,646,165,481,2,144,63,81,142,125,0,17,0,13
E02001962,1979,1446,428,1018,11,172,75,97,337,316,2,18,1,13
E02001963,1066,886,265,621,2,55,28,27,116,98,5,12,1,7
E02001964,2344,1541,442,1099,18,374,141,233,388,360,3,20,5,23
E02001965,5204,3711,882,2829,46,416,149,267,981,911,2,60,8,50
E02001966,4917,3634,1009,2625,31,421,166,255,805,733,2,61,9,26
E02001967,3269,2611,763,1848,23,176,73,103,434,401,4,24,5,25
E02001968,2744,2195,624,1571,7,161,77,84,368,331,3,27,7,13
E02001969,984,717,208,509,2,91,44,47,167,152,1,12,2,7
E02001970,1241,954,276,678,8,88,31,57,179,164,2,13,0,12
E02001971,658,553,162,391,0,21,9,12,76,70,1,4,1,8
E02001972,3920,2747,853,1894,24,417,130,287,696,638,4,47,7,36
E02001973,1410,872,262,610,8,209,87,122,309,281,1,22,5,12
E02001974,2595,1966,545,1421,10,145,49,96,460,404,1,51,4,14
E02001975,1097,896,249,647,3,35,18,17,151,130,1,17,3,12
E02001976,11351,8473,2272,6201,80,860,332,528,1893,1737,23,118,15,45
E02001977,3209,2147,619,1528,25,306,104,202,710,647,6,48,9,21
E02001978,1793,1270,375,895,7,140,42,98,357,332,1,21,3,19
E02001979,1110,878,257,621,2,51,22,29,171,155,2,13,1,8
E02001980,764,648,216,432,1,30,11,19,77,71,1,5,0,8
E02001981,3433,2214,766,1448,25,447,118,329,715,659,3,46,7,32
E02001982,1350,1067,280,787,14,93,27,66,171,155,1,12,3,5
E02001983,3997,2740,707,2033,16,376,151,225,842,802,1,36,3,23
E02001984,1848,1276,344,932,5,146,56,90,400,370,3,20,7,21
E02001985,2806,1941,581,1360,13,194,71,123,636,592,8,31,5,22
E02001986,1710,1296,347,949,12,205,83,122,185,169,1,13,2,12
E02001987,1423,1036,293,743,6,73,18,55,295,261,2,26,6,13
E02001988,24922,18309,5131,13178,189,1785,622,1163,4464,4125,33,257,49,175
E02001989,1866,1355,396,959,11,173,62,111,318,297,4,17,0,9
E02001990,4872,3740,977,2763,43,312,124,188,750,680,9,57,4,27
E02001991,3519,2753,869,1884,9,239,93,146,499,445,8,33,13,19
E02001992,3909,2846,812,2034,24,448,184,264,570,534,3,31,2,21
E02001993,9032,7033,1759,5274,78,602,248,354,1273,1149,14,95,15,46
E02001994,1157,870,261,609,6,83,30,53,184,156,2,20,6,14
E02001995,8188,6195,1625,4570,34,499,208,291,1431,1346,8,60,17,29
E02001996,1926,1338,325,1013,18,319,121,198,242,227,3,11,1,9
E02001997,981,819,295,524,5,49,16,33,101,86,1,10,4,7
E02001998,1246,1061,302,759,3,41,17,24,135,119,1,15,0,6
E02001999,8731,6255,1882,4373,53,383,150,233,1991,1854,32,87,18,49
E02002000,1638,1188,364,824,4,304,248,56,132,120,1,10,1,10
E02002001,1636,1233,365,868,9,233,192,41,154,138,1,11,4,7
E02002002,1248,1033,359,674,1,130,110,20,75,67,0,8,0,9
E02002003,1460,1135,337,798,6,183,162,21,123,105,1,10,7,13
E02002004,1112,830,222,608,13,173,123,50,89,80,3,5,1,7
E02002005,5091,3522,1096,2426,40,875,724,151,622,571,8,38,5,32
E02002006,1121,830,242,588,18,187,147,40,76,65,2,8,1,10
E02002007,1400,1111,375,736,5,151,135,16,113,101,3,8,1,20
E02002008,1826,1474,417,1057,13,180,142,38,143,128,1,12,2,16
E02002009,1861,1240,398,842,4,397,337,60,203,186,0,16,1,17
E02002010,7044,5389,1665,3724,61,847,687,160,705,640,5,49,11,42
E02002011,6241,4886,1587,3299,30,719,584,135,566,521,3,32,10,40
E02002012,6340,4787,1355,3432,37,727,569,158,740,634,39,34,33,49
E02002013,1860,1504,523,981,12,170,139,31,168,147,1,13,7,6
E02002014,4670,3655,1080,2575,21,548,447,101,412,370,8,25,9,34
E02002015,2238,1785,534,1251,13,224,191,33,208,179,2,23,4,8
E02002016,3137,2303,727,1576,17,517,444,73,273,247,2,22,2,27
E02002017,3960,2933,912,2021,20,580,496,84,408,375,6,21,6,19
E02002018,1671,1455,490,965,5,103,86,17,95,89,1,5,0,13
E02002019,2662,1899,589,1310,17,424,366,58,304,276,4,19,5,18
E02002020,2410,1923,596,1327,7,237,187,50,233,211,1,15,6,10
E02002021,15873,11891,3349,8542,104,1956,1575,381,1837,1683,12,125,17,85
E02002022,2651,1978,611,1367,13,370,313,57,274,244,4,22,4,16
E02002023,667,521,183,338,5,76,54,22,65,57,3,4,1,0
E02002024,1586,1189,359,830,6,227,203,24,150,131,3,13,3,14
E02002025,2901,2258,693,1565,16,313,244,69,295,270,2,22,1,19
E02002026,1070,906,264,642,11,44,34,10,108,93,2,12,1,1
E02002027,984,879,242,637,8,46,39,7,50,46,0,4,0,1
E02002028,773,612,188,424,4,79,64,15,73,67,0,5,1,5
E02002029,1731,1395,394,1001,12,136,107,29,175,152,0,19,4,13
E02002030,2328,1797,545,1252,19,261,185,76,234,212,2,17,3,17
E02002031,3092,2364,799,1565,25,369,295,74,323,279,0,44,0,11
E02002032,1859,1410,428,982,12,226,170,56,195,179,4,11,1,16
E02002033,6027,4750,1429,3321,35,608,464,144,605,566,2,33,4,29
E02002034,5547,4345,1332,3013,25,535,405,130,591,537,11,41,2,51
E02002035,1349,1096,396,700,4,127,96,31,109,98,1,8,2,13
E02002036,2241,1611,522,1089,14,336,289,47,263,245,2,13,3,17
E02002037,1027,848,280,568,2,89,80,9,84,72,1,9,2,4
E02002038,4721,3630,1104,2526,35,491,375,116,542,485,7,44,6,23
E02002039,2468,1907,672,1235,13,218,167,51,283,255,5,15,8,47
E02002040,1340,1143,432,711,3,78,67,11,104,91,3,8,2,12
E02002041,1024,830,291,539,4,107,100,7,70,64,1,4,1,13
E02002042,1138,962,324,638,3,80,60,20,89,77,2,8,2,4
E02002043,2839,1991,556,1435,14,469,371,98,343,314,2,24,3,22
E02002044,695,516,124,392,2,84,61,23,87,83,0,3,1,6
E02002045,1450,1066,330,736,8,220,180,40,146,129,1,14,2,10
E02002046,977,649,188,461,2,240,221,19,79,69,0,6,4,7
E02002047,6255,4303,1246,3057,36,1087,821,266,792,720,7,59,6,37
E02002048,1580,1271,427,844,9,116,78,38,169,155,6,7,1,15
E02002049,2230,1636,527,1109,22,345,272,73,214,192,3,16,3,13
E02002051,671,446,106,340,4,144,115,29,66,54,1,11,0,11
E02002052,2487,1695,474,1221,10,474,385,89,290,278,2,7,3,18
E02002053,1006,733,226,507,5,99,74,25,158,154,0,4,0,11
E02002054,660,534,198,336,2,56,46,10,60,51,1,5,3,8
E02002055,6459,4194,1280,2914,40,1125,878,247,1064,994,7,49,14,36
E02002056,2749,1904,602,1302,11,560,468,92,256,232,4,13,7,18
E02002057,2125,1514,459,1055,24,365,293,72,210,203,0,6,1,12
E02002058,5817,4330,1220,3110,39,735,573,162,676,615,4,48,9,37
E02002059,5499,3954,1054,2900,35,683,518,165,795,732,16,36,11,32
E02002060,5000,3547,1126,2421,33,777,655,122,612,558,8,38,8,31
E02002061,6928,5123,1543,3580,54,902,653,249,793,734,8,43,8,56
E02002062,8394,6007,1769,4238,60,1268,928,340,994,916,9,59,10,65
E02002063,8171,5873,1658,4215,54,1141,887,254,1050,976,10,61,3,53
E02002064,1336,1005,277,728,8,202,180,22,111,100,2,7,2,10
E02002065,8992,6361,1902,4459,71,1083,798,285,1413,1293,7,92,21,64
E02002066,7354,5379,1633,3746,48,1013,784,229,862,799,5,38,20,52
E02002067,1462,1085,336,749,15,213,187,26,144,129,1,12,2,5
E02002068,6507,4567,1450,3117,43,911,637,274,934,881,4,38,11,52
E02002069,3261,2398,626,1772,25,422,329,93,390,356,5,25,4,26
E02002070,1737,1171,379,792,10,227,161,66,309,291,2,13,3,20
E02002071,776,575,168,407,10,119,95,24,67,60,1,2,4,5
E02002072,2287,1729,495,1234,9,274,222,52,258,238,0,15,5,17
E02002073,1080,770,236,534,8,186,159,27,108,102,1,3,2,8
E02002074,1023,749,233,516,2,161,143,18,106,99,1,6,0,5
E02002075,3131,2256,673,1583,29,447,370,77,381,340,8,26,7,18
E02002076,2552,1761,615,1146,7,267,204,63,497,458,7,24,8,20
E02002077,4553,3365,1024,2341,23,645,520,125,488,452,3,27,6,32
E02002078,1134,879,270,609,3,101,81,20,142,126,2,13,1,9
E02002079,1439,1085,307,778,15,166,140,26,166,155,3,7,1,7
E02002080,3137,2356,784,1572,23,425,353,72,305,274,5,18,8,28
E02002081,1235,996,302,694,6,119,61,58,106,95,1,9,1,8
E02002082,465,314,81,233,5,100,82,18,44,40,0,4,0,2
E02002083,1399,1120,294,826,16,133,88,45,119,109,2,6,2,11
E02002084,1324,931,230,701,15,252,195,57,119,107,1,9,2,7
E02002085,1034,740,205,535,8,168,142,26,112,104,1,7,0,6
E02002086,2760,1860,440,1420,27,586,470,116,277,247,2,25,3,10
E02002087,1318,965,234,731,8,212,180,32,127,110,3,13,1,6
E02002088,1125,801,191,610,9,205,161,44,102,88,0,14,0,8
E02002089,17643,13158,3291,9867,185,1693,1185,508,2523,2380,11,122,10,84
E02002090,805,679,187,492,3,34,25,9,85,76,1,8,0,4
E02002091,8375,6871,1622,5249,37,741,519,222,691,645,4,36,6,35
E02002092,1573,1207,345,862,9,143,108,35,200,183,0,15,2,14
E02002093,2153,1688,513,1175,13,169,117,52,269,251,0,17,1,14
E02002094,1115,940,300,640,6,42,36,6,117,107,0,10,0,10
E02002095,1950,1534,485,1049,12,135,102,33,257,221,7,22,7,12
E02002096,6266,4878,1448,3430,51,448,331,117,846,790,8,44,4,43
E02002097,3748,2898,881,2017,22,252,159,93,532,485,8,31,8,44
E02002098,2860,2311,665,1646,16,199,157,42,320,298,1,18,3,14
E02002099,14266,11145,3230,7915,128,929,673,256,1991,1839,21,115,16,73
E02002101,952,764,216,548,7,70,54,16,104,89,4,7,4,7
E02002102,7875,6233,1676,4557,80,485,360,125,1037,959,3,66,9,40
E02002103,1244,1073,340,733,1,49,41,8,115,102,3,8,2,6
E02002104,1026,894,293,601,3,22,15,7,98,89,1,8,0,9
E02002105,2138,1803,576,1227,9,91,53,38,218,198,6,9,5,17
E02002106,3324,2722,882,1840,12,154,105,49,407,367,7,26,7,29
E02002107,3093,2371,608,1763,34,236,171,65,441,412,2,26,1,11
E02002108,1982,1694,568,1126,8,70,41,29,197,183,1,10,3,13
E02002109,4551,3616,901,2715,34,157,96,61,713,653,10,39,11,31
E02002110,2951,2206,599,1607,25,369,180,189,334,298,14,18,4,17
E02002111,2145,1587,435,1152,12,286,141,145,244,220,6,18,0,16
E02002112,556,459,135,324,1,54,34,20,37,35,0,2,0,5
E02002113,2432,1817,486,1331,19,302,133,169,279,253,2,19,5,15
E02002114,1012,777,241,536,4,119,59,60,107,92,0,12,3,5
E02002115,1046,789,232,557,2,148,76,72,98,84,3,8,3,9
E02002116,1049,861,253,608,2,89,42,47,94,85,1,8,0,3
E02002117,1984,1464,364,1100,13,301,148,153,198,174,2,16,6,8
E02002118,854,617,159,458,3,154,89,65,71,58,0,12,1,9
E02002119,1288,1056,303,753,6,92,46,46,125,104,1,19,1,9
E02002120,1034,853,241,612,4,95,54,41,76,68,0,8,0,6
E02002121,2235,1548,434,1114,4,420,223,197,252,220,4,18,10,11
E02002122,1006,707,225,482,8,186,102,84,103,96,2,4,1,2
E02002123,732,528,179,349,4,107,51,56,81,73,0,6,2,12
E02002124,6878,5085,1450,3635,46,844,430,414,861,797,8,50,6,42
E02002125,3166,2374,694,1680,36,371,182,189,366,334,4,22,6,19
E02002126,5521,3670,1078,2592,34,997,432,565,790,723,4,54,9,30
E02002127,4674,3330,875,2455,37,673,325,348,604,542,3,51,8,30
E02002128,1088,864,266,598,8,120,73,47,93,80,1,12,0,3
E02002129,2736,2020,578,1442,8,394,242,152,306,275,2,24,5,8
E02002130,1373,975,279,696,5,225,67,158,163,155,2,6,0,5
E02002131,2399,1961,591,1370,13,191,118,73,221,206,2,11,2,13
E02002132,748,539,150,389,1,144,84,60,64,55,0,9,0,0
E02002133,3626,2489,727,1762,22,453,196,257,636,604,2,25,5,26
E02002134,4840,3502,1082,2420,19,755,461,294,520,481,2,34,3,44
E02002135,7287,5391,1527,3864,45,966,464,502,845,772,9,46,18,40
E02002136,4438,3149,935,2214,29,709,470,239,525,488,6,24,7,26
E02002137,1050,917,295,622,2,35,15,20,87,77,0,10,0,9
E02002138,1320,1033,369,664,6,102,45,57,163,147,2,12,2,16
E02002139,14994,10829,3332,7497,101,2146,987,1159,1826,1680,10,112,24,92
E02002140,2023,1406,440,966,13,310,170,140,276,258,0,15,3,18
E02002141,1173,1009,259,750,9,32,21,11,120,102,1,16,1,3
E02002142,5073,3590,1131,2459,19,854,487,367,586,540,3,40,3,24
E02002143,2354,1693,538,1155,7,290,126,164,341,301,4,31,5,23
E02002144,842,723,283,440,1,26,16,10,86,79,2,3,2,6
E02002145,1408,993,305,688,1,270,152,118,136,122,1,9,4,8
E02002146,1777,1339,346,993,15,193,94,99,211,194,2,14,1,19
E02002147,2021,1367,458,909,10,376,260,116,255,236,3,15,1,13
E02002148,1725,1481,382,1099,9,75,47,28,142,136,0,6,0,18
E02002149,2991,2251,589,1662,22,391,310,81,314,274,6,27,7,13
E02002150,4737,3710,1020,2690,17,496,360,136,481,435,4,37,5,33
E02002151,973,678,183,495,10,187,154,33,85,75,0,9,1,13
E02002152,1091,736,192,544,6,235,208,27,99,92,1,4,2,15
E02002153,845,659,177,482,0,143,126,17,42,35,0,4,3,1
E02002154,1607,1147,321,826,9,284,215,69,156,143,1,9,3,11
E02002155,922,572,142,430,6,253,194,59,90,82,6,1,1,1
E02002156,1475,1128,296,832,4,193,170,23,141,126,1,13,1,9
E02002157,1762,1371,463,908,6,160,123,37,198,185,1,12,0,27
E02002158,1377,1008,320,688,3,216,186,30,139,122,0,12,5,11
E02002159,1693,1133,366,767,12,344,278,66,190,179,1,8,2,14
E02002160,6996,5095,1505,3590,21,1055,781,274,779,726,9,34,10,46
E02002161,2857,2015,594,1421,15,388,276,112,425,386,5,24,10,14
E02002162,2345,1847,640,1207,13,198,144,54,267,242,4,21,0,20
E02002163,9565,6976,2021,4955,59,1355,1058,297,1120,1025,26,42,27,55
E02002164,1729,985,334,651,8,381,254,127,334,309,0,16,9,21
E02002165,4607,3301,1012,2289,26,531,348,183,713,655,3,42,13,36
E02002166,4228,2959,920,2039,18,743,591,152,478,438,0,32,8,30
E02002167,1477,1154,397,757,0,135,112,23,177,165,2,9,1,11
E02002168,22313,16478,4974,11504,112,2683,1903,780,2910,2697,34,147,32,130
E02002169,2824,2268,784,1484,13,230,172,58,295,263,4,27,1,18
E02002170,600,458,139,319,4,84,66,18,51,46,1,4,0,3
E02002171,1364,1011,329,682,3,204,175,29,133,118,3,11,1,13
E02002174,1300,1030,344,686,4,99,69,30,144,139,1,3,1,23
E02002175,4506,3030,997,2033,26,767,589,178,637,590,4,38,5,46
E02002176,1291,1024,301,723,4,162,142,20,95,86,2,7,0,6
E02002177,5311,3792,1120,2672,32,870,704,166,587,544,7,31,5,30
E02002178,1254,907,369,538,1,127,86,41,205,190,3,12,0,14
E02002179,1446,1159,385,774,7,108,84,24,154,144,1,4,5,18
E02002180,2120,1572,517,1055,11,320,267,53,203,179,4,17,3,14
E02002181,2027,1368,438,930,9,436,373,63,197,183,0,10,4,17
E02002182,1275,891,315,576,5,249,214,35,124,113,2,7,2,6
E02002183,1808,1439,501,938,9,80,40,40,257,237,6,12,2,23
E02002184,5361,4212,1409,2803,27,272,128,144,792,734,7,45,6,58
E02002185,1202,920,313,607,9,75,42,33,187,162,1,22,2,11
E02002186,7536,5977,1769,4208,31,283,135,148,1191,1086,12,82,11,54
E02002187,1068,869,310,559,7,54,28,26,126,109,2,10,5,12
E02002188,2530,2058,576,1482,10,97,43,54,343,320,0,23,0,22
E02002189,1689,1331,436,895,3,87,42,45,241,226,1,12,2,27
E02002190,10190,7811,2381,5430,61,635,282,353,1603,1441,14,129,19,80
E02002191,2015,1543,503,1040,13,136,62,74,302,259,4,34,5,21
E02002192,2687,2143,622,1521,7,98,38,60,412,382,3,26,1,27
E02002193,1936,1508,491,1017,6,126,69,57,285,268,3,13,1,11
E02002194,1047,868,218,650,7,55,34,21,108,94,0,14,0,9
E02002195,1641,1332,377,955,2,57,32,25,228,195,12,20,1,22
E02002196,970,801,240,561,16,40,17,23,107,92,2,11,2,6
E02002197,3664,2861,877,1984,15,216,94,122,554,502,2,44,6,18
E02002198,2584,2040,543,1497,12,165,95,70,358,319,8,29,2,9
E02002199,2359,1760,423,1337,17,211,111,100,343,313,0,26,4,28
E02002200,2721,2052,586,1466,11,162,79,83,476,446,2,27,1,20
E02002201,3233,2489,616,1873,20,217,120,97,473,419,4,33,17,34
E02002202,8221,6344,1740,4604,38,506,235,271,1278,1155,11,96,16,55
E02002203,1201,908,238,670,6,109,61,48,173,154,2,15,2,5
E02002204,3651,2946,832,2114,14,181,83,98,480,424,5,43,8,30
E02002205,2671,2149,698,1451,10,58,24,34,419,383,3,27,6,35
E02002206,1492,1143,270,873,7,101,51,50,223,207,0,15,1,18
E02002207,1411,1078,349,729,6,67,32,35,240,225,0,10,5,20
E02002208,2349,1783,455,1328,11,204,112,92,338,304,0,29,5,13
E02002209,1111,782,207,575,6,168,98,70,153,138,1,11,3,2
E02002210,1310,1042,301,741,7,61,35,26,192,173,3,13,3,8
E02002211,1203,924,296,628,5,61,32,29,201,172,2,26,1,12
E02002212,2897,2215,518,1697,11,170,94,76,471,436,2,31,2,30
E02002213,1842,1387,446,941,8,112,53,59,310,263,22,22,3,25
E02002214,938,760,213,547,7,40,20,20,127,109,3,13,2,4
E02002215,1941,1575,529,1046,12,76,26,50,251,227,1,18,5,27
E02002216,3542,2656,958,1698,11,264,87,177,555,518,9,22,6,56
E02002217,2225,1661,542,1119,7,154,65,89,379,342,1,33,3,24
E02002218,1376,1035,305,730,5,121,60,61,209,181,5,18,5,6
E02002219,6374,5031,1364,3667,21,286,129,157,997,914,11,68,4,39
E02002220,6046,4385,1237,3148,32,553,319,234,1039,964,5,65,5,37
E02002221,26462,19525,5649,13876,133,2017,851,1166,4596,4160,31,359,46,191
E02002222,2529,1641,440,1201,19,238,104,134,614,581,6,17,10,17
E02002223,4840,3492,1165,2327,24,362,156,206,917,856,0,46,15,45
E02002224,2446,1820,665,1155,7,168,56,112,407,367,3,33,4,44
E02002225,2103,1684,475,1209,4,130,57,73,262,226,2,25,9,23
E02002226,7913,5910,2122,3788,32,396,161,235,1475,1365,8,83,19,100
E02002227,8629,6843,1912,4931,42,598,260,338,1077,972,6,88,11,69
E02002228,6175,4517,1182,3335,21,584,265,319,1011,918,9,67,17,42
E02002229,1394,1128,350,778,5,76,27,49,176,144,1,23,8,9
E02002230,5424,3971,1131,2840,21,446,193,253,931,857,12,50,12,55
E02002231,2041,1514,435,1079,14,140,70,70,347,313,1,30,3,26
E02002232,2124,1547,480,1067,11,182,82,100,363,337,4,19,3,21
E02002233,1270,966,329,637,8,107,50,57,175,158,1,13,3,14
E02002234,1076,657,135,522,5,224,117,107,177,166,1,10,0,13
E02002235,3994,2983,752,2231,22,309,141,168,646,591,2,45,8,34
E02002236,1388,1078,298,780,6,83,43,40,210,191,3,14,2,11
E02002237,1260,973,227,746,4,81,44,37,194,179,2,11,2,8
E02002238,1648,1208,313,895,5,145,69,76,277,253,3,16,5,13
E02002239,8886,6349,1585,4764,40,891,481,410,1532,1427,7,87,11,74
E02002240,2507,2047,534,1513,6,104,47,57,322,288,5,23,6,28
E02002241,3137,2467,609,1858,5,287,163,124,356,311,2,36,7,22
E02002242,5292,4185,1026,3159,18,328,174,154,709,635,10,55,9,52
E02002243,2412,1842,523,1319,8,175,101,74,367,330,8,24,5,20
E02002244,2301,1774,505,1269,9,199,90,109,306,249,16,31,10,13
E02002245,863,587,163,424,0,127,59,68,140,131,2,6,1,9
E02002246,2001,1666,477,1189,5,61,29,32,254,230,5,14,5,15
E02002247,3234,2474,947,1527,22,188,61,127,520,460,4,48,8,30
E02002248,1641,1239,300,939,10,167,85,82,215,195,1,19,0,10
E02002249,1067,775,189,586,8,127,55,72,147,127,2,17,1,10
E02002250,3030,2336,766,1570,7,163,71,92,503,461,3,36,3,21
E02002251,22903,17836,4295,13541,112,1375,553,822,3431,3113,10,269,39,149
E02002252,619,508,177,331,0,43,16,27,59,47,0,10,2,9
E02002253,2358,1785,515,1270,6,211,74,137,332,295,3,32,2,24
E02002254,1838,1462,454,1008,7,109,55,54,249,221,2,24,2,11
E02002255,4797,3656,1234,2422,24,410,153,257,670,595,8,57,10,37
E02002256,3200,2377,794,1583,29,218,92,126,550,476,14,43,17,26
E02002257,1623,1221,386,835,4,125,38,87,258,235,4,14,5,15
E02002258,4870,3823,1056,2767,18,310,186,124,676,614,4,46,12,43
E02002259,3488,2742,667,2075,11,146,56,90,559,489,5,55,10,30
E02002260,3082,2339,640,1699,23,194,72,122,493,457,5,28,3,33
E02002261,3374,2561,684,1877,12,229,124,105,545,503,2,38,2,27
E02002262,4999,3829,1115,2714,20,359,185,174,768,691,8,61,8,23
E02002263,1403,1119,349,770,2,100,39,61,160,146,0,12,2,22
E02002264,4374,3391,957,2434,15,280,100,180,664,595,11,50,8,24
E02002265,1682,1289,430,859,10,94,44,50,280,252,11,15,2,9
E02002266,1226,931,297,634,6,100,59,41,182,165,3,12,2,7
E02002267,1653,1309,342,967,1,123,72,51,202,176,5,16,5,18
E02002268,7930,6008,1634,4374,21,597,314,283,1247,1119,8,108,12,57
E02002269,2667,2024,595,1429,10,197,97,100,420,373,4,38,5,16
E02002270,2358,1924,613,1311,12,93,37,56,305,276,1,22,6,24
E02002271,2037,1705,424,1281,3,73,51,22,233,201,0,30,2,23
E02002272,6504,4856,1228,3628,26,609,466,143,966,881,4,72,9,47
E02002273,3377,2628,641,1987,14,215,142,73,494,446,1,38,9,26
E02002274,1085,877,229,648,3,64,50,14,128,115,0,9,4,13
E02002275,4280,3280,911,2369,16,326,252,74,621,561,2,52,6,37
E02002276,1780,1338,414,924,9,141,116,25,279,249,1,24,5,13
E02002277,2156,1659,518,1141,6,212,143,69,255,238,1,13,3,24
E02002278,975,794,218,576,2,87,69,18,88,79,0,9,0,4
E02002279,2445,1789,480,1309,6,248,181,67,383,353,0,24,6,19
E02002280,3589,2631,844,1787,23,431,321,110,474,428,4,34,8,30
E02002281,2493,1945,578,1367,6,199,149,50,311,275,3,29,4,32
E02002282,919,713,212,501,7,75,61,14,116,102,1,11,2,8
E02002283,2607,1947,728,1219,12,241,183,58,382,354,0,27,1,25
E02002284,2547,1916,576,1340,4,251,193,58,356,317,2,36,1,20
E02002285,4385,3236,981,2255,16,454,349,105,640,573,5,52,10,39
E02002286,3493,2726,754,1972,20,272,220,52,454,398,8,40,8,21
E02002287,7000,5255,1625,3630,27,702,527,175,960,864,7,84,5,56
E02002288,1749,1359,357,1002,6,187,167,20,187,169,3,12,3,10
E02002289,1671,1194,354,840,8,217,179,38,236,220,3,12,1,16
E02002290,820,687,214,473,2,28,24,4,95,88,3,4,0,8
E02002291,1877,1450,411,1039,5,154,116,38,255,231,3,15,6,13
E02002292,2213,1757,522,1235,5,128,96,32,304,277,1,21,5,19
E02002293,3135,2224,716,1508,9,338,260,78,520,470,1,43,6,44
E02002294,5298,3942,1341,2601,22,560,432,128,701,636,11,50,4,73
E02002295,3445,2437,648,1789,15,410,324,86,554,508,5,37,4,29
E02002296,2673,2158,639,1519,6,159,125,34,334,298,7,21,8,16
E02002297,1265,1058,361,697,3,36,28,8,153,142,0,11,0,15
E02002298,1132,859,263,596,3,144,138,6,121,94,3,19,5,5
E02002299,18231,13372,3845,9527,56,1442,1104,338,3236,2975,16,227,18,125
E02002300,1180,926,288,638,2,50,32,18,190,170,1,16,3,12
E02002301,2401,1826,594,1232,13,175,125,50,366,328,0,27,11,21
E02002302,1898,1437,425,1012,5,151,118,33,293,260,2,22,9,12
E02002303,5108,3844,1074,2770,15,344,239,105,863,766,23,57,17,42
E02002304,4250,3169,1011,2158,11,276,176,100,757,701,8,46,2,37
E02002305,1069,758,212,546,6,139,110,29,152,129,1,18,4,14
E02002306,1554,1296,421,875,6,45,31,14,198,174,4,14,6,9
E02002307,1257,983,302,681,4,111,85,26,150,130,1,16,3,9
E02002308,1400,1126,317,809,2,72,56,16,191,169,5,12,5,9
E02002309,2622,2023,646,1377,7,191,135,56,366,332,6,25,3,35
E02002310,835,629,163,466,4,78,69,9,118,103,0,11,4,6
E02002311,1183,897,255,642,4,101,85,16,172,153,1,17,1,9
E02002312,8303,6370,1846,4524,28,542,411,131,1322,1219,10,84,9,41
E02002313,2382,1765,643,1122,9,160,93,67,419,386,3,28,2,29
E02002314,1125,881,278,603,3,94,74,20,141,122,2,16,1,6
E02002315,2751,2074,621,1453,10,193,145,48,453,407,2,40,4,21
E02002316,1879,1412,422,990,6,154,119,35,285,266,0,14,5,22
E02002317,1181,891,265,626,6,91,73,18,185,165,1,15,4,8
E02002318,1656,1230,425,805,14,155,109,46,247,220,2,22,3,10
E02002319,2583,2059,633,1426,9,138,112,26,361,333,2,22,4,16
E02002320,1414,1136,371,765,3,105,91,14,164,138,3,16,7,6
E02002321,2108,1715,541,1174,6,96,68,28,272,247,3,19,3,19
E02002322,1750,1381,463,918,5,85,64,21,251,232,3,13,3,28
E02002323,2857,2299,744,1555,8,136,107,29,391,352,1,33,5,23
E02002324,1916,1520,495,1025,5,114,87,27,261,230,2,28,1,16
E02002325,2816,2109,639,1470,7,228,186,42,447,409,4,27,7,25
E02002326,1882,1537,480,1057,7,77,56,21,246,215,11,15,5,15
E02002327,3815,3093,968,2125,14,185,146,39,495,452,11,24,8,28
E02002328,1809,1519,519,1000,1,64,53,11,205,167,3,28,7,20
E02002329,4109,3392,1205,2187,10,186,150,36,484,419,14,37,14,37
E02002330,840,722,261,461,5,42,35,7,61,56,1,4,0,10
E02002331,9228,7115,1968,5147,47,757,590,167,1235,1144,15,64,12,74
E02002332,1157,923,290,633,4,111,99,12,113,102,1,8,2,6
E02002333,4344,3300,1073,2227,14,376,304,72,612,550,9,47,6,42
E02002334,2525,2002,650,1352,7,169,143,26,320,265,30,21,4,27
E02002335,1995,1598,526,1072,6,114,86,28,241,215,6,16,4,36
E02002336,5190,3935,1135,2800,31,354,259,95,830,763,4,55,8,40
E02002337,1774,1391,394,997,15,109,73,36,242,210,2,21,9,17
E02002338,3094,2341,703,1638,17,282,219,63,427,392,4,28,3,27
E02002339,2639,1967,597,1370,15,298,239,59,339,317,0,17,5,20
E02002340,1581,1248,333,915,13,107,87,20,209,189,2,17,1,4
E02002341,1509,1279,435,844,2,60,44,16,150,143,2,5,0,18
E02002342,831,626,189,437,0,84,69,15,112,97,4,10,1,9
E02002343,1809,1444,397,1047,7,135,107,28,208,177,1,26,4,15
E02002344,1087,867,265,602,4,45,34,11,153,143,2,7,1,18
E02002345,1643,1284,389,895,2,148,128,20,196,182,1,12,1,13
E02002346,1173,811,224,587,1,223,179,44,125,108,0,10,7,13
E02002347,1504,1013,318,695,5,279,236,43,189,174,1,14,0,18
E02002348,2692,2003,467,1536,8,318,264,54,351,323,1,24,3,12
E02002349,1630,1151,359,792,4,132,84,48,318,299,0,18,1,25
E02002350,2958,2217,668,1549,15,269,218,51,431,394,0,28,9,26
E02002351,1571,1198,330,868,4,104,73,31,255,239,5,8,3,10
E02002352,2750,2007,518,1489,6,258,189,69,461,424,3,33,1,18
E02002353,1104,844,265,579,3,97,64,33,147,128,1,17,1,13
E02002354,1778,1246,359,887,11,238,165,73,265,249,2,14,0,18
E02002356,4501,3403,896,2507,13,325,251,74,701,629,7,58,7,59
E02002357,3279,2370,558,1812,11,357,295,62,528,497,4,25,2,13
E02002358,3140,2304,525,1779,17,395,339,56,404,374,2,27,1,20
E02002359,2016,1540,421,1119,6,155,119,36,285,254,8,19,4,30
E02002360,1205,805,210,595,2,194,119,75,193,176,3,13,1,11
E02002361,1885,1410,401,1009,4,217,167,50,239,226,0,11,2,15
E02002362,1874,1263,340,923,3,336,296,40,251,225,1,22,3,21
E02002363,2888,2091,513,1578,11,242,167,75,515,480,0,32,3,29
E02002364,3022,2023,439,1584,8,615,521,94,356,314,2,36,4,20
E02002366,1734,1175,379,796,4,228,157,71,306,278,1,20,7,21
E02002367,1002,565,149,416,6,250,192,58,177,164,2,10,1,4
E02002368,2290,1795,476,1319,9,145,112,33,325,292,2,27,4,16
E02002369,1126,718,211,507,5,255,230,25,142,127,0,11,4,6
E02002370,742,457,86,371,4,203,163,40,69,54,2,13,0,9
E02002371,3322,2183,626,1557,13,554,351,203,549,510,3,35,1,23
E02002373,2557,1276,311,965,19,204,111,93,1030,983,3,39,5,28
E02002374,2004,1238,348,890,13,334,261,73,404,363,6,33,2,15
E02002375,738,459,103,356,3,177,152,25,96,87,0,5,4,3
E02002376,924,586,180,406,2,210,168,42,118,106,1,11,0,8
E02002377,1557,939,312,627,12,263,137,126,312,293,0,16,3,31
E02002379,1450,1045,231,814,5,259,221,38,122,109,1,9,3,19
E02002380,1149,864,234,630,4,128,110,18,136,119,0,12,5,17
E02002381,1533,1113,273,840,8,193,142,51,210,189,0,16,5,9
E02002382,1343,743,220,523,9,261,207,54,303,282,6,14,1,27
E02002383,900,387,169,218,6,101,63,38,396,379,2,12,3,10
E02002384,6461,4056,1070,2986,39,938,668,270,1374,1286,9,64,15,54
E02002385,2906,1748,480,1268,8,330,249,81,797,758,1,33,5,23
E02002386,4119,2992,796,2196,25,561,460,101,511,471,0,34,6,30
E02002387,2392,1670,406,1264,8,371,308,63,316,276,2,34,4,27
E02002388,1360,933,222,711,5,191,141,50,224,209,0,14,1,7
E02002389,684,367,80,287,2,234,203,31,72,66,0,5,1,9
E02002390,3269,2266,574,1692,16,563,432,131,412,380,2,30,0,12
E02002391,5184,3872,1023,2849,20,604,496,108,650,582,8,53,7,38
E02002392,15088,10320,2650,7670,62,930,599,331,3688,3477,30,151,30,88
E02002393,10462,7031,1693,5338,46,1603,1260,343,1713,1573,19,108,13,69
E02002394,3047,1989,501,1488,22,574,460,114,446,422,2,20,2,16
E02002395,4533,3492,804,2688,17,260,179,81,724,661,9,51,3,40
E02002396,3738,2647,678,1969,4,534,430,104,529,494,4,28,3,24
E02002397,1448,1118,274,844,6,168,142,26,148,129,0,16,3,8
E02002398,1576,1260,367,893,3,138,104,34,156,137,2,15,2,19
E02002399,5155,3608,833,2775,20,763,645,118,743,674,4,57,8,21
E02002400,12104,8135,1743,6392,49,1550,1178,372,2291,2116,9,145,21,79
E02002401,777,453,119,334,3,234,192,42,81,73,2,4,2,6
E02002402,4384,3366,758,2608,17,307,214,93,670,607,7,54,2,24
E02002403,3161,2414,684,1730,11,281,233,48,428,391,3,31,3,27
E02002404,4306,2797,674,2123,19,717,558,159,734,684,7,35,8,39
E02002405,1697,1224,376,848,6,138,102,36,311,282,1,23,5,18
E02002406,1359,1156,332,824,0,87,69,18,104,98,0,6,0,12
E02002407,1589,1047,265,782,10,309,260,49,215,191,1,16,7,8
E02002408,3101,2371,602,1769,16,314,273,41,373,333,2,34,4,27
E02002409,1219,855,238,617,6,197,179,18,146,129,2,12,3,15
E02002410,3135,2081,513,1568,12,474,373,101,553,525,5,22,1,15
E02002411,8413,5895,1335,4560,36,765,567,198,1662,1553,7,94,8,55
E02002412,4062,2988,697,2291,17,422,351,71,615,563,2,41,9,20
E02002414,4758,3256,780,2476,24,628,490,138,814,751,1,56,6,36
E02002415,1612,1065,306,759,9,233,161,72,283,261,3,17,2,22
E02002416,3859,2920,749,2171,16,350,280,70,539,494,7,34,4,34
E02002417,1598,1277,321,956,12,140,105,35,151,128,5,14,4,18
E02002418,1057,865,221,644,5,82,71,11,95,79,2,14,0,10
E02002419,7662,5514,1334,4180,32,844,680,164,1231,1150,2,74,5,41
E02002420,5104,3612,948,2664,16,639,506,133,797,735,1,55,6,40
E02002421,813,510,115,395,3,222,169,53,72,60,1,8,3,6
E02002422,7997,5825,1271,4554,33,693,483,210,1404,1302,3,92,7,42
E02002423,673,435,102,333,3,167,145,22,66,56,1,8,1,2
E02002424,3442,2596,638,1958,15,313,251,62,498,455,0,39,4,20
E02002425,2563,2025,511,1514,8,187,154,33,318,283,1,28,6,25
E02002426,1694,1301,333,968,5,180,146,34,193,169,3,12,9,15
E02002427,2405,1800,534,1266,5,303,252,51,277,245,3,23,6,20
E02002428,1734,1284,290,994,26,204,172,32,205,188,1,13,3,15
E02002429,1736,1343,335,1008,2,148,110,38,231,210,8,9,4,12
E02002430,1014,632,116,516,2,259,221,38,113,97,3,12,1,8
E02002431,3927,2807,633,2174,21,393,298,95,679,637,1,37,4,27
E02002432,1406,1123,300,823,6,127,102,25,140,130,1,7,2,10
E02002433,4546,3326,846,2480,21,461,369,92,698,631,4,53,10,40
E02002434,1663,1274,259,1015,18,160,122,38,198,174,3,17,4,13
E02002435,7434,5641,1374,4267,22,686,530,156,1040,950,6,74,10,45
E02002436,1737,1311,345,966,2,207,155,52,202,180,3,18,1,15
E02002437,747,654,148,506,3,26,22,4,59,51,1,5,2,5
E02002438,1210,814,212,602,6,279,222,57,99,83,3,10,3,12
E02002439,6371,4699,1313,3386,30,764,602,162,834,748,13,67,6,44
E02002440,1058,828,196,632,1,140,110,30,79,64,0,13,2,10
E02002441,2588,2032,533,1499,12,268,210,58,264,234,3,22,5,12
E02002442,6369,4865,1229,3636,27,650,504,146,791,709,7,69,6,36
E02002443,2187,1751,421,1330,8,164,132,32,253,225,1,27,0,11
E02002444,1826,1412,379,1033,9,188,143,45,209,188,4,14,3,8
E02002445,2810,2084,525,1559,14,304,233,71,377,341,4,32,0,31
E02002446,3415,2567,609,1958,11,395,296,99,421,377,6,38,0,21
E02002447,2663,1997,535,1462,14,357,291,66,280,257,0,18,5,15
E02002448,2371,1834,504,1330,11,300,236,64,212,186,5,19,2,14
E02002449,1662,1231,320,911,10,199,136,63,215,197,4,14,0,7
E02002450,8368,6057,1471,4586,34,902,692,210,1343,1247,7,83,6,32
E02002451,7708,5886,1326,4560,35,650,472,178,1105,1031,5,58,11,32
E02002452,7134,5422,1523,3899,45,872,646,226,752,683,9,49,11,43
E02002453,2903,2225,565,1660,6,325,261,64,330,289,4,30,7,17
E02002454,15324,11265,2984,8281,63,1692,1240,452,2212,1969,19,192,32,92
E02002455,1013,733,189,544,6,167,134,33,91,80,2,7,2,16
E02002456,9460,7452,1945,5507,23,768,557,211,1150,1046,13,84,7,67
E02002457,1084,768,206,562,2,184,137,47,119,106,3,9,1,11
E02002458,3802,2882,777,2105,12,399,293,106,480,426,7,41,6,29
E02002459,3003,2194,568,1626,9,382,294,88,400,356,1,34,9,18
E02002460,1340,1102,359,743,5,101,71,30,115,108,0,5,2,17
E02002461,5220,3528,792,2736,28,617,466,151,1012,954,10,39,9,35
E02002462,2929,2255,613,1642,8,294,218,76,348,324,1,18,5,24
E02002463,1354,858,214,644,4,333,262,71,146,128,0,12,6,13
E02002464,3154,2384,614,1770,12,367,286,81,374,340,2,28,4,17
E02002465,5251,3791,953,2838,16,687,486,201,719,655,2,55,7,38
E02002466,2335,1795,496,1299,7,261,210,51,249,226,1,18,4,23
E02002467,4485,3197,957,2240,24,614,450,164,621,574,4,39,4,29
E02002468,2116,1640,452,1188,4,232,188,44,223,195,0,19,9,17
E02002469,1551,1272,393,879,0,125,91,34,137,113,6,15,3,17
E02002470,2081,1658,541,1117,4,230,164,66,173,150,3,16,4,16
E02002471,2441,1959,683,1276,7,149,113,36,293,240,12,37,4,33
E02002472,1593,1320,383,937,1,109,71,38,151,134,0,14,3,12
E02002473,2751,2184,549,1635,11,188,142,46,352,311,10,25,6,16
E02002474,1695,1270,339,931,8,243,193,50,167,140,0,24,3,7
E02002475,1497,1183,399,784,4,113,79,34,187,159,6,19,3,10
E02002476,1261,887,252,635,8,196,143,53,150,138,2,9,1,20
E02002477,899,685,213,472,0,106,79,27,95,81,1,11,2,13
E02002478,850,698,211,487,0,53,36,17,93,82,0,10,1,6
E02002479,2643,2025,598,1427,7,286,224,62,301,273,3,17,8,24
E02002480,2832,2093,588,1505,4,266,195,71,449,410,9,26,4,20
E02002481,5119,3454,837,2617,12,663,504,159,965,902,4,51,8,25
E02002482,910,687,172,515,2,125,94,31,88,73,1,14,0,8
E02002483,1195,990,221,769,7,90,44,46,101,89,0,10,2,7
E02002484,4829,3574,854,2720,14,654,314,340,557,500,5,41,11,30
E02002485,1315,1000,254,746,7,172,88,84,122,107,0,15,0,14
E02002487,5212,3831,906,2925,30,599,296,303,720,659,10,43,8,32
E02002488,1189,969,274,695,4,90,47,43,113,95,2,13,3,13
E02002489,7399,5571,1365,4206,23,857,372,485,899,816,4,66,13,49
E02002490,1773,1239,358,881,1,230,90,140,283,257,8,16,2,20
E02002491,993,762,180,582,3,118,70,48,104,85,1,16,2,6
E02002492,3109,2465,571,1894,9,342,158,184,272,240,1,28,3,21
E02002493,3874,3133,871,2262,12,324,152,172,383,346,6,29,2,22
E02002494,1171,846,215,631,1,203,103,100,113,103,0,9,1,8
E02002496,26162,19713,4960,14753,105,2400,1194,1206,3754,3384,33,295,42,190
E02002497,3206,2362,577,1785,11,413,208,205,395,365,5,17,8,25
E02002498,3144,2220,582,1638,10,327,158,169,551,496,5,42,8,36
E02002499,1813,1227,289,938,8,357,221,136,200,175,4,17,4,21
E02002500,1648,1217,337,880,14,154,81,73,242,213,3,23,3,21
E02002501,1417,1072,237,835,11,155,74,81,167,140,3,22,2,12
E02002502,1766,1226,291,935,4,306,202,104,211,179,4,25,3,19
E02002503,1626,1199,287,912,9,172,90,82,226,203,3,18,2,20
E02002504,2177,1689,481,1208,11,149,69,80,297,262,1,30,4,31
E02002505,685,475,118,357,2,141,82,59,61,54,0,4,3,6
E02002506,9163,7141,1628,5513,36,783,367,416,1145,952,66,98,29,58
E02002507,1099,919,276,643,4,49,24,25,114,102,0,12,0,13
E02002508,870,730,174,556,1,53,23,30,81,71,1,9,0,5
E02002509,695,519,132,387,1,84,38,46,84,74,0,8,2,7
E02002510,648,549,168,381,0,30,14,16,65,55,1,5,4,4
E02002512,665,562,165,397,2,47,12,35,50,40,0,10,0,4
E02002513,1238,843,217,626,7,224,77,147,141,117,2,18,4,23
E02002514,3179,2344,519,1825,19,396,166,230,386,332,3,43,8,34
E02002515,5075,3688,954,2734,35,499,244,255,824,726,5,82,11,29
E02002516,1137,913,263,650,7,110,53,57,97,87,1,8,1,10
E02002517,8962,7267,1911,5356,37,699,363,336,916,836,7,67,6,43
E02002518,1550,1288,352,936,8,79,33,46,153,133,1,16,3,22
E02002519,1000,713,175,538,5,156,66,90,120,114,0,5,1,6
E02002520,2280,1853,560,1293,14,114,52,62,280,235,11,32,2,19
E02002521,1808,1328,399,929,2,155,61,94,316,291,9,16,0,7
E02002523,1215,789,178,611,8,242,152,90,157,141,0,14,2,19
E02002524,1142,909,254,655,1,80,40,40,143,125,1,12,5,9
E02002525,1391,1028,271,757,5,186,115,71,161,137,2,16,6,11
E02002526,1524,1180,328,852,5,94,41,53,234,205,5,20,4,11
E02002527,1336,1014,307,707,5,147,72,75,166,144,3,17,2,4
E02002529,1422,1111,256,855,5,132,76,56,158,142,2,11,3,16
E02002530,2017,1620,553,1067,7,107,58,49,259,216,18,20,5,24
E02002532,3714,2932,826,2106,11,278,175,103,459,400,7,46,6,34
E02002533,719,575,175,400,1,28,13,15,102,82,8,12,0,13
E02002534,1365,1081,348,733,1,89,54,35,180,157,7,16,0,14
E02002535,1849,1537,367,1170,5,95,51,44,201,188,1,12,0,11
E02002536,2551,2005,496,1509,10,220,142,78,300,266,3,27,4,16
E02002537,8604,6962,1746,5216,27,720,403,317,858,765,2,85,6,37
E02002538,2646,2165,590,1575,4,143,78,65,317,282,3,30,2,17
E02002539,3813,3115,785,2330,9,247,144,103,422,382,3,33,4,20
E02002540,1104,951,263,688,3,51,37,14,90,76,0,13,1,9
E02002541,1259,987,285,702,1,100,57,43,163,139,3,18,3,8
E02002542,1809,1354,276,1078,3,264,169,95,166,149,0,15,2,22
E02002543,4715,3713,808,2905,17,408,263,145,559,493,14,49,3,18
E02002544,3535,2724,638,2086,6,329,177,152,451,406,2,38,5,25
E02002545,725,642,182,460,1,23,14,9,51,45,0,6,0,8
E02002546,2164,1607,414,1193,3,250,141,109,288,247,4,34,3,16
E02002547,1342,1138,312,826,2,76,47,29,108,95,1,8,4,18
E02002548,21630,16355,3862,12493,72,2233,1225,1008,2845,2557,20,234,34,125
E02002549,1190,1039,303,736,2,46,19,27,89,82,1,6,0,14
E02002550,1116,855,249,606,4,101,48,53,137,119,2,16,0,19
E02002551,10341,8067,1826,6241,42,776,365,411,1400,1245,11,124,20,56
E02002552,756,580,148,432,3,94,45,49,75,67,0,7,1,4
E02002553,1151,912,232,680,0,113,75,38,119,101,3,13,2,7
E02002554,4205,3189,831,2358,18,458,238,220,516,450,4,54,8,24
E02002555,3248,2637,693,1944,10,200,102,98,381,338,1,34,8,20
E02002556,1167,984,245,739,4,33,14,19,122,110,3,8,1,24
E02002557,2026,1764,305,1459,3,44,23,21,206,190,1,13,2,9
E02002558,3108,2542,759,1783,8,142,47,95,394,345,9,33,7,22
E02002559,11089,8414,2035,6379,33,762,515,247,1817,1606,26,153,32,63
E02002560,1054,889,243,646,0,46,29,17,111,94,2,14,1,8
E02002561,965,749,202,547,5,85,41,44,116,105,3,7,1,10
E02002562,1605,1150,277,873,4,161,104,57,279,256,9,7,7,11
E02002563,967,717,183,534,0,107,76,31,138,131,1,6,0,5
E02002564,1373,1064,246,818,0,164,113,51,133,116,2,14,1,12
E02002565,862,643,174,469,1,38,27,11,173,155,4,12,2,7
E02002566,15204,11476,2791,8685,37,1073,736,337,2510,2223,57,201,29,108
E02002567,7684,5729,1403,4326,18,624,441,183,1248,1089,17,131,11,65
E02002568,1514,1208,364,844,2,73,48,25,220,195,3,22,0,11
E02002569,2537,2123,603,1520,6,121,77,44,261,228,4,27,2,26
E02002570,1579,1029,290,739,3,188,144,44,341,318,2,13,8,18
E02002571,702,493,117,376,3,79,71,8,121,103,0,15,3,6
E02002572,1725,1222,320,902,9,187,143,44,297,273,2,19,3,10
E02002573,3120,2417,673,1744,8,233,161,72,433,379,10,37,7,29
E02002574,1546,1292,358,934,5,107,30,77,132,121,2,7,2,10
E02002575,943,857,183,674,0,22,5,17,59,54,1,4,0,5
E02002576,2960,2326,649,1677,13,321,93,228,291,260,1,28,2,9
E02002577,1433,978,271,707,6,320,92,228,117,104,0,11,2,12
E02002578,1594,1260,329,931,1,180,59,121,142,125,1,10,6,11
E02002579,1873,1362,345,1017,5,289,88,201,211,191,1,17,2,6
E02002580,10372,7687,1975,5712,45,1378,403,975,1209,1098,13,86,12,53
E02002581,4039,3100,842,2258,28,474,145,329,411,386,1,21,3,26
E02002582,13589,10635,2311,8324,113,1228,260,968,1556,1444,5,95,12,57
E02002583,3147,2182,573,1609,34,599,98,501,323,294,2,23,4,9
E02002584,1356,1046,268,778,6,178,34,144,120,100,2,14,4,6
E02002585,5134,3923,1056,2867,32,584,99,485,573,522,3,37,11,22
E02002586,2893,1878,479,1399,16,734,100,634,246,219,1,21,5,19
E02002587,886,616,169,447,15,177,15,162,73,68,0,3,2,5
E02002588,3745,2848,823,2025,29,519,75,444,338,315,0,21,2,11
E02002589,1815,1473,395,1078,15,156,29,127,162,150,0,12,0,9
E02002590,3233,2618,798,1820,9,247,152,95,346,306,3,29,8,13
E02002591,2150,1695,520,1175,13,195,108,87,228,206,3,15,4,19
E02002592,2904,2293,581,1712,11,274,125,149,305,276,0,24,5,21
E02002593,14546,11399,2681,8718,80,971,350,621,2038,1868,8,151,11,58
E02002594,3019,2260,570,1690,21,359,94,265,368,337,1,27,3,11
E02002595,3127,2263,543,1720,19,465,252,213,361,316,3,32,10,19
E02002596,2321,1892,454,1438,14,142,44,98,263,241,1,19,2,10
E02002597,1340,911,245,666,11,307,134,173,106,93,0,12,1,5
E02002598,10941,8986,2017,6969,64,674,263,411,1183,1101,6,74,2,34
E02002599,2359,1905,441,1464,16,206,67,139,223,211,1,7,4,9
E02002600,3276,2431,594,1837,20,392,194,198,413,363,10,36,4,20
E02002601,2414,1755,438,1317,13,268,117,151,371,331,1,36,3,7
E02002602,8298,6381,1529,4852,52,862,409,453,971,886,6,72,7,32
E02002603,7235,5247,1418,3829,39,775,349,426,1145,1087,4,51,3,29
E02002604,1347,1114,312,802,1,75,28,47,132,118,1,7,6,25
E02002605,1346,1096,260,836,9,100,24,76,136,113,2,15,6,5
E02002606,5195,3806,989,2817,37,586,295,291,746,678,1,61,6,20
E02002607,20269,15086,3764,11322,146,2110,950,1160,2819,2575,14,211,19,108
E02002608,2707,2269,613,1656,12,167,64,103,244,227,2,10,5,15
E02002609,2005,1407,334,1073,7,282,160,122,297,274,1,16,6,12
E02002610,3487,2784,853,1931,17,230,125,105,432,379,13,34,6,24
E02002611,1501,1244,347,897,12,97,43,54,134,117,1,15,1,14
E02002612,3010,2465,717,1748,14,191,88,103,314,277,10,23,4,26
E02002613,5358,4225,1096,3129,37,393,173,220,669,598,16,45,10,34
E02002614,977,882,312,570,0,31,14,17,58,51,2,5,0,6
E02002615,4182,3335,1025,2310,16,273,96,177,521,470,7,40,4,37
E02002616,1234,1033,399,634,1,45,13,32,133,118,1,12,2,22
E02002617,3299,2535,962,1573,12,290,80,210,438,385,6,30,17,24
E02002618,1324,1002,485,517,5,116,31,85,178,151,3,18,6,23
E02002619,2246,1715,572,1143,17,158,55,103,321,292,2,24,3,35
E02002620,15292,11936,4011,7925,75,1222,394,828,1939,1711,21,177,30,120
E02002621,3377,2623,1053,1570,24,316,81,235,370,326,4,36,4,44
E02002622,4911,3533,1075,2458,21,573,217,356,757,677,5,55,20,27
E02002623,2616,1922,529,1393,15,258,94,164,400,361,7,24,8,21
E02002624,2308,1891,623,1268,15,130,48,82,248,219,5,23,1,24
E02002625,9836,7775,2029,5746,32,599,231,368,1372,1221,35,103,13,58
E02002626,764,581,197,384,2,101,48,53,72,65,0,6,1,8
E02002627,1810,1445,358,1087,4,93,41,52,256,230,4,18,4,12
E02002628,2503,1925,508,1417,14,159,61,98,387,355,2,28,2,18
E02002629,859,635,192,443,6,62,17,45,149,142,0,6,1,7
E02002630,3934,3023,848,2175,20,229,76,153,639,567,9,55,8,23
E02002631,1849,1488,397,1091,8,94,32,62,244,212,0,30,2,15
E02002632,1999,1628,523,1105,2,90,35,55,261,228,4,16,13,18
E02002633,1486,1182,323,859,2,40,12,28,254,226,7,20,1,8
E02002634,4012,3156,833,2323,26,155,81,74,644,574,8,59,3,31
E02002635,1472,1124,290,834,7,41,22,19,289,265,4,17,3,11
E02002636,5704,4755,1294,3461,31,229,112,117,663,596,0,62,5,26
E02002637,955,758,183,575,2,26,11,15,161,147,0,13,1,8
E02002638,3674,2383,649,1734,12,214,98,116,1043,970,13,51,9,22
E02002639,821,574,162,412,3,138,100,38,101,90,1,10,0,5
E02002640,1298,904,257,647,9,105,60,45,272,254,3,15,0,8
E02002641,6316,4989,1167,3822,34,192,97,95,1066,953,7,101,5,35
E02002642,10085,7185,1804,5381,39,538,266,272,2254,2065,18,155,16,69
E02002643,1504,1103,299,804,4,65,28,37,322,287,2,30,3,10
E02002644,2237,1764,439,1325,5,59,30,29,389,347,5,37,0,20
E02002645,4158,2896,790,2106,18,186,94,92,1016,952,8,52,4,42
E02002646,5665,4366,1153,3213,16,331,198,133,922,821,10,82,9,30
E02002647,1930,1422,388,1034,3,81,33,48,401,354,5,36,6,23
E02002648,2327,1710,487,1223,7,131,76,55,463,418,1,40,4,16
E02002649,3019,2125,547,1578,13,119,61,58,741,686,5,45,5,21
E02002650,3481,2702,724,1978,15,143,67,76,604,533,6,61,4,17
E02002651,1240,978,289,689,7,43,33,10,204,188,1,15,0,8
E02002652,3232,2303,438,1865,6,425,281,144,487,445,2,37,3,11
E02002653,1799,1222,270,952,6,358,311,47,199,178,0,18,3,14
E02002654,750,456,111,345,0,212,175,37,70,64,0,5,1,12
E02002655,1580,1113,211,902,5,241,218,23,210,196,1,11,2,11
E02002656,939,699,198,501,3,96,73,23,132,118,3,7,4,9
E02002657,758,586,146,440,1,73,58,15,95,85,2,6,2,3
E02002658,1055,832,197,635,1,88,69,19,127,106,3,12,6,7
E02002659,1134,705,157,548,2,287,226,61,124,114,0,10,0,16
E02002660,1505,1110,301,809,7,245,218,27,133,122,0,11,0,10
E02002661,862,595,149,446,1,161,145,16,95,79,2,10,4,10
E02002662,1487,1076,267,809,6,217,182,35,179,163,1,12,3,9
E02002663,5276,3961,1108,2853,11,298,209,89,979,910,1,53,15,27
E02002664,2051,1633,407,1226,6,171,148,23,234,215,1,17,1,7
E02002665,2595,1957,571,1386,4,225,175,50,389,355,4,24,6,20
E02002666,3403,2180,532,1648,12,311,243,68,883,809,9,58,7,17
E02002667,10784,7380,1804,5576,23,1337,1090,247,2003,1883,11,88,21,41
E02002668,965,593,137,456,6,232,182,50,124,115,0,9,0,10
E02002669,1177,740,236,504,6,67,47,20,353,332,0,18,3,11
E02002670,1687,1278,285,993,3,167,143,24,232,214,1,17,0,7
E02002671,9182,6982,1702,5280,28,905,723,182,1233,1127,8,94,4,34
E02002672,1097,698,159,539,3,232,188,44,159,138,2,19,0,5
E02002673,1195,792,205,587,6,136,103,33,255,236,4,14,1,6
E02002674,975,727,196,531,4,59,49,10,172,156,0,16,0,13
E02002675,9034,6563,1578,4985,24,787,622,165,1614,1494,16,91,13,46
E02002676,1859,1292,380,912,1,129,96,33,422,383,3,32,4,15
E02002677,8826,6277,1418,4859,24,877,684,193,1584,1465,7,103,9,64
E02002678,1456,1021,256,765,1,92,70,22,329,309,4,11,5,13
E02002679,1316,1040,281,759,4,97,82,15,163,148,1,12,2,12
E02002680,31349,22215,5297,16918,92,3083,2432,651,5797,5401,22,315,59,162
E02002681,8648,5826,1481,4345,28,1011,799,212,1740,1611,5,112,12,43
E02002682,2037,1388,337,1051,9,307,238,69,324,294,1,25,4,9
E02002684,1650,1315,480,835,3,89,57,32,225,199,3,22,1,18
E02002685,1749,1378,492,886,6,97,68,29,245,209,6,26,4,23
E02002686,1864,1360,455,905,4,162,140,22,322,285,7,29,1,16
E02002687,2686,1968,628,1340,5,139,96,43,541,482,11,45,3,33
E02002688,3736,2550,847,1703,10,228,144,84,912,816,21,70,5,36
E02002689,3083,2142,797,1345,11,172,119,53,685,625,12,42,6,73
E02002691,3261,2432,821,1611,6,154,120,34,591,505,46,30,10,78
E02002692,3165,2490,781,1709,10,172,99,73,460,416,7,22,15,33
E02002693,2633,2094,774,1320,4,124,93,31,373,308,23,29,13,38
E02002694,4493,3343,1056,2287,14,232,169,63,772,720,22,23,7,132
E02002695,2409,1843,595,1248,3,137,110,27,401,370,7,19,5,25
E02002696,2839,2061,623,1438,6,157,110,47,564,448,62,14,40,51
E02002697,2222,1753,623,1130,5,113,85,28,324,277,9,23,15,27
E02002698,2824,2207,714,1493,9,146,106,40,430,374,9,32,15,32
E02002699,2013,1660,489,1171,9,86,65,21,237,206,6,19,6,21
E02002700,2497,1886,522,1364,11,277,234,43,309,279,2,26,2,14
E02002701,3547,2834,1059,1775,16,182,120,62,448,393,12,35,8,67
E02002702,9295,7260,2126,5134,27,608,464,144,1323,1186,8,105,24,77
E02002703,3201,2398,693,1705,15,240,184,56,512,452,14,36,10,36
E02002704,1520,1178,415,763,5,102,79,23,191,162,3,20,6,44
E02002705,6075,4807,1238,3569,14,388,311,77,832,765,12,50,5,34
E02002706,3096,2458,527,1931,6,219,182,37,400,374,2,16,8,13
E02002707,2599,2086,634,1452,13,114,88,26,357,317,13,19,8,29
E02002708,1714,1280,379,901,4,148,127,21,262,241,2,14,5,20
E02002709,2804,2153,651,1502,10,175,123,52,439,393,14,29,3,27
E02002710,1614,1336,363,973,1,75,63,12,189,171,0,18,0,13
E02002711,3020,2503,770,1733,5,164,136,28,324,295,5,22,2,24
E02002712,5154,3767,1032,2735,14,301,253,48,1029,980,7,35,7,43
E02002714,2576,2042,663,1379,10,121,108,13,371,320,11,23,17,32
E02002715,4805,4073,993,3080,14,162,136,26,526,486,2,32,6,30
E02002716,1652,1312,383,929,5,99,69,30,216,193,1,19,3,20
E02002717,4413,3407,817,2590,9,327,281,46,657,606,7,41,3,13
E02002718,2366,1881,545,1336,2,159,130,29,304,283,1,19,1,20
E02002719,2360,1858,498,1360,11,129,114,15,345,317,3,23,2,17
E02002720,3048,2469,745,1724,6,126,99,27,427,390,4,24,9,20
E02002721,2763,2081,637,1444,3,145,117,28,505,469,4,27,5,29
E02002722,2603,1961,638,1323,9,196,177,19,411,356,11,35,9,26
E02002723,6785,4948,1441,3507,13,492,394,98,1304,1210,12,74,8,28
E02002724,2931,2184,618,1566,13,278,228,50,434,400,4,23,7,22
E02002725,2470,2024,628,1396,5,147,119,28,272,250,3,14,5,22
E02002726,6089,4872,1206,3666,13,376,165,211,793,697,11,77,8,35
E02002727,8106,5843,1500,4343,36,681,240,441,1503,1388,4,95,16,43
E02002728,12729,9749,2481,7268,46,735,263,472,2135,1946,8,160,21,64
E02002729,5339,4270,1004,3266,13,284,105,179,749,678,7,58,6,23
E02002730,1274,925,219,706,7,53,17,36,279,254,0,24,1,10
E02002731,532,344,92,252,0,41,18,23,144,135,0,7,2,3
E02002732,5848,4695,1136,3559,15,288,113,175,816,740,8,59,9,34
E02002733,2957,2249,555,1694,9,166,51,115,506,453,10,42,1,27
E02002734,1117,829,212,617,7,79,34,45,194,173,3,17,1,8
E02002735,1831,1367,376,991,7,71,32,39,362,323,3,35,1,24
E02002736,1279,959,281,678,4,54,14,40,258,237,2,17,2,4
E02002737,2684,2120,541,1579,8,143,46,97,400,357,7,28,8,13
E02002738,722,584,163,421,4,40,22,18,91,82,1,8,0,3
E02002739,943,719,197,522,1,35,13,22,186,173,0,13,0,2
E02002740,1374,1109,306,803,8,100,39,61,150,145,0,5,0,7
E02002741,6100,4856,1212,3644,16,245,88,157,941,778,65,71,27,42
E02002742,2573,2014,571,1443,3,85,32,53,461,416,9,31,5,10
E02002743,860,708,195,513,1,56,22,34,89,84,1,4,0,6
E02002744,908,612,145,467,4,164,72,92,125,117,0,8,0,3
E02002745,1579,1257,357,900,7,60,33,27,245,205,12,19,9,10
E02002746,1340,1130,282,848,6,37,14,23,162,146,3,13,0,5
E02002747,2713,2275,652,1623,6,98,37,61,316,289,7,18,2,18
E02002748,2045,1626,489,1137,5,71,27,44,316,280,14,19,3,27
E02002749,4015,3126,847,2279,11,267,129,138,574,512,11,36,15,37
E02002750,1694,1349,383,966,4,98,42,56,221,197,8,16,0,22
E02002751,1432,1155,353,802,4,87,48,39,165,144,3,15,3,21
E02002752,6640,5556,1337,4219,11,238,122,116,792,678,21,83,10,43
E02002753,4457,3328,819,2509,12,335,146,189,745,673,18,44,10,37
E02002754,2178,1758,530,1228,12,145,87,58,242,205,6,22,9,21
E02002755,9645,6522,1601,4921,33,902,434,468,2131,2002,17,95,17,57
E02002756,7320,5318,1440,3878,16,714,346,368,1191,1085,15,75,16,81
E02002757,3558,2881,729,2152,6,221,90,131,437,395,11,29,2,13
E02002758,9628,7602,1952,5650,25,745,361,384,1203,1107,9,78,9,53
E02002759,5277,4173,1280,2893,13,320,134,186,715,626,16,64,9,56
E02002760,2642,2189,603,1586,5,174,87,87,253,216,13,24,0,21
E02002761,1525,1152,321,831,6,80,38,42,272,233,14,22,3,15
E02002762,1107,861,217,644,3,103,56,47,128,115,0,11,2,12
E02002763,1761,1284,315,969,2,229,105,124,230,203,1,26,0,16
E02002764,1223,905,274,631,3,163,99,64,139,120,7,11,1,13
E02002765,1574,1175,326,849,0,177,103,74,206,185,3,15,3,16
E02002766,1141,923,246,677,1,70,37,33,136,125,1,9,1,11
E02002767,1860,1484,394,1090,8,125,50,75,235,198,5,31,1,8
E02002768,2932,2339,732,1607,7,149,91,58,395,335,12,39,9,42
E02002769,1295,1058,376,682,8,63,44,19,133,108,13,10,2,33
E02002770,2110,1592,479,1113,7,121,51,70,370,280,63,16,11,20
E02002771,1656,1375,507,868,4,102,64,38,159,135,2,20,2,16
E02002772,1588,1144,363,781,5,109,31,78,317,186,69,13,49,13
E02002773,1148,911,320,591,4,80,30,50,144,125,2,14,3,9
E02002774,1168,976,283,693,3,45,20,25,135,117,6,9,3,9
E02002775,1832,1250,403,847,34,303,62,241,231,210,2,14,5,14
E02002776,5999,4315,1208,3107,57,554,273,281,1041,956,17,49,19,32
E02002777,7056,5103,1329,3774,42,630,337,293,1236,1118,22,81,15,45
E02002778,3053,2258,635,1623,9,241,147,94,510,463,4,39,4,35
E02002779,2117,1542,567,975,17,144,92,52,383,355,5,17,6,31
E02002780,4846,3344,870,2474,35,476,316,160,959,890,5,56,8,32
E02002781,4101,2838,750,2088,35,433,297,136,764,726,5,30,3,31
E02002782,4017,2960,888,2072,23,304,201,103,678,595,24,52,7,52
E02002783,1899,1409,353,1056,14,189,140,49,272,247,6,14,5,15
E02002784,28186,18570,5478,13092,174,2187,1368,819,6988,6496,62,351,79,267
E02002785,2685,1986,638,1348,10,203,132,71,465,423,6,32,4,21
E02002786,1226,697,241,456,11,181,151,30,329,291,8,25,5,8
E02002787,3481,2423,690,1733,25,359,246,113,641,572,16,48,5,33
E02002788,3738,2752,797,1955,22,195,116,79,728,681,7,36,4,41
E02002789,1299,868,210,658,5,273,216,57,142,130,0,12,0,11
E02002790,6078,4021,1061,2960,38,431,248,183,1533,1266,124,56,87,55
E02002791,3016,2360,749,1611,12,198,126,72,419,377,3,27,12,27
E02002792,1840,1360,412,948,4,109,62,47,352,310,8,32,2,15
E02002793,2754,2156,685,1471,20,281,189,92,275,255,2,15,3,22
E02002794,6922,4795,1342,3453,37,331,190,141,1681,1550,31,75,25,78
E02002795,1590,1339,489,850,4,88,43,45,141,125,3,9,4,18
E02002796,852,730,238,492,2,39,29,10,76,66,0,9,1,5
E02002797,2514,2014,638,1376,9,106,61,45,359,339,5,13,2,26
E02002798,1279,1051,261,790,3,40,29,11,174,159,0,14,1,11
E02002799,4203,3140,875,2265,31,480,378,102,535,492,3,33,7,17
E02002800,3024,2309,684,1625,14,196,117,79,478,440,5,27,6,27
E02002801,1354,1103,288,815,4,108,86,22,125,112,0,12,1,14
E02002802,4035,2917,784,2133,32,494,389,105,577,521,3,45,8,15
E02002803,6426,4816,1317,3499,54,522,323,199,999,928,5,56,10,35
E02002804,1116,810,234,576,7,150,113,37,141,131,0,8,2,8
E02002805,1027,831,256,575,6,60,39,21,124,113,2,9,0,6
E02002806,1806,1246,325,921,14,144,73,71,392,363,3,23,3,10
E02002807,3612,2718,718,2000,24,323,230,93,534,494,2,36,2,13
E02002808,18865,12822,3703,9119,172,1924,1107,817,3823,3533,31,223,36,124
E02002809,5563,4340,1141,3199,42,464,320,144,693,653,2,33,5,24
E02002810,1124,949,280,669,8,55,27,28,106,95,0,8,3,6
E02002811,3397,2271,742,1529,18,372,205,167,702,640,6,38,18,34
E02002812,11451,8748,2315,6433,53,926,508,418,1664,1527,24,99,14,60
E02002813,9133,6475,1993,4482,61,987,592,395,1520,1417,10,77,16,90
E02002814,1824,1474,485,989,18,110,64,46,210,185,8,13,4,12
E02002815,995,702,253,449,8,73,29,44,206,186,1,12,7,6
E02002816,2043,1722,511,1211,19,82,40,42,202,188,1,11,2,18
E02002817,907,729,243,486,1,53,38,15,120,105,1,13,1,4
E02002818,1323,816,276,540,7,230,163,67,253,227,1,22,3,17
E02002819,16725,12714,3157,9557,99,1196,731,465,2655,2470,15,152,18,61
E02002820,2161,1555,397,1158,8,257,175,82,321,290,4,24,3,20
E02002821,5605,4048,1070,2978,32,675,489,186,823,754,3,59,7,27
E02002822,772,578,197,381,7,98,56,42,84,80,0,3,1,5
E02002823,938,730,177,553,8,106,68,38,90,77,0,8,5,4
E02002824,6869,5359,1388,3971,35,641,415,226,800,737,5,46,12,34
E02002825,1366,1024,280,744,20,113,74,39,194,185,1,7,1,15
E02002826,992,767,195,572,12,93,47,46,115,104,3,7,1,5
E02002827,5558,3627,967,2660,38,752,526,226,1119,1045,6,53,15,22
E02002828,6630,4991,1600,3391,39,588,365,223,975,906,8,52,9,37
E02002829,2606,1760,476,1284,18,405,304,101,411,369,4,32,6,12
E02002830,8686,6332,1638,4694,70,1027,697,330,1211,1108,28,62,13,46
E02002831,1530,1141,374,767,9,117,63,54,252,242,0,9,1,11
E02002832,3537,2601,930,1671,26,314,154,160,553,510,8,24,11,43
E02002833,1377,970,372,598,8,142,49,93,231,212,0,16,3,26
E02002834,8122,6047,1833,4214,61,707,474,233,1267,1167,13,77,10,40
E02002835,3565,2702,677,2025,25,295,171,124,519,480,7,26,6,24
E02002836,4258,2956,976,1980,25,468,263,205,780,722,2,40,16,29
E02002837,2076,1393,494,899,11,294,222,72,363,332,2,25,4,15
E02002838,1548,1097,299,798,14,256,209,47,166,160,0,6,0,15
E02002839,983,756,219,537,9,97,70,27,120,99,1,13,7,1
E02002842,1924,1206,417,789,14,239,143,96,453,427,3,20,3,12
E02002843,3371,2268,853,1415,17,389,208,181,660,605,11,28,16,37
E02002844,3777,2351,808,1543,28,699,511,188,662,623,9,22,8,37
E02002845,5742,4277,1260,3017,39,546,356,190,852,738,58,36,20,28
E02002846,3845,2762,846,1916,41,317,230,87,712,680,2,26,4,13
E02002847,5273,3741,1259,2482,29,476,307,169,980,903,10,52,15,47
E02002848,1582,954,381,573,16,210,90,120,382,354,12,13,3,20
E02002849,4649,3032,924,2108,35,442,256,186,1099,1039,6,42,12,41
E02002851,1561,1234,409,825,9,119,95,24,182,174,0,7,1,17
E02002852,1361,854,202,652,9,285,218,67,204,191,0,13,0,9
E02002853,2096,1523,578,945,10,149,71,78,384,356,5,12,11,30
E02002854,1687,1117,265,852,7,295,214,81,260,244,1,15,0,8
E02002855,1560,1004,337,667,13,146,92,54,373,340,3,17,13,24
E02002856,8321,5709,1742,3967,46,514,297,217,1986,1889,13,68,16,66
E02002857,4261,2960,934,2026,17,444,289,155,816,759,5,50,2,24
E02002858,1424,1102,397,705,5,96,59,37,208,192,4,12,0,13
E02002860,1812,1346,379,967,14,171,127,44,271,236,14,21,0,10
E02002861,1107,678,175,503,8,268,226,42,149,137,1,8,3,4
E02002862,868,592,154,438,1,172,158,14,95,90,0,5,0,8
E02002863,4550,3059,839,2220,42,319,115,204,1077,618,280,37,142,53
E02002864,3011,2192,757,1435,45,265,85,180,483,428,20,27,8,26
E02002865,4039,2897,901,1996,52,326,120,206,696,604,25,32,35,68
E02002866,2705,1950,627,1323,25,194,96,98,512,416,45,27,24,24
E02002867,3030,2196,764,1432,35,236,89,147,503,423,38,33,9,60
E02002868,1392,1045,262,783,12,164,120,44,165,151,1,13,0,6
E02002869,4291,2943,715,2228,17,671,516,155,637,573,3,54,7,23
E02002871,1673,1201,296,905,9,193,144,49,258,231,3,22,2,12
E02002872,3973,2810,704,2106,21,520,406,114,606,549,0,55,2,16
E02002873,946,589,133,456,4,176,154,22,171,160,1,8,2,6
E02002874,8441,6412,1661,4751,30,711,521,190,1248,1141,12,86,9,40
E02002875,2036,1419,355,1064,19,272,207,65,308,289,3,14,2,18
E02002876,2521,1832,482,1350,14,279,200,79,372,348,3,20,1,24
E02002877,3101,2222,705,1517,13,297,190,107,535,493,5,35,2,34
E02002878,933,506,136,370,3,297,274,23,124,118,0,4,2,3
E02002879,3777,2598,730,1868,23,386,241,145,751,698,2,46,5,19
E02002880,675,404,91,313,1,168,150,18,101,91,0,10,0,1
E02002881,3144,2417,511,1906,18,316,248,68,380,341,3,36,0,13
E02002882,2180,1425,441,984,9,235,148,87,491,455,10,23,3,20
E02002883,1671,1104,270,834,10,231,116,115,311,285,3,18,5,15
E02002884,3796,2587,701,1886,27,403,263,140,754,718,3,27,6,25
E02002885,3100,1817,509,1308,19,506,324,182,734,680,6,39,9,24
E02002886,3465,2614,710,1904,12,370,258,112,445,404,3,30,8,24
E02002887,3300,2288,575,1713,14,528,432,96,450,405,5,37,3,20
E02002888,1850,1199,301,898,6,308,249,59,328,299,2,24,3,9
E02002889,9454,6218,1710,4508,60,859,480,379,2254,2099,16,115,24,63
E02002890,9988,6060,1626,4434,58,1462,1001,461,2328,2186,9,118,15,80
E02002891,1464,1107,308,799,6,138,105,33,201,183,3,14,1,12
E02002892,2750,2024,570,1454,21,303,229,74,396,370,1,25,0,6
E02002893,3779,2276,631,1645,34,618,407,211,819,757,0,55,7,32
E02002894,1685,1292,369,923,2,125,89,36,251,229,2,20,0,15
E02002895,8363,5842,1516,4326,48,589,359,230,1845,1731,9,96,9,39
E02002896,5999,3950,1001,2949,39,734,468,266,1219,1117,7,87,8,57
E02002897,1448,1152,428,724,5,128,80,48,153,140,5,8,0,10
E02002898,17016,11987,3033,8954,102,1430,931,499,3424,3212,19,169,24,73
E02002899,7906,5278,1598,3680,28,421,275,146,2111,1956,43,79,33,68
E02002901,1477,1147,328,819,7,146,106,40,172,159,3,10,0,5
E02002902,2731,1975,521,1454,5,344,281,63,389,358,3,26,2,18
E02002903,644,434,122,312,4,134,109,25,66,56,0,10,0,6
E02002904,750,548,155,393,3,113,102,11,81,73,1,6,1,5
E02002905,1987,1419,691,728,19,95,18,77,383,311,29,34,9,71
E02002906,738,502,193,309,7,109,6,103,114,100,3,10,1,6
E02002907,5284,3559,1334,2225,66,560,84,476,1031,948,27,40,16,68
E02002908,4165,2907,1335,1572,53,327,56,271,755,675,36,32,12,123
E02002909,4209,2952,1288,1664,34,327,55,272,814,718,34,51,11,82
E02002910,3256,2266,1151,1115,21,240,80,160,633,559,54,12,8,96
E02002911,3739,2397,808,1589,41,295,92,203,924,658,155,31,80,82
E02002912,2594,1926,691,1235,20,179,36,143,434,370,29,24,11,35
E02002913,1593,1185,532,653,18,132,41,91,218,169,21,22,6,40
E02002914,7782,5114,1542,3572,95,762,240,522,1764,1621,24,87,32,47
E02002915,2901,2080,747,1333,34,292,110,182,468,408,21,34,5,27
E02002916,14290,9945,3128,6817,178,1468,446,1022,2527,2226,77,187,37,172
E02002917,1655,1154,406,748,21,172,48,124,293,259,9,20,5,15
E02002918,1551,1227,415,812,11,91,18,73,211,185,6,19,1,11
E02002919,2361,1505,436,1069,40,390,155,235,400,326,26,31,17,26
E02002920,2025,1513,536,977,19,188,64,124,274,240,8,21,5,31
E02002921,709,384,106,278,12,209,102,107,98,87,3,7,1,6
E02002922,2095,1513,705,808,16,156,35,121,353,313,22,14,4,57
E02002923,4724,3102,1042,2060,89,418,62,356,1063,995,19,42,7,52
E02002924,2291,1709,959,750,22,120,54,66,378,325,23,24,6,62
E02002925,6966,4751,1776,2975,90,704,239,465,1318,1163,50,84,21,103
E02002926,5431,3799,1354,2445,54,543,189,354,977,884,11,70,12,58
E02002927,4055,2995,1275,1720,18,229,68,161,674,538,71,54,11,139
E02002928,935,703,227,476,5,74,37,37,148,136,1,7,4,5
E02002929,2049,1560,577,983,8,108,50,58,326,270,32,19,5,47
E02002930,3051,2318,683,1635,14,236,98,138,469,431,5,25,8,14
E02002931,2141,1601,366,1235,10,194,74,120,324,269,16,28,11,12
E02002932,5333,3908,1047,2861,21,722,296,426,656,551,30,51,24,26
E02002933,1619,1285,322,963,3,126,58,68,192,176,1,13,2,13
E02002934,2476,1927,409,1518,14,196,78,118,329,292,6,24,7,10
E02002935,3935,2684,666,2018,19,475,231,244,731,686,6,32,7,26
E02002936,5352,3617,890,2727,28,654,275,379,1021,940,13,58,10,32
E02002937,3411,2539,770,1769,25,263,105,158,552,479,30,32,11,32
E02002938,3613,2664,756,1908,16,425,191,234,472,402,33,27,10,36
E02002939,3967,2790,776,2014,17,489,231,258,630,570,8,44,8,41
E02002940,991,693,182,511,5,118,46,72,170,157,2,8,3,5
E02002941,5328,3788,958,2830,22,619,280,339,862,780,16,53,13,37
E02002942,2456,1913,494,1419,6,199,86,113,326,288,14,16,8,12
E02002943,11684,8846,1996,6850,53,1015,400,615,1693,1512,38,123,20,77
E02002944,2372,1672,394,1278,18,317,136,181,353,315,5,27,6,12
E02002945,10650,7517,1843,5674,62,1243,559,684,1767,1631,8,117,11,61
E02002946,1129,821,190,631,7,143,67,76,151,137,1,12,1,7
E02002947,530,392,111,281,2,63,26,37,72,59,1,12,0,1
E02002948,633,410,92,318,1,99,42,57,120,111,2,7,0,3
E02002949,2436,1708,457,1251,13,322,136,186,375,329,3,36,7,18
E02002950,6702,4668,1203,3465,40,813,398,415,1131,1045,9,68,9,50
E02002951,1244,1019,290,729,2,125,106,19,92,80,1,11,0,6
E02002952,1935,1461,380,1081,6,230,165,65,226,208,0,16,2,12
E02002953,816,587,177,410,4,149,132,17,70,62,2,6,0,6
E02002954,1166,877,273,604,4,162,137,25,108,92,1,13,2,15
E02002955,3866,2882,867,2015,13,475,303,172,469,432,2,29,6,27
E02002956,2718,2049,608,1441,6,348,268,80,296,279,1,15,1,19
E02002957,1676,1422,458,964,5,75,61,14,163,150,2,11,0,11
E02002958,1322,997,312,685,5,159,132,27,149,136,1,9,3,12
E02002959,5730,4131,1307,2824,15,754,501,253,769,715,1,44,9,61
E02002960,564,467,161,306,1,51,47,4,42,38,0,4,0,3
E02002961,4500,3297,969,2328,24,491,323,168,654,589,3,50,12,34
E02002962,2371,1813,479,1334,8,350,265,85,189,173,1,11,4,11
E02002963,2136,1610,489,1121,9,235,176,59,255,232,2,16,5,27
E02002964,1692,1314,406,908,7,211,154,57,144,127,2,13,2,16
E02002965,19475,14210,3904,10306,74,2012,1251,761,3003,2680,81,211,31,176
E02002966,7322,5210,1562,3648,30,780,534,246,1250,1158,5,60,27,52
E02002967,1385,839,214,625,6,422,264,158,109,89,3,12,5,9
E02002968,11364,9052,2291,6761,36,838,469,369,1385,1259,22,87,17,53
E02002969,7500,5694,1665,4029,34,779,512,267,941,868,4,52,17,52
E02002970,5225,3907,1191,2716,17,634,451,183,641,574,4,54,9,26
E02002971,1534,1134,342,792,5,186,127,59,198,176,2,20,0,11
E02002972,5127,4008,1216,2792,14,599,477,122,471,407,7,52,5,35
E02002973,5677,4292,1184,3108,15,654,412,242,689,616,5,59,9,27
E02002974,1029,812,272,540,4,111,76,35,97,90,1,6,0,5
E02002975,693,607,159,448,3,27,25,2,49,44,1,4,0,7
E02002976,3039,2164,559,1605,6,434,324,110,418,379,6,31,2,17
E02002977,1229,929,283,646,2,162,129,33,122,106,1,12,3,14
E02002978,801,546,148,398,11,159,133,26,81,74,1,6,0,4
E02002979,1869,1451,439,1012,5,182,135,47,218,199,1,14,4,13
E02002980,1221,954,274,680,6,116,86,30,135,116,4,13,2,10
E02002981,1153,915,243,672,2,134,119,15,99,87,0,12,0,3
E02002982,3555,2698,750,1948,13,454,332,122,368,342,2,21,3,22
E02002983,1645,1303,371,932,7,174,134,40,153,135,0,18,0,8
E02002984,1340,1044,320,724,3,132,100,32,157,131,6,18,2,4
E02002985,2500,1911,558,1353,14,260,97,163,300,268,1,29,2,15
E02002986,1930,1515,449,1066,9,164,57,107,230,202,3,21,4,12
E02002987,2135,1701,508,1193,9,165,71,94,250,230,3,13,4,10
E02002988,1314,926,301,625,8,89,21,68,278,247,7,13,11,13
E02002989,1031,694,236,458,2,108,38,70,216,190,2,17,7,11
E02002990,1407,940,294,646,15,129,31,98,318,297,1,16,4,5
E02002991,19480,12494,3574,8920,108,1491,349,1142,5193,4806,93,246,48,194
E02002992,7105,5280,1463,3817,52,584,152,432,1156,1056,17,70,13,33
E02002993,5594,3622,1032,2590,28,468,110,358,1430,1338,9,67,16,46
E02002994,3148,2394,879,1515,20,172,41,131,493,433,25,32,3,69
E02002995,1938,1258,328,930,10,330,83,247,333,300,5,24,4,7
E02002996,10394,7158,2125,5033,77,581,158,423,2496,2355,25,101,15,82
E02002997,1307,873,275,598,8,111,41,70,303,267,3,29,4,12
E02002998,1200,783,241,542,12,136,39,97,261,241,2,15,3,8
E02002999,713,505,169,336,5,113,32,81,84,73,0,10,1,6
E02003000,2735,2145,807,1338,7,232,78,154,323,276,7,28,12,28
E02003001,2164,1665,573,1092,13,174,51,123,288,262,7,17,2,24
E02003002,2510,1876,549,1327,10,251,81,170,356,315,6,28,7,17
E02003003,1200,848,221,627,19,120,27,93,203,176,6,10,11,10
E02003004,2121,1731,526,1205,14,142,67,75,208,187,3,13,5,26
E02003005,2374,1858,715,1143,14,145,51,94,318,268,20,19,11,39
E02003006,2888,2227,700,1527,20,152,56,96,456,413,12,16,15,33
E02003007,2758,2194,740,1454,17,200,82,118,329,288,15,20,6,18
E02003008,1803,1376,432,944,10,174,63,111,232,205,5,20,2,11
E02003009,2665,2139,664,1475,7,186,56,130,313,289,9,14,1,20
E02003010,3479,2803,830,1973,15,240,72,168,402,364,5,33,0,19
E02003011,1189,949,287,662,9,75,13,62,148,141,3,3,1,8
E02003012,2165,1370,354,1016,13,411,357,54,354,331,5,13,5,17
E02003013,2462,1624,473,1151,19,392,332,60,409,384,1,22,2,18
E02003014,5645,3756,900,2856,42,792,598,194,1032,957,13,53,9,23
E02003015,6375,4720,1327,3393,41,508,353,155,1086,1010,15,60,1,20
E02003016,1292,745,200,545,15,198,115,83,322,302,3,12,5,12
E02003017,2953,2141,590,1551,19,262,188,74,487,449,6,28,4,44
E02003018,802,566,163,403,4,141,124,17,87,81,0,5,1,4
E02003019,8243,5927,1551,4376,56,907,680,227,1311,1209,12,78,12,42
E02003020,1751,1318,429,889,6,169,122,47,227,201,1,18,7,31
E02003021,1346,880,249,631,11,80,49,31,366,339,3,21,3,9
E02003022,1265,978,338,640,4,121,87,34,160,148,0,10,2,2
E02003023,1241,824,268,556,7,138,79,59,244,220,7,14,3,28
E02003024,4896,3318,989,2329,31,516,303,213,995,925,7,58,5,36
E02003025,3491,2273,584,1689,32,430,297,133,735,682,5,42,6,21
E02003026,3072,2255,689,1566,14,226,163,63,538,441,44,28,25,39
E02003027,3789,2599,764,1835,24,249,155,94,886,844,7,30,5,31
E02003028,2695,1862,593,1269,12,162,98,64,626,580,3,40,3,33
E02003029,1127,770,207,563,6,143,115,28,203,176,4,17,6,5
E02003030,1819,1264,331,933,16,155,90,65,366,325,6,30,5,18
E02003031,3258,2017,663,1354,31,191,113,78,1007,937,6,60,4,12
E02003032,3236,2373,671,1702,19,252,153,99,569,516,1,48,4,23
E02003033,3423,2072,604,1468,25,230,119,111,1073,1012,10,48,3,23
E02003034,7039,4185,1046,3139,60,785,379,406,1955,1833,9,101,12,54
E02003036,8330,4977,1312,3665,62,758,471,287,2481,2333,23,113,12,52
E02003037,5462,3313,876,2437,37,231,143,88,1833,1739,16,67,11,48
E02003038,1221,911,231,680,6,99,54,45,199,167,12,14,6,6
E02003039,1307,937,245,692,6,119,79,40,237,219,0,18,0,8
E02003040,2952,1938,529,1409,28,278,186,92,685,644,4,32,5,23
E02003041,4211,2637,812,1825,23,212,135,77,1264,1172,30,47,15,75
E02003043,49716,32370,7885,24485,410,2800,1660,1140,13854,13044,125,614,71,282
E02003044,928,726,187,539,2,49,28,21,149,134,1,14,0,2
E02003045,1526,859,313,546,13,149,79,70,483,453,0,19,11,22
E02003046,4261,2978,678,2300,42,420,277,143,798,725,8,61,4,23
E02003047,3870,2578,656,1922,44,308,208,100,917,853,5,54,5,23
E02003048,1015,647,161,486,12,93,42,51,255,232,1,16,6,8
E02003049,3885,2841,796,2045,30,396,269,127,599,539,3,52,5,19
E02003050,6136,3880,1075,2805,51,865,658,207,1306,1214,7,71,14,34
E02003051,1017,654,171,483,9,110,89,21,232,218,3,11,0,12
E02003052,4049,2954,758,2196,23,379,280,99,672,623,4,44,1,21
E02003053,2165,1670,512,1158,8,174,129,45,300,283,1,15,1,13
E02003054,3770,2881,849,2032,27,353,243,110,495,447,4,42,2,14
E02003055,885,577,130,447,8,181,159,22,110,104,0,5,1,9
E02003056,2582,1799,452,1347,18,409,352,57,342,318,1,22,1,14
E02003057,2975,2251,545,1706,21,233,168,65,456,418,7,30,1,14
E02003058,2772,1976,534,1442,18,348,247,101,412,375,3,33,1,18
E02003059,2661,1954,551,1403,15,352,290,62,330,295,7,27,1,10
E02003060,1731,1369,423,946,10,174,125,49,170,148,0,16,6,8
E02003061,733,479,120,359,9,156,140,16,83,75,0,8,0,6
E02003062,639,389,91,298,3,169,136,33,73,62,2,8,1,5
E02003063,1705,1420,432,988,6,87,63,24,186,167,0,15,4,6
E02003064,2685,1814,466,1348,18,428,331,97,409,373,6,27,3,16
E02003065,3378,2629,664,1965,31,235,100,135,460,422,4,29,5,23
E02003066,2268,1936,449,1487,15,50,17,33,259,246,2,9,2,8
E02003067,2880,2240,524,1716,32,160,65,95,432,391,3,35,3,16
E02003068,4201,3109,814,2295,22,334,195,139,701,644,14,34,9,35
E02003069,2737,2175,665,1510,13,90,34,56,447,391,7,41,8,12
E02003070,5402,4112,1134,2978,53,335,173,162,861,790,13,52,6,41
E02003071,3247,2477,737,1740,26,191,79,112,531,479,9,40,3,22
E02003072,3776,2959,854,2105,19,255,129,126,524,476,3,42,3,19
E02003073,1668,1370,412,958,4,90,45,45,189,171,5,9,4,15
E02003074,2122,1705,478,1227,11,91,33,58,304,274,3,27,0,11
E02003075,2280,1862,562,1300,15,108,57,51,278,249,4,24,1,17
E02003076,4508,3460,1001,2459,30,252,117,135,729,656,9,57,7,37
E02003077,4664,3417,1061,2356,39,279,162,117,891,805,13,69,4,38
E02003078,2802,2122,675,1447,22,159,61,98,459,409,10,35,5,40
E02003079,1846,1497,356,1141,17,52,27,25,263,232,0,25,6,17
E02003080,2489,1955,553,1402,28,124,52,72,368,319,2,42,5,14
E02003081,1737,1447,401,1046,14,67,38,29,198,176,2,18,2,11
E02003082,2985,2027,595,1432,20,169,75,94,746,699,5,42,0,23
E02003084,8264,5547,1401,4146,58,646,285,361,1943,1792,17,123,11,70
E02003085,2785,1850,462,1388,19,356,188,168,542,499,1,42,0,18
E02003086,1637,1148,334,814,4,97,46,51,373,353,4,12,4,15
E02003087,1878,1526,456,1070,11,89,59,30,237,210,1,22,4,15
E02003088,4260,3054,1091,1963,34,170,85,85,955,863,40,35,17,47
E02003089,3889,2995,787,2208,26,226,118,108,625,562,8,51,4,17
E02003090,3669,2947,848,2099,13,197,78,119,489,433,6,46,4,23
E02003091,4010,3047,883,2164,27,237,89,148,670,614,3,45,8,29
E02003092,5309,4085,1178,2907,38,346,123,223,802,741,17,40,4,38
E02003093,3908,3085,1010,2075,18,181,84,97,573,503,11,54,5,51
E02003094,11074,7753,2036,5717,69,1120,674,446,2066,1931,17,100,18,66
E02003095,3608,2909,757,2152,11,176,62,114,484,442,5,29,8,28
E02003096,1745,1327,342,985,11,113,41,72,287,260,2,23,2,7
E02003097,2882,2311,621,1690,23,153,42,111,374,332,3,37,2,21
E02003098,7531,5530,1131,4399,52,341,157,184,1564,1493,7,58,6,44
E02003099,1607,1317,341,976,9,83,17,66,194,172,2,18,2,4
E02003100,12394,8818,1776,7042,88,772,360,412,2657,2504,14,127,12,59
E02003101,2214,1525,283,1242,9,159,42,117,508,477,3,25,3,13
E02003102,1235,1027,325,702,3,74,21,53,120,105,2,10,3,11
E02003103,893,759,202,557,2,17,2,15,111,96,0,14,1,4
E02003104,1065,849,201,648,12,68,22,46,130,124,0,4,2,6
E02003105,1894,1519,446,1073,5,125,58,67,234,209,0,24,1,11
E02003106,25482,19193,4592,14601,145,1025,447,578,4957,4370,256,204,127,162
E02003107,7209,5112,1285,3827,49,590,332,258,1426,1340,7,60,19,32
E02003108,7868,5930,1560,4370,53,631,255,376,1216,1113,13,80,10,38
E02003109,1071,940,281,659,2,29,10,19,90,81,2,7,0,10
E02003110,5211,3312,761,2551,29,652,387,265,1198,1084,29,62,23,20
E02003111,1997,1623,464,1159,13,114,45,69,222,197,0,25,0,25
E02003112,979,741,192,549,7,107,40,67,117,99,3,14,1,7
E02003113,4098,3036,1077,1959,28,279,87,192,634,544,31,46,13,121
E02003114,2725,2124,630,1494,16,225,92,133,343,313,8,19,3,17
E02003115,3399,2516,718,1798,21,320,120,200,518,476,5,35,2,24
E02003116,1412,1057,277,780,4,173,40,133,167,153,1,7,6,11
E02003117,3722,2771,738,2033,28,325,133,192,573,516,6,44,7,25
E02003118,3165,2540,650,1890,17,221,82,139,369,337,2,25,5,18
E02003119,2224,1690,471,1219,7,227,63,164,278,258,1,14,5,22
E02003120,2387,1881,535,1346,5,153,62,91,334,299,5,29,1,14
E02003121,3502,2848,815,2033,17,235,67,168,388,346,4,38,0,14
E02003122,4454,3197,846,2351,47,457,230,227,732,635,38,39,20,21
E02003123,1867,1363,381,982,13,270,148,122,214,197,3,12,2,7
E02003124,974,661,160,501,6,173,108,65,129,106,2,16,5,5
E02003125,1367,985,259,726,18,235,122,113,126,105,5,15,1,3
E02003126,15044,10988,2714,8274,143,1186,519,667,2656,2316,101,170,69,71
E02003127,1416,983,265,718,7,269,166,103,151,130,4,15,2,6
E02003128,1929,1177,288,889,23,435,257,178,289,263,7,16,3,5
E02003129,3550,2648,634,2014,28,303,129,174,552,414,70,40,28,19
E02003130,1541,1032,226,806,10,286,113,173,194,168,4,20,2,19
E02003131,2122,1553,404,1149,24,213,98,115,321,280,7,25,9,11
E02003132,1788,1278,316,962,20,239,129,110,244,220,4,18,2,7
E02003133,1090,822,230,592,5,120,48,72,139,121,3,13,2,4
E02003134,1785,1151,264,887,21,323,201,122,277,250,4,21,2,13
E02003135,6031,4320,840,3480,39,511,229,282,1151,669,277,48,157,10
E02003136,3300,2511,684,1827,31,276,118,158,467,403,12,41,11,15
E02003137,2480,1912,577,1335,13,181,95,86,362,324,8,23,7,12
E02003138,1522,1122,304,818,15,98,37,61,275,250,4,19,2,12
E02003139,1289,982,233,749,19,111,35,76,175,155,3,16,1,2
E02003140,2771,2037,521,1516,32,257,106,151,438,363,10,57,8,7
E02003141,1602,988,248,740,7,219,107,112,372,337,2,28,5,16
E02003142,3094,2233,573,1660,33,351,147,204,463,408,15,29,11,14
E02003143,1314,1002,275,727,11,98,24,74,197,146,17,15,19,6
E02003144,4329,2761,656,2105,27,357,176,181,1141,1054,17,61,9,43
E02003145,3600,2247,587,1660,51,481,192,289,791,708,17,61,5,30
E02003146,1513,954,233,721,19,113,64,49,415,381,5,26,3,12
E02003147,6018,4331,1183,3148,52,767,361,406,844,744,20,68,12,24
E02003148,21937,14108,3585,10523,192,1990,851,1139,5509,4883,132,372,122,138
E02003149,5078,3208,811,2397,54,524,234,290,1261,1127,32,94,8,31
E02003150,8951,5786,1341,4445,82,968,391,577,2059,1805,80,116,58,56
E02003151,1170,907,289,618,13,72,32,40,169,131,12,21,5,9
E02003152,4703,3392,894,2498,59,382,175,207,833,736,31,48,18,37
E02003153,1587,1190,303,887,5,65,18,47,312,209,58,18,27,15
E02003154,1148,838,231,607,12,117,17,100,177,156,1,19,1,4
E02003155,1984,1420,397,1023,24,82,13,69,436,396,1,34,5,22
E02003156,8059,6192,1621,4571,107,320,48,272,1401,1276,11,109,5,39
E02003157,2935,2093,598,1495,54,164,24,140,608,548,5,53,2,16
E02003158,1639,1140,314,826,12,78,3,75,398,362,3,30,3,11
E02003159,953,717,188,529,5,32,5,27,196,176,2,17,1,3
E02003161,7960,5246,1364,3882,94,379,46,333,2182,2014,20,130,18,59
E02003163,2616,1758,581,1177,12,93,19,74,730,677,6,43,4,23
E02003164,1933,1460,423,1037,14,63,8,55,380,336,7,35,2,16
E02003165,1094,836,200,636,10,31,5,26,209,185,1,21,2,8
E02003166,5680,4097,1161,2936,92,361,38,323,1094,975,11,101,7,36
E02003167,5540,3839,1191,2648,63,269,34,235,1322,1218,8,85,11,47
E02003168,1506,1093,333,760,29,58,7,51,311,277,10,24,0,15
E02003169,1373,1109,422,687,4,38,1,37,207,181,8,16,2,15
E02003170,3142,2267,774,1493,29,118,20,98,705,631,9,54,11,23
E02003171,1477,1107,358,749,14,74,5,69,265,235,3,26,1,17
E02003172,1186,844,265,579,13,148,82,66,172,153,1,15,3,9
E02003173,3011,2085,538,1547,19,370,243,127,524,476,4,39,5,13
E02003174,1297,1040,295,745,4,81,59,22,159,149,0,8,2,13
E02003175,1291,942,220,722,17,82,45,37,242,219,5,17,1,8
E02003176,2161,1355,352,1003,23,365,262,103,411,380,5,22,4,7
E02003177,1517,1166,298,868,9,53,28,25,276,241,3,29,3,13
E02003178,1658,1161,318,843,7,180,125,55,299,270,3,25,1,11
E02003179,4376,2775,734,2041,56,520,298,222,998,936,8,46,8,27
E02003180,3344,2171,574,1597,19,271,142,129,861,789,10,61,1,22
E02003181,2049,1551,393,1158,10,76,31,45,388,357,3,25,3,24
E02003182,11762,8298,1905,6393,115,544,221,323,2753,2524,56,147,26,52
E02003183,1868,1276,362,914,7,87,38,49,483,454,6,23,0,15
E02003184,1847,1148,284,864,8,88,45,43,583,542,8,29,4,20
E02003185,1317,953,271,682,3,127,56,71,220,205,1,14,0,14
E02003186,1772,1107,283,824,7,111,32,79,539,499,4,27,9,8
E02003187,2635,1753,498,1255,16,123,39,84,716,661,4,44,7,27
E02003188,13771,8461,2271,6190,132,696,270,426,4403,4119,26,233,25,79
E02003189,2193,1479,432,1047,20,93,33,60,578,546,7,25,0,23
E02003190,3785,1976,600,1376,34,293,104,189,1449,1366,5,71,7,33
E02003191,1854,1295,399,896,9,94,25,69,443,405,3,30,5,13
E02003192,10222,6107,1516,4591,95,547,223,324,3413,3156,50,184,23,60
E02003194,1628,1267,427,840,10,74,23,51,235,185,26,13,11,42
E02003195,2305,1655,436,1219,23,172,112,60,441,405,5,31,0,14
E02003196,2748,2316,742,1574,14,92,41,51,306,274,7,23,2,20
E02003197,6092,4405,1297,3108,55,493,236,257,1107,1009,13,74,11,32
E02003198,1541,1141,285,856,21,124,50,74,245,220,7,14,4,10
E02003199,4944,3710,948,2762,43,399,199,200,772,691,9,71,1,20
E02003200,3184,2124,593,1531,24,369,239,130,652,587,7,45,13,15
E02003201,5431,3700,947,2753,64,491,260,231,1143,1050,8,73,12,33
E02003202,4636,3174,904,2270,45,268,121,147,1124,1047,4,58,15,25
E02003203,1917,1364,345,1019,15,114,55,59,411,380,1,26,4,13
E02003204,5475,4006,1126,2880,55,376,180,196,993,882,27,64,20,45
E02003205,4186,3028,749,2279,50,260,132,128,819,747,16,50,6,29
E02003206,2369,1718,505,1213,13,121,56,65,497,450,10,33,4,20
E02003207,3265,2175,542,1633,32,390,225,165,655,419,155,30,51,13
E02003208,18081,11909,3103,8806,227,1397,686,711,4417,4087,68,223,39,131
E02003209,2145,1537,402,1135,25,176,104,72,397,356,7,28,6,10
E02003210,3125,2278,731,1547,18,147,59,88,652,597,6,39,10,30
E02003211,5406,3708,1089,2619,40,248,126,122,1362,1276,7,72,7,48
E02003212,2663,1953,543,1410,21,201,126,75,461,402,15,23,21,27
E02003214,573,318,65,253,5,198,181,17,48,40,3,3,2,4
E02003215,1088,871,241,630,3,79,53,26,124,100,1,14,9,11
E02003216,2042,1522,401,1121,12,248,188,60,246,200,18,27,1,14
E02003217,1136,828,159,669,12,153,122,31,133,122,2,8,1,10
E02003218,914,602,148,454,6,186,163,23,109,95,6,6,2,11
E02003219,14669,10542,2235,8307,200,1239,731,508,2601,2331,66,150,54,87
E02003220,6874,4985,1188,3797,68,675,443,232,1108,995,19,81,13,38
E02003221,4951,3595,812,2783,65,458,314,144,805,739,14,47,5,28
E02003222,977,776,147,629,8,67,37,30,117,107,1,7,2,9
E02003223,12526,9194,2158,7036,108,998,648,350,2187,2016,26,123,22,39
E02003224,1664,1341,335,1006,23,75,52,23,219,202,4,13,0,6
E02003225,5368,4151,930,3221,56,295,167,128,847,752,17,71,7,19
E02003226,8336,5956,1302,4654,130,589,387,202,1628,1487,17,107,17,33
E02003227,1220,820,237,583,24,219,172,47,149,136,0,10,3,8
E02003228,5040,3694,1010,2684,55,481,290,191,782,701,16,55,10,28
E02003229,851,697,154,543,8,40,17,23,106,93,2,8,3,0
E02003230,7426,4891,1170,3721,98,711,445,266,1683,1567,19,79,18,43
E02003231,1082,672,151,521,16,261,224,37,123,102,3,15,3,10
E02003232,2499,1765,482,1283,45,166,93,73,511,470,4,30,7,12
E02003233,7948,5839,1180,4659,92,603,353,250,1381,1280,16,68,17,33
E02003234,5221,3934,964,2970,63,499,320,179,707,654,5,42,6,18
E02003235,4579,3364,783,2581,69,234,129,105,894,838,15,30,11,18
E02003236,3732,2797,821,1976,57,312,199,113,523,455,25,27,16,43
E02003237,1530,1215,332,883,13,91,48,43,194,168,7,16,3,17
E02003238,1335,1026,238,788,13,106,36,70,183,169,2,10,2,7
E02003239,1310,1029,317,712,12,88,51,37,170,152,5,10,3,11
E02003240,2943,1920,538,1382,19,211,77,134,756,340,241,22,153,37
E02003241,1591,1173,333,840,20,147,59,88,222,197,9,9,7,29
E02003242,4276,3157,786,2371,41,396,157,239,667,610,8,42,7,15
E02003243,1755,1173,323,850,13,297,133,164,264,236,3,17,8,8
E02003244,939,572,151,421,6,177,75,102,171,154,1,13,3,13
E02003245,3388,2083,443,1640,29,324,125,199,930,867,8,49,6,22
E02003246,4638,3037,718,2319,50,501,204,297,1025,952,14,51,8,25
E02003247,2201,1506,378,1128,17,279,89,190,390,354,4,30,2,9
E02003248,3890,2418,678,1740,37,320,119,201,1083,1027,7,35,14,32
E02003249,12705,8683,2228,6455,123,1371,514,857,2462,2321,12,115,14,66
E02003250,17766,12281,3173,9108,169,1650,600,1050,3509,3224,61,176,48,157
E02003251,9236,6976,1718,5258,101,515,185,330,1592,1430,50,79,33,52
E02003252,3968,2796,705,2091,41,331,118,213,773,703,9,51,10,27
E02003253,3063,1969,488,1481,31,331,113,218,705,655,13,31,6,27
E02003254,9886,7311,1685,5626,117,598,208,390,1780,1617,28,115,20,80
E02003255,2094,1395,331,1064,18,202,77,125,469,439,4,16,10,10
E02003257,2848,1892,487,1405,19,356,142,214,564,525,3,31,5,17
E02003258,2437,1943,521,1422,9,148,84,64,320,301,2,16,1,17
E02003259,3804,2784,735,2049,31,357,244,113,618,569,10,32,7,14
E02003260,1326,874,207,667,9,256,218,38,182,170,2,8,2,5
E02003261,1240,998,308,690,3,100,79,21,137,122,3,9,3,2
E02003262,2584,1741,464,1277,13,416,286,130,396,371,4,15,6,18
E02003263,2538,1815,502,1313,12,222,149,73,460,419,5,33,3,29
E02003264,2065,1693,470,1223,17,90,49,41,261,243,5,9,4,4
E02003265,2395,1860,479,1381,21,153,89,64,347,318,6,18,5,14
E02003266,2095,1472,356,1116,12,311,216,95,290,263,1,23,3,10
E02003267,2499,1723,443,1280,13,179,88,91,562,524,1,26,11,22
E02003268,2713,1918,532,1386,21,223,109,114,542,499,2,37,4,9
E02003269,2639,1991,595,1396,15,187,119,68,426,400,6,15,5,20
E02003270,4739,3345,830,2515,42,424,212,212,908,853,5,37,13,20
E02003271,12740,9035,1909,7126,125,812,448,364,2727,2554,14,143,16,41
E02003272,4113,2602,777,1825,26,429,271,158,1021,955,12,36,18,35
E02003273,2724,2033,537,1496,11,280,210,70,395,365,3,25,2,5
E02003274,2554,1618,453,1165,16,211,100,111,672,620,3,34,15,37
E02003275,17512,11351,2947,8404,136,1591,989,602,4330,4096,47,134,53,104
E02003276,4945,3169,856,2313,36,525,289,236,1185,1117,4,51,13,30
E02003277,1428,899,220,679,12,226,171,55,275,265,0,7,3,16
E02003278,10697,7588,1697,5891,81,670,398,272,2315,2164,13,107,31,43
E02003279,3363,2635,710,1925,22,195,93,102,490,439,6,38,7,21
E02003280,5194,4059,955,3104,38,291,171,120,769,696,5,64,4,37
E02003281,1665,1295,400,895,5,93,65,28,260,238,5,17,0,12
E02003282,7256,5474,1572,3902,38,403,209,194,1305,1176,45,66,18,36
E02003283,2355,1806,487,1319,11,191,139,52,329,299,0,28,2,18
E02003284,6002,4431,1143,3288,34,455,254,201,1046,973,7,61,5,36
E02003285,2164,1507,384,1123,12,103,55,48,522,489,5,27,1,20
E02003286,2211,1807,595,1212,5,61,32,29,325,309,1,15,0,13
E02003287,2184,1611,484,1127,12,209,107,102,330,309,3,16,2,22
E02003288,9291,6762,1758,5004,52,697,381,316,1720,1592,13,96,19,60
E02003289,4158,3117,885,2232,14,150,93,57,843,789,8,41,5,34
E02003290,3430,2238,662,1576,18,263,122,141,887,841,6,36,4,24
E02003291,3993,2645,712,1933,30,517,234,283,763,699,3,50,11,38
E02003292,3430,2195,562,1633,25,335,127,208,850,809,4,28,9,25
E02003293,11363,7402,1964,5438,76,796,366,430,2992,2839,18,126,9,97
E02003294,1757,1367,434,933,10,80,30,50,284,261,2,19,2,16
E02003295,2100,1538,423,1115,11,222,130,92,314,290,1,23,0,15
E02003296,2885,2433,688,1745,5,170,100,70,256,241,2,11,2,21
E02003297,1917,1480,440,1040,9,207,148,59,217,198,5,13,1,4
E02003298,1005,822,243,579,2,93,53,40,85,74,3,7,1,3
E02003299,2490,1900,509,1391,11,240,194,46,310,263,13,20,14,29
E02003300,2139,1717,483,1234,6,170,104,66,233,212,5,13,3,13
E02003301,2243,1571,417,1154,12,359,303,56,288,257,3,21,7,13
E02003302,1731,1199,241,958,12,314,276,38,192,180,2,9,1,14
E02003303,2411,1743,406,1337,11,326,252,74,318,292,2,19,5,13
E02003304,2162,1666,425,1241,8,284,242,42,197,186,2,9,0,7
E02003305,1197,955,260,695,7,111,94,17,117,103,2,12,0,7
E02003307,1364,897,217,680,5,332,289,43,127,122,1,3,1,3
E02003308,1366,1027,270,757,10,126,88,38,193,173,8,8,4,10
E02003309,2197,1736,447,1289,16,192,154,38,240,214,2,21,3,13
E02003310,21775,14616,3437,11179,179,2754,2106,648,4134,3902,14,177,41,92
E02003311,4160,2905,737,2168,17,546,436,110,666,612,5,38,11,26
E02003312,3465,2305,578,1727,27,486,385,101,631,589,5,32,5,16
E02003313,6250,4478,1177,3301,30,955,787,168,765,721,2,39,3,22
E02003314,3525,2733,824,1909,39,236,59,177,484,418,18,33,15,33
E02003315,1079,899,246,653,5,50,15,35,115,104,2,7,2,10
E02003316,2251,1739,515,1224,28,178,32,146,289,234,24,13,18,17
E02003317,6937,5150,1247,3903,100,566,178,388,1093,1009,12,61,11,28
E02003318,785,655,187,468,7,31,6,25,89,78,3,5,3,3
E02003319,2480,1729,473,1256,40,244,53,191,432,387,8,29,8,35
E02003320,8227,5955,1462,4493,119,569,166,403,1538,1267,133,51,87,46
E02003321,1066,829,202,627,6,124,19,105,105,102,1,2,0,2
E02003322,1376,876,233,643,17,143,70,73,330,306,1,20,3,10
E02003323,1150,773,207,566,23,141,55,86,209,189,1,16,3,4
E02003324,4390,3115,773,2342,78,462,98,364,717,652,8,48,9,18
E02003325,2786,1773,488,1285,27,234,114,120,712,654,10,40,8,40
E02003326,1919,1437,340,1097,26,138,51,87,306,289,3,11,3,12
E02003327,2682,1785,540,1245,29,213,42,171,584,523,17,27,17,71
E02003328,10045,6847,1780,5067,157,963,252,711,1999,1771,57,120,51,79
E02003329,5679,4163,1025,3138,70,354,121,233,1069,969,30,54,16,23
E02003330,1227,860,226,634,23,111,16,95,216,197,3,13,3,17
E02003331,1896,1433,378,1055,13,216,142,74,221,201,4,11,5,13
E02003332,1564,1227,288,939,15,104,50,54,209,184,7,13,5,9
E02003333,1306,851,216,635,15,94,28,66,332,308,1,12,11,14
E02003334,883,564,186,378,6,69,13,56,235,218,1,14,2,9
E02003335,907,628,140,488,14,71,7,64,191,168,3,17,3,3
E02003336,1271,1085,308,777,8,53,25,28,117,106,0,4,7,8
E02003337,2524,1818,471,1347,44,191,34,157,454,416,8,27,3,17
E02003338,1935,1440,405,1035,20,167,87,80,290,262,4,20,4,18
E02003339,3933,3147,811,2336,50,226,50,176,495,453,3,36,3,15
E02003340,1795,1330,345,985,14,198,42,156,239,212,4,22,1,14
E02003341,988,809,215,594,13,58,7,51,100,84,5,7,4,8
E02003342,1530,1252,326,926,14,73,35,38,183,162,5,12,4,8
E02003343,6442,4821,1278,3543,63,434,190,244,1091,1011,8,60,12,33
E02003344,1201,923,227,696,7,113,22,91,146,136,2,8,0,12
E02003345,904,759,192,567,3,16,3,13,120,106,0,14,0,6
E02003346,2232,1681,462,1219,27,177,36,141,340,312,6,18,4,7
E02003347,951,786,132,654,11,36,5,31,112,100,3,6,3,6
E02003348,3128,2590,724,1866,20,135,66,69,365,327,7,27,4,18
E02003349,1286,1104,296,808,6,44,16,28,122,108,1,12,1,10
E02003350,1255,1021,239,782,10,84,22,62,131,118,4,9,0,9
E02003351,2310,1888,428,1460,27,121,28,93,263,237,5,20,1,11
E02003352,1879,1416,438,978,14,122,53,69,295,247,23,14,11,32
E02003353,8568,6575,1433,5142,91,444,150,294,1399,1268,65,48,18,59
E02003354,2652,1995,425,1570,29,232,85,147,384,348,6,23,7,12
E02003355,5662,4069,745,3324,90,588,197,391,893,821,9,56,7,22
E02003356,2025,1484,411,1073,18,139,47,92,329,281,21,18,9,55
E02003357,3004,2052,451,1601,31,379,140,239,507,467,10,28,2,35
E02003358,10471,7342,1697,5645,147,1400,496,904,1529,1364,36,101,28,53
E02003359,901,616,115,501,15,117,54,63,147,136,2,8,1,6
E02003360,9151,6935,1406,5529,120,791,292,499,1272,1164,27,66,15,33
E02003361,1599,1063,191,872,20,282,99,183,225,210,1,13,1,9
E02003362,869,648,147,501,7,115,39,76,94,77,1,16,0,5
E02003363,2545,1881,534,1347,23,148,50,98,356,264,61,21,10,137
E02003364,3524,2651,620,2031,45,292,87,205,518,420,53,30,15,18
E02003365,1955,1539,414,1125,16,134,37,97,246,209,9,19,9,20
E02003366,3551,2512,732,1780,27,285,72,213,700,347,193,32,128,27
E02003367,3086,2076,629,1447,51,320,32,288,523,430,50,21,22,116
E02003368,2477,1527,479,1048,15,344,45,299,485,396,53,25,11,106
E02003369,2444,1756,526,1230,33,153,26,127,429,356,42,23,8,73
E02003370,1288,1062,305,757,13,76,27,49,122,111,1,8,2,15
E02003371,1285,1107,292,815,15,40,17,23,114,92,8,13,1,9
E02003372,2699,2119,582,1537,23,235,54,181,303,276,5,16,6,19
E02003373,2859,1877,609,1268,46,216,17,199,623,419,124,15,65,97
E02003374,925,710,161,549,4,77,10,67,131,112,6,11,2,3
E02003375,8350,5995,1437,4558,122,628,213,415,1540,1416,27,75,22,65
E02003376,3505,2441,751,1690,31,404,49,355,578,510,23,33,12,51
E02003377,11447,8268,2157,6111,163,1031,158,873,1820,1581,111,86,42,165
E02003378,7229,5247,1096,4151,82,479,54,425,1361,1230,51,54,26,60
E02003379,2897,1949,486,1463,55,303,31,272,567,525,13,24,5,23
E02003380,1385,1018,258,760,22,180,13,167,159,148,0,9,2,6
E02003381,2442,1688,428,1260,28,220,58,162,482,417,29,24,12,24
E02003382,2013,1404,410,994,22,307,25,282,259,231,10,16,2,21
E02003383,1610,1218,286,932,22,136,18,118,216,195,3,18,0,18
E02003384,2492,1658,540,1118,28,213,22,191,486,420,27,20,19,107
E02003385,19314,13486,3572,9914,337,2183,207,1976,3194,2945,72,150,27,114
E02003386,2081,1364,383,981,25,362,23,339,312,294,5,11,2,18
E02003387,1997,1541,481,1060,20,154,18,136,263,235,8,17,3,19
E02003388,2718,1912,561,1351,47,243,56,187,473,438,13,12,10,43
E02003389,1773,1422,414,1008,14,74,36,38,251,228,3,19,1,12
E02003390,1395,1214,412,802,10,35,14,21,131,116,0,14,1,5
E02003391,1821,1383,430,953,20,110,64,46,277,245,8,19,5,31
E02003392,2186,1455,442,1013,48,225,92,133,440,414,2,15,9,18
E02003393,1665,1356,364,992,14,94,47,47,190,166,5,14,5,11
E02003394,2462,1689,425,1264,46,346,230,116,368,337,2,24,5,13
E02003395,6026,3829,992,2837,93,612,306,306,1456,1359,15,62,20,36
E02003396,1714,1126,277,849,37,139,54,85,406,364,18,21,3,6
E02003397,1706,1296,322,974,15,178,124,54,206,183,6,11,6,11
E02003398,3458,2137,593,1544,48,283,128,155,974,928,6,28,12,16
E02003399,32853,21722,5109,16613,616,2371,1058,1313,7986,7465,81,354,86,158
E02003400,2441,1578,498,1080,21,104,41,63,710,670,13,18,9,28
E02003401,2461,1599,422,1177,24,301,168,133,514,475,8,27,4,23
E02003402,6956,4654,1259,3395,139,585,232,353,1551,1431,51,47,22,27
E02003403,3285,2176,613,1563,55,496,305,191,534,497,11,23,3,24
E02003404,1326,802,234,568,21,226,158,68,255,231,7,6,11,22
E02003405,9762,6513,1448,5065,179,1120,640,480,1887,1748,25,91,23,63
E02003406,5151,3592,809,2783,97,519,297,222,913,861,9,38,5,30
E02003407,1304,760,153,607,22,326,255,71,185,167,2,14,2,11
E02003408,11788,7978,1934,6044,134,1019,507,512,2596,2448,24,95,29,61
E02003409,5777,3920,968,2952,65,695,358,337,1074,1006,13,46,9,23
E02003410,2344,1434,411,1023,19,259,147,112,621,576,8,30,7,11
E02003411,4605,2783,683,2100,64,721,298,423,1014,937,19,36,22,23
E02003412,2334,1631,381,1250,28,191,103,88,468,446,4,13,5,16
E02003413,5751,3606,1009,2597,91,642,296,346,1368,1282,7,67,12,44
E02003414,4480,2950,654,2296,70,424,207,217,1015,967,9,32,7,21
E02003415,8903,5628,1318,4310,141,772,348,424,2293,2169,18,72,34,69
E02003416,3443,2502,714,1788,45,275,152,123,611,580,9,21,1,10
E02003417,8435,5329,1371,3958,103,874,424,450,2068,1961,31,61,15,61
E02003418,1888,1249,311,938,22,245,185,60,354,327,5,16,6,18
E02003419,4037,2673,666,2007,56,494,222,272,792,743,7,40,2,22
E02003420,9409,5983,1417,4566,178,1114,509,605,2075,1962,17,82,14,59
E02003421,1227,913,299,614,12,113,18,95,169,149,5,10,5,20
E02003422,6430,4599,1536,3063,48,472,114,358,1169,997,89,64,19,142
E02003423,1500,996,292,704,13,246,38,208,240,213,11,14,2,5
E02003424,2775,2011,589,1422,18,203,48,155,518,491,7,17,3,25
E02003425,14130,9851,2645,7206,172,1404,282,1122,2572,2370,42,115,45,131
E02003426,2535,1943,606,1337,21,221,32,189,329,291,15,11,12,21
E02003427,4784,3436,807,2629,47,350,68,282,919,863,9,35,12,32
E02003428,2860,2099,558,1541,26,290,38,252,430,405,5,18,2,15
E02003429,3167,2299,720,1579,24,217,64,153,570,507,17,32,14,57
E02003430,8605,5102,1387,3715,100,806,234,572,2248,1859,213,73,103,349
E02003431,2935,2141,495,1646,23,233,83,150,514,468,17,24,5,24
E02003432,5715,3847,937,2910,52,419,113,306,1348,1085,128,40,95,49
E02003433,1473,991,348,643,13,211,31,180,246,165,40,5,36,12
E02003434,2077,1356,393,963,22,332,57,275,347,286,26,18,17,20
E02003435,3220,2324,708,1616,30,279,66,213,543,475,36,15,17,44
E02003436,2387,1561,498,1063,15,180,57,123,568,397,123,22,26,63
E02003437,4748,3411,887,2524,41,457,125,332,723,657,21,36,9,116
E02003438,4723,3404,1064,2340,30,389,110,279,767,686,35,33,13,133
E02003439,3244,2333,730,1603,34,276,161,115,537,483,22,20,12,64
E02003440,2262,1746,498,1248,23,126,83,43,351,329,1,14,7,16
E02003441,3139,2373,643,1730,31,146,80,66,564,518,8,28,10,25
E02003442,1388,1175,303,872,15,47,26,21,141,135,0,6,0,10
E02003443,2846,2148,638,1510,29,260,181,79,391,359,9,21,2,18
E02003444,10827,8324,1838,6486,111,436,208,228,1911,1790,20,84,17,45
E02003445,1348,1158,339,819,7,35,20,15,142,127,2,13,0,6
E02003446,3395,2604,823,1781,51,148,91,57,568,534,9,15,10,24
E02003447,5234,3888,865,3023,89,316,137,179,912,859,14,35,4,29
E02003448,3816,2906,803,2103,39,302,144,158,522,467,21,32,2,47
E02003449,1785,1425,279,1146,15,70,33,37,269,244,3,20,2,6
E02003450,3837,2798,739,2059,52,232,127,105,738,695,14,23,6,17
E02003451,6260,4640,1284,3356,84,524,295,229,952,879,20,38,15,60
E02003452,1260,980,277,703,18,83,54,29,173,143,15,12,3,6
E02003453,1024,903,292,611,4,34,21,13,77,71,1,5,0,6
E02003454,5290,3972,1092,2880,78,451,225,226,766,699,13,42,12,23
E02003455,3296,2388,649,1739,87,245,159,86,535,492,10,23,10,41
E02003456,3629,2604,697,1907,44,266,138,128,677,362,185,32,98,38
E02003457,1798,1554,458,1096,4,58,46,12,167,148,6,9,4,15
E02003458,2855,2195,608,1587,22,159,80,79,440,392,20,19,9,39
E02003459,3106,2388,683,1705,32,174,108,66,486,451,9,19,7,26
E02003460,3939,2977,862,2115,103,248,126,122,563,510,12,32,9,48
E02003461,1202,945,252,693,31,68,45,23,151,137,2,10,2,7
E02003462,3907,2926,691,2235,141,248,149,99,568,495,15,48,10,24
E02003463,2877,1947,464,1483,171,262,141,121,478,447,7,22,2,19
E02003464,974,589,171,418,44,162,117,45,175,159,1,15,0,4
E02003465,5342,3895,802,3093,308,333,163,170,780,728,5,45,2,26
E02003466,2441,1560,410,1150,74,284,175,109,509,461,9,31,8,14
E02003467,5205,3506,687,2819,248,482,248,234,944,872,6,54,12,25
E02003468,6189,4374,1115,3259,254,539,289,250,979,911,8,53,7,43
E02003469,810,612,170,442,35,43,32,11,115,103,0,10,2,5
E02003470,1838,1116,267,849,83,318,228,90,306,290,1,15,0,15
E02003471,1858,1158,296,862,80,245,141,104,363,291,2,68,2,12
E02003472,28855,19207,3851,15356,1416,2288,1137,1151,5807,5440,28,288,51,137
E02003473,4031,2744,624,2120,253,344,199,145,678,614,9,49,6,12
E02003474,1399,951,252,699,65,125,50,75,244,236,1,6,1,14
E02003475,15473,10143,2167,7976,837,1309,561,748,3118,2928,25,136,29,66
E02003476,5807,3657,891,2766,354,824,404,420,954,887,19,39,9,18
E02003477,4782,3230,612,2618,290,391,156,235,855,805,7,34,9,16
E02003478,5292,3711,860,2851,312,374,153,221,872,822,4,42,4,23
E02003479,2751,1735,354,1381,134,351,139,212,515,483,8,21,3,16
E02003480,5122,3575,708,2867,285,405,143,262,838,793,7,33,5,19
E02003481,9762,6141,1455,4686,481,1418,899,519,1680,1567,19,84,10,42
E02003482,3489,2522,698,1824,115,299,139,160,530,467,18,34,11,23
E02003483,2287,1519,276,1243,126,280,54,226,348,328,1,17,2,14
E02003484,1289,831,181,650,94,157,44,113,197,186,0,7,4,10
E02003485,1719,1206,339,867,76,169,121,48,258,238,0,18,2,10
E02003486,1874,1195,226,969,103,166,57,109,405,384,0,19,2,5
E02003487,847,653,185,468,21,81,60,21,89,81,0,8,0,3
E02003488,4712,3031,779,2252,219,622,407,215,811,761,11,30,9,29
E02003489,3418,2365,557,1808,152,329,192,137,545,503,10,22,10,27
E02003490,1085,702,173,529,38,204,158,46,136,124,0,11,1,5
E02003491,3616,2569,676,1893,32,387,286,101,603,562,2,36,3,25
E02003492,4250,2647,780,1867,39,336,248,88,1203,1137,7,47,12,25
E02003493,1859,1416,428,988,10,99,65,34,297,269,3,24,1,37
E02003494,1890,1474,405,1069,19,100,70,30,286,267,3,13,3,11
E02003495,1095,816,230,586,12,122,56,66,136,127,0,9,0,9
E02003496,1187,820,235,585,7,165,141,24,182,161,3,15,3,13
E02003497,4156,2914,714,2200,38,222,139,83,953,896,3,53,1,29
E02003498,2249,1425,451,974,33,322,212,110,449,412,4,28,5,20
E02003499,1792,908,228,680,19,471,303,168,386,361,3,20,2,8
E02003500,2057,1436,397,1039,16,164,114,50,428,407,5,13,3,13
E02003501,2871,2038,580,1458,20,112,63,49,671,638,7,26,0,30
E02003502,1755,1250,331,919,18,202,151,51,275,244,7,23,1,10
E02003503,3505,2392,653,1739,33,404,250,154,654,607,3,41,3,22
E02003504,3894,2385,614,1771,58,219,130,89,1212,1151,4,48,9,20
E02003505,2724,1455,396,1059,23,273,179,94,944,885,1,47,11,29
E02003506,3180,2017,520,1497,31,288,166,122,818,769,7,38,4,26
E02003507,2383,1697,438,1259,24,283,195,88,367,336,2,26,3,12
E02003508,2290,1461,447,1014,29,184,116,68,601,570,0,22,9,15
E02003509,4424,2504,733,1771,41,480,325,155,1355,1288,6,54,7,44
E02003510,3350,2033,533,1500,28,194,108,86,1061,1004,9,41,7,34
E02003511,5962,4007,1055,2952,55,527,366,161,1335,1234,6,88,7,38
E02003512,1632,971,256,715,10,115,67,48,524,492,4,25,3,12
E02003513,1848,1179,318,861,11,185,129,56,458,427,0,31,0,15
E02003514,2836,1513,379,1134,21,174,97,77,1096,1038,4,51,3,32
E02003515,2244,1267,348,919,32,524,387,137,399,372,1,22,4,22
E02003516,4845,2690,717,1973,37,257,140,117,1821,1739,6,68,8,40
E02003517,30144,15975,4032,11943,292,1946,1174,772,11679,11081,62,468,68,252
E02003518,3945,2342,655,1687,31,268,179,89,1262,1194,3,55,10,42
E02003519,3695,1651,443,1208,28,244,134,110,1738,1666,6,57,9,34
E02003520,7280,4054,987,3067,89,533,362,171,2543,2405,10,111,17,61
E02003521,8336,4874,1159,3715,121,666,439,227,2604,2454,22,114,14,71
E02003522,3661,1985,584,1401,27,478,327,151,1139,1082,5,49,3,32
E02003523,2579,1982,625,1357,33,138,87,51,404,378,3,19,4,22
E02003524,1766,1245,273,972,15,288,230,58,209,172,6,20,11,9
E02003525,10736,7616,1751,5865,98,1117,698,419,1853,1552,98,143,60,52
E02003526,1707,1340,396,944,12,134,76,58,207,167,23,12,5,14
E02003527,4457,3180,737,2443,36,352,197,155,864,726,48,71,19,25
E02003529,3467,2592,685,1907,25,376,245,131,465,421,8,27,9,9
E02003530,2289,1587,431,1156,23,269,134,135,396,311,39,21,25,14
E02003531,11761,8721,2246,6475,97,1018,577,441,1875,1679,25,143,28,50
E02003532,1591,1145,289,856,7,92,48,44,334,303,7,20,4,13
E02003533,2820,2039,458,1581,21,194,115,79,557,323,145,31,58,9
E02003534,2987,2064,476,1588,28,221,119,102,654,584,8,56,6,20
E02003535,1613,1156,238,918,18,126,65,61,307,263,5,27,12,6
E02003536,6707,4578,1022,3556,62,776,514,262,1247,1031,83,74,59,44
E02003537,2226,1676,407,1269,28,161,85,76,346,294,7,36,9,15
E02003538,2048,1306,304,1002,26,223,112,111,483,427,9,41,6,10
E02003539,22647,14811,3774,11037,238,2504,1579,925,4982,4091,386,263,242,112
E02003540,4835,3468,919,2549,37,404,224,180,895,790,8,86,11,31
E02003541,2996,1699,464,1235,37,470,365,105,768,702,15,38,13,22
E02003542,1058,686,179,507,4,60,28,32,298,275,5,16,2,10
E02003543,1893,1072,295,777,20,158,83,75,628,576,11,39,2,15
E02003544,1301,907,238,669,5,95,41,54,281,247,5,23,6,13
E02003545,2928,1751,504,1247,18,259,149,110,878,796,19,51,12,22
E02003546,1364,863,261,602,5,68,39,29,411,342,28,20,21,17
E02003547,6592,3613,910,2703,58,532,297,235,2310,2087,45,140,38,79
E02003548,1647,983,313,670,21,150,81,69,472,430,10,23,9,21
E02003549,1137,752,220,532,8,130,100,30,240,218,4,11,7,7
E02003550,1781,1324,319,1005,20,177,132,45,244,223,4,14,3,16
E02003551,1930,1187,287,900,19,291,143,148,424,389,7,21,7,9
E02003552,1197,733,204,529,12,286,212,74,156,146,1,9,0,10
E02003553,1025,480,136,344,9,178,149,29,350,331,5,11,3,8
E02003554,1660,1094,340,754,12,211,141,70,331,306,9,16,0,12
E02003555,1880,1406,393,1013,14,233,170,63,218,197,1,19,1,9
E02003556,1055,787,204,583,12,100,79,21,154,138,3,12,1,2
E02003557,6190,4037,1243,2794,39,266,150,116,1802,1701,16,69,16,46
E02003558,11607,7700,1847,5853,151,1262,791,471,2438,2251,41,109,37,56
E02003559,1993,1389,400,989,13,150,92,58,423,389,9,18,7,18
E02003560,2663,1804,491,1313,20,475,381,94,341,310,2,26,3,23
E02003561,1597,786,232,554,14,221,110,111,563,545,3,11,4,13
E02003562,2422,1605,422,1183,27,263,160,103,508,480,9,16,3,19
E02003563,3780,2418,652,1766,44,598,422,176,700,661,2,30,7,20
E02003564,1338,918,228,690,14,197,161,36,196,176,2,15,3,13
E02003565,2211,1228,326,902,29,259,143,116,674,639,4,26,5,21
E02003566,903,627,157,470,20,138,105,33,116,107,0,9,0,2
E02003567,4940,3291,770,2521,51,655,469,186,921,846,16,45,14,22
E02003568,1736,1023,256,767,17,117,56,61,563,523,6,30,4,16
E02003569,3660,2405,653,1752,44,412,254,158,775,720,10,39,6,24
E02003570,11057,6806,1676,5130,130,1180,671,509,2874,2699,22,136,17,67
E02003571,19152,11896,2833,9063,214,1897,1188,709,5062,4740,36,252,34,83
E02003572,1842,1266,319,947,18,198,130,68,351,328,5,17,1,9
E02003573,1429,825,213,612,15,416,355,61,163,145,1,13,4,10
E02003574,1459,1131,279,852,24,116,68,48,182,160,1,20,1,6
E02003575,1008,602,117,485,19,267,225,42,113,96,3,9,5,7
E02003576,1773,1242,275,967,15,196,131,65,311,287,2,17,5,9
E02003577,13678,8635,2274,6361,151,1394,874,520,3401,3210,21,148,22,97
E02003578,1181,883,198,685,10,121,73,48,162,136,4,21,1,5
E02003579,1897,1265,373,892,10,257,142,115,345,319,4,18,4,20
E02003580,753,411,86,325,8,240,206,34,86,80,1,5,0,8
E02003581,2694,1903,609,1294,10,153,11,142,595,541,13,36,5,33
E02003582,2722,2130,658,1472,13,124,10,114,431,385,2,42,2,24
E02003583,2855,2134,660,1474,22,212,25,187,466,428,8,26,4,21
E02003584,3552,2366,746,1620,22,239,26,213,885,817,10,50,8,40
E02003585,1320,962,369,593,17,71,4,67,255,224,11,17,3,15
E02003586,1562,1114,365,749,12,110,10,100,313,272,4,29,8,13
E02003587,2181,1509,475,1034,19,180,17,163,458,418,0,35,5,15
E02003588,8797,6539,1901,4638,81,564,71,493,1561,1414,13,120,14,52
E02003589,7011,5045,1407,3638,69,465,46,419,1397,1250,15,123,9,35
E02003590,3281,2405,910,1495,23,163,15,148,650,585,15,43,7,40
E02003591,3761,2722,843,1879,26,315,51,264,665,591,12,58,4,33
E02003592,2694,1855,812,1043,21,262,15,247,516,454,6,41,15,40
E02003593,1972,1502,608,894,15,126,35,91,294,244,11,26,13,35
E02003594,3042,2140,732,1408,38,242,14,228,598,542,7,44,5,24
E02003595,2399,1869,655,1214,13,140,12,128,363,324,4,34,1,14
E02003596,2506,1702,607,1095,19,171,15,156,587,543,2,42,0,27
E02003597,1420,1081,483,598,8,82,9,73,223,196,7,16,4,26
E02003598,2015,1440,592,848,12,156,14,142,375,320,8,37,10,32
E02003599,1100,834,189,645,19,125,17,108,121,111,1,8,1,1
E02003600,3446,2553,716,1837,35,410,73,337,429,404,7,11,7,19
E02003601,2028,1528,488,1040,17,203,33,170,263,239,5,14,5,17
E02003602,3696,2586,761,1825,32,403,70,333,632,576,19,28,9,43
E02003603,3566,2499,740,1759,48,478,79,399,514,465,7,29,13,27
E02003604,3215,2316,625,1691,39,433,83,350,411,387,7,15,2,16
E02003605,7044,4820,1287,3533,123,452,143,309,1585,1448,39,55,43,64
E02003606,2513,1979,608,1371,19,195,41,154,307,262,13,23,9,13
E02003607,2484,1759,525,1234,28,194,36,158,437,372,26,16,23,66
E02003608,3008,2189,586,1603,28,370,93,277,400,334,28,25,13,21
E02003609,4590,3128,865,2263,47,490,80,410,909,560,183,39,127,16
E02003610,4057,3186,917,2269,45,300,64,236,507,448,8,29,22,19
E02003611,3510,2532,657,1875,35,299,46,253,626,316,198,21,91,18
E02003612,1919,1460,376,1084,21,222,66,156,202,183,4,10,5,14
E02003613,2159,1584,417,1167,19,270,35,235,276,245,5,20,6,10
E02003614,1893,1507,435,1072,10,117,28,89,245,213,10,17,5,14
E02003615,2405,1911,575,1336,17,174,41,133,272,238,8,17,9,31
E02003616,2818,2163,697,1466,24,171,28,143,430,360,16,40,14,30
E02003617,2736,2099,703,1396,21,169,31,138,404,350,15,32,7,43
E02003618,3204,2467,705,1762,33,210,48,162,476,425,8,31,12,18
E02003619,4583,3402,938,2464,71,373,80,293,671,612,15,35,9,66
E02003620,1513,1201,397,804,20,108,13,95,174,152,2,15,5,10
E02003621,1185,963,335,628,5,99,13,86,116,103,2,9,2,2
E02003622,3915,2713,724,1989,55,471,66,405,649,610,7,29,3,27
E02003623,1703,1423,460,963,15,76,9,67,180,161,7,9,3,9
E02003624,2926,2111,681,1430,40,237,43,194,493,443,12,32,6,45
E02003625,5661,3970,1157,2813,50,594,86,508,995,928,12,41,14,52
E02003626,2387,1615,491,1124,32,315,59,256,407,368,6,25,8,18
E02003627,11050,7491,2075,5416,133,1154,197,957,2189,2012,24,110,43,83
E02003628,1412,931,264,667,21,128,24,104,305,287,3,12,3,27
E02003629,6595,4603,1162,3441,92,794,132,662,1070,997,8,55,10,36
E02003630,8065,5815,1641,4174,116,866,141,725,1229,1103,42,58,26,39
E02003631,1768,1293,363,930,21,214,29,185,226,200,6,12,8,14
E02003632,1565,1140,349,791,7,142,14,128,256,237,2,12,5,20
E02003633,6968,5142,1303,3839,93,723,117,606,984,893,16,63,12,26
E02003634,2591,1757,478,1279,48,309,48,261,450,415,6,22,7,27
E02003635,1599,1265,345,920,15,116,22,94,192,169,3,15,5,11
E02003636,1842,1486,432,1054,17,97,46,51,227,204,1,18,4,15
E02003637,3550,2725,762,1963,36,304,217,87,444,393,14,25,12,41
E02003638,1332,1083,311,772,8,102,85,17,122,106,5,11,0,17
E02003639,4795,3473,1019,2454,73,532,330,202,669,587,13,54,15,48
E02003640,1390,1099,352,747,9,102,58,44,167,142,6,16,3,13
E02003641,759,629,167,462,2,22,16,6,98,87,2,7,2,8
E02003642,1174,828,193,635,12,178,148,30,149,136,3,7,3,7
E02003643,5362,3889,987,2902,84,606,347,259,757,689,14,40,14,26
E02003644,5407,3904,921,2983,60,568,359,209,846,780,3,56,7,29
E02003645,4820,3037,775,2262,45,518,337,181,1199,1121,9,52,17,21
E02003646,2218,1736,488,1248,23,210,151,59,233,211,3,14,5,16
E02003647,5485,3943,1025,2918,54,628,404,224,830,761,11,47,11,30
E02003648,930,690,165,525,9,125,98,27,96,88,0,4,4,10
E02003649,1626,1277,349,928,23,80,48,32,239,221,5,12,1,7
E02003650,2154,1625,540,1085,15,227,172,55,262,214,21,21,6,25
E02003651,2195,1630,405,1225,19,173,124,49,350,316,8,18,8,23
E02003652,4363,3213,911,2302,63,346,110,236,680,630,19,27,4,61
E02003653,2428,1798,538,1260,28,217,64,153,363,324,8,30,1,22
E02003654,1629,1289,371,918,24,108,42,66,183,161,5,17,0,25
E02003655,3605,2776,818,1958,33,284,80,204,443,378,17,33,15,69
E02003656,1553,1145,368,777,15,152,52,100,208,183,7,13,5,33
E02003657,1966,1430,462,968,35,181,83,98,282,237,16,22,7,38
E02003658,2358,1725,508,1217,22,224,80,144,351,301,6,32,12,36
E02003659,2527,1759,555,1204,26,244,55,189,421,354,33,25,9,77
E02003660,3224,2543,769,1774,29,261,118,143,368,328,13,18,9,23
E02003661,2655,2020,612,1408,28,187,53,134,383,329,26,17,11,37
E02003662,897,611,143,468,10,101,19,82,172,159,5,7,1,3
E02003663,5090,3478,910,2568,56,765,234,531,766,706,8,40,12,25
E02003664,4196,2913,781,2132,59,477,162,315,724,655,9,53,7,23
E02003665,2518,1850,526,1324,30,254,77,177,372,331,3,33,5,12
E02003666,10640,7663,2055,5608,153,1061,279,782,1699,1564,26,88,21,64
E02003667,2030,1461,290,1171,24,179,48,131,355,325,6,20,4,11
E02003668,2522,2072,537,1535,21,108,32,76,307,273,20,11,3,14
E02003669,1416,943,236,707,20,243,94,149,201,184,4,13,0,9
E02003670,4593,3352,874,2478,68,457,125,332,691,617,12,43,19,25
E02003671,848,589,126,463,7,110,33,77,131,125,3,3,0,11
E02003672,3671,2782,838,1944,30,282,93,189,557,472,31,39,15,20
E02003673,3583,2632,789,1843,36,285,84,201,580,522,19,34,5,50
E02003674,2546,1878,571,1307,26,237,73,164,376,334,12,17,13,29
E02003675,4003,2664,744,1920,31,436,130,306,838,425,254,21,138,34
E02003676,2595,1980,822,1158,20,257,74,183,300,257,19,19,5,38
E02003677,2081,1455,466,989,26,367,73,294,221,194,0,23,4,12
E02003678,1503,1192,380,812,13,126,35,91,161,142,2,14,3,11
E02003679,4110,2774,906,1868,54,663,160,503,581,544,8,26,3,38
E02003680,3311,2621,921,1700,21,264,70,194,361,306,31,12,12,44
E02003681,4367,3241,1106,2135,46,441,85,356,592,534,18,35,5,47
E02003682,5238,3852,1185,2667,79,460,102,358,804,746,12,36,10,43
E02003683,2350,1725,544,1181,41,188,40,148,372,353,6,11,2,24
E02003685,2392,1915,667,1248,28,135,37,98,275,249,8,11,7,39
E02003686,2956,2114,715,1399,37,201,57,144,579,498,54,20,7,25
E02003687,2139,1660,517,1143,26,162,31,131,262,232,11,13,6,29
E02003688,6923,4919,1567,3352,73,695,217,478,1142,968,78,51,45,94
E02003689,3551,2642,889,1753,47,218,60,158,568,493,35,25,15,76
E02003690,5186,3623,1002,2621,66,438,181,257,1004,921,29,45,9,55
E02003691,2163,1505,506,999,33,211,72,139,362,301,40,18,3,52
E02003692,4190,2959,879,2080,58,366,146,220,760,682,45,23,10,47
E02003693,3133,2134,738,1396,32,294,94,200,620,535,39,31,15,53
E02003694,2459,1719,469,1250,39,330,87,243,340,306,9,12,13,31
E02003695,5358,3731,1037,2694,100,548,194,354,946,874,7,47,18,33
E02003696,3224,2434,791,1643,24,352,211,141,394,342,12,27,13,20
E02003697,1638,1308,445,863,14,82,40,42,203,140,36,12,15,31
E02003698,2627,2099,700,1399,18,144,70,74,328,215,63,22,28,38
E02003699,2017,1512,448,1064,24,115,64,51,330,264,33,23,10,36
E02003701,2240,1633,481,1152,17,233,140,93,341,316,10,12,3,16
E02003702,4852,3061,1061,2000,32,264,104,160,1376,655,451,28,242,119
E02003703,2285,1656,470,1186,17,154,75,79,436,400,19,11,6,22
E02003704,1214,1027,297,730,10,63,37,26,104,95,3,3,3,10
E02003705,1405,932,230,702,20,132,69,63,307,289,2,12,4,14
E02003706,988,679,177,502,35,134,72,62,126,108,9,8,1,14
E02003707,3035,2088,578,1510,35,331,181,150,565,520,3,36,6,16
E02003708,2976,2034,629,1405,41,318,191,127,574,533,9,20,12,9
E02003709,780,522,112,410,13,156,92,64,83,66,3,12,2,6
E02003710,18444,12569,3682,8887,266,1848,943,905,3624,3303,94,135,92,137
E02003711,4730,3238,832,2406,80,444,211,233,939,849,16,55,19,29
E02003712,4153,2944,830,2114,35,420,279,141,731,686,12,26,7,23
E02003713,1285,1053,285,768,12,87,66,21,125,104,10,10,1,8
E02003714,4972,3659,1010,2649,84,474,255,219,722,661,18,37,6,33
E02003715,2551,1949,626,1323,17,159,90,69,384,302,42,13,27,42
E02003716,3022,2253,676,1577,19,216,130,86,500,469,6,22,3,34
E02003717,3220,2380,668,1712,18,217,140,77,574,515,22,19,18,31
E02003718,6508,4725,1178,3547,74,418,237,181,1250,1143,23,74,10,41
E02003719,1678,842,226,616,55,430,322,108,334,290,8,11,25,17
E02003720,1569,922,351,571,16,296,217,79,318,297,7,10,4,17
E02003721,7991,5229,1414,3815,130,872,408,464,1720,1624,15,66,15,40
E02003722,3248,2041,660,1381,43,386,218,168,742,691,12,27,12,36
E02003723,6818,4633,1494,3139,121,548,305,243,1432,1296,38,57,41,84
E02003724,4490,2677,781,1896,73,844,547,297,858,803,9,40,6,38
E02003725,25609,15202,5041,10161,452,2656,1452,1204,6984,6380,198,254,152,315
E02003726,5127,3073,991,2082,75,671,388,283,1252,1150,42,39,21,56
E02003727,2686,1606,513,1093,52,416,271,145,589,549,13,18,9,23
E02003728,3807,2304,702,1602,65,599,386,213,806,759,9,28,10,33
E02003729,3112,1985,644,1341,41,355,200,155,709,652,15,35,7,22
E02003730,11533,7890,2307,5583,173,823,454,369,2532,2331,65,107,29,115
E02003731,14877,9703,2688,7015,284,1568,757,811,3201,2985,61,120,35,121
E02003732,2518,1784,519,1265,35,296,38,258,370,324,15,24,7,33
E02003733,2095,1603,560,1043,22,213,41,172,230,202,3,21,4,27
E02003734,3002,2158,664,1494,61,310,43,267,442,389,9,36,8,31
E02003735,6916,4873,1446,3427,117,702,98,604,1092,997,29,55,11,132
E02003736,2968,2302,761,1541,31,270,60,210,336,300,9,23,4,29
E02003737,3917,2804,858,1946,57,353,67,286,653,581,34,36,2,50
E02003738,3957,2479,737,1742,55,395,119,276,974,903,19,35,17,54
E02003739,1687,1292,398,894,23,171,44,127,181,160,5,14,2,20
E02003740,2153,1512,537,975,22,211,64,147,344,287,24,22,11,64
E02003742,1182,961,385,576,5,64,11,53,135,117,3,11,4,17
E02003743,3310,2138,642,1496,24,317,87,230,811,756,12,37,6,20
E02003744,10607,7433,2228,5205,65,913,241,672,2108,1948,17,119,24,88
E02003745,2378,1797,603,1194,6,173,53,120,373,320,10,37,6,29
E02003746,5382,3953,990,2963,48,354,95,259,989,912,18,50,9,38
E02003747,3183,2543,714,1829,13,176,50,126,434,394,4,33,3,17
E02003748,1608,1191,382,809,15,92,19,73,291,268,5,16,2,19
E02003749,2140,1585,454,1131,7,171,67,104,348,311,4,26,7,29
E02003750,2547,1901,601,1300,12,135,26,109,472,427,3,34,8,27
E02003751,1871,1444,453,991,9,95,32,63,297,244,31,19,3,26
E02003752,3646,2618,745,1873,13,229,59,170,753,695,5,31,22,33
E02003753,2880,2146,551,1595,23,245,77,168,451,407,4,39,1,15
E02003754,2166,1598,490,1108,13,169,57,112,352,311,11,26,4,34
E02003755,2621,1966,544,1422,11,244,68,176,371,332,7,23,9,29
E02003756,1860,1459,423,1036,14,120,25,95,254,219,6,23,6,13
E02003757,1365,1100,319,781,9,77,22,55,167,137,3,22,5,12
E02003758,3852,2913,904,2009,21,240,56,184,626,456,92,27,51,52
E02003759,2611,2042,520,1522,25,141,29,112,387,352,9,24,2,16
E02003760,4386,2784,675,2109,49,662,188,474,869,804,16,33,16,22
E02003761,980,723,197,526,11,86,17,69,156,139,8,9,0,4
E02003762,7273,5020,1286,3734,66,522,139,383,1608,1415,65,79,49,57
E02003763,3777,2835,728,2107,40,278,80,198,608,552,7,45,4,16
E02003764,13165,9733,2234,7499,189,1115,252,863,2035,1783,107,103,42,93
E02003765,4320,3266,924,2342,43,331,87,244,648,578,21,36,13,32
E02003766,2452,1788,469,1319,22,212,40,172,414,386,3,22,3,16
E02003767,4201,2543,815,1728,25,239,64,175,1341,1248,39,25,29,53
E02003768,2550,1909,690,1219,17,226,71,155,375,341,5,19,10,23
E02003769,2142,1676,472,1204,12,136,30,106,303,271,9,16,7,15
E02003770,2148,1600,505,1095,36,189,59,130,294,262,15,16,1,29
E02003771,3493,2533,648,1885,33,380,89,291,527,477,9,38,3,20
E02003772,1283,1077,294,783,3,60,11,49,138,121,0,16,1,5
E02003773,3229,2354,593,1761,29,412,103,309,414,382,7,20,5,20
E02003774,3920,2600,676,1924,35,426,125,301,839,791,7,29,12,20
E02003775,1672,1331,481,850,20,148,80,68,160,127,6,24,3,13
E02003776,2187,1679,601,1078,25,229,127,102,234,204,5,13,12,20
E02003777,3047,2300,732,1568,38,247,131,116,436,389,17,26,4,26
E02003778,3515,2234,690,1544,43,468,241,227,726,426,165,25,110,44
E02003779,2965,2134,573,1561,48,296,140,156,469,435,2,26,6,18
E02003780,4717,3287,981,2306,85,519,247,272,784,714,9,52,9,42
E02003781,10590,7286,1899,5387,154,848,446,402,2241,2099,47,78,17,61
E02003783,2097,1453,507,946,33,211,118,93,363,323,14,15,11,37
E02003784,2415,1854,620,1234,52,216,120,96,258,234,7,11,6,35
E02003785,4576,3223,976,2247,77,524,293,231,711,655,20,30,6,41
E02003786,2099,1477,527,950,24,272,190,82,306,268,5,18,15,20
E02003787,2272,1680,591,1089,20,254,127,127,267,229,15,17,6,51
E02003788,2150,1600,568,1032,24,201,135,66,307,290,5,10,2,18
E02003789,3100,2093,653,1440,70,487,318,169,432,396,12,22,2,18
E02003790,3167,2220,750,1470,49,337,206,131,504,454,23,17,10,57
E02003791,8428,5828,1665,4163,106,697,404,293,1721,1573,63,59,26,76
E02003792,4404,3256,1033,2223,51,517,327,190,532,450,35,27,20,48
E02003793,3015,2015,625,1390,30,360,214,146,575,386,90,17,82,35
E02003794,3367,2534,748,1786,20,256,129,127,529,481,10,26,12,28
E02003795,4743,3694,1061,2633,16,294,164,130,700,527,98,28,47,39
E02003796,1503,1178,426,752,15,143,69,74,153,136,5,10,2,14
E02003797,7123,5532,1521,4011,55,506,251,255,993,883,24,57,29,37
E02003798,920,659,134,525,5,174,67,107,79,70,3,4,2,3
E02003799,984,676,176,500,4,191,67,124,106,85,6,14,1,7
E02003800,1690,1363,455,908,14,95,37,58,196,170,10,14,2,22
E02003801,988,789,264,525,0,75,35,40,115,110,1,4,0,9
E02003802,6910,4874,1301,3573,45,678,338,340,1253,1139,15,89,10,60
E02003803,22690,15836,4454,11382,183,2111,897,1214,4385,4051,40,237,57,175
E02003804,1385,1030,294,736,5,91,32,59,245,224,2,15,4,14
E02003805,1945,1572,498,1074,6,106,49,57,241,214,10,13,4,20
E02003806,1507,1218,392,826,18,72,26,46,182,164,5,11,2,17
E02003807,2642,2067,688,1379,10,183,75,108,364,334,6,23,1,18
E02003808,970,747,180,567,10,103,36,67,102,92,1,9,0,8
E02003809,8510,6459,1617,4842,75,431,180,251,1389,1266,40,72,11,156
E02003810,3546,2690,965,1725,37,196,93,103,576,490,22,59,5,47
E02003811,2454,2033,729,1304,10,130,50,80,241,219,6,12,4,40
E02003812,2498,2106,622,1484,6,99,32,67,272,249,2,20,1,15
E02003813,1516,1242,324,918,4,96,30,66,167,148,2,14,3,7
E02003814,3771,3118,784,2334,16,235,94,141,392,358,7,21,6,10
E02003815,2082,1647,491,1156,3,213,61,152,202,176,0,24,2,17
E02003816,5233,4146,1331,2815,10,399,114,285,631,554,15,55,7,47
E02003817,2428,2020,652,1368,3,150,42,108,241,219,4,14,4,14
E02003818,1210,1009,376,633,3,70,24,46,117,107,1,6,3,11
E02003819,2414,1999,619,1380,4,113,34,79,283,259,3,15,6,15
E02003820,2535,2076,594,1482,13,132,45,87,299,274,4,17,4,15
E02003821,1600,1255,409,846,7,117,32,85,208,185,0,17,6,13
E02003822,3108,2505,900,1605,9,189,58,131,364,306,9,33,16,41
E02003823,1997,1624,508,1116,2,176,76,100,178,167,0,9,2,17
E02003824,1239,1015,321,694,3,69,19,50,144,129,1,13,1,8
E02003825,796,669,127,542,1,36,16,20,86,79,1,5,1,4
E02003826,1165,903,260,643,1,133,58,75,119,102,4,9,4,9
E02003827,2045,1503,474,1029,7,211,76,135,317,295,4,15,3,7
E02003828,6421,5086,1124,3962,20,450,175,275,845,781,7,54,3,20
E02003829,10714,8098,2034,6064,40,720,250,470,1797,1651,6,128,12,59
E02003830,7362,5326,1436,3890,32,616,253,363,1353,1251,10,82,10,35
E02003831,4026,3142,916,2226,10,246,111,135,601,531,9,37,24,27
E02003832,1867,1387,382,1005,8,111,51,60,348,310,9,24,5,13
E02003833,1146,926,221,705,4,102,43,59,102,93,2,7,0,12
E02003834,3929,2984,760,2224,15,276,85,191,630,568,4,43,15,24
E02003835,1199,1060,346,714,2,39,16,23,87,76,1,8,2,11
E02003836,2910,2302,708,1594,16,188,62,126,382,350,5,21,6,22
E02003837,8403,6757,2057,4700,37,419,145,274,1111,967,39,89,16,79
E02003838,1292,1046,347,699,9,51,14,37,182,162,1,13,6,4
E02003839,3693,2850,849,2001,24,247,92,155,550,503,7,31,9,22
E02003840,4668,3265,1178,2087,27,372,141,231,934,840,35,46,13,70
E02003841,2753,2161,659,1502,9,282,169,113,282,243,4,30,5,19
E02003842,2278,1764,528,1236,8,157,91,66,329,297,9,18,5,20
E02003843,854,642,163,479,10,114,96,18,83,75,2,6,0,5
E02003844,912,756,253,503,0,65,42,23,86,74,0,12,0,5
E02003845,9307,7214,1708,5506,51,963,708,255,1030,939,12,76,3,49
E02003846,1246,908,248,660,6,198,184,14,126,104,0,18,4,8
E02003847,1328,1111,276,835,6,63,45,18,140,122,0,12,6,8
E02003848,1228,940,280,660,2,162,143,19,118,104,3,9,2,6
E02003849,9422,7269,1860,5409,52,1020,781,239,1041,957,4,68,12,40
E02003850,684,580,165,415,2,56,46,10,44,38,0,6,0,2
E02003851,2009,1623,408,1215,22,125,87,38,218,202,1,15,0,21
E02003852,978,870,238,632,6,40,30,10,60,52,3,4,1,2
E02003853,1645,1363,454,909,10,78,38,40,177,160,1,9,7,17
E02003854,1405,1214,410,804,1,67,22,45,116,101,1,13,1,7
E02003855,2291,1959,611,1348,7,96,35,61,214,194,8,10,2,15
E02003856,6236,4680,1288,3392,44,614,156,458,859,783,7,59,10,39
E02003857,1104,896,248,648,3,76,14,62,122,114,0,8,0,7
E02003858,8084,6151,1666,4485,51,428,108,320,1408,1295,16,93,4,46
E02003859,9620,7483,2067,5416,60,551,212,339,1412,1304,24,63,21,114
E02003860,1588,1348,417,931,2,61,11,50,159,137,9,11,2,18
E02003861,2497,1871,513,1358,12,257,63,194,336,300,7,26,3,21
E02003862,3589,2830,896,1934,20,190,83,107,509,470,5,28,6,40
E02003863,5339,4168,1206,2962,25,291,79,212,814,755,12,40,7,41
E02003864,8266,6787,1708,5079,33,270,66,204,1119,1043,15,56,5,57
E02003865,3206,2506,719,1787,14,159,47,112,512,469,6,20,17,15
E02003866,1621,1356,377,979,8,53,11,42,195,183,0,10,2,9
E02003867,1806,1493,436,1057,4,114,29,85,186,178,0,6,2,9
E02003868,4962,3841,935,2906,23,362,126,236,713,661,4,44,4,23
E02003869,5030,3953,1124,2829,30,351,117,234,665,603,5,53,4,31
E02003870,10537,8005,2169,5836,54,810,231,579,1607,1432,12,137,26,61
E02003871,1013,763,243,520,7,131,45,86,105,93,0,11,1,7
E02003872,3559,2731,1111,1620,21,219,61,158,527,447,15,43,22,61
E02003873,2292,1614,461,1153,22,269,83,186,368,338,2,22,6,19
E02003874,2604,2050,673,1377,21,221,65,156,287,242,4,26,15,25
E02003875,2486,2006,678,1328,23,182,80,102,248,206,7,18,17,27
E02003876,850,675,188,487,5,65,44,21,95,85,3,5,2,10
E02003877,2860,2295,764,1531,17,175,63,112,352,320,4,21,7,21
E02003878,9210,7010,1877,5133,85,733,352,381,1332,1206,12,95,19,50
E02003879,6948,5386,1507,3879,59,579,278,301,884,802,6,72,4,40
E02003880,1369,1109,353,756,9,125,68,57,111,102,2,7,0,15
E02003881,1589,1262,355,907,16,97,42,55,205,187,2,12,4,9
E02003882,1242,945,233,712,21,159,86,73,114,100,10,3,1,3
E02003883,3419,2922,833,2089,22,138,59,79,313,276,9,23,5,24
E02003884,2102,1699,585,1114,9,113,50,63,253,214,11,20,8,28
E02003885,1217,964,281,683,5,73,26,47,161,135,6,12,8,14
E02003886,4634,3422,822,2600,26,516,234,282,642,587,4,49,2,28
E02003887,3237,2781,553,2228,13,155,64,91,277,246,5,24,2,11
E02003888,4163,3184,827,2357,22,454,221,233,488,429,15,42,2,15
E02003889,996,755,232,523,6,142,59,83,82,72,3,7,0,11
E02003890,1873,1494,425,1069,9,158,46,112,201,178,3,14,6,11
E02003891,2597,1988,739,1249,35,142,48,94,402,343,19,27,13,30
E02003892,1517,1150,441,709,19,105,56,49,217,181,3,25,8,26
E02003893,1734,1340,579,761,14,96,66,30,262,220,5,31,6,22
E02003894,3984,2741,902,1839,56,333,184,149,801,722,7,62,10,53
E02003895,3938,2738,993,1745,25,405,257,148,729,635,15,72,7,41
E02003896,2988,2145,706,1439,24,306,213,93,489,423,2,59,5,24
E02003897,2711,2034,622,1412,31,159,101,58,468,409,10,45,4,19
E02003898,2015,1437,613,824,10,149,102,47,373,320,11,35,7,46
E02003899,966,739,226,513,16,92,67,25,115,96,3,14,2,4
E02003900,2328,1690,464,1226,28,204,123,81,388,343,9,26,10,18
E02003901,2397,1685,758,927,15,254,183,71,396,316,18,54,8,47
E02003902,1533,1090,315,775,7,150,84,66,273,228,12,20,13,13
E02003903,2596,1792,571,1221,19,223,129,94,530,383,83,35,29,32
E02003904,1918,1375,551,824,9,125,85,40,380,329,9,38,4,29
E02003905,2233,1563,587,976,28,186,110,76,431,377,11,36,7,25
E02003906,2020,1404,599,805,11,175,99,76,389,327,11,36,15,41
E02003907,2419,1713,661,1052,32,148,67,81,481,413,7,53,8,45
E02003908,2199,1587,488,1099,16,213,137,76,354,317,9,26,2,29
E02003909,10422,7710,2414,5296,96,683,345,338,1858,1660,31,153,14,75
E02003910,13174,9381,2902,6479,125,907,518,389,2639,2356,27,220,36,122
E02003911,2577,1846,743,1103,27,146,88,58,526,481,5,37,3,32
E02003912,2875,1871,807,1064,29,312,192,120,586,495,41,36,14,77
E02003913,1797,1353,569,784,13,120,75,45,290,239,10,33,8,21
E02003914,3140,2115,702,1413,41,321,202,119,637,571,7,48,11,26
E02003915,2499,1578,503,1075,22,303,230,73,565,508,3,47,7,31
E02003916,4206,2795,953,1842,37,321,209,112,1010,905,12,78,15,43
E02003917,2204,1702,585,1117,21,128,77,51,333,287,3,36,7,20
E02003918,1364,1043,393,650,15,61,21,40,227,184,11,25,7,18
E02003919,5313,3918,1285,2633,45,416,145,271,891,804,7,72,8,43
E02003920,2188,1636,549,1087,20,130,46,84,385,336,6,40,3,17
E02003921,1173,907,352,555,3,67,20,47,179,145,7,20,7,17
E02003922,6644,4786,1596,3190,65,527,171,356,1219,1093,12,103,11,47
E02003923,2220,1602,522,1080,9,158,45,113,431,381,8,38,4,20
E02003924,3083,2268,744,1524,23,217,71,146,544,470,8,56,10,31
E02003925,1013,751,277,474,6,100,34,66,144,130,2,12,0,12
E02003926,2095,1654,688,966,14,110,26,84,285,238,7,39,1,32
E02003927,4101,2867,1119,1748,30,264,153,111,896,779,19,73,25,44
E02003928,4474,3203,1078,2125,23,336,86,250,871,700,70,65,36,41
E02003929,1651,1232,540,692,13,121,24,97,262,222,17,21,2,23
E02003930,5835,4281,1552,2729,31,369,92,277,1073,684,221,71,97,81
E02003931,4250,2945,1165,1780,62,391,199,192,789,685,10,90,4,63
E02003932,2524,1919,956,963,16,138,71,67,378,323,13,39,3,73
E02003933,2178,1652,797,855,10,143,80,63,342,292,7,33,10,31
E02003934,2459,1788,833,955,12,175,98,77,434,367,9,49,9,50
E02003935,4341,3025,1028,1997,44,319,200,119,899,809,11,71,8,54
E02003936,4667,3299,1342,1957,41,258,158,100,1008,911,9,79,9,61
E02003937,3457,2331,1050,1281,25,367,226,141,659,561,30,60,8,75
E02003938,2781,1838,787,1051,18,322,216,106,564,466,39,48,11,39
E02003939,2501,1793,686,1107,20,252,168,84,414,351,10,48,5,22
E02003940,2181,1634,785,849,14,142,93,49,334,280,10,36,8,57
E02003941,7252,4895,1506,3389,73,686,424,262,1553,1375,34,134,10,45
E02003942,2337,1617,503,1114,22,308,211,97,369,322,5,35,7,21
E02003943,3650,2468,963,1505,38,364,59,305,726,627,19,71,9,54
E02003944,3688,2609,898,1711,50,360,76,284,629,534,15,68,12,40
E02003945,1900,1421,594,827,17,108,19,89,331,280,5,39,7,23
E02003946,2425,1648,702,946,24,169,35,134,523,454,10,49,10,61
E02003947,3264,2207,981,1226,33,315,42,273,648,573,14,52,9,61
E02003948,2691,1866,700,1166,22,325,41,284,438,377,16,41,4,40
E02003949,4858,3164,1143,2021,26,483,68,415,1111,975,21,98,17,74
E02003950,2104,1487,668,819,17,169,24,145,376,326,3,40,7,55
E02003951,1696,1202,502,700,5,158,33,125,302,273,2,20,7,29
E02003952,3045,2054,694,1360,23,170,48,122,758,567,95,58,38,40
E02003953,5031,3451,1153,2298,55,374,133,241,1077,935,17,106,19,74
E02003954,3310,2105,628,1477,36,184,46,138,946,817,31,79,19,39
E02003955,3082,2240,620,1620,32,162,35,127,625,521,27,66,11,23
E02003956,2685,1897,675,1222,36,202,73,129,518,461,9,38,10,32
E02003957,3335,2497,929,1568,19,228,81,147,553,485,10,47,11,38
E02003958,2093,1650,577,1073,25,96,23,73,306,267,7,27,5,16
E02003959,2031,1475,517,958,19,138,37,101,382,334,3,41,4,17
E02003960,2220,1601,574,1027,17,140,40,100,442,395,3,39,5,20
E02003961,4053,3044,978,2066,57,286,87,199,636,557,7,65,7,30
E02003962,3268,2525,793,1732,36,162,37,125,527,453,12,53,9,18
E02003963,5465,3952,1287,2665,82,435,129,306,953,845,13,89,6,43
E02003964,3191,2326,934,1392,28,180,64,116,594,494,25,61,14,63
E02003965,4717,3797,1524,2273,9,385,53,332,471,399,10,59,3,55
E02003966,2395,1906,993,913,13,101,23,78,320,245,20,44,11,55
E02003967,2413,1911,849,1062,17,205,26,179,235,197,5,29,4,45
E02003968,2312,1756,688,1068,7,300,41,259,219,196,2,20,1,30
E02003969,1454,985,343,642,1,274,31,243,178,160,3,11,4,16
E02003970,3796,2956,1143,1813,25,322,47,275,446,390,8,37,11,47
E02003971,2343,1766,704,1062,26,225,33,192,297,243,13,27,14,29
E02003972,6550,5093,1543,3550,17,831,154,677,564,499,8,46,11,45
E02003973,5691,4275,1398,2877,13,874,139,735,486,407,9,63,7,43
E02003974,1070,797,290,507,3,174,24,150,88,71,2,8,7,8
E02003975,3495,2705,916,1789,15,426,95,331,315,294,3,17,1,34
E02003976,3829,2497,1046,1451,42,562,112,450,637,509,38,51,39,91
E02003977,1532,1288,426,862,6,50,39,11,179,153,3,21,2,9
E02003978,1050,857,285,572,1,45,37,8,132,113,7,11,1,15
E02003979,3404,2956,888,2068,5,109,88,21,315,262,25,19,9,19
E02003980,6701,5381,1361,4020,6,417,325,92,839,746,11,74,8,58
E02003981,1572,1328,352,976,2,72,55,17,157,150,0,5,2,13
E02003982,1419,1192,368,824,4,81,67,14,135,125,0,8,2,7
E02003983,1034,801,211,590,1,75,57,18,133,109,4,18,2,24
E02003984,12549,10347,2718,7629,20,582,407,175,1531,1342,17,149,23,69
E02003985,833,674,202,472,2,47,36,11,103,89,1,12,1,7
E02003986,1117,928,274,654,0,35,28,7,145,126,1,17,1,9
E02003987,2719,2100,929,1171,6,172,30,142,388,343,14,26,5,53
E02003988,3111,2221,759,1462,12,248,59,189,587,398,93,35,61,43
E02003989,4611,3654,1102,2552,25,281,57,224,611,540,14,55,2,40
E02003990,5426,4239,1335,2904,29,328,50,278,793,702,7,73,11,37
E02003991,1778,1463,527,936,5,106,14,92,182,152,6,20,4,22
E02003992,14433,11030,3442,7588,68,998,159,839,2231,2030,25,152,24,106
E02003993,2875,2301,875,1426,13,122,30,92,389,332,18,32,7,50
E02003994,6137,4802,1393,3409,14,442,86,356,845,737,25,67,16,34
E02003995,1094,798,219,579,4,148,28,120,131,114,2,15,0,13
E02003996,7008,5127,1515,3612,17,636,136,500,1182,1077,11,84,10,46
E02003997,2267,1827,518,1309,9,182,47,135,231,206,2,23,0,18
E02003998,1055,797,249,548,4,120,28,92,120,111,1,8,0,14
E02003999,3868,3081,1065,2016,12,205,44,161,527,462,18,32,15,43
E02004000,1051,811,322,489,2,137,47,90,92,80,1,11,0,9
E02004001,5084,3970,1195,2775,7,627,264,363,441,367,14,52,8,39
E02004002,3572,2997,935,2062,3,259,96,163,297,232,22,25,18,16
E02004003,2234,1675,656,1019,7,304,103,201,218,182,5,26,5,30
E02004004,1343,951,300,651,2,259,126,133,118,93,1,20,4,13
E02004005,3338,2736,817,1919,4,285,111,174,293,256,3,30,4,20
E02004006,14685,12775,3506,9269,15,744,259,485,1065,965,15,71,14,86
E02004007,3138,2491,974,1517,7,221,55,166,378,329,9,36,4,41
E02004008,2247,1671,858,813,15,142,25,117,351,305,19,22,5,68
E02004009,3295,2369,1002,1367,33,213,72,141,588,533,17,34,4,92
E02004010,8537,6259,2126,4133,99,673,102,571,1404,1236,43,112,13,102
E02004011,3221,2395,886,1509,29,222,47,175,519,446,16,46,11,56
E02004012,2854,1839,862,977,21,216,29,187,682,553,61,46,22,96
E02004013,5024,3475,1530,1945,64,397,81,316,975,865,20,76,14,113
E02004014,3291,2387,1271,1116,17,161,26,135,630,547,15,55,13,96
E02004015,4908,2891,1126,1765,32,626,271,355,1248,1068,82,79,19,111
E02004016,3630,2425,919,1506,19,318,190,128,814,727,34,45,8,54
E02004017,7422,5653,2012,3641,35,567,378,189,1104,1020,7,68,9,63
E02004018,6017,4307,1463,2844,35,523,362,161,1078,981,8,77,12,74
E02004019,1923,1543,612,931,9,69,44,25,277,242,1,34,0,25
E02004020,3550,2851,983,1868,18,193,137,56,467,421,6,34,6,21
E02004021,2832,1954,876,1078,18,186,94,92,602,519,30,33,20,72
E02004022,2639,1893,873,1020,15,180,81,99,497,401,34,37,25,54
E02004023,3335,2389,1014,1375,35,170,111,59,635,523,44,65,3,106
E02004024,2892,2258,905,1353,25,109,66,43,445,390,8,44,3,55
E02004025,2966,2321,863,1458,15,171,133,38,420,354,26,30,10,39
E02004026,4490,3653,1200,2453,11,254,202,52,539,480,18,38,3,33
E02004027,2765,2080,950,1130,7,150,98,52,458,395,23,35,5,70
E02004028,1506,1253,476,777,9,81,50,31,140,129,3,3,5,23
E02004029,4409,3401,1088,2313,12,457,296,161,508,454,4,45,5,31
E02004030,1608,1310,533,777,6,108,56,52,168,131,6,25,6,16
E02004031,6538,4936,1456,3480,15,676,409,267,873,789,6,68,10,38
E02004032,4161,3161,971,2190,17,384,252,132,568,520,3,39,6,31
E02004033,5313,4418,1219,3199,15,279,149,130,574,512,8,48,6,27
E02004034,3055,2562,840,1722,5,179,85,94,293,264,0,23,6,16
E02004035,2122,1696,682,1014,5,106,64,42,300,264,6,14,16,15
E02004036,3778,2942,960,1982,19,324,178,146,471,434,3,31,3,22
E02004037,1508,1234,348,886,8,85,41,44,177,167,1,9,0,4
E02004038,5504,4269,1318,2951,23,387,202,185,790,703,11,58,18,35
E02004039,1588,1327,406,921,3,68,36,32,185,171,2,8,4,5
E02004040,3058,2409,697,1712,9,213,121,92,410,365,6,37,2,17
E02004041,2443,1981,605,1376,11,151,71,80,286,256,3,26,1,14
E02004043,3108,2500,832,1668,11,226,105,121,348,309,5,32,2,23
E02004044,2557,1985,655,1330,17,122,58,64,394,358,4,21,11,39
E02004045,5622,4269,1139,3130,12,549,475,74,753,670,4,72,7,39
E02004046,1008,769,239,530,1,97,84,13,133,117,3,7,6,8
E02004047,1339,964,303,661,2,138,106,32,223,190,10,19,4,12
E02004048,2364,1803,559,1244,5,234,201,33,307,268,5,30,4,15
E02004049,1286,1030,340,690,2,122,106,16,125,106,3,13,3,7
E02004050,1145,867,296,571,2,143,120,23,125,109,0,13,3,8
E02004051,4275,2679,764,1915,18,446,320,126,1090,1031,3,49,7,42
E02004052,2640,2098,632,1466,11,262,227,35,244,203,6,28,7,25
E02004053,1333,1057,339,718,0,107,84,23,155,141,0,12,2,14
E02004054,8277,6331,1788,4543,28,691,503,188,1181,1081,5,88,7,46
E02004055,5076,3811,1131,2680,15,666,585,81,562,503,3,52,4,22
E02004056,3213,2272,690,1582,4,614,556,58,310,285,1,24,0,13
E02004057,1488,1056,296,760,1,203,157,46,209,192,2,13,2,19
E02004058,5612,3945,1087,2858,16,784,683,101,834,772,8,43,11,33
E02004059,1603,1207,409,798,5,196,165,31,182,164,1,16,1,13
E02004060,1710,1233,359,874,5,287,240,47,178,157,0,20,1,7
E02004061,2974,2125,635,1490,9,427,374,53,396,344,7,40,5,17
E02004062,928,668,206,462,3,159,155,4,84,74,0,5,5,14
E02004063,2729,2114,660,1454,6,231,209,22,360,332,4,20,4,18
E02004064,16811,12482,3789,8693,48,1975,1710,265,2196,1963,12,172,49,110
E02004065,2035,1700,599,1101,5,161,140,21,156,140,0,9,7,13
E02004066,6742,5204,1535,3669,11,695,588,107,796,703,21,66,6,36
E02004067,760,500,158,342,2,186,180,6,65,58,1,5,1,7
E02004068,2582,1870,810,1060,27,231,97,134,413,348,5,55,5,41
E02004069,4347,3045,1267,1778,31,342,146,196,758,630,52,41,35,171
E02004070,2740,2061,963,1098,15,194,94,100,418,347,12,39,20,52
E02004071,2019,1545,627,918,6,166,81,85,277,233,21,17,6,25
E02004072,3910,3118,1179,1939,18,276,131,145,453,396,11,33,13,45
E02004073,7482,5962,2280,3682,22,562,318,244,868,730,26,91,21,68
E02004074,2049,1625,638,987,8,160,76,84,234,221,0,11,2,22
E02004075,4148,3180,1325,1855,40,261,129,132,584,527,7,38,12,83
E02004076,3778,2446,780,1666,50,506,247,259,732,688,3,33,8,44
E02004077,2870,2147,874,1273,18,142,66,76,472,415,20,26,11,91
E02004078,995,726,232,494,1,143,48,95,117,100,0,13,4,8
E02004080,6581,5192,1498,3694,25,515,261,254,796,731,5,55,5,53
E02004081,2258,1828,602,1226,11,131,64,67,272,255,1,14,2,16
E02004082,1784,1477,493,984,5,98,44,54,193,175,0,15,3,11
E02004083,4281,3383,1032,2351,15,355,172,183,512,469,3,36,4,16
E02004084,800,653,196,457,3,77,28,49,60,54,0,6,0,7
E02004085,4423,3540,998,2542,20,298,161,137,542,493,5,39,5,23
E02004086,1862,1508,435,1073,15,114,58,56,210,187,2,20,1,15
E02004087,1646,1187,353,834,8,175,84,91,265,249,1,15,0,11
E02004088,1875,1524,453,1071,12,84,41,43,215,194,5,16,0,40
E02004089,6271,4761,1300,3461,35,492,205,287,950,879,5,59,7,33
E02004090,1838,1415,433,982,14,120,60,60,275,246,4,18,7,14
E02004091,3650,2798,780,2018,10,234,131,103,590,548,7,33,2,18
E02004092,1795,1458,391,1067,10,109,42,67,205,185,2,14,4,13
E02004093,1644,1269,354,915,9,162,104,58,194,164,0,22,8,10
E02004094,2269,1653,437,1216,5,342,264,78,246,223,1,16,6,23
E02004095,4331,3287,859,2428,19,383,304,79,589,535,6,42,6,53
E02004096,2148,1754,508,1246,4,136,113,23,236,203,2,22,9,18
E02004097,3360,2710,927,1783,12,214,157,57,407,351,0,40,16,17
E02004098,1689,1294,440,854,17,158,115,43,199,174,4,19,2,21
E02004100,2786,2293,830,1463,18,161,124,37,290,250,2,30,8,24
E02004102,5379,3915,1348,2567,31,360,243,117,1002,887,13,94,8,71
E02004103,1828,1361,456,905,12,190,124,66,254,220,0,29,5,11
E02004104,3072,2494,811,1683,13,153,109,44,396,356,9,27,4,16
E02004105,2473,2004,596,1408,8,232,198,34,221,183,5,18,15,8
E02004106,1688,1351,465,886,0,147,117,30,177,159,2,13,3,13
E02004108,4240,3284,993,2291,10,540,424,116,383,335,6,34,8,23
E02004109,1344,1088,425,663,5,113,88,25,119,102,2,11,4,19
E02004110,2512,1783,546,1237,6,363,299,64,337,316,0,14,7,23
E02004111,1381,1009,362,647,2,174,140,34,185,169,0,13,3,11
E02004112,1616,1327,534,793,5,103,89,14,169,147,4,10,8,12
E02004113,3554,2522,826,1696,10,619,552,67,383,347,1,26,9,20
E02004114,2171,1761,738,1023,2,182,151,31,201,171,4,24,2,25
E02004115,1658,1316,383,933,8,164,153,11,162,139,1,20,2,8
E02004116,4003,2859,930,1929,20,667,612,55,433,390,5,31,7,24
E02004117,1682,1267,527,740,2,208,172,36,184,158,11,10,5,21
E02004118,6963,5224,1137,4087,40,454,269,185,1190,1094,23,56,17,55
E02004119,2825,2255,606,1649,9,142,86,56,405,361,8,32,4,14
E02004120,1468,1154,377,777,9,99,55,44,190,172,2,16,0,16
E02004121,2123,1734,552,1182,4,116,82,34,252,228,7,17,0,17
E02004122,2938,2185,712,1473,13,179,102,77,480,374,64,34,8,81
E02004123,2182,1654,617,1037,11,141,88,53,340,309,17,10,4,36
E02004124,761,593,198,395,1,92,71,21,74,67,1,5,1,1
E02004125,1367,1094,321,773,6,111,83,28,148,124,5,17,2,8
E02004126,6541,5029,1407,3622,32,534,339,195,907,840,6,57,4,39
E02004128,2932,2333,717,1616,16,229,149,80,324,285,6,30,3,30
E02004129,2165,1643,803,840,17,141,80,61,317,267,10,39,1,47
E02004130,2850,2045,721,1324,12,253,177,76,507,465,2,32,8,33
E02004131,1907,1376,406,970,9,184,106,78,324,300,1,21,2,14
E02004132,2724,2046,846,1200,19,169,122,47,435,376,19,35,5,55
E02004133,3757,2719,1057,1662,23,427,265,162,548,468,16,61,3,40
E02004134,6569,4691,1379,3312,58,529,292,237,1225,1093,24,87,21,66
E02004135,2319,1698,819,879,13,227,140,87,331,274,12,34,11,50
E02004136,2336,1755,686,1069,24,164,133,31,366,308,11,39,8,27
E02004137,1969,1452,679,773,14,149,96,53,314,266,15,25,8,40
E02004138,2031,1381,587,794,10,198,105,93,422,380,11,27,4,20
E02004139,1386,1031,394,637,12,152,98,54,177,157,1,16,3,14
E02004140,3324,2364,957,1407,36,288,214,74,590,522,20,38,10,46
E02004141,2241,1530,557,973,16,192,128,64,462,405,28,25,4,41
E02004142,5625,4041,1093,2948,57,330,192,138,1159,911,98,79,71,38
E02004143,1018,797,240,557,7,62,34,28,148,137,0,9,2,4
E02004144,1205,914,284,630,4,74,31,43,198,169,9,14,6,15
E02004145,1507,1085,419,666,9,117,74,43,266,236,6,18,6,30
E02004146,2169,1510,421,1089,16,269,157,112,361,322,9,22,8,13
E02004147,3739,2500,748,1752,24,267,159,108,898,810,20,61,7,50
E02004148,2066,1329,434,895,9,255,172,83,452,413,9,25,5,21
E02004149,4440,2825,979,1846,32,208,103,105,1340,1271,8,56,5,35
E02004150,1003,649,205,444,6,144,107,37,198,180,4,10,4,6
E02004151,2666,1942,508,1434,25,330,195,135,358,321,5,22,10,11
E02004152,3055,1896,545,1351,30,237,122,115,867,805,5,46,11,25
E02004153,899,616,173,443,10,132,30,102,138,121,3,10,4,3
E02004154,1685,1102,326,776,19,204,121,83,348,324,3,20,1,12
E02004155,1491,1032,306,726,9,258,189,69,179,162,5,10,2,13
E02004156,19433,12744,3580,9164,212,1566,816,750,4757,4415,57,255,30,154
E02004157,4870,3684,1188,2496,32,256,165,91,858,788,7,52,11,40
E02004158,2508,1667,503,1164,28,288,133,155,505,453,6,39,7,20
E02004159,20249,14980,3768,11212,186,1233,715,518,3757,3481,24,232,20,93
E02004160,1264,946,285,661,4,106,55,51,199,174,10,15,0,9
E02004161,7642,5434,1467,3967,79,654,466,188,1442,1288,44,76,34,33
E02004162,9584,6625,1912,4713,103,942,516,426,1852,1681,16,142,13,62
E02004163,1782,1263,450,813,11,190,130,60,300,276,5,19,0,18
E02004164,2266,1723,810,913,11,108,72,36,372,328,12,29,3,52
E02004165,1432,1007,357,650,17,78,33,45,305,274,6,17,8,25
E02004166,1951,1444,562,882,30,153,76,77,276,236,13,24,3,48
E02004167,3990,2667,802,1865,72,439,321,118,740,664,15,61,0,72
E02004168,4122,2777,922,1855,48,419,283,136,825,711,41,54,19,53
E02004169,3008,1921,709,1212,38,257,172,85,756,711,14,26,5,36
E02004170,3155,2279,684,1595,35,288,162,126,524,477,10,31,6,29
E02004171,2368,1713,710,1003,8,202,114,88,393,345,14,22,12,52
E02004172,1995,1528,716,812,18,105,63,42,302,257,13,30,2,42
E02004173,2312,1719,748,971,12,140,90,50,393,318,39,30,6,48
E02004174,3660,2634,857,1777,45,335,210,125,623,575,12,34,2,23
E02004175,1967,1311,417,894,6,104,28,76,526,472,10,37,7,20
E02004176,1842,1360,595,765,4,87,20,67,349,293,19,32,5,42
E02004177,2499,1733,547,1186,31,133,31,102,578,530,4,38,6,24
E02004178,2339,1665,653,1012,13,91,18,73,513,409,54,38,12,57
E02004179,3988,2794,949,1845,31,251,60,191,873,560,136,59,118,39
E02004180,1867,1434,638,796,16,102,30,72,277,223,19,29,6,38
E02004181,5771,4242,1296,2946,51,317,82,235,1114,964,54,75,21,47
E02004182,6498,4597,1373,3224,53,481,149,332,1314,1176,25,86,27,53
E02004183,3338,2447,800,1647,26,225,61,164,620,556,10,49,5,20
E02004184,3922,2793,750,2043,39,310,90,220,759,684,8,59,8,21
E02004185,1545,1159,405,754,15,94,29,65,261,224,7,17,13,16
E02004186,3453,2541,840,1701,43,203,49,154,639,560,9,63,7,27
E02004187,5503,3926,1502,2424,67,312,107,205,1091,952,38,90,11,107
E02004188,2289,1794,908,886,16,95,38,57,320,263,19,37,1,64
E02004189,8612,6107,1509,4598,78,762,325,437,1604,1395,47,123,39,61
E02004190,3044,2196,862,1334,37,216,47,169,554,477,23,37,17,41
E02004191,5646,3936,1420,2516,85,463,68,395,1122,1029,14,73,6,40
E02004192,2337,1768,816,952,16,114,27,87,380,322,9,39,10,59
E02004193,3520,2761,787,1974,43,202,30,172,484,436,12,31,5,30
E02004194,2833,2034,843,1191,42,190,24,166,527,459,13,50,5,40
E02004195,3008,1953,699,1254,36,370,72,298,621,512,45,36,28,28
E02004196,4706,3358,1178,2180,48,413,115,298,822,723,24,56,19,65
E02004197,1764,1298,502,796,21,131,42,89,303,256,22,18,7,11
E02004198,3421,2271,844,1427,57,391,88,303,669,590,18,57,4,33
E02004199,1571,1157,560,597,14,126,21,105,251,224,7,14,6,23
E02004200,2318,1580,684,896,43,197,39,158,464,393,11,56,4,34
E02004201,1743,1308,596,712,12,84,36,48,319,288,17,12,2,20
E02004202,2819,1993,643,1350,29,226,104,122,524,464,15,37,8,47
E02004203,2094,1533,695,838,14,123,29,94,390,315,24,44,7,34
E02004204,2568,1974,605,1369,23,166,47,119,386,335,11,28,12,19
E02004205,1931,1396,445,951,20,114,35,79,383,351,8,23,1,18
E02004206,2092,1416,490,926,33,129,31,98,486,448,12,25,1,28
E02004207,4961,3542,1038,2504,59,390,121,269,927,846,3,76,2,43
E02004208,1352,1077,353,724,4,53,11,42,206,182,2,20,2,12
E02004209,2631,2012,626,1386,35,155,29,126,409,377,4,24,4,20
E02004210,2867,2011,646,1365,27,193,46,147,614,540,11,54,9,22
E02004211,1734,1340,515,825,14,91,34,57,266,236,6,22,2,23
E02004212,1267,967,260,707,15,69,15,54,205,189,0,14,2,11
E02004213,2289,1800,572,1228,16,83,30,53,374,344,5,19,6,16
E02004214,8132,5785,1643,4142,105,571,167,404,1613,1431,16,154,12,58
E02004215,2831,2048,578,1470,22,214,46,168,531,471,7,45,8,16
E02004216,1682,1295,390,905,24,118,34,84,237,211,5,17,4,8
E02004217,3650,2592,868,1724,38,325,76,249,661,582,22,48,9,34
E02004218,1295,1021,355,666,17,70,16,54,172,141,11,19,1,15
E02004219,1784,1421,547,874,20,88,26,62,242,207,7,25,3,13
E02004220,1387,1033,396,637,16,90,17,73,224,200,1,23,0,24
E02004221,1537,1136,475,661,19,75,20,55,295,259,12,19,5,12
E02004222,3446,2512,834,1678,37,232,46,186,619,550,7,56,6,46
E02004223,4671,3329,1052,2277,65,394,96,298,848,767,15,58,8,35
E02004224,2218,1562,686,876,22,106,33,73,455,369,29,48,9,73
E02004225,2182,1640,583,1057,9,147,35,112,371,331,1,36,3,15
E02004226,2506,1882,907,975,28,120,40,80,403,344,18,37,4,73
E02004227,4204,3292,1514,1778,32,214,53,161,585,498,23,61,3,81
E02004228,2375,1880,903,977,12,82,27,55,343,300,9,32,2,58
E02004229,3729,2817,1289,1528,30,228,61,167,601,515,19,63,4,53
E02004230,3250,2394,877,1517,26,236,66,170,558,501,9,45,3,36
E02004231,2812,2024,893,1131,24,171,64,107,533,457,15,43,18,60
E02004232,2704,2002,918,1084,10,141,62,79,490,431,24,32,3,61
E02004233,5601,4131,1443,2688,58,436,131,305,904,820,15,62,7,72
E02004234,1394,1053,482,571,10,124,43,81,187,160,4,21,2,20
E02004235,1762,1321,507,814,10,148,48,100,260,219,15,20,6,23
E02004236,4545,3361,980,2381,38,271,87,184,845,767,8,63,7,30
E02004237,1811,1376,397,979,21,134,22,112,260,246,1,13,0,20
E02004238,1759,1331,481,850,12,99,34,65,300,275,5,17,3,17
E02004239,2638,2033,674,1359,23,164,43,121,389,367,2,16,4,29
E02004240,2826,1807,501,1306,47,441,75,366,516,475,4,33,4,15
E02004241,5775,4032,1210,2822,71,480,84,396,1153,1072,20,53,8,39
E02004242,1274,941,371,570,12,90,10,80,220,208,2,9,1,11
E02004243,2059,1390,467,923,3,196,58,138,391,321,32,22,16,79
E02004244,2607,1997,539,1458,6,195,54,141,391,355,1,29,6,18
E02004245,2793,2137,639,1498,6,228,67,161,401,361,5,22,13,21
E02004246,1963,1587,582,1005,7,102,22,80,244,218,4,19,3,23
E02004247,2692,1889,720,1169,14,197,27,170,491,418,35,21,17,101
E02004248,1749,1353,478,875,8,144,13,131,228,183,21,14,10,16
E02004249,1585,1348,453,895,6,74,12,62,148,133,4,6,5,9
E02004250,3153,2373,802,1571,22,251,52,199,482,418,12,37,15,25
E02004251,6396,4766,1346,3420,48,455,167,288,1095,1021,15,53,6,32
E02004252,4480,3332,1054,2278,19,375,70,305,701,627,15,45,14,53
E02004253,2385,1914,593,1321,15,132,45,87,304,274,9,13,8,20
E02004254,1995,1604,500,1104,11,113,18,95,247,210,7,24,6,20
E02004255,3706,2553,789,1764,42,378,71,307,705,637,14,46,8,28
E02004256,2607,1926,750,1176,25,187,35,152,405,350,28,24,3,64
E02004257,3839,2669,822,1847,34,415,60,355,679,604,19,46,10,42
E02004258,4212,2955,1076,1879,47,465,52,413,695,600,47,37,11,50
E02004259,2541,1809,674,1135,21,257,35,222,374,294,33,33,14,80
E02004260,5244,3227,1059,2168,34,493,62,431,1348,735,382,40,191,142
E02004261,4543,3162,952,2210,48,570,63,507,709,607,42,39,21,54
E02004262,2660,1807,760,1047,19,261,31,230,486,350,73,19,44,87
E02004263,1321,941,338,603,6,122,41,81,211,180,16,8,7,41
E02004264,1706,1269,332,937,24,94,26,68,292,253,13,22,4,27
E02004265,5388,3718,1236,2482,53,556,161,395,1016,887,56,60,13,45
E02004266,5894,3984,1229,2755,68,508,114,394,1238,750,303,49,136,96
E02004267,2192,1425,599,826,28,190,42,148,471,402,33,18,18,78
E02004268,3389,2305,941,1364,32,345,60,285,657,588,8,52,9,50
E02004269,5005,3311,1201,2110,54,576,93,483,918,812,46,50,10,146
E02004270,2774,1749,714,1035,23,281,53,228,646,571,34,28,13,75
E02004271,3312,2262,1011,1251,26,303,26,277,605,502,58,41,4,116
E02004272,4232,2879,1135,1744,41,367,38,329,801,666,63,54,18,144
E02004273,2914,2030,935,1095,42,301,34,267,490,424,14,38,14,51
E02004274,2812,1943,738,1205,18,351,25,326,464,413,8,37,6,36
E02004275,2379,1643,838,805,29,208,25,183,430,336,35,44,15,69
E02004276,3084,2025,876,1149,33,420,36,384,569,507,16,38,8,37
E02004277,14807,10660,3266,7394,189,1354,149,1205,2452,2234,45,155,18,152
E02004278,2097,1515,557,958,23,237,26,211,298,261,7,23,7,24
E02004279,2296,1571,594,977,24,212,33,179,399,330,34,24,11,90
E02004280,5996,4353,1360,2993,43,429,112,317,1102,982,33,77,10,69
E02004281,914,619,203,416,5,138,58,80,133,116,3,12,2,19
E02004282,2028,1432,508,924,14,170,62,108,380,342,7,26,5,32
E02004283,2474,1761,523,1238,16,254,82,172,415,373,9,31,2,28
E02004284,7413,4720,1485,3235,63,812,304,508,1741,1562,34,113,32,77
E02004285,2072,1465,420,1045,12,221,72,149,362,335,4,20,3,12
E02004286,702,514,165,349,6,73,27,46,103,94,2,6,1,6
E02004287,1092,797,248,549,5,97,34,63,184,165,4,14,1,9
E02004288,2350,1685,485,1200,17,219,81,138,417,360,6,39,12,12
E02004289,1842,1352,396,956,12,161,57,104,306,269,2,20,15,11
E02004290,988,793,228,565,0,84,46,38,103,89,1,13,0,8
E02004291,1109,865,204,661,4,114,71,43,117,113,0,3,1,9
E02004292,3821,2980,755,2225,15,452,245,207,357,320,6,27,4,17
E02004293,3300,2440,633,1807,11,498,228,270,329,291,1,35,2,22
E02004294,2449,2006,554,1452,4,187,86,101,235,204,5,24,2,17
E02004295,1549,1209,322,887,3,174,75,99,148,133,0,11,4,15
E02004296,1714,1291,357,934,4,228,136,92,173,146,2,20,5,18
E02004297,2726,2106,539,1567,5,278,188,90,319,282,5,30,2,18
E02004298,2243,1804,510,1294,2,183,97,86,246,218,3,23,2,8
E02004299,3969,3072,815,2257,10,419,249,170,448,405,0,38,5,20
E02004300,1286,1018,302,716,1,123,69,54,137,129,0,7,1,7
E02004301,1211,883,241,642,2,178,92,86,137,126,2,8,1,11
E02004302,2971,2362,654,1708,5,274,161,113,315,286,1,24,4,15
E02004303,6543,5047,1327,3720,8,653,343,310,797,718,8,63,8,38
E02004304,2658,2057,522,1535,3,224,116,108,351,318,2,28,3,23
E02004305,2417,1684,466,1218,3,252,129,123,460,435,4,19,2,18
E02004306,2329,1679,577,1102,5,221,91,130,387,346,19,17,5,37
E02004307,1662,1283,360,923,7,184,105,79,171,148,1,20,2,17
E02004308,3876,3237,814,2423,6,245,150,95,366,308,6,45,7,22
E02004309,3918,3154,755,2399,8,329,228,101,406,363,1,39,3,21
E02004310,1984,1608,449,1159,5,172,135,37,180,153,1,23,3,19
E02004311,1641,1290,396,894,5,182,142,40,144,117,2,23,2,20
E02004312,3914,3080,847,2233,12,326,204,122,467,410,8,41,8,29
E02004313,3801,2653,718,1935,7,669,434,235,455,416,7,28,4,17
E02004314,12224,8685,2450,6235,27,979,645,334,2388,2201,32,124,31,145
E02004315,14700,12252,3222,9030,33,964,633,331,1368,1228,5,123,12,83
E02004316,1070,804,225,579,3,131,113,18,124,106,0,15,3,8
E02004317,1265,912,272,640,2,194,166,28,146,129,1,16,0,11
E02004318,2710,2175,599,1576,2,287,214,73,227,208,3,15,1,19
E02004319,1324,1029,328,701,0,149,127,22,134,113,1,17,3,12
E02004320,2754,2086,567,1519,11,277,219,58,361,332,8,20,1,19
E02004321,4123,3098,804,2294,7,445,342,103,544,507,2,31,4,29
E02004322,1001,710,181,529,2,199,168,31,85,74,3,7,1,5
E02004323,1924,1531,398,1133,3,193,141,52,188,172,4,11,1,9
E02004324,2342,1842,474,1368,3,246,176,70,234,213,1,18,2,17
E02004325,2811,2060,554,1506,6,423,334,89,318,289,9,15,5,4
E02004326,9105,7106,1624,5482,18,917,651,266,1013,895,5,107,6,51
E02004327,1216,918,267,651,4,161,104,57,127,117,1,9,0,6
E02004328,1563,1292,290,1002,5,128,106,22,132,115,2,14,1,6
E02004329,2626,2070,497,1573,5,274,228,46,266,238,0,27,1,11
E02004330,987,772,239,533,2,110,74,36,95,85,0,6,4,8
E02004331,1200,921,274,647,2,170,143,27,93,85,3,3,2,14
E02004332,1395,1107,357,750,7,120,93,27,140,119,7,12,2,21
E02004333,1481,1191,367,824,5,131,76,55,143,127,2,12,2,11
E02004334,1257,983,271,712,1,134,99,35,134,118,3,13,0,5
E02004335,4251,3363,895,2468,6,476,289,187,388,346,5,33,4,18
E02004336,1507,1161,341,820,2,167,130,37,162,147,1,9,5,15
E02004337,2281,1751,513,1238,4,225,137,88,271,248,2,17,4,30
E02004338,1953,1505,441,1064,4,206,139,67,223,201,7,15,0,15
E02004339,2841,2255,706,1549,7,231,167,64,321,270,14,34,3,27
E02004340,2901,2158,583,1575,5,352,242,110,367,316,6,40,5,19
E02004341,1115,930,235,695,3,73,45,28,103,91,2,6,4,6
E02004342,678,435,102,333,1,151,111,40,87,86,0,1,0,4
E02004343,1424,1121,259,862,4,159,118,41,133,126,0,5,2,7
E02004344,10090,7648,1885,5763,27,1180,823,357,1191,1082,10,87,12,44
E02004345,3560,2639,1113,1526,13,263,124,139,566,503,14,31,18,79
E02004346,1862,1227,646,581,12,74,23,51,466,414,14,31,7,83
E02004347,4949,3743,1267,2476,17,390,105,285,726,659,4,56,7,73
E02004348,2961,2355,937,1418,8,201,123,78,320,268,12,34,6,77
E02004349,1557,1228,403,825,2,177,91,86,134,122,1,11,0,16
E02004350,3295,2616,798,1818,6,294,212,82,346,301,9,34,2,33
E02004351,1254,939,278,661,0,160,114,46,147,137,1,8,1,8
E02004352,6302,4773,1357,3416,5,703,499,204,784,717,8,52,7,37
E02004353,2821,2303,629,1674,2,205,135,70,297,260,2,34,1,14
E02004354,2630,2057,615,1442,7,217,169,48,333,295,2,34,2,16
E02004355,2105,1684,459,1225,5,202,140,62,197,181,2,12,2,17
E02004356,1625,1020,238,782,24,303,204,99,268,240,1,27,0,10
E02004357,752,518,138,380,12,136,68,68,81,76,0,5,0,5
E02004358,873,614,164,450,5,121,80,41,125,116,0,8,1,8
E02004359,4939,3299,953,2346,35,490,283,207,1090,1018,6,62,4,25
E02004361,1593,1207,388,819,6,155,120,35,212,188,9,14,1,13
E02004362,2383,1572,412,1160,18,186,117,69,595,541,8,42,4,12
E02004363,5750,3901,1131,2770,44,421,250,171,1353,1195,78,45,35,31
E02004364,2180,1528,415,1113,10,155,92,63,469,436,4,25,4,18
E02004365,4680,2699,778,1921,19,449,249,200,1481,1395,17,63,6,32
E02004366,10271,6918,1896,5022,70,621,368,253,2567,2361,73,116,17,95
E02004367,2266,1557,545,1012,10,118,70,48,544,504,9,28,3,37
E02004368,3666,2672,736,1936,20,260,46,214,690,647,7,29,7,24
E02004369,4837,3518,1083,2435,36,298,49,249,958,877,15,53,13,27
E02004370,4620,3076,865,2211,21,460,67,393,1034,949,13,66,6,29
E02004371,1412,940,248,692,9,123,21,102,322,294,4,19,5,18
E02004372,1125,701,197,504,7,135,13,122,270,247,3,19,1,12
E02004373,3053,2019,542,1477,16,251,36,215,743,685,7,49,2,24
E02004374,2157,1426,475,951,11,121,17,104,578,532,6,24,16,21
E02004375,2853,1924,535,1389,15,138,22,116,756,705,4,37,10,20
E02004376,7060,4342,1241,3101,48,502,76,426,2119,1969,19,123,8,49
E02004377,3151,2134,592,1542,18,228,34,194,752,689,22,28,13,19
E02004378,2773,1547,507,1040,12,183,24,159,994,923,16,40,15,37
E02004379,2648,1974,638,1336,28,227,141,86,380,316,21,29,14,39
E02004380,3852,2732,966,1766,36,268,122,146,729,645,26,46,12,87
E02004381,8800,6258,1635,4623,98,742,560,182,1625,1479,18,110,18,77
E02004382,3029,2078,671,1407,31,221,136,85,617,565,8,32,12,82
E02004383,5098,3878,1281,2597,44,298,223,75,857,785,3,62,7,21
E02004384,1350,1084,278,806,8,51,32,19,198,176,0,15,7,9
E02004385,2273,1719,467,1252,20,124,89,35,389,344,2,42,1,21
E02004386,4056,2851,827,2024,18,403,273,130,757,688,9,55,5,27
E02004387,1747,1181,327,854,11,204,148,56,342,316,3,22,1,9
E02004388,1066,782,223,559,13,82,45,37,186,160,7,13,6,3
E02004389,1657,1274,388,886,11,92,62,30,263,248,2,13,0,17
E02004390,1473,1177,373,804,8,105,70,35,171,161,1,9,0,12
E02004391,2858,2048,665,1383,17,207,128,79,564,520,8,30,6,22
E02004392,3313,2494,808,1686,28,293,63,230,444,398,13,31,2,54
E02004393,2059,1455,597,858,13,224,54,170,322,268,31,14,9,45
E02004394,2845,2167,827,1340,15,178,50,128,426,372,19,28,7,59
E02004395,3409,2323,885,1438,21,339,99,240,672,553,56,52,11,54
E02004396,2522,1903,760,1143,10,145,30,115,433,395,6,23,9,31
E02004397,3715,2706,880,1826,32,254,79,175,669,590,19,51,9,54
E02004398,1708,1175,340,835,13,188,41,147,320,287,6,25,2,12
E02004399,3088,2139,584,1555,21,245,46,199,668,633,3,30,2,15
E02004400,2156,1707,581,1126,17,97,21,76,318,296,8,12,2,17
E02004401,2323,1593,539,1054,10,135,25,110,566,525,0,36,5,19
E02004402,4833,3174,1016,2158,32,259,63,196,1313,1242,11,53,7,55
E02004403,2850,2090,686,1404,24,173,91,82,460,414,20,25,1,103
E02004404,2865,2162,726,1436,23,183,70,113,434,385,17,22,10,63
E02004405,1864,1476,451,1025,34,115,50,65,231,214,2,12,3,8
E02004406,3143,2336,740,1596,41,239,107,132,488,448,7,27,6,39
E02004407,2715,2071,755,1316,15,187,75,112,374,328,13,28,5,68
E02004408,2379,1798,464,1334,27,234,137,97,305,277,1,26,1,15
E02004409,2233,1672,615,1057,19,149,69,80,327,284,18,17,8,66
E02004410,3027,2362,840,1522,26,185,98,87,408,358,11,27,12,46
E02004411,5040,3756,1005,2751,62,398,202,196,790,732,7,47,4,34
E02004412,2786,2127,652,1475,13,181,108,73,444,388,7,39,10,21
E02004413,2552,1997,684,1313,15,128,61,67,369,329,8,21,11,43
E02004414,1715,1346,366,980,13,106,48,58,228,210,4,10,4,22
E02004415,2665,1992,686,1306,29,190,95,95,410,364,8,26,12,44
E02004416,2119,1664,660,1004,17,106,54,52,300,244,15,30,11,32
E02004417,3429,2567,696,1871,39,284,153,131,514,465,3,41,5,25
E02004418,2625,1903,507,1396,30,241,107,134,432,392,8,27,5,19
E02004419,1215,815,237,578,18,193,137,56,167,144,2,20,1,22
E02004420,4052,3036,1003,2033,32,163,85,78,732,631,34,58,9,89
E02004421,2053,1533,479,1054,22,130,73,57,346,311,7,24,4,22
E02004422,2508,1903,549,1354,10,131,66,65,429,400,10,19,0,35
E02004423,1465,1171,362,809,4,54,35,19,220,187,12,20,1,16
E02004424,1265,1108,341,767,7,41,24,17,102,95,1,6,0,7
E02004425,2066,1658,462,1196,5,179,108,71,211,191,3,12,5,13
E02004426,3758,2966,826,2140,18,295,161,134,464,430,4,29,1,15
E02004427,3173,2598,785,1813,21,204,131,73,321,287,4,28,2,29
E02004428,1426,1109,303,806,6,123,83,40,181,161,6,12,2,7
E02004429,1852,1628,486,1142,7,88,52,36,121,114,2,5,0,8
E02004430,3945,3220,833,2387,25,291,157,134,399,364,5,24,6,10
E02004431,2200,1769,428,1341,21,159,80,79,238,223,2,13,0,13
E02004432,1856,1505,498,1007,14,158,110,48,167,145,6,14,2,12
E02004433,2805,2120,473,1647,21,300,146,154,348,314,3,30,1,16
E02004434,6357,4436,1107,3329,108,881,576,305,901,835,10,52,4,31
E02004435,9003,6831,1862,4969,76,1022,662,360,1028,942,6,75,5,46
E02004436,1124,690,166,524,12,279,208,71,138,123,2,12,1,5
E02004437,8760,6779,1622,5157,74,784,491,293,1093,1029,7,53,4,30
E02004438,15576,10751,2660,8091,202,2517,1544,973,2034,1879,24,119,12,72
E02004439,1380,797,186,611,11,395,184,211,170,157,1,11,1,7
E02004440,1329,931,231,700,15,229,164,65,152,139,0,13,0,2
E02004441,2266,1499,410,1089,15,449,301,148,285,270,1,13,1,18
E02004442,1143,654,137,517,12,332,128,204,132,118,0,10,4,13
E02004443,7459,5393,1396,3997,62,857,538,319,1123,1013,35,59,16,24
E02004444,1779,1361,356,1005,9,214,131,83,185,172,5,4,4,10
E02004445,2214,1508,352,1156,12,392,253,139,291,270,2,18,1,11
E02004446,1994,1518,491,1027,6,195,65,130,240,201,14,16,9,35
E02004447,1787,1332,535,797,14,101,29,72,301,254,13,27,7,39
E02004448,2043,1457,491,966,19,234,68,166,315,295,8,9,3,18
E02004449,2750,1911,564,1347,22,386,120,266,413,374,7,27,5,18
E02004450,2678,2018,627,1391,17,198,65,133,393,309,46,19,19,52
E02004451,3801,2841,866,1975,16,347,119,228,562,511,11,34,6,35
E02004452,2481,1897,528,1369,15,232,63,169,319,291,8,16,4,18
E02004453,4352,3052,832,2220,35,601,163,438,646,591,8,44,3,18
E02004454,6082,4319,1139,3180,53,596,149,447,1065,973,19,61,12,49
E02004455,2499,1898,502,1396,26,214,57,157,346,320,10,12,4,15
E02004456,3394,2298,540,1758,20,505,132,373,552,493,11,44,4,19
E02004457,2752,1873,493,1380,23,450,113,337,381,344,15,14,8,25
E02004458,2260,1800,465,1335,25,167,29,138,260,224,14,18,4,8
E02004459,3794,2917,855,2062,17,282,96,186,535,476,12,40,7,43
E02004460,1948,1474,380,1094,11,226,60,166,224,194,6,23,1,13
E02004461,710,481,79,402,3,124,35,89,99,87,0,10,2,3
E02004462,9798,6861,1822,5039,63,1172,369,803,1641,1531,15,74,21,61
E02004463,2398,1703,518,1185,18,244,72,172,382,346,17,16,3,51
E02004464,2431,1993,692,1301,16,202,129,73,192,162,10,15,5,28
E02004465,2085,1593,542,1051,12,175,128,47,267,239,2,15,11,38
E02004466,1981,1468,408,1060,11,266,206,60,221,203,2,13,3,15
E02004467,1529,1107,319,788,13,219,159,60,178,159,4,12,3,12
E02004468,4196,3392,1075,2317,23,274,181,93,479,423,16,27,13,28
E02004469,3480,2735,775,1960,31,251,179,72,434,379,27,24,4,29
E02004470,9082,6757,1883,4874,86,869,570,299,1304,1190,39,61,14,66
E02004471,6768,5140,1367,3773,43,665,463,202,892,831,14,42,5,28
E02004472,2225,1698,536,1162,9,209,140,69,284,257,6,18,3,25
E02004473,1256,1094,358,736,3,35,21,14,123,114,0,8,1,1
E02004474,4747,3842,1163,2679,22,258,143,115,601,544,1,51,5,24
E02004475,1721,1480,416,1064,3,64,39,25,164,144,2,15,3,10
E02004476,2075,1771,525,1246,11,57,33,24,222,197,1,21,3,14
E02004477,1241,1059,313,746,4,40,24,16,134,123,2,9,0,4
E02004478,2793,2187,658,1529,10,169,111,58,415,381,5,27,2,12
E02004479,1865,1508,421,1087,9,119,94,25,215,194,1,17,3,14
E02004480,1223,1069,277,792,3,52,14,38,94,84,3,7,0,5
E02004481,994,823,259,564,4,45,30,15,112,100,0,11,1,10
E02004482,2842,2173,588,1585,7,278,184,94,374,342,2,29,1,10
E02004483,3328,2713,848,1865,6,185,121,64,408,363,5,26,14,16
E02004484,1283,1058,284,774,4,45,28,17,166,151,1,14,0,10
E02004485,2067,1565,502,1063,24,195,37,158,258,213,16,15,14,25
E02004486,6613,4863,1371,3492,47,671,127,544,996,923,12,47,14,36
E02004487,1578,1115,374,741,5,228,42,186,209,186,10,7,6,21
E02004488,1767,1465,411,1054,3,92,20,72,194,177,3,14,0,13
E02004489,6275,4919,1338,3581,34,575,124,451,708,646,8,41,13,39
E02004490,1464,974,262,712,10,294,48,246,174,154,6,11,3,12
E02004491,1419,1150,293,857,7,57,12,45,194,174,2,12,6,11
E02004492,4551,3456,917,2539,37,412,104,308,630,581,12,33,4,16
E02004493,7578,5528,1541,3987,61,811,211,600,1146,1067,8,66,5,32
E02004494,22455,16812,4493,12319,192,1704,446,1258,3567,3276,54,205,32,180
E02004495,2714,2066,720,1346,16,248,76,172,361,317,14,25,5,23
E02004496,2725,2146,639,1507,12,225,48,177,324,294,1,27,2,18
E02004497,2405,1842,585,1257,12,222,58,164,297,271,9,14,3,32
E02004498,2338,1763,499,1264,18,293,68,225,253,222,10,18,3,11
E02004499,1107,916,265,651,12,61,19,42,110,103,2,4,1,8
E02004500,3040,2398,729,1669,14,267,60,207,334,297,2,27,8,27
E02004501,1645,1328,456,872,9,141,37,104,155,134,5,11,5,12
E02004502,2869,2333,748,1585,13,189,76,113,309,273,17,15,4,25
E02004503,4323,3603,968,2635,16,200,62,138,470,405,20,44,1,34
E02004504,1179,1006,259,747,2,50,7,43,114,93,9,8,4,7
E02004505,2235,1807,542,1265,11,148,62,86,247,214,11,17,5,22
E02004506,2778,2089,684,1405,10,225,132,93,420,371,13,32,4,34
E02004507,8268,6041,1502,4539,55,634,291,343,1485,1356,21,91,17,53
E02004508,1990,1516,513,1003,10,134,93,41,316,269,15,20,12,14
E02004509,8076,5655,1503,4152,34,574,273,301,1771,1584,43,111,33,42
E02004512,17439,12213,3299,8914,93,1514,797,717,3515,3166,71,209,69,104
E02004513,2164,1257,356,901,8,372,233,139,521,480,6,26,9,6
E02004514,2227,1721,501,1220,6,184,122,62,298,255,15,26,2,18
E02004515,4383,3264,949,2315,20,373,206,167,689,611,18,46,14,37
E02004516,3447,2223,669,1554,11,348,158,190,839,631,93,37,78,26
E02004517,3784,2842,788,2054,14,298,154,144,606,550,13,29,14,24
E02004518,2486,1926,570,1356,12,120,59,61,410,325,33,24,28,18
E02004519,1538,1194,370,824,7,121,85,36,198,179,3,10,6,18
E02004520,3638,2217,596,1621,26,403,221,182,974,431,284,32,227,18
E02004521,3284,2354,599,1755,29,350,224,126,536,472,9,47,8,15
E02004522,4169,2811,937,1874,15,136,79,57,1181,1106,11,47,17,26
E02004523,1476,980,239,741,3,179,105,74,305,199,46,26,34,9
E02004524,2476,1996,655,1341,8,128,91,37,305,267,13,18,7,39
E02004525,2831,2239,683,1556,14,175,93,82,376,309,40,24,3,27
E02004526,2194,1731,605,1126,7,131,76,55,310,266,5,28,11,15
E02004527,3128,2292,679,1613,27,396,282,114,383,346,7,25,5,30
E02004528,3059,2408,742,1666,15,279,180,99,325,304,6,12,3,32
E02004529,2644,1965,653,1312,23,269,195,74,333,294,9,22,8,54
E02004530,2075,1550,463,1087,9,238,183,55,266,248,4,9,5,12
E02004531,4317,3165,985,2180,33,626,451,175,467,425,10,24,8,26
E02004532,2058,1491,461,1030,15,254,192,62,281,261,6,11,3,17
E02004533,1308,896,250,646,14,256,181,75,136,123,5,3,5,6
E02004534,3443,2342,592,1750,36,524,328,196,522,486,2,29,5,19
E02004535,4168,2924,845,2079,29,545,328,217,615,555,30,26,4,55
E02004536,1562,1172,374,798,4,145,107,38,228,210,6,10,2,13
E02004537,4754,3384,862,2522,40,676,504,172,631,596,4,26,5,23
E02004538,3958,2905,934,1971,25,466,352,114,541,498,12,27,4,21
E02004539,1666,1209,343,866,8,213,181,32,220,203,1,13,3,16
E02004540,2506,1863,541,1322,17,211,138,73,380,339,11,27,3,35
E02004541,3445,2571,853,1718,20,310,225,85,511,473,15,18,5,33
E02004542,2396,1826,615,1211,16,172,128,44,334,276,41,9,8,48
E02004543,1059,736,237,499,6,148,123,25,160,152,0,8,0,9
E02004544,2140,1555,413,1142,29,273,222,51,268,248,1,13,6,15
E02004545,7171,4555,1093,3462,82,1424,1154,270,1084,1007,11,58,8,26
E02004546,3161,2142,513,1629,29,498,418,80,467,431,4,29,3,25
E02004547,13668,9274,2171,7103,144,2303,1715,588,1900,1767,19,97,17,47
E02004548,1415,1089,167,922,16,152,98,54,157,145,2,10,0,1
E02004549,1793,1167,282,885,8,415,369,46,197,180,4,10,3,6
E02004550,5458,3272,789,2483,63,1332,1106,226,767,730,7,26,4,24
E02004551,987,592,132,460,5,270,245,25,114,102,1,9,2,6
E02004552,1192,908,229,679,6,159,134,25,107,100,0,6,1,12
E02004553,1885,1258,314,944,29,382,305,77,209,192,4,13,0,7
E02004554,896,606,129,477,6,171,153,18,108,97,1,9,1,5
E02004555,2018,1613,579,1034,13,116,22,94,251,220,6,18,7,25
E02004556,2650,2121,715,1406,18,180,37,143,297,258,12,24,3,34
E02004557,2174,1741,486,1255,2,192,40,152,231,205,2,16,8,8
E02004558,6298,4814,1469,3345,41,577,66,511,813,746,17,43,7,53
E02004559,1765,1452,430,1022,4,134,13,121,168,157,0,11,0,7
E02004560,2534,2009,636,1373,11,172,28,144,306,276,14,13,3,36
E02004561,3036,2474,747,1727,7,182,43,139,347,285,13,40,9,26
E02004562,2458,1915,600,1315,12,185,22,163,322,286,11,20,5,24
E02004563,1072,963,323,640,2,20,8,12,73,61,2,9,1,14
E02004564,1481,1297,355,942,6,41,12,29,127,110,2,14,1,10
E02004565,3765,3236,970,2266,10,113,48,65,380,347,6,22,5,26
E02004566,2388,1751,505,1246,15,228,40,188,362,315,11,28,8,32
E02004567,1519,1323,400,923,8,36,9,27,137,129,2,6,0,15
E02004568,3006,2430,687,1743,19,230,102,128,316,280,5,28,3,11
E02004569,5085,3753,1084,2669,27,401,175,226,869,806,12,47,4,35
E02004570,4262,3521,973,2548,15,216,76,140,481,439,6,35,1,29
E02004571,2350,1945,600,1345,2,107,57,50,280,262,1,15,2,16
E02004572,1685,1303,416,887,6,108,40,68,253,218,3,14,18,15
E02004573,2357,1766,517,1249,9,160,107,53,403,360,10,31,2,19
E02004574,3027,2324,693,1631,20,188,137,51,477,433,2,36,6,18
E02004575,4053,3106,1077,2029,12,313,229,84,564,497,17,43,7,58
E02004576,1546,1230,426,804,5,90,67,23,196,171,9,13,3,25
E02004577,2667,2034,700,1334,6,213,131,82,373,337,15,16,5,41
E02004578,2310,1713,592,1121,7,74,53,21,483,427,17,33,6,33
E02004579,2672,2070,684,1386,6,122,77,45,437,372,14,49,2,37
E02004580,2216,1738,627,1111,9,77,50,27,362,320,7,31,4,30
E02004581,3041,2407,832,1575,9,146,95,51,457,410,2,31,14,22
E02004582,3669,2712,865,1847,17,237,122,115,683,631,4,39,9,20
E02004583,2131,1695,575,1120,4,89,59,30,335,307,3,25,0,8
E02004584,1084,877,332,545,0,48,15,33,146,133,2,9,2,13
E02004585,1289,1014,299,715,8,84,43,41,176,155,1,18,2,7
E02004586,3021,2278,685,1593,9,156,81,75,563,511,3,46,3,15
E02004587,839,592,181,411,9,102,59,43,126,110,5,11,0,10
E02004588,5102,3698,1154,2544,14,294,143,151,1065,981,10,64,10,31
E02004589,1865,1418,438,980,11,113,58,55,307,277,3,26,1,16
E02004590,1311,977,355,622,6,48,18,30,266,219,10,27,10,14
E02004591,3663,2706,831,1875,32,299,183,116,594,539,16,30,9,32
E02004592,5679,3976,1250,2726,65,698,387,311,903,800,24,57,22,37
E02004593,2422,1847,718,1129,29,195,111,84,318,285,18,11,4,33
E02004594,3013,2001,706,1295,38,300,174,126,629,365,157,19,88,45
E02004595,3999,3046,958,2088,49,327,190,137,532,489,7,27,9,45
E02004596,11405,7626,1962,5664,156,1034,513,521,2514,2381,17,97,19,75
E02004597,3575,2612,731,1881,55,403,238,165,479,447,8,20,4,26
E02004598,3251,2474,805,1669,22,261,160,101,445,399,11,26,9,49
E02004599,2870,2117,635,1482,26,275,175,100,406,362,14,25,5,46
E02004600,5234,3556,1067,2489,54,618,343,275,979,914,7,51,7,27
E02004601,1663,1215,384,831,13,94,53,41,321,296,5,15,5,20
E02004602,962,648,158,490,11,148,99,49,153,133,3,13,4,2
E02004603,3435,2016,585,1431,31,358,203,155,1014,968,9,32,5,16
E02004604,1790,1184,347,837,21,299,214,85,274,246,2,22,4,12
E02004605,1739,1186,317,869,30,236,168,68,275,258,0,15,2,12
E02004606,3791,2529,677,1852,37,375,224,151,817,757,3,50,7,33
E02004607,4117,2641,773,1868,36,314,167,147,1087,1017,8,54,8,39
E02004608,19023,12852,3424,9428,163,1097,542,555,4778,4486,42,211,39,133
E02004609,7518,5681,1395,4286,78,213,110,103,1509,1381,42,63,23,37
E02004610,4529,3382,950,2432,38,215,99,116,833,755,12,55,11,61
E02004611,3168,2438,720,1718,25,165,98,67,511,466,5,33,7,29
E02004612,1697,1256,364,892,17,137,82,55,274,251,8,14,1,13
E02004613,2507,1931,564,1367,13,91,42,49,460,437,4,17,2,12
E02004614,1826,1434,425,1009,8,76,40,36,291,264,3,21,3,17
E02004615,4215,2884,1030,1854,81,476,82,394,680,607,33,30,10,94
E02004616,4344,2720,977,1743,69,491,64,427,889,747,92,34,16,175
E02004617,3648,2337,862,1475,64,430,64,366,665,564,50,40,11,152
E02004618,4089,2705,963,1742,29,268,97,171,857,743,61,43,10,230
E02004619,2870,1764,667,1097,11,277,52,225,627,520,52,28,27,191
E02004620,1238,957,311,646,6,122,23,99,142,130,1,7,4,11
E02004621,7818,5458,1669,3789,95,829,150,679,1362,1199,62,77,24,74
E02004622,4544,2911,813,2098,86,629,106,523,878,666,93,57,62,40
E02004623,3011,2112,720,1392,41,352,58,294,430,356,25,32,17,76
E02004624,2704,1874,587,1287,48,258,55,203,491,428,22,23,18,33
E02004625,4417,2918,1077,1841,47,470,101,369,835,726,63,30,16,147
E02004626,3588,2698,1095,1603,36,208,60,148,581,500,12,54,15,65
E02004627,2075,1513,559,954,15,156,37,119,368,326,10,26,6,23
E02004628,3088,2408,786,1622,34,236,59,177,391,335,7,40,9,19
E02004629,4450,3401,1194,2207,21,446,98,348,553,504,6,38,5,29
E02004630,2194,1611,627,984,10,135,42,93,390,335,23,29,3,48
E02004631,1400,1136,468,668,8,91,24,67,143,114,4,20,5,22
E02004632,4588,3625,1154,2471,17,388,79,309,527,482,5,30,10,31
E02004633,2028,1632,593,1039,12,167,29,138,196,173,5,14,4,21
E02004634,4251,3387,1185,2202,18,322,72,250,479,428,3,43,5,45
E02004635,2494,1754,617,1137,11,196,61,135,504,301,106,25,72,29
E02004636,1875,1502,425,1077,4,79,31,48,269,243,4,18,4,21
E02004637,8709,6547,1828,4719,72,566,295,271,1470,1349,20,81,20,54
E02004638,1272,1009,336,673,4,60,32,28,193,179,2,11,1,6
E02004639,16980,12420,3489,8931,157,1268,596,672,3013,2765,59,153,36,122
E02004640,2952,2118,683,1435,30,237,115,122,547,495,9,33,10,20
E02004641,1716,1437,452,985,9,73,39,34,187,165,3,18,1,10
E02004642,10752,8178,2083,6095,103,677,361,316,1750,1585,20,128,17,44
E02004643,1318,880,232,648,17,168,97,71,241,220,2,15,4,12
E02004644,4602,3341,934,2407,45,429,231,198,762,685,7,67,3,25
E02004645,1444,1178,305,873,11,60,22,38,187,163,1,19,4,8
E02004646,1302,908,241,667,8,213,171,42,156,141,1,11,3,17
E02004647,1145,887,270,617,13,113,71,42,122,107,3,11,1,10
E02004648,1411,1101,322,779,17,85,44,41,202,177,2,18,5,6
E02004649,2558,1953,445,1508,30,129,46,83,433,379,5,46,3,13
E02004650,5634,4262,847,3415,78,373,154,219,898,805,25,47,21,23
E02004651,2540,1832,553,1279,24,181,98,83,475,414,23,31,7,28
E02004652,2821,1969,775,1194,18,248,148,100,528,431,37,23,37,58
E02004653,3714,2698,857,1841,35,377,277,100,553,477,27,42,7,51
E02004654,2832,2125,706,1419,19,265,208,57,408,379,6,22,1,15
E02004655,7277,5193,1415,3778,60,668,472,196,1307,1250,10,44,3,49
E02004656,7601,5598,1760,3838,58,751,492,259,1147,1057,13,69,8,47
E02004657,3212,2455,776,1679,20,254,160,94,466,428,2,32,4,17
E02004658,1560,1277,391,886,10,77,50,27,185,177,1,4,3,11
E02004659,1545,1176,436,740,6,159,123,36,184,159,8,14,3,20
E02004660,3107,2370,826,1544,21,248,156,92,430,386,8,31,5,38
E02004661,1977,1508,488,1020,17,234,185,49,206,182,6,16,2,12
E02004662,2967,2201,709,1492,23,250,173,77,450,402,13,29,6,43
E02004663,2622,1939,672,1267,22,240,157,83,403,356,12,31,4,18
E02004664,2410,1771,576,1195,28,308,244,64,287,265,4,15,3,16
E02004665,3754,2966,1005,1961,17,248,187,61,486,447,5,30,4,37
E02004666,9652,7023,1833,5190,130,831,223,608,1627,1472,37,95,23,41
E02004667,4274,3025,966,2059,43,487,94,393,677,594,25,44,14,42
E02004668,3124,2272,838,1434,43,248,45,203,502,450,13,26,13,59
E02004669,3348,2433,818,1615,24,175,70,105,663,585,27,41,10,53
E02004670,4663,3581,997,2584,36,317,81,236,697,637,5,44,11,32
E02004671,1969,1513,522,991,15,119,51,68,288,249,8,22,9,34
E02004672,6739,5064,1439,3625,36,426,175,251,1167,755,217,57,138,46
E02004673,4374,3271,917,2354,36,336,126,210,696,629,17,44,6,35
E02004674,7654,5510,1278,4232,76,605,265,340,1421,1324,14,79,4,42
E02004675,2308,1680,470,1210,38,302,24,278,271,241,14,13,3,17
E02004676,1663,1300,396,904,9,136,12,124,196,165,9,11,11,22
E02004677,2318,1662,608,1054,28,197,21,176,323,266,32,14,11,108
E02004678,2514,1859,653,1206,19,227,16,211,307,252,24,24,7,102
E02004679,2995,2094,545,1549,35,332,31,301,458,403,33,16,6,76
E02004680,937,738,170,568,13,48,3,45,135,129,0,6,0,3
E02004681,6717,4772,966,3806,115,785,83,702,1011,922,15,63,11,34
E02004682,8307,5690,1236,4454,146,1104,127,977,1329,1229,17,78,5,38
E02004683,6369,4153,942,3211,121,1022,99,923,1044,975,13,45,11,29
E02004684,4887,3620,876,2744,86,570,44,526,595,533,18,34,10,16
E02004685,15226,10780,2338,8442,275,1706,157,1549,2399,2198,49,128,24,66
E02004686,5305,3751,917,2834,96,674,39,635,755,678,12,61,4,29
E02004687,1151,760,183,577,20,261,17,244,107,93,4,8,2,3
E02004688,2607,1658,399,1259,34,538,38,500,367,330,11,22,4,10
E02004689,1379,1084,374,710,8,75,10,65,173,144,15,9,5,39
E02004690,6602,4827,1111,3716,71,649,63,586,1025,955,26,37,7,30
E02004691,3205,2245,715,1530,50,301,31,270,485,425,27,23,10,124
E02004692,1268,1074,309,765,6,82,6,76,99,81,2,12,4,7
E02004693,1308,865,187,678,16,248,13,235,174,157,4,10,3,5
E02004694,2723,1755,527,1228,31,427,77,350,440,385,30,22,3,70
E02004695,2026,1574,293,1281,27,177,12,165,239,221,2,14,2,9
E02004696,2746,1906,559,1347,35,331,42,289,424,351,42,25,6,50
E02004697,4108,2967,983,1984,46,412,105,307,622,505,64,35,18,61
E02004698,3399,2334,719,1615,51,452,80,372,506,430,22,41,13,56
E02004699,4834,3435,1069,2366,73,497,113,384,783,699,14,54,16,46
E02004700,1804,1172,310,862,29,266,64,202,306,200,52,13,41,31
E02004702,1635,1266,346,920,19,168,29,139,164,141,10,11,2,18
E02004703,3306,2493,899,1594,41,314,52,262,370,312,24,28,6,88
E02004704,5048,3190,948,2242,72,669,206,463,1056,766,155,43,92,61
E02004705,3452,2488,728,1760,41,371,81,290,509,458,20,17,14,43
E02004706,2227,1582,559,1023,12,253,36,217,344,302,14,18,10,36
E02004707,4465,3130,1076,2054,47,402,84,318,750,635,68,34,13,136
E02004708,6470,4393,1275,3118,63,836,217,619,1130,1011,41,70,8,48
E02004709,1309,1114,331,783,6,58,24,34,116,102,3,9,2,15
E02004710,1560,1260,372,888,9,114,30,84,165,145,1,12,7,12
E02004712,2618,2150,641,1509,20,125,30,95,312,288,4,19,1,11
E02004713,2765,2175,622,1553,29,215,73,142,333,300,5,27,1,13
E02004714,8125,6119,1422,4697,99,553,219,334,1309,1216,13,70,10,45
E02004715,3711,2677,717,1960,62,431,138,293,531,490,0,37,4,10
E02004716,1303,1013,264,749,8,144,19,125,131,119,1,9,2,7
E02004717,8919,6339,1517,4822,119,880,291,589,1538,1397,20,104,17,43
E02004718,9046,6305,1644,4661,106,1069,351,718,1474,1343,25,90,16,92
E02004719,2467,2011,540,1471,17,160,52,108,261,239,4,18,0,18
E02004720,4079,3074,854,2220,31,327,142,185,619,555,14,43,7,28
E02004721,2431,1890,409,1481,30,164,51,113,329,295,7,26,1,18
E02004722,6324,4722,1224,3498,73,662,287,375,835,767,16,50,2,32
E02004723,2671,2082,529,1553,19,165,82,83,391,355,5,29,2,14
E02004724,2504,1641,476,1165,26,442,166,276,370,325,12,26,7,25
E02004725,1081,720,215,505,4,157,47,110,178,157,4,11,6,22
E02004726,6065,4198,1017,3181,60,566,278,288,1213,1123,11,63,16,28
E02004727,4640,3694,770,2924,31,208,87,121,682,553,60,44,25,25
E02004728,9962,7604,1951,5653,116,743,374,369,1450,1303,37,92,18,49
E02004729,1361,1030,261,769,5,182,108,74,134,118,4,10,2,10
E02004730,2980,2277,602,1675,22,259,142,117,404,350,14,31,9,18
E02004731,1714,1429,362,1067,10,73,42,31,197,179,2,13,3,5
E02004732,2124,1713,484,1229,23,109,73,36,270,241,8,19,2,9
E02004733,2873,2102,548,1554,35,241,133,108,461,396,16,35,14,34
E02004734,10109,7515,1868,5647,93,829,433,396,1596,1388,50,133,25,76
E02004735,1246,1006,285,721,6,67,34,33,160,113,23,13,11,7
E02004736,1158,984,285,699,5,42,33,9,124,107,6,7,4,3
E02004737,3896,2827,710,2117,46,385,238,147,614,538,15,55,6,24
E02004738,2448,1843,504,1339,8,252,168,84,335,285,8,35,7,10
E02004739,5144,3654,889,2765,47,454,253,201,962,667,161,42,92,27
E02004740,1145,937,286,651,3,43,26,17,154,103,25,13,13,8
E02004741,2618,1978,439,1539,28,261,159,102,335,287,21,19,8,16
E02004742,2488,1837,446,1391,23,222,149,73,391,323,14,40,14,15
E02004743,1995,1542,364,1178,15,160,85,75,274,228,15,25,6,4
E02004744,1561,924,208,716,15,248,73,175,366,215,72,21,58,8
E02004745,1274,868,179,689,17,140,75,65,239,208,7,20,4,10
E02004746,2276,1688,455,1233,31,157,72,85,381,290,50,28,13,19
E02004747,3583,2559,615,1944,38,280,168,112,686,427,153,35,71,20
E02004748,6230,4267,1045,3222,61,718,377,341,1112,955,38,92,27,72
E02004749,1884,1463,369,1094,11,99,37,62,296,232,29,22,13,15
E02004750,2676,2045,610,1435,20,205,123,82,397,310,51,15,21,9
E02004751,2136,1712,471,1241,23,162,9,153,226,197,11,13,5,13
E02004752,3338,2764,767,1997,31,182,28,154,341,308,6,15,12,20
E02004753,3408,2519,652,1867,29,245,56,189,600,354,134,26,86,15
E02004754,3047,2185,603,1582,26,282,53,229,505,419,31,31,24,49
E02004755,6563,4849,1126,3723,103,469,82,387,1086,979,25,65,17,56
E02004756,7186,5485,1232,4253,127,448,72,376,1097,987,29,62,19,29
E02004757,2285,1860,501,1359,23,92,16,76,299,265,5,22,7,11
E02004758,3038,2134,623,1511,43,231,37,194,591,535,24,21,11,39
E02004759,2137,1669,432,1237,22,150,27,123,289,237,21,11,20,7
E02004760,2247,1691,514,1177,25,183,47,136,325,258,39,16,12,23
E02004761,3718,2115,610,1505,32,306,35,271,1171,412,488,25,246,94
E02004764,4710,3551,867,2684,41,495,222,273,606,540,6,55,5,17
E02004765,823,683,177,506,1,18,7,11,113,104,0,9,0,8
E02004766,3805,2770,662,2108,16,539,198,341,458,408,8,38,4,22
E02004767,854,559,139,420,13,201,140,61,78,65,2,10,1,3
E02004768,1158,842,206,636,7,149,37,112,150,133,4,12,1,10
E02004769,1127,637,159,478,5,357,267,90,117,106,2,9,0,11
E02004770,3179,2273,565,1708,30,499,302,197,363,329,4,29,1,14
E02004771,1498,940,221,719,9,360,232,128,179,157,1,17,4,10
E02004772,2711,2193,548,1645,14,213,123,90,276,239,11,21,5,15
E02004774,2633,1951,686,1265,14,251,91,160,399,333,19,34,13,18
E02004775,14228,10281,2485,7796,127,1462,715,747,2292,2036,32,199,25,66
E02004776,1799,1367,419,948,9,145,54,91,260,210,11,31,8,18
E02004777,1277,946,301,645,7,114,29,85,200,174,3,19,4,10
E02004778,1675,1237,423,814,5,128,45,83,295,255,9,27,4,10
E02004779,4165,2949,1131,1818,19,323,180,143,766,666,46,40,14,108
E02004780,1314,998,300,698,8,161,104,57,143,117,13,12,1,4
E02004781,3666,2682,686,1996,36,376,191,185,554,497,15,39,3,18
E02004782,5268,3743,1052,2691,57,590,337,253,849,777,12,42,18,29
E02004783,1782,1377,351,1026,19,145,80,65,233,210,3,19,1,8
E02004784,3603,2744,829,1915,25,276,146,130,540,482,12,37,9,18
E02004785,3996,2921,989,1932,38,286,168,118,677,575,54,31,17,74
E02004786,3628,2365,658,1707,37,416,205,211,789,518,159,38,74,21
E02004787,2891,2223,694,1529,32,258,147,111,358,312,11,29,6,20
E02004788,2748,2114,736,1378,25,137,62,75,446,399,4,35,8,26
E02004789,1571,1153,358,795,15,207,139,68,184,153,6,16,9,12
E02004790,6009,4335,1254,3081,43,477,255,222,1112,999,17,81,15,42
E02004791,635,441,129,312,2,111,44,67,72,62,1,6,3,9
E02004792,6256,4721,1291,3430,46,560,292,268,898,806,13,67,12,31
E02004793,3345,2429,946,1483,28,302,189,113,541,483,32,22,4,45
E02004794,2104,1574,570,1004,11,146,77,69,329,278,24,18,9,44
E02004795,6666,4529,1707,2822,55,621,404,217,1297,1166,60,60,11,164
E02004796,2207,1753,623,1130,8,146,83,63,275,230,11,27,7,25
E02004797,2962,2031,672,1359,36,362,263,99,515,466,9,34,6,18
E02004798,2871,1946,586,1360,17,345,220,125,520,480,7,32,1,43
E02004799,3723,2600,900,1700,44,391,231,160,657,599,11,37,10,31
E02004800,1534,1141,439,702,5,79,48,31,286,255,16,11,4,23
E02004801,2197,1603,655,948,22,161,110,51,378,333,22,18,5,33
E02004802,2355,1711,383,1328,33,269,39,230,321,272,15,25,9,21
E02004803,886,505,88,417,18,221,33,188,114,94,2,15,3,28
E02004804,1082,923,188,735,8,42,6,36,106,78,4,13,11,3
E02004805,3686,2772,601,2171,48,281,47,234,559,476,23,41,19,26
E02004806,3841,2939,642,2297,58,207,39,168,621,579,13,19,10,16
E02004807,7318,5289,1252,4037,120,758,131,627,1120,969,50,71,30,31
E02004808,11616,8247,1949,6298,175,767,186,581,2368,1714,322,91,241,59
E02004809,9600,5853,1425,4428,157,1019,264,755,2519,1423,585,91,420,52
E02004810,2977,2006,496,1510,43,377,109,268,535,441,22,52,20,16
E02004811,1705,1179,294,885,17,152,29,123,342,295,16,12,19,15
E02004812,1332,1025,253,772,5,84,27,57,205,173,5,15,12,13
E02004813,2167,1461,402,1059,25,364,104,260,297,261,9,18,9,20
E02004814,1331,916,265,651,6,115,29,86,226,192,20,8,6,68
E02004815,1338,883,181,702,13,262,98,164,172,138,15,14,5,8
E02004816,7984,5253,1329,3924,103,1112,352,760,1460,1247,109,66,38,56
E02004817,4666,3146,809,2337,59,680,233,447,739,607,49,61,22,42
E02004818,7143,4766,1209,3557,83,829,260,569,1402,991,230,70,111,63
E02004819,3691,2545,668,1877,36,431,150,281,650,558,39,33,20,29
E02004820,3839,2459,758,1701,42,394,140,254,882,435,287,24,136,62
E02004821,2304,1522,527,995,11,192,66,126,421,336,56,6,23,158
E02004822,3250,2182,796,1386,37,316,109,207,571,450,66,27,28,144
E02004823,2092,1544,497,1047,13,191,78,113,326,301,7,16,2,18
E02004824,4457,3195,1029,2166,40,453,188,265,728,651,22,40,15,41
E02004825,2693,2056,626,1430,25,208,77,131,374,328,16,25,5,30
E02004826,4317,3202,1074,2128,46,328,139,189,681,559,74,38,10,60
E02004827,1113,931,224,707,8,53,12,41,116,107,0,8,1,5
E02004828,6996,4926,1302,3624,59,696,452,244,1285,1190,8,75,12,30
E02004829,1903,1269,396,873,32,178,63,115,384,295,44,16,29,40
E02004830,2771,1842,612,1230,31,276,161,115,545,363,98,31,53,77
E02004831,3906,2716,803,1913,26,390,197,193,714,493,135,29,57,60
E02004832,5421,4063,1083,2980,92,325,208,117,821,733,32,41,15,120
E02004833,4618,3460,890,2570,63,453,241,212,613,518,34,38,23,29
E02004834,5613,3414,972,2442,67,1051,695,356,1025,919,30,58,18,56
E02004835,16407,11138,3269,7869,219,1662,913,749,3184,2783,180,169,52,204
E02004836,1509,831,283,548,11,279,201,78,369,331,14,19,5,19
E02004837,4608,3513,988,2525,27,298,193,105,728,672,15,34,7,42
E02004838,4345,3285,969,2316,25,336,181,155,635,535,36,52,12,64
E02004839,3078,2310,855,1455,16,249,127,122,435,373,17,29,16,68
E02004840,2906,2219,728,1491,24,265,182,83,370,317,13,34,6,28
E02004841,13472,10101,2191,7910,144,838,456,382,2285,2079,37,144,25,104
E02004842,4175,3120,852,2268,35,237,129,108,747,573,84,35,55,36
E02004843,1282,1053,295,758,4,107,24,83,106,95,3,7,1,12
E02004844,5080,3469,949,2520,53,680,287,393,850,793,7,44,6,28
E02004845,6301,4669,1201,3468,51,599,190,409,940,866,7,61,6,42
E02004846,1532,1299,422,877,10,86,20,66,130,125,1,4,0,7
E02004847,2157,1587,365,1222,24,227,51,176,301,275,3,21,2,18
E02004848,1065,913,266,647,7,56,25,31,83,76,2,5,0,6
E02004849,1813,1473,412,1061,24,137,50,87,163,154,4,5,0,16
E02004850,3470,2664,784,1880,24,398,128,270,369,349,4,13,3,15
E02004851,902,703,184,519,25,109,19,90,58,53,2,3,0,7
E02004852,5383,3880,920,2960,56,449,178,271,968,917,8,36,7,30
E02004853,2019,1598,472,1126,23,201,62,139,178,157,7,11,3,19
E02004854,2155,1543,458,1085,24,219,106,113,352,333,2,13,4,17
E02004855,5673,3809,1054,2755,81,826,420,406,934,883,2,36,13,23
E02004856,2102,1495,453,1042,10,259,195,64,303,274,11,14,4,35
E02004857,2880,2147,680,1467,25,297,212,85,386,353,14,18,1,25
E02004858,1446,1060,298,762,4,203,168,35,171,135,17,13,6,8
E02004859,1881,1462,486,976,10,170,133,37,211,174,23,11,3,28
E02004860,834,575,128,447,5,140,69,71,113,108,0,5,0,1
E02004861,1956,1477,525,952,8,188,155,33,246,219,11,14,2,37
E02004862,1297,776,206,570,7,374,272,102,132,118,3,10,1,8
E02004863,1323,728,181,547,31,387,300,87,170,162,1,7,0,7
E02004864,3522,2538,820,1718,27,399,306,93,512,443,33,29,7,46
E02004865,1885,1336,330,1006,12,311,245,66,212,189,4,16,3,14
E02004866,1155,771,194,577,5,274,237,37,102,97,0,5,0,3
E02004867,1443,1092,355,737,9,177,146,31,157,142,1,12,2,8
E02004868,14709,9782,2263,7519,126,2039,1447,592,2700,2540,16,123,21,62
E02004869,2782,2094,614,1480,14,276,218,58,378,344,11,20,3,20
E02004870,9243,5972,1598,4374,99,1827,1347,480,1291,1214,16,54,7,54
E02004871,750,537,139,398,0,132,117,15,75,62,4,9,0,6
E02004872,1797,1316,373,943,13,248,202,46,211,199,3,9,0,9
E02004873,4607,3145,886,2259,38,712,495,217,684,634,7,33,10,28
E02004874,1901,1180,286,894,12,428,301,127,272,242,1,19,10,9
E02004875,1958,1357,345,1012,12,386,311,75,181,164,7,7,3,22
E02004876,3412,2377,759,1618,28,474,312,162,503,452,15,25,11,30
E02004877,3030,2252,663,1589,33,340,219,121,381,341,21,13,6,24
E02004878,2304,1712,544,1168,18,248,72,176,286,271,2,10,3,40
E02004879,2339,1674,595,1079,23,310,119,191,283,229,19,23,12,49
E02004880,2856,2165,665,1500,34,258,73,185,348,312,16,11,9,51
E02004881,4357,3207,871,2336,65,411,166,245,644,586,12,43,3,30
E02004882,3473,2555,697,1858,37,316,157,159,532,490,14,24,4,33
E02004883,2145,1614,507,1107,15,203,62,141,273,240,14,9,10,40
E02004884,3535,2494,643,1851,53,425,145,280,538,497,5,30,6,25
E02004885,1765,1463,382,1081,9,91,35,56,194,182,5,7,0,8
E02004886,2367,1583,491,1092,28,322,125,197,393,348,21,21,3,41
E02004887,2348,1730,591,1139,14,231,76,155,325,298,11,9,7,48
E02004888,2970,2238,631,1607,27,277,141,136,410,376,5,24,5,18
E02004889,3343,2429,672,1757,31,415,104,311,444,416,7,15,6,24
E02004890,5711,4426,1154,3272,58,488,171,317,712,669,8,22,13,27
E02004891,2247,1701,544,1157,14,228,45,183,281,257,5,16,3,23
E02004892,825,564,159,405,8,158,25,133,89,81,1,5,2,6
E02004893,2579,1948,467,1481,40,266,87,179,318,297,6,13,2,7
E02004894,9078,6797,2018,4779,92,986,312,674,1120,1043,17,50,10,83
E02004895,3726,2706,867,1839,33,393,143,250,460,378,44,26,12,134
E02004896,5232,3781,1141,2640,39,502,217,285,872,795,14,52,11,38
E02004897,2238,1702,550,1152,20,220,69,151,281,261,7,10,3,15
E02004898,2133,1524,472,1052,22,304,103,201,266,248,5,10,3,17
E02004899,3759,2529,702,1827,42,471,178,293,674,632,9,26,7,43
E02004900,2394,1819,638,1181,13,173,48,125,356,337,3,10,6,33
E02004901,2506,1557,401,1156,48,526,114,412,356,339,4,11,2,19
E02004902,3132,1977,491,1486,53,493,120,373,588,557,7,20,4,21
E02004903,3914,2597,696,1901,59,517,159,358,709,666,12,20,11,32
E02004904,4407,2759,697,2062,86,685,193,492,793,743,12,27,11,84
E02004905,4961,3376,1044,2332,57,434,140,294,995,895,52,33,15,99
E02004906,5162,3270,838,2432,100,749,221,528,1011,951,10,42,8,32
E02004907,3157,2335,695,1640,32,301,80,221,463,409,14,29,11,26
E02004908,3196,2355,709,1646,23,233,76,157,563,487,34,24,18,22
E02004909,1731,1290,405,885,10,208,91,117,206,191,2,11,2,17
E02004910,5650,4097,1134,2963,67,631,326,305,820,760,13,33,14,35
E02004911,868,589,164,425,5,201,70,131,67,56,3,8,0,6
E02004912,3282,2269,649,1620,38,519,220,299,432,385,8,28,11,24
E02004913,4674,3313,1007,2306,49,577,277,300,659,575,31,40,13,76
E02004914,8476,5662,1529,4133,107,1594,605,989,1074,990,8,67,9,39
E02004915,1277,893,233,660,23,207,70,137,148,134,3,5,6,6
E02004916,4180,2830,905,1925,54,774,258,516,492,455,8,16,13,30
E02004917,999,680,204,476,11,193,75,118,110,94,7,7,2,5
E02004918,5316,3670,1007,2663,58,757,327,430,808,760,4,38,6,23
E02004919,1329,991,279,712,16,164,79,85,149,139,3,4,3,9
E02004920,6809,4769,1302,3467,72,945,450,495,958,869,16,63,10,65
E02004921,1842,1391,418,973,16,194,88,106,226,203,6,14,3,15
E02004922,2990,1983,680,1303,17,378,213,165,541,458,28,30,25,71
E02004923,2917,2100,662,1438,11,382,206,176,382,350,12,17,3,42
E02004924,2727,1974,556,1418,14,304,200,104,426,392,8,19,7,9
E02004925,1891,1446,452,994,11,184,134,50,226,203,9,12,2,24
E02004926,4820,3572,1167,2405,24,371,232,139,823,751,32,33,7,30
E02004927,1651,1234,420,814,16,188,153,35,186,153,18,10,5,27
E02004928,1081,913,356,557,3,51,32,19,105,95,2,6,2,9
E02004929,2211,1585,479,1106,14,247,183,64,333,300,11,14,8,32
E02004930,3099,2225,616,1609,31,337,252,85,491,447,8,31,5,15
E02004931,1379,1120,347,773,5,93,67,26,149,132,0,12,5,12
E02004932,2427,1734,528,1206,16,375,223,152,288,271,1,14,2,14
E02004933,1301,1043,356,687,5,93,72,21,151,136,4,8,3,9
E02004934,3099,2094,691,1403,29,382,240,142,562,531,5,22,4,32
E02004935,11068,7631,2192,5439,97,1166,725,441,2095,1931,35,106,23,79
E02004936,2083,1528,459,1069,15,221,151,70,308,282,9,17,0,11
E02004937,2988,2109,698,1411,21,252,165,87,566,513,17,27,9,40
E02004938,3674,2462,681,1781,40,546,324,222,594,523,43,22,6,32
E02004939,1686,1175,375,800,12,284,196,88,201,186,2,10,3,14
E02004940,3212,2289,608,1681,14,402,277,125,493,462,8,19,4,14
E02004941,3762,2348,629,1719,41,623,355,268,722,671,10,33,8,28
E02004942,3979,2676,756,1920,30,527,283,244,724,673,13,34,4,22
E02004943,3084,2393,759,1634,19,247,136,111,411,382,3,19,7,14
E02004944,2399,1635,409,1226,22,418,304,114,315,282,0,27,6,9
E02004945,7948,5360,1333,4027,115,1244,780,464,1191,1091,15,76,9,38
E02004946,971,618,134,484,15,223,141,82,109,102,0,7,0,6
E02004947,1011,789,175,614,7,107,83,24,106,95,0,11,0,2
E02004948,7287,4920,1216,3704,74,1110,712,398,1145,1062,13,69,1,38
E02004949,2944,1944,472,1472,27,514,341,173,442,402,3,27,10,17
E02004950,1056,720,165,555,23,185,142,43,114,103,0,9,2,14
E02004951,9343,6173,1545,4628,121,1613,1163,450,1383,1257,13,107,6,53
E02004952,1164,751,155,596,13,250,214,36,146,119,1,25,1,4
E02004953,1368,877,209,668,15,318,284,34,146,133,3,10,0,12
E02004954,8528,5671,1543,4128,95,1532,1115,417,1198,1093,7,82,16,32
E02004955,739,535,138,397,2,134,122,12,64,59,0,5,0,4
E02004956,3898,2693,746,1947,31,430,223,207,728,678,4,44,2,16
E02004957,3355,2499,665,1834,26,335,112,223,478,444,6,22,6,17
E02004958,2020,1411,434,977,13,174,64,110,386,333,26,17,10,36
E02004959,3487,2599,788,1811,19,243,83,160,570,513,26,22,9,56
E02004960,1630,1292,432,860,8,102,41,61,202,186,5,7,4,26
E02004961,4091,3108,780,2328,27,275,97,178,645,599,8,31,7,36
E02004962,3173,2374,705,1669,20,290,116,174,467,424,9,30,4,22
E02004963,1001,703,181,522,15,174,63,111,105,88,5,12,0,4
E02004964,3458,2542,592,1950,28,354,166,188,518,489,3,23,3,16
E02004965,1380,1024,306,718,12,140,47,93,192,178,2,11,1,12
E02004966,6277,4115,1223,2892,60,642,276,366,1393,938,284,41,130,67
E02004967,1441,873,190,683,22,340,154,186,197,178,1,12,6,9
E02004968,1581,1072,247,825,21,254,88,166,222,203,0,15,4,12
E02004969,1201,852,209,643,10,151,42,109,180,151,15,10,4,8
E02004970,1795,1119,307,812,19,356,139,217,289,272,2,13,2,12
E02004971,1974,1334,294,1040,19,264,90,174,342,328,0,13,1,15
E02004972,7140,4950,1276,3674,79,813,312,501,1246,1171,14,56,5,52
E02004973,2654,1734,439,1295,19,293,128,165,585,537,13,26,9,23
E02004974,1642,1110,331,779,16,154,50,104,351,332,5,10,4,11
E02004975,3810,2845,892,1953,43,370,145,225,527,481,20,20,6,25
E02004976,17691,11678,3129,8549,220,2070,786,1284,3607,3390,40,148,29,116
E02004977,4908,3215,860,2355,58,552,196,356,1046,978,14,37,17,37
E02004978,5522,3589,997,2592,84,744,256,488,1081,1012,11,49,9,24
E02004979,1434,1047,272,775,7,159,61,98,204,194,1,7,2,17
E02004980,1147,926,313,613,7,88,56,32,106,99,2,3,2,20
E02004981,3857,2492,679,1813,40,603,395,208,691,650,18,19,4,31
E02004982,975,695,229,466,12,185,151,34,74,67,1,6,0,9
E02004983,9575,6639,1501,5138,108,1078,733,345,1713,1619,11,79,4,37
E02004984,1016,691,193,498,8,197,113,84,119,117,1,1,0,1
E02004985,8064,5849,1366,4483,117,1154,813,341,893,833,14,41,5,51
E02004986,6666,4111,999,3112,77,1441,1002,439,1005,942,3,45,15,32
E02004987,3731,2263,584,1679,44,975,626,349,437,398,19,12,8,12
E02004988,1745,1061,237,824,22,426,332,94,223,206,1,12,4,13
E02004989,16240,9947,2391,7556,207,2077,1354,723,3929,3760,42,108,19,80
E02004990,3745,2389,630,1759,52,633,436,197,630,582,15,21,12,41
E02004991,3059,1397,374,1023,36,822,618,204,783,747,13,20,3,21
E02004992,1243,622,183,439,21,284,202,82,306,295,1,7,3,10
E02004993,3508,2318,643,1675,28,485,326,159,630,592,14,15,9,47
E02004994,1830,1425,485,940,9,125,82,43,229,187,24,8,10,42
E02004995,1680,1350,477,873,14,102,62,40,195,179,1,12,3,19
E02004996,3542,2514,740,1774,44,248,146,102,679,614,27,34,4,57
E02004997,2872,2193,766,1427,34,242,137,105,370,326,4,32,8,33
E02004998,1518,1129,297,832,16,139,88,51,226,204,3,15,4,8
E02004999,6411,4531,1140,3391,95,624,341,283,1115,1017,15,67,16,46
E02005000,11715,8317,2013,6304,168,1028,603,425,2130,1897,27,185,21,72
E02005001,7852,5710,1438,4272,103,589,355,234,1407,1243,46,95,23,43
E02005002,1970,1362,298,1064,28,220,167,53,343,306,2,33,2,17
E02005003,1307,899,180,719,22,203,112,91,176,161,0,14,1,7
E02005004,5122,3365,712,2653,84,484,299,185,1166,1074,7,67,18,23
E02005005,2807,2178,680,1498,23,154,79,75,414,367,10,23,14,38
E02005006,1578,1216,479,737,21,134,79,55,182,153,9,16,4,25
E02005007,2462,1894,632,1262,38,178,107,71,325,288,7,26,4,27
E02005008,3855,2806,986,1820,58,383,233,150,546,493,13,33,7,62
E02005009,1535,1160,423,737,17,134,88,46,202,173,9,17,3,22
E02005010,3739,2630,811,1819,35,215,149,66,810,748,10,45,7,49
E02005011,1466,1160,340,820,18,56,35,21,214,191,6,17,0,18
E02005012,1786,1367,398,969,12,115,83,32,275,249,0,23,3,17
E02005013,1734,1319,360,959,16,108,75,33,277,241,13,21,2,14
E02005014,4000,3217,933,2284,28,186,110,76,544,503,5,31,5,25
E02005015,1871,1474,404,1070,24,94,45,49,266,236,2,21,7,13
E02005016,1268,967,296,671,8,69,38,31,209,179,4,19,7,15
E02005017,3072,2219,695,1524,22,178,111,67,621,558,9,44,10,32
E02005018,2932,2255,654,1601,29,186,107,79,442,391,8,35,8,20
E02005019,2108,1535,502,1033,15,170,115,55,354,287,21,31,15,34
E02005020,2747,1872,526,1346,24,263,188,75,542,491,11,27,13,46
E02005021,5249,3437,1127,2310,29,221,120,101,1483,1385,23,63,12,79
E02005022,1503,956,288,668,20,179,78,101,340,304,5,25,6,8
E02005023,5264,3277,1022,2255,70,660,394,266,1217,974,82,54,107,40
E02005025,10430,7625,2231,5394,118,658,431,227,1953,1767,48,101,37,76
E02005026,2262,1662,534,1128,18,182,97,85,377,329,14,22,12,23
E02005027,2122,1365,457,908,16,168,107,61,521,445,43,18,15,52
E02005028,3638,2453,643,1810,50,518,316,202,601,562,4,33,2,16
E02005029,2544,1650,366,1284,37,292,174,118,555,507,29,16,3,10
E02005030,9639,6753,1863,4890,127,1157,604,553,1558,1452,12,73,21,44
E02005031,1304,853,184,669,24,188,126,62,232,220,2,6,4,7
E02005032,1890,1288,330,958,21,184,105,79,379,329,4,16,30,18
E02005033,17433,12161,2684,9477,210,1808,975,833,3174,2988,23,139,24,80
E02005034,1531,1210,297,913,7,132,64,68,176,156,1,18,1,6
E02005035,5452,4021,1039,2982,67,504,291,213,824,762,9,45,8,36
E02005036,2735,1960,534,1426,38,370,202,168,358,336,0,21,1,9
E02005037,2111,1662,420,1242,29,193,91,102,220,206,0,12,2,7
E02005038,2108,1623,463,1160,29,149,86,63,288,266,7,11,4,19
E02005039,1653,1203,328,875,13,200,134,66,222,189,8,22,3,15
E02005040,2717,2041,647,1394,17,201,119,82,432,403,6,20,3,26
E02005041,2003,1456,559,897,13,185,97,88,309,242,42,15,10,40
E02005042,6245,4684,1303,3381,26,363,225,138,1113,1006,21,77,9,59
E02005043,1716,1229,361,868,12,147,105,42,305,274,6,21,4,23
E02005044,3266,2311,823,1488,20,217,137,80,686,633,13,34,6,32
E02005045,1285,926,302,624,7,109,81,28,211,170,8,27,6,32
E02005046,2134,1438,424,1014,18,296,218,78,359,329,6,19,5,23
E02005047,1281,912,273,639,6,113,83,30,237,213,4,15,5,13
E02005048,2320,1478,521,957,13,191,126,65,613,566,12,27,8,25
E02005049,1805,1365,502,863,12,98,62,36,287,240,14,31,2,43
E02005050,4670,3374,959,2415,32,449,249,200,788,701,10,59,18,27
E02005051,2904,1947,548,1399,23,387,258,129,523,465,11,41,6,24
E02005052,5845,4035,1130,2905,46,445,268,177,1258,1063,55,93,47,61
E02005053,6489,4555,1268,3287,42,569,351,218,1289,1167,14,99,9,34
E02005054,1166,910,327,583,7,56,22,34,174,149,7,17,1,19
E02005055,2995,2019,628,1391,24,389,273,116,548,517,2,23,6,15
E02005056,9175,6281,1860,4421,84,1020,684,336,1723,1593,16,90,24,67
E02005057,3570,2545,738,1807,27,394,275,119,584,548,4,24,8,20
E02005058,1387,937,288,649,11,147,111,36,276,251,12,10,3,16
E02005059,1922,1462,417,1045,15,123,79,44,307,267,7,27,6,15
E02005060,3433,2453,658,1795,62,379,262,117,519,481,6,24,8,20
E02005061,905,613,186,427,8,172,143,29,104,88,4,7,5,8
E02005062,1188,985,289,696,8,80,68,12,111,104,0,6,1,4
E02005063,1487,1110,355,755,14,198,148,50,157,141,1,13,2,8
E02005064,1839,1477,440,1037,12,113,73,40,218,177,8,20,13,19
E02005065,893,613,156,457,6,164,129,35,102,90,1,9,2,8
E02005066,2046,1672,523,1149,15,106,77,29,235,212,6,16,1,18
E02005067,1129,937,286,651,10,46,32,14,118,91,11,12,4,18
E02005068,3887,2931,792,2139,51,304,82,222,559,499,11,39,10,42
E02005069,2411,1834,490,1344,21,132,29,103,407,358,15,23,11,17
E02005070,2876,2229,566,1663,32,154,35,119,441,405,10,24,2,20
E02005071,17840,12747,3204,9543,274,1500,339,1161,3212,2729,161,170,152,107
E02005072,2390,1948,533,1415,24,109,24,85,299,272,3,20,4,10
E02005073,5105,3555,936,2619,82,452,92,360,989,908,26,47,8,27
E02005074,1758,1432,386,1046,7,73,18,55,234,215,2,13,4,12
E02005075,6386,4706,1319,3387,90,523,96,427,1029,904,46,63,16,38
E02005076,2444,1702,390,1312,26,279,53,226,421,383,3,28,7,16
E02005077,2118,1629,394,1235,28,221,46,175,225,189,4,28,4,15
E02005078,4115,3080,908,2172,54,328,106,222,605,557,11,30,7,48
E02005079,2993,2395,610,1785,32,209,54,155,329,290,5,33,1,28
E02005080,2402,1555,414,1141,39,520,114,406,270,242,10,12,6,18
E02005081,1991,1532,521,1011,22,150,24,126,264,238,9,10,7,23
E02005082,6855,5344,1375,3969,102,504,109,395,833,733,34,54,12,72
E02005083,2165,1707,445,1262,24,147,36,111,265,244,4,12,5,22
E02005084,2847,2037,745,1292,18,209,71,138,519,442,44,28,5,64
E02005085,3185,2309,756,1553,29,260,74,186,537,463,34,34,6,50
E02005086,2200,1655,570,1085,21,156,29,127,344,318,10,15,1,24
E02005087,1641,1279,408,871,25,168,43,125,151,126,6,17,2,18
E02005088,2803,1883,533,1350,62,573,136,437,275,254,3,17,1,10
E02005089,2821,2110,578,1532,38,323,97,226,335,304,8,23,0,15
E02005090,1432,1128,373,755,15,123,40,83,150,131,3,13,3,16
E02005091,2399,1737,516,1221,44,268,85,183,316,279,11,18,8,34
E02005093,2327,1856,546,1310,36,153,48,105,262,229,24,7,2,20
E02005094,4228,3038,1057,1981,89,400,63,337,662,574,23,52,13,39
E02005095,2715,2050,706,1344,54,265,44,221,317,285,11,19,2,29
E02005096,3626,2460,823,1637,94,480,66,414,558,506,16,29,7,34
E02005097,2247,1633,616,1017,30,192,26,166,335,299,20,11,5,57
E02005098,8004,5779,1983,3796,144,642,83,559,1284,1118,86,65,15,155
E02005099,4158,3128,1066,2062,53,312,74,238,583,519,29,22,13,82
E02005100,3864,2684,834,1850,102,522,124,398,524,488,7,24,5,32
E02005101,2298,1629,639,990,27,206,29,177,364,329,10,18,7,72
E02005102,1812,1442,572,870,12,56,38,18,268,227,10,20,11,34
E02005103,1522,1049,274,775,15,116,50,66,332,276,9,28,19,10
E02005104,1910,1310,386,924,21,212,144,68,355,325,0,26,4,12
E02005105,1351,850,243,607,8,129,71,58,344,323,5,13,3,20
E02005106,2323,1514,400,1114,20,206,135,71,563,463,35,32,33,20
E02005107,8500,5795,1585,4210,52,561,304,257,2027,1614,131,107,175,65
E02005109,3380,2565,797,1768,19,174,100,74,590,529,9,43,9,32
E02005110,2584,1929,586,1343,30,155,80,75,444,369,21,43,11,26
E02005111,2932,2041,670,1371,16,234,169,65,613,551,18,32,12,28
E02005112,1699,1260,468,792,11,131,85,46,264,222,11,21,10,33
E02005113,2235,1675,545,1130,7,138,80,58,386,327,10,37,12,29
E02005114,2775,2114,641,1473,13,134,95,39,482,406,19,38,19,32
E02005115,2146,1464,432,1032,23,182,26,156,467,430,5,29,3,10
E02005116,3712,2515,709,1806,25,394,65,329,756,703,6,39,8,22
E02005117,1104,863,247,616,8,73,8,65,153,139,2,7,5,7
E02005118,1702,1298,329,969,38,117,23,94,239,220,2,14,3,10
E02005119,2161,1631,465,1166,12,169,26,143,328,292,11,22,3,21
E02005120,2829,2193,547,1646,45,132,29,103,413,360,11,35,7,46
E02005121,3426,2485,491,1994,29,273,65,208,623,576,9,34,4,16
E02005122,2374,1708,517,1191,21,187,53,134,437,397,14,22,4,21
E02005123,3917,2916,717,2199,54,324,49,275,602,554,11,27,10,21
E02005124,8658,6140,1531,4609,105,781,149,632,1583,1455,17,93,18,49
E02005125,2497,1845,472,1373,27,206,33,173,408,371,4,30,3,11
E02005126,2038,1615,428,1187,14,124,22,102,280,252,2,17,9,5
E02005127,4165,3272,903,2369,58,231,39,192,575,518,7,44,6,29
E02005128,2444,1772,536,1236,26,269,62,207,363,333,5,19,6,14
E02005129,4546,3274,1017,2257,53,451,88,363,718,643,16,46,13,50
E02005130,2497,1785,569,1216,17,241,40,201,407,359,17,26,5,47
E02005131,1764,1257,408,849,11,140,36,104,289,228,29,26,6,67
E02005132,3900,2347,629,1718,13,271,119,152,1236,1151,17,56,12,33
E02005133,1859,1400,405,995,8,91,45,46,336,306,3,22,5,24
E02005134,3199,2171,522,1649,15,219,104,115,773,708,23,41,1,21
E02005135,4869,3249,838,2411,28,416,201,215,1149,982,80,63,24,27
E02005136,1476,1116,303,813,2,84,37,47,268,252,2,14,0,6
E02005137,1432,1001,233,768,2,177,112,65,243,216,1,26,0,9
E02005138,2204,1487,432,1055,7,141,71,70,550,516,6,25,3,19
E02005139,1629,1179,374,805,3,80,44,36,345,318,7,16,4,22
E02005140,1822,1429,478,951,3,78,42,36,295,276,5,12,2,17
E02005141,3310,2349,749,1600,13,173,82,91,729,656,7,58,8,46
E02005142,7593,5156,1354,3802,25,632,327,305,1740,1612,9,105,14,40
E02005143,1472,1027,306,721,2,98,45,53,335,301,1,29,4,10
E02005144,2175,1500,408,1092,11,264,144,120,391,347,6,33,5,9
E02005145,3551,2488,725,1763,17,234,130,104,768,665,24,48,31,44
E02005146,1723,1222,333,889,1,113,48,65,358,334,4,19,1,29
E02005147,4063,2570,744,1826,11,321,167,154,1128,1038,14,63,13,33
E02005148,1151,864,265,599,2,42,18,24,233,214,1,16,2,10
E02005149,3879,2973,724,2249,45,308,59,249,528,473,6,40,9,25
E02005150,4498,3145,777,2368,70,568,92,476,696,652,11,27,6,19
E02005151,4502,3266,858,2408,98,552,107,445,554,501,6,36,11,32
E02005153,8693,6332,1593,4739,150,921,190,731,1239,1135,18,70,16,51
E02005154,4870,3641,1094,2547,65,459,78,381,628,531,40,40,17,77
E02005155,8454,6544,1444,5100,150,541,99,442,1162,1066,13,79,4,57
E02005156,2710,1957,622,1335,30,311,42,269,370,300,24,30,16,42
E02005157,1022,718,210,508,11,191,20,171,88,76,2,8,2,14
E02005158,2607,2029,603,1426,37,191,32,159,318,272,28,15,3,32
E02005159,1323,974,341,633,14,215,23,192,111,100,4,7,0,9
E02005160,9541,6212,1826,4386,189,1365,178,1187,1688,1494,92,91,11,87
E02005161,3432,2404,690,1714,69,353,51,302,570,527,10,30,3,36
E02005162,5428,3741,1140,2601,78,613,87,526,939,842,37,44,16,57
E02005163,2402,1717,492,1225,29,259,29,230,369,347,5,13,4,28
E02005164,4681,3083,892,2191,71,670,92,578,828,771,15,38,4,29
E02005165,2991,2171,681,1490,36,342,59,283,402,372,8,15,7,40
E02005166,1979,1292,384,908,29,389,43,346,253,234,4,13,2,16
E02005167,2421,1892,663,1229,9,149,18,131,311,255,36,13,7,60
E02005168,2623,1907,580,1327,34,165,26,139,487,445,5,30,7,30
E02005169,13628,8974,2447,6527,185,1125,135,990,3234,3031,39,148,16,110
E02005170,2570,1726,606,1120,31,281,38,243,513,471,20,11,11,19
E02005171,1693,928,307,621,16,297,40,257,443,425,8,10,0,9
E02005172,3149,2253,787,1466,21,260,31,229,529,452,33,36,8,86
E02005173,4353,3058,909,2149,44,282,36,246,931,881,5,34,11,38
E02005174,3432,2342,822,1520,54,392,63,329,553,504,19,24,6,91
E02005175,3395,2443,851,1592,35,341,61,280,483,397,44,36,6,93
E02005176,2479,1968,594,1374,6,120,41,79,361,328,2,26,5,24
E02005177,4276,3465,1000,2465,8,199,70,129,579,514,6,50,9,25
E02005178,10864,8553,2610,5943,40,576,188,388,1596,1431,10,144,11,99
E02005179,3227,2458,688,1770,1,239,87,152,506,461,4,37,4,23
E02005180,984,825,246,579,1,46,13,33,111,94,1,15,1,1
E02005181,1380,1001,262,739,1,93,23,70,272,248,2,21,1,13
E02005182,2109,1576,492,1084,10,141,44,97,364,329,0,33,2,18
E02005183,719,591,171,420,0,57,23,34,68,62,0,6,0,3
E02005184,1285,1054,369,685,5,34,16,18,176,158,2,13,3,16
E02005185,3211,2443,744,1699,11,261,89,172,472,421,3,42,6,24
E02005186,4538,3627,985,2642,8,236,79,157,649,597,0,44,8,18
E02005189,1253,806,226,580,9,272,25,247,158,140,1,7,10,8
E02005190,1914,1521,572,949,7,127,39,88,239,211,1,19,8,20
E02005191,1946,1577,474,1103,5,144,21,123,212,179,8,21,4,8
E02005192,1946,1591,462,1129,10,121,37,84,214,194,0,18,2,10
E02005193,2686,2236,659,1577,11,168,61,107,254,227,4,21,2,17
E02005194,4898,3794,1080,2714,18,406,120,286,648,570,9,64,5,32
E02005195,3290,2779,861,1918,14,130,35,95,343,295,9,37,2,24
E02005196,4693,3857,1101,2756,27,302,82,220,483,452,1,22,8,24
E02005197,2331,1830,556,1274,16,210,65,145,256,231,0,21,4,19
E02005198,7265,5797,1605,4192,23,530,162,368,880,774,7,94,5,35
E02005199,2235,1858,645,1213,14,116,41,75,230,204,5,19,2,17
E02005200,1248,956,251,705,9,110,37,73,164,151,0,12,1,9
E02005201,2023,1628,482,1146,7,168,72,96,197,185,0,8,4,23
E02005202,3409,2718,830,1888,6,199,84,115,460,403,2,45,10,26
E02005203,5731,4445,1183,3262,29,234,66,168,963,746,95,61,61,60
E02005204,5237,3931,1042,2889,29,364,97,267,876,787,11,56,22,37
E02005205,3245,2753,783,1970,10,134,40,94,324,273,7,32,12,24
E02005206,2757,2127,565,1562,7,118,40,78,489,443,3,41,2,16
E02005207,2007,1671,436,1235,4,44,11,33,270,240,8,21,1,18
E02005208,5770,4127,1137,2990,27,229,62,167,1312,1218,9,78,7,75
E02005209,10150,8788,2163,6625,29,247,71,176,1049,931,15,91,12,37
E02005210,2530,2032,641,1391,10,75,15,60,392,359,2,30,1,21
E02005211,5235,4142,1187,2955,13,169,48,121,871,773,8,83,7,40
E02005212,2966,2302,777,1525,10,156,58,98,480,432,2,37,9,18
E02005213,7255,5627,1539,4088,11,420,135,285,1143,1034,9,86,14,54
E02005214,2326,1818,499,1319,5,117,38,79,372,330,4,34,4,14
E02005215,3524,2734,809,1925,7,209,74,135,542,489,5,46,2,32
E02005216,1865,1428,450,978,4,121,48,73,300,280,0,19,1,12
E02005217,4597,3631,1277,2354,17,297,105,192,613,542,4,60,7,39
E02005218,2272,1732,533,1199,5,155,52,103,357,317,2,34,4,23
E02005219,5146,4082,1269,2813,10,290,95,195,729,657,3,60,9,35
E02005220,1163,966,311,655,3,44,15,29,138,122,0,11,5,12
E02005221,4063,3222,1080,2142,23,214,155,59,562,495,10,53,4,42
E02005222,2247,1732,795,937,15,99,60,39,343,269,20,46,8,58
E02005223,1869,1549,558,991,11,56,39,17,231,201,3,24,3,22
E02005224,1330,981,309,672,7,63,32,31,264,238,4,21,1,15
E02005225,2129,1666,583,1083,21,117,72,45,306,267,4,32,3,19
E02005226,4320,3114,902,2212,48,210,95,115,914,819,12,75,8,34
E02005228,913,735,235,500,6,30,18,12,139,121,0,18,0,3
E02005229,1364,882,274,608,12,78,33,45,378,351,6,19,2,14
E02005230,5066,3743,1122,2621,36,318,189,129,938,857,7,69,5,31
E02005231,1483,1134,298,836,11,125,101,24,195,172,1,18,4,18
E02005233,2514,1993,555,1438,10,142,103,39,357,327,0,30,0,12
E02005234,13520,9946,2800,7146,99,689,398,291,2665,2457,21,162,25,121
E02005235,1480,1060,336,724,7,42,21,21,352,324,4,23,1,19
E02005236,4639,3770,1037,2733,17,178,103,75,640,564,8,65,3,34
E02005237,2097,1596,532,1064,12,133,88,45,342,304,2,32,4,14
E02005238,988,788,249,539,0,53,38,15,136,119,1,15,1,11
E02005239,5438,3904,1389,2515,25,146,87,59,1284,1129,64,78,13,79
E02005240,1890,1526,465,1061,3,63,24,39,285,264,3,16,2,13
E02005241,1574,1270,445,825,1,42,23,19,245,230,2,12,1,16
E02005242,2435,1956,581,1375,8,99,38,61,354,326,4,22,2,18
E02005243,1579,1194,412,782,4,97,57,40,267,235,5,20,7,17
E02005244,2309,1722,532,1190,2,195,104,91,369,338,2,27,2,21
E02005245,1938,1607,535,1072,2,63,31,32,248,216,4,25,3,18
E02005246,4184,3142,979,2163,8,275,124,151,727,666,7,48,6,32
E02005247,2884,2255,759,1496,5,126,53,73,469,425,3,35,6,29
E02005248,3627,2823,957,1866,16,214,110,104,539,490,3,39,7,35
E02005249,2900,2130,776,1354,9,210,87,123,532,489,5,32,6,19
E02005250,3716,2988,1057,1931,14,172,76,96,515,469,3,39,4,27
E02005251,1248,996,342,654,2,95,54,41,146,124,2,18,2,9
E02005252,4248,3363,1078,2285,15,215,90,125,617,544,8,64,1,38
E02005253,2319,1859,661,1198,10,111,29,82,317,264,5,33,15,22
E02005254,2760,2269,747,1522,12,102,21,81,334,287,4,37,6,43
E02005255,1725,1496,455,1041,4,56,10,46,163,147,1,14,1,6
E02005256,15660,12438,3106,9332,89,959,226,733,2110,1910,22,165,13,64
E02005257,772,505,133,372,5,172,26,146,82,76,1,5,0,8
E02005258,3379,2783,863,1920,23,181,37,144,368,330,6,27,5,24
E02005259,4193,3108,826,2282,25,413,111,302,620,525,31,35,29,27
E02005260,1381,1137,339,798,3,91,22,69,140,126,0,13,1,10
E02005261,4159,3023,716,2307,23,533,165,368,558,497,7,47,7,22
E02005262,6496,4934,1190,3744,37,440,97,343,1059,963,8,83,5,26
E02005263,2521,1901,570,1331,20,194,36,158,378,342,3,29,4,28
E02005264,9136,6811,1858,4953,43,612,102,510,1625,1490,15,107,13,45
E02005265,1847,1373,383,990,14,194,46,148,252,232,3,16,1,14
E02005266,3636,2685,778,1907,25,340,72,268,539,492,6,38,3,47
E02005267,2851,2044,613,1431,20,309,67,242,453,414,4,30,5,25
E02005268,2627,1906,601,1305,9,245,48,197,445,412,3,22,8,22
E02005269,20722,15693,4422,11271,108,1529,298,1231,3230,2974,45,193,18,162
E02005270,3231,2173,914,1259,27,125,35,90,835,707,74,33,21,71
E02005271,5241,4072,1304,2768,31,294,81,213,804,709,15,73,7,40
E02005272,2554,1947,686,1261,8,195,45,150,381,341,4,33,3,23
E02005273,1740,1369,528,841,6,82,24,58,247,197,9,18,23,36
E02005274,2963,2318,744,1574,5,148,27,121,468,409,7,41,11,24
E02005275,2684,2104,724,1380,14,138,35,103,410,360,8,38,4,18
E02005276,4075,3204,943,2261,15,179,51,128,640,557,26,45,12,37
E02005277,7192,6273,1615,4658,23,196,61,135,647,556,13,62,16,53
E02005278,1679,1400,434,966,6,74,31,43,189,158,5,22,4,10
E02005279,4976,3822,1166,2656,14,412,157,255,698,617,6,68,7,30
E02005280,2418,1869,587,1282,3,196,100,96,327,291,1,34,1,23
E02005281,4437,3503,1099,2404,21,305,125,180,577,519,2,55,1,31
E02005284,1465,1128,343,785,4,111,43,68,215,187,0,27,1,7
E02005285,3323,2696,807,1889,14,170,79,91,431,391,3,34,3,12
E02005286,1770,1413,409,1004,2,141,83,58,202,179,2,21,0,12
E02005287,1647,1421,444,977,8,66,10,56,142,128,1,11,2,10
E02005288,2441,2023,608,1415,5,120,29,91,279,259,2,14,4,14
E02005289,1054,913,299,614,5,49,11,38,82,75,0,6,1,5
E02005290,2203,1728,497,1231,13,128,22,106,324,294,5,24,1,10
E02005291,1026,829,251,578,2,59,9,50,130,111,6,8,5,6
E02005292,821,612,167,445,6,103,16,87,95,85,0,6,4,5
E02005293,2746,2189,662,1527,12,231,44,187,299,264,2,32,1,15
E02005294,9828,7516,2028,5488,35,869,187,682,1369,1239,6,107,17,39
E02005295,1801,1460,436,1024,9,105,16,89,208,183,5,19,1,19
E02005296,2209,1865,541,1324,6,98,27,71,221,187,14,17,3,19
E02005297,2089,1697,641,1056,9,77,15,62,290,263,7,16,4,16
E02005298,6213,4944,1280,3664,29,427,99,328,786,720,7,54,5,27
E02005299,4293,3399,899,2500,18,381,48,333,470,413,5,48,4,25
E02005300,3354,2396,606,1790,25,362,69,293,556,529,6,20,1,15
E02005301,3238,2660,750,1910,20,253,31,222,288,252,4,30,2,17
E02005302,2854,2265,604,1661,20,171,47,124,381,351,2,26,2,17
E02005303,1117,801,214,587,6,186,10,176,120,105,2,10,3,4
E02005304,2591,2143,789,1354,17,88,52,36,326,277,15,25,9,17
E02005305,2669,1965,764,1201,30,105,58,47,535,488,10,27,10,34
E02005306,2854,2236,780,1456,19,142,88,54,425,354,10,53,8,32
E02005307,3676,3038,905,2133,15,257,181,76,347,301,3,34,9,19
E02005308,3449,2888,988,1900,16,191,146,45,331,296,3,29,3,23
E02005309,1465,1137,374,763,13,100,71,29,207,196,0,8,3,8
E02005310,8155,6457,1842,4615,30,508,324,184,1118,1036,9,62,11,42
E02005311,2793,2190,690,1500,5,202,132,70,374,335,5,32,2,22
E02005312,2925,2338,559,1779,7,246,194,52,328,308,2,15,3,6
E02005313,5726,4293,1008,3285,14,725,611,114,674,629,1,43,1,20
E02005314,3199,2429,646,1783,12,367,288,79,374,346,2,26,0,17
E02005315,1437,1209,431,778,7,72,51,21,139,127,0,11,1,10
E02005316,1627,1301,295,1006,2,170,145,25,149,135,1,12,1,5
E02005317,909,649,164,485,2,135,124,11,112,104,1,7,0,11
E02005318,5863,4307,1029,3278,43,584,445,139,901,830,7,52,12,28
E02005319,4190,3018,817,2201,20,299,67,232,817,758,7,46,6,36
E02005320,940,716,217,499,6,90,23,67,116,100,5,9,2,12
E02005321,1755,1361,380,981,7,131,35,96,232,179,24,25,4,24
E02005322,2207,1813,653,1160,14,71,13,58,284,237,8,32,7,25
E02005323,2344,1813,518,1295,8,174,49,125,327,297,6,23,1,22
E02005324,3850,3023,1166,1857,45,170,41,129,544,488,19,34,3,68
E02005325,3285,2664,991,1673,33,131,21,110,433,379,11,37,6,24
E02005326,3045,2326,667,1659,15,114,25,89,570,511,14,40,5,20
E02005327,2214,1842,767,1075,14,85,23,62,244,212,2,23,7,29
E02005328,3049,2680,721,1959,10,79,26,53,262,229,0,31,2,18
E02005329,3222,2702,706,1996,14,91,21,70,400,359,4,34,3,15
E02005330,1455,1262,351,911,7,29,5,24,143,129,3,11,0,14
E02005331,4824,3945,1129,2816,26,163,40,123,648,584,9,53,2,42
E02005332,1169,997,309,688,0,17,2,15,147,136,0,10,1,8
E02005334,1028,848,248,600,2,67,48,19,106,96,0,9,1,5
E02005335,2873,1987,577,1410,19,207,129,78,632,602,8,16,6,28
E02005336,6502,4960,1211,3749,41,439,276,163,1036,975,4,47,10,26
E02005337,2053,1552,467,1085,13,146,80,66,325,306,4,14,1,17
E02005338,15941,12418,2845,9573,124,913,508,405,2423,2198,21,176,28,63
E02005339,4461,3691,919,2772,25,213,121,92,522,472,4,39,7,10
E02005340,3501,2726,696,2030,29,271,140,131,454,409,2,39,4,21
E02005341,3923,3174,870,2304,34,242,125,117,450,421,2,24,3,23
E02005342,2025,1661,496,1165,12,133,64,69,207,186,0,15,6,12
E02005343,1590,1351,405,946,8,81,47,34,139,122,0,15,2,11
E02005344,2141,1768,558,1210,10,143,76,67,208,174,13,19,2,12
E02005345,1392,1076,342,734,8,116,54,62,187,164,6,13,4,5
E02005346,12303,9210,2638,6572,97,1051,634,417,1877,1744,12,91,30,68
E02005347,7049,5125,1550,3575,56,555,341,214,1262,1162,19,73,8,51
E02005348,1068,849,278,571,4,59,43,16,149,138,3,7,1,7
E02005349,2217,1802,564,1238,16,157,105,52,232,208,1,17,6,10
E02005350,2938,2256,647,1609,24,237,142,95,405,358,6,34,7,16
E02005351,4039,2794,915,1879,23,218,143,75,975,917,8,43,7,29
E02005352,2710,2182,778,1404,13,142,98,44,332,291,7,29,5,41
E02005353,3985,2984,819,2165,33,374,269,105,554,499,8,40,7,40
E02005354,2580,2013,611,1402,23,111,67,44,413,380,4,25,4,20
E02005355,1920,1505,452,1053,19,124,83,41,257,223,10,18,6,15
E02005356,2759,2164,667,1497,21,184,124,60,368,335,3,26,4,22
E02005357,1837,1450,416,1034,8,125,100,25,243,203,21,15,4,11
E02005358,2055,1619,457,1162,13,190,158,32,219,189,2,23,5,14
E02005359,1710,1404,471,933,8,80,60,20,196,176,2,18,0,22
E02005360,1849,1429,552,877,11,107,75,32,260,218,22,12,8,42
E02005361,4204,3267,939,2328,33,305,193,112,574,522,10,36,6,25
E02005362,1223,997,285,712,10,65,35,30,143,122,4,16,1,8
E02005363,1108,935,317,618,6,52,36,16,107,92,2,12,1,8
E02005364,1434,1184,350,834,7,72,41,31,165,152,4,8,1,6
E02005365,5292,4148,1331,2817,33,434,253,181,650,596,8,41,5,27
E02005366,1516,1216,342,874,8,88,65,23,190,170,2,15,3,14
E02005368,1829,1359,552,807,11,75,32,43,317,271,23,15,8,67
E02005369,3090,2501,859,1642,22,195,81,114,348,312,9,23,4,24
E02005370,2299,1937,523,1414,23,94,37,57,232,202,6,16,8,13
E02005371,3602,2823,935,1888,31,204,68,136,503,449,16,34,4,41
E02005372,11094,7777,2125,5652,98,1063,591,472,2055,1912,25,96,22,101
E02005373,2676,2162,637,1525,27,121,38,83,344,297,21,23,3,22
E02005374,5641,4256,1251,3005,86,400,125,275,851,764,18,67,2,48
E02005375,3663,2762,714,2048,51,216,51,165,618,570,11,28,9,16
E02005376,6698,5075,1357,3718,87,523,206,317,977,902,3,57,15,36
E02005377,2669,2147,658,1489,11,195,134,61,299,269,3,20,7,17
E02005378,1627,1394,420,974,8,74,44,30,146,134,2,9,1,5
E02005379,1325,1106,335,771,4,77,45,32,130,114,1,13,2,8
E02005380,3362,2581,887,1694,23,236,163,73,486,407,29,20,30,36
E02005381,3786,2997,951,2046,15,298,216,82,450,401,3,37,9,26
E02005382,2258,1740,552,1188,17,210,125,85,275,249,9,14,3,16
E02005383,2717,2102,658,1444,13,258,157,101,330,301,0,28,1,14
E02005384,2865,2334,737,1597,14,133,77,56,345,310,4,23,8,39
E02005385,2943,2403,729,1674,21,150,95,55,349,323,4,19,3,20
E02005386,5936,4627,1321,3306,39,448,278,170,800,715,17,56,12,22
E02005387,5682,4513,1116,3397,41,371,249,122,732,659,4,60,9,25
E02005388,2689,2044,550,1494,28,165,89,76,428,394,1,32,1,24
E02005389,1151,973,311,662,0,71,51,20,103,93,0,6,4,4
E02005390,3383,2658,747,1911,19,197,109,88,492,449,4,25,14,17
E02005391,3209,2334,888,1446,21,178,139,39,611,542,21,32,16,65
E02005392,3546,2713,861,1852,33,256,181,75,528,479,16,19,14,16
E02005393,3018,2344,772,1572,25,207,139,68,404,360,12,18,14,38
E02005394,5030,3559,1034,2525,51,435,294,141,952,870,17,57,8,33
E02005395,4033,3028,838,2190,41,323,238,85,607,552,9,37,9,34
E02005396,3197,2322,777,1545,21,185,114,71,602,534,31,28,9,67
E02005397,11269,8526,2195,6331,88,791,537,254,1819,1690,15,101,13,45
E02005398,4364,3405,934,2471,35,233,154,79,654,589,12,50,3,37
E02005399,7108,5475,1571,3904,56,581,375,206,947,860,12,66,9,49
E02005400,1594,1300,442,858,11,103,72,31,170,153,4,11,2,10
E02005401,2050,1585,495,1090,14,142,105,37,285,248,8,25,4,24
E02005402,1325,1045,325,720,12,122,99,23,133,120,0,12,1,13
E02005403,1172,944,257,687,9,86,70,16,125,112,1,8,4,8
E02005404,2132,1627,472,1155,9,203,157,46,282,267,1,13,1,11
E02005405,1432,1084,302,782,13,201,132,69,118,107,0,8,3,16
E02005406,7457,5614,1627,3987,56,711,479,232,1040,938,17,77,8,36
E02005407,3007,2429,674,1755,33,173,119,54,354,313,2,36,3,18
E02005408,2839,2207,695,1512,11,263,210,53,332,295,7,28,2,26
E02005409,7806,5921,1613,4308,57,706,497,209,1084,1001,5,67,11,38
E02005412,4173,3273,1016,2257,36,263,176,87,571,528,7,33,3,30
E02005414,5425,4122,1247,2875,46,490,363,127,723,685,3,18,17,44
E02005415,4969,3771,1140,2631,29,449,275,174,692,630,6,48,8,28
E02005416,1199,1055,362,693,15,28,17,11,96,90,0,6,0,5
E02005417,3294,2214,759,1455,16,205,68,137,804,720,39,29,16,55
E02005418,2430,1299,388,911,38,317,149,168,762,718,9,22,13,14
E02005419,11428,8057,2365,5692,120,927,355,572,2244,2064,47,99,34,80
E02005420,901,573,171,402,13,126,46,80,183,158,4,16,5,6
E02005422,2157,1579,528,1051,9,160,74,86,387,344,14,20,9,22
E02005423,2942,1998,684,1314,24,354,136,218,542,487,19,23,13,24
E02005424,2147,1783,669,1114,10,57,23,34,265,208,22,29,6,32
E02005425,2378,1913,690,1223,19,106,28,78,319,282,11,21,5,21
E02005426,4340,3259,1044,2215,25,314,102,212,715,655,9,49,2,27
E02005427,4029,2931,970,1961,25,291,83,208,745,668,14,51,12,37
E02005428,2399,1724,702,1022,22,171,45,126,448,398,10,39,1,34
E02005429,1096,793,357,436,12,64,11,53,206,184,9,12,1,21
E02005430,1895,1430,689,741,15,101,34,67,295,241,25,19,10,54
E02005431,2731,2026,837,1189,22,162,48,114,478,397,32,40,9,43
E02005432,2596,1862,793,1069,9,99,35,64,523,441,44,26,12,103
E02005433,2366,1560,650,910,34,174,50,124,569,512,20,37,0,29
E02005434,3519,2643,963,1680,32,194,56,138,619,538,23,44,14,31
E02005435,1719,1170,385,785,19,134,44,90,387,348,11,27,1,9
E02005436,2915,2113,798,1315,28,216,69,147,528,465,10,47,6,30
E02005437,4680,3203,1070,2133,61,328,83,245,1063,976,18,66,3,25
E02005438,1752,1128,394,734,26,173,48,125,413,394,7,12,0,12
E02005439,6261,4568,1177,3391,56,261,116,145,1309,814,288,58,149,67
E02005440,1358,969,395,574,11,103,50,53,239,181,32,25,1,36
E02005441,2303,1732,684,1048,17,142,55,87,352,305,30,13,4,60
E02005442,766,481,122,359,9,189,172,17,79,71,1,5,2,8
E02005443,1810,1258,356,902,10,200,165,35,329,296,4,27,2,13
E02005444,9533,6975,1873,5102,72,680,497,183,1715,1557,36,97,25,91
E02005445,8244,5704,1519,4185,55,874,675,199,1559,1380,27,142,10,52
E02005446,11285,8081,2164,5917,77,707,517,190,2352,2153,34,146,19,68
E02005447,9001,6393,1693,4700,73,734,536,198,1746,1593,26,107,20,55
E02005448,1016,676,142,534,8,185,150,35,137,120,3,12,2,10
E02005449,4236,2968,734,2234,32,329,245,84,877,801,17,54,5,30
E02005450,3797,2967,783,2184,28,240,166,74,541,491,9,38,3,21
E02005451,2156,1437,344,1093,12,364,298,66,330,291,8,29,2,13
E02005452,2382,1837,519,1318,11,218,173,45,303,264,8,27,4,13
E02005453,2101,1677,465,1212,10,88,56,32,297,243,21,25,8,29
E02005455,5521,4129,1185,2944,47,340,263,77,942,818,37,74,13,63
E02005456,5424,3923,824,3099,29,280,157,123,1164,575,383,39,167,28
E02005457,1927,1501,497,1004,11,144,107,37,250,219,15,10,6,21
E02005458,2125,1616,522,1094,12,140,107,33,311,257,11,30,13,46
E02005459,2046,1493,538,955,13,187,164,23,296,250,18,22,6,57
E02005460,3763,2733,685,2048,16,172,110,62,807,392,272,23,120,35
E02005461,1949,1336,403,933,9,153,125,28,410,351,22,20,17,41
E02005462,6764,5033,1293,3740,46,544,385,159,1082,967,25,77,13,59
E02005463,1448,1120,289,831,11,87,48,39,221,200,4,12,5,9
E02005464,3815,2353,661,1692,25,313,238,75,1078,998,28,31,21,46
E02005465,2454,1936,712,1224,16,192,143,49,295,258,14,20,3,15
E02005466,3132,1942,556,1386,35,219,147,72,904,839,24,21,20,32
E02005467,2097,1652,523,1129,11,153,101,52,262,235,10,12,5,19
E02005468,2541,1754,632,1122,14,192,146,46,545,452,64,24,5,36
E02005469,6727,4558,1351,3207,74,479,351,128,1573,1419,92,48,14,43
E02005470,7915,5401,1486,3915,92,557,369,188,1812,1664,41,94,13,53
E02005471,4318,2810,878,1932,39,347,248,99,1080,1001,16,42,21,42
E02005472,4468,3198,965,2233,31,420,267,153,773,703,14,42,14,46
E02005473,1593,1189,400,789,28,92,54,38,272,242,7,20,3,12
E02005474,2089,1527,590,937,14,146,109,37,380,342,18,15,5,22
E02005475,1464,1152,416,736,8,116,85,31,177,147,8,19,3,11
E02005476,2966,2206,683,1523,20,214,164,50,495,432,24,27,12,31
E02005477,3597,2747,815,1932,35,233,177,56,541,492,14,30,5,41
E02005478,3006,2297,636,1661,14,242,198,44,419,372,10,28,9,34
E02005479,6753,4580,1230,3350,48,628,480,148,1446,1341,22,68,15,51
E02005480,2468,1689,417,1272,20,349,260,89,400,368,5,22,5,10
E02005481,6470,4582,1194,3388,46,551,401,150,1232,1120,24,69,19,59
E02005482,3655,2609,760,1849,27,265,182,83,651,561,46,22,22,103
E02005483,1842,1368,473,895,10,157,121,36,283,229,18,17,19,24
E02005484,2657,1792,553,1239,14,248,153,95,536,499,8,25,4,67
E02005485,2283,1786,474,1312,32,137,97,40,313,279,7,24,3,15
E02005486,4343,2980,788,2192,71,378,253,125,882,817,24,34,7,32
E02005487,2675,2119,738,1381,21,194,130,64,292,251,16,18,7,49
E02005488,3404,2616,781,1835,32,267,131,136,471,422,20,29,0,18
E02005489,1617,1345,382,963,18,70,44,26,173,154,4,14,1,11
E02005490,1987,1402,386,1016,24,246,192,54,299,272,5,17,5,16
E02005491,7302,5257,1600,3657,64,633,441,192,1252,1118,39,59,36,96
E02005492,3312,2434,866,1568,9,239,86,153,524,464,18,39,3,106
E02005493,2320,1806,563,1243,19,153,51,102,310,271,9,16,14,32
E02005494,3450,2539,922,1617,22,225,68,157,577,513,13,42,9,87
E02005495,5522,4113,1173,2940,62,432,145,287,872,767,31,68,6,43
E02005496,2218,1559,563,996,19,109,38,71,470,392,54,18,6,61
E02005497,2664,1861,501,1360,46,394,134,260,342,299,5,35,3,21
E02005498,1716,1338,516,822,13,101,33,68,232,185,19,24,4,32
E02005499,2072,1633,562,1071,21,110,43,67,274,232,15,23,4,34
E02005500,2620,1918,545,1373,23,138,65,73,505,367,78,28,32,36
E02005501,3056,2498,698,1800,23,116,77,39,383,335,17,19,12,36
E02005502,1947,1534,532,1002,7,127,53,74,251,218,9,18,6,28
E02005503,2063,1360,511,849,9,194,27,167,460,320,78,19,43,40
E02005504,2592,1894,761,1133,5,208,54,154,411,335,48,22,6,74
E02005505,1735,1280,423,857,13,136,24,112,289,253,18,17,1,17
E02005506,1393,1041,376,665,8,111,22,89,203,173,12,18,0,30
E02005507,6577,4616,1450,3166,59,650,163,487,1214,1095,25,75,19,38
E02005508,1889,1478,563,915,7,139,43,96,231,196,11,23,1,34
E02005509,3115,2143,694,1449,15,359,83,276,561,487,39,29,6,37
E02005510,1318,989,421,568,7,119,11,108,175,153,10,11,1,28
E02005511,2699,1748,559,1189,17,228,60,168,676,605,23,38,10,30
E02005512,2920,2071,680,1391,31,213,47,166,538,473,26,31,8,67
E02005513,4328,3067,959,2108,50,327,96,231,821,745,14,55,7,63
E02005514,2327,1490,518,972,13,187,34,153,561,476,41,28,16,76
E02005515,2758,1999,663,1336,29,197,51,146,491,417,35,32,7,42
E02005516,2812,2026,769,1257,24,205,57,148,459,406,27,24,2,98
E02005517,4154,2770,697,2073,39,467,120,347,841,754,13,61,13,37
E02005518,3114,2083,508,1575,36,319,82,237,646,581,22,30,13,30
E02005519,4049,2587,661,1926,48,551,117,434,836,771,18,40,7,27
E02005520,3151,2277,842,1435,18,279,59,220,540,478,20,35,7,37
E02005521,4140,2955,1071,1884,31,381,125,256,705,630,40,26,9,68
E02005522,1450,1043,413,630,10,132,31,101,241,208,11,14,8,24
E02005523,2337,1746,615,1131,21,228,80,148,313,274,9,23,7,29
E02005524,1186,907,330,577,10,122,46,76,134,117,0,16,1,13
E02005525,2290,1761,500,1261,22,153,44,109,339,312,6,19,2,15
E02005526,1612,1256,375,881,15,123,37,86,212,197,4,9,2,6
E02005527,2983,2236,726,1510,29,286,114,172,403,362,3,37,1,29
E02005528,1412,1102,353,749,10,126,45,81,166,148,5,10,3,8
E02005529,3404,2534,742,1792,34,333,179,154,488,445,3,37,3,15
E02005530,2729,1971,599,1372,20,388,257,131,333,292,7,33,1,17
E02005531,1237,932,325,607,6,140,59,81,151,140,2,8,1,8
E02005532,4881,3608,1086,2522,55,557,313,244,635,567,7,58,3,26
E02005533,1927,1496,520,976,9,160,56,104,225,189,16,15,5,37
E02005534,1325,1082,324,758,5,89,24,65,140,124,5,11,0,9
E02005535,4244,3224,892,2332,34,325,151,174,639,581,3,50,5,22
E02005536,4981,3578,1036,2542,34,446,206,240,887,809,14,55,9,36
E02005537,1863,1383,523,860,18,155,55,100,283,241,8,31,3,24
E02005538,1978,1585,648,937,9,93,73,20,262,215,22,22,3,29
E02005539,1928,1507,580,927,7,98,71,27,266,222,9,26,9,50
E02005540,2006,1508,528,980,8,162,121,41,308,279,10,19,0,20
E02005541,1612,1171,374,797,12,168,137,31,247,217,10,15,5,14
E02005542,5685,3896,1259,2637,30,640,473,167,1083,991,14,64,14,36
E02005543,5754,3910,1256,2654,17,639,478,161,1149,1044,14,79,12,39
E02005544,5526,3969,1183,2786,17,561,397,164,943,863,12,53,15,36
E02005545,3583,2856,837,2019,15,212,157,55,480,437,6,30,7,20
E02005546,1691,1174,324,850,1,235,197,38,276,251,3,22,0,5
E02005547,3138,2307,714,1593,10,258,197,61,540,470,9,39,22,23
E02005548,4223,3205,898,2307,12,372,262,110,612,497,34,49,32,22
E02005549,1219,922,339,583,5,95,73,22,178,159,3,9,7,19
E02005550,1477,1111,374,737,3,120,69,51,225,181,19,19,6,18
E02005551,2173,1472,597,875,19,152,27,125,485,427,24,27,7,45
E02005552,3290,2208,898,1310,18,289,63,226,656,562,39,38,17,119
E02005553,2037,1503,656,847,14,147,34,113,339,311,6,17,5,34
E02005554,1691,1189,492,697,17,86,20,66,289,248,22,15,4,110
E02005555,1339,1084,399,685,4,72,15,57,162,148,4,3,7,17
E02005556,1044,787,231,556,12,75,9,66,163,141,7,14,1,7
E02005557,3149,2292,626,1666,20,314,86,228,499,439,11,39,10,24
E02005558,1599,1275,440,835,8,99,27,72,195,165,18,5,7,22
E02005559,3950,2991,866,2125,25,288,76,212,605,521,12,52,20,41
E02005560,3857,2768,726,2042,41,275,59,216,738,674,23,36,5,35
E02005561,15544,11033,3158,7875,123,1433,403,1030,2832,2569,59,159,45,123
E02005562,2225,1665,609,1056,21,138,33,105,340,283,24,25,8,61
E02005563,2268,1775,620,1155,11,128,36,92,325,286,10,26,3,29
E02005564,5790,3885,972,2913,30,327,73,254,1506,788,437,44,237,42
E02005565,1344,1095,396,699,7,68,15,53,151,127,8,11,5,23
E02005566,2445,1876,674,1202,7,176,50,126,337,283,11,35,8,49
E02005567,3205,2402,827,1575,14,230,68,162,526,463,24,28,11,33
E02005568,2482,1836,731,1105,21,176,57,119,387,317,30,29,11,62
E02005569,3075,2198,727,1471,11,203,66,137,594,492,49,34,19,69
E02005570,2581,1775,708,1067,11,225,55,170,525,459,12,53,1,45
E02005571,2413,1418,685,733,6,334,75,259,538,449,51,30,8,117
E02005572,3783,2511,999,1512,24,369,77,292,840,777,9,51,3,39
E02005573,3479,2403,1003,1400,16,363,92,271,621,554,27,37,3,76
E02005574,1746,1258,504,754,12,141,40,101,291,259,11,17,4,44
E02005575,1949,1401,653,748,13,177,41,136,315,266,22,21,6,43
E02005576,1785,1380,571,809,7,121,34,87,260,231,10,14,5,17
E02005577,1546,1100,468,632,7,122,24,98,285,252,7,23,3,32
E02005578,2029,1314,528,786,8,205,53,152,397,337,33,11,16,105
E02005579,4786,3466,1197,2269,35,477,104,373,759,680,18,59,2,49
E02005580,4792,3219,1178,2041,22,550,129,421,932,856,16,55,5,69
E02005581,2306,1619,559,1060,10,199,56,143,418,369,19,26,4,60
E02005582,2313,1638,682,956,16,254,89,165,355,316,8,25,6,50
E02005583,3846,2793,1156,1637,24,381,116,265,592,521,30,36,5,56
E02005584,10873,7207,2044,5163,84,1535,1010,525,2000,1855,22,115,8,47
E02005585,3754,2284,610,1674,40,830,586,244,585,526,9,44,6,15
E02005586,1966,1245,367,878,11,249,191,58,446,413,5,28,0,15
E02005587,2217,1572,462,1110,15,339,263,76,279,259,2,14,4,12
E02005588,3371,2115,545,1570,35,661,416,245,543,493,9,33,8,17
E02005589,3162,2028,595,1433,31,585,421,164,492,444,9,34,5,26
E02005590,26469,17606,4673,12933,246,2890,1751,1139,5560,5092,47,389,32,167
E02005592,2082,1391,513,878,13,198,132,66,448,417,3,26,2,32
E02005593,5003,3142,1030,2112,43,479,312,167,1316,1221,9,83,3,23
E02005594,5397,3685,1082,2603,49,566,390,176,1043,951,14,75,3,54
E02005595,2361,1703,590,1113,12,264,192,72,358,339,2,17,0,24
E02005596,6347,4602,1364,3238,58,754,541,213,898,817,6,63,12,35
E02005597,3753,2706,840,1866,63,518,234,284,442,398,3,35,6,24
E02005598,10574,7826,2229,5597,96,779,402,377,1788,1636,32,109,11,85
E02005599,1578,1209,377,832,11,106,42,64,234,214,4,16,0,18
E02005600,2317,1692,612,1080,19,180,39,141,397,339,37,18,3,29
E02005601,1689,1287,470,817,23,136,44,92,219,191,9,14,5,24
E02005602,4149,3065,1044,2021,27,356,191,165,646,587,15,41,3,55
E02005603,5822,4591,1309,3282,76,379,166,213,746,659,14,72,1,30
E02005604,2660,2024,747,1277,15,204,85,119,367,322,10,30,5,50
E02005605,3670,2829,968,1861,31,255,105,150,513,454,13,39,7,42
E02005606,2001,1404,510,894,9,170,80,90,377,340,12,25,0,41
E02005607,3746,2881,1008,1873,53,316,105,211,448,386,20,37,5,48
E02005608,1890,1416,588,828,14,150,53,97,252,216,13,19,4,58
E02005609,2400,1747,731,1016,35,226,68,158,362,318,11,30,3,30
E02005610,2652,2038,792,1246,25,214,81,133,327,282,8,28,9,48
E02005611,5281,3780,1315,2465,58,461,168,293,910,823,10,68,9,72
E02005612,7606,5104,1120,3984,50,815,606,209,1614,1514,15,74,11,23
E02005613,1060,804,191,613,4,118,103,15,126,116,2,7,1,8
E02005614,12127,8319,1823,6496,74,1355,1010,345,2330,2189,17,111,13,49
E02005615,1823,1408,333,1075,8,196,164,32,202,175,3,22,2,9
E02005616,3771,2612,586,2026,27,499,389,110,607,551,9,46,1,26
E02005617,1080,731,177,554,8,169,150,19,168,152,0,13,3,4
E02005619,1821,1379,490,889,12,127,46,81,269,236,14,13,6,34
E02005620,3770,2996,818,2178,22,215,96,119,478,436,10,22,10,59
E02005621,7513,4924,1186,3738,121,712,321,391,1709,1566,13,79,51,47
E02005622,3600,2690,801,1889,27,228,94,134,610,545,23,33,9,45
E02005623,3338,2544,776,1768,35,250,139,111,461,409,10,37,5,48
E02005624,3322,2332,509,1823,54,326,94,232,595,560,2,32,1,15
E02005625,5819,3991,983,3008,82,736,258,478,981,924,9,39,9,29
E02005626,4497,3190,813,2377,76,536,189,347,677,610,4,47,16,18
E02005627,2409,1751,552,1199,11,234,94,140,386,361,0,20,5,27
E02005628,2277,1704,575,1129,15,188,62,126,349,315,11,20,3,21
E02005629,2094,1466,525,941,25,200,50,150,353,308,17,20,8,50
E02005630,4706,3406,1076,2330,45,396,119,277,766,635,90,34,7,93
E02005631,4441,3112,865,2247,31,331,113,218,915,864,5,37,9,52
E02005632,1662,1331,397,934,5,145,40,105,172,148,5,15,4,9
E02005633,2561,1900,493,1407,12,254,59,195,382,347,4,30,1,13
E02005634,2594,1915,491,1424,21,246,61,185,404,366,7,31,0,8
E02005635,2425,1909,444,1465,10,163,39,124,318,284,15,16,3,25
E02005636,5960,4406,1133,3273,53,592,146,446,873,797,7,61,8,36
E02005637,3030,2215,604,1611,21,330,67,263,443,399,2,39,3,21
E02005638,1476,1247,331,916,6,51,19,32,160,143,4,10,3,12
E02005639,2689,1943,550,1393,11,196,126,70,495,444,12,39,0,44
E02005640,3022,2235,598,1637,36,238,135,103,490,456,2,31,1,23
E02005641,1945,1535,418,1117,6,128,76,52,265,247,8,10,0,11
E02005642,1727,1369,373,996,12,90,47,43,253,235,3,12,3,3
E02005643,1250,880,188,692,7,183,144,39,174,157,0,16,1,6
E02005644,4288,3098,837,2261,38,350,212,138,772,709,11,50,2,30
E02005645,13847,10247,2472,7775,129,1075,613,462,2298,2106,20,157,15,98
E02005646,1267,1080,309,771,6,41,22,19,137,119,0,10,8,3
E02005647,6369,4877,1137,3740,39,469,259,210,953,876,6,67,4,31
E02005648,1402,1146,329,817,9,65,40,25,175,164,3,3,5,7
E02005649,4328,3117,747,2370,49,286,155,131,841,794,5,40,2,35
E02005650,2247,1754,488,1266,22,95,57,38,363,340,1,20,2,13
E02005651,10653,7998,1777,6221,158,617,412,205,1837,1703,11,117,6,43
E02005652,1362,1023,302,721,10,117,75,42,194,177,1,16,0,18
E02005653,3247,2210,514,1696,38,371,275,96,612,567,1,39,5,16
E02005654,769,500,114,386,16,127,110,17,122,112,0,6,4,4
E02005655,1934,1535,376,1159,23,130,101,29,232,209,2,18,3,14
E02005656,2151,1477,371,1106,28,284,225,59,350,324,2,21,3,12
E02005657,2621,1988,561,1427,28,204,127,77,387,361,2,19,5,14
E02005658,1003,677,179,498,8,133,111,22,179,155,1,19,4,6
E02005659,567,450,114,336,1,44,35,9,69,63,0,4,2,3
E02005660,2509,1817,402,1415,28,256,187,69,391,361,2,26,2,17
E02005661,948,715,184,531,7,95,77,18,129,115,2,9,3,2
E02005662,1782,1278,331,947,12,164,124,40,315,281,6,24,4,13
E02005663,668,549,148,401,3,18,11,7,92,77,1,12,2,6
E02005664,2543,1753,451,1302,24,220,145,75,531,485,5,28,13,15
E02005665,1252,978,197,781,12,67,40,27,186,170,1,14,1,9
E02005666,2568,1660,380,1280,29,406,293,113,452,418,8,26,0,21
E02005667,3961,2776,636,2140,52,347,243,104,760,708,1,41,10,26
E02005668,1274,1057,274,783,11,64,42,22,134,118,0,15,1,8
E02005669,821,687,221,466,5,35,26,9,85,77,1,7,0,9
E02005670,9507,5945,1416,4529,138,1146,708,438,2209,2051,10,122,26,69
E02005671,2701,1885,488,1397,21,207,137,70,573,531,8,30,4,15
E02005672,3717,2381,596,1785,64,336,190,146,915,833,10,58,14,21
E02005673,5234,3552,884,2668,78,506,327,179,1056,978,6,66,6,42
E02005674,18115,12947,3078,9869,237,1421,859,562,3419,3178,26,180,35,91
E02005675,1187,866,161,705,27,106,73,33,183,164,4,14,1,5
E02005676,1523,1106,232,874,13,184,131,53,213,194,0,16,3,7
E02005677,21100,15144,3278,11866,306,1669,997,672,3881,3619,21,212,29,100
E02005678,5573,3581,766,2815,116,473,254,219,1377,1314,6,46,11,26
E02005679,3392,2713,485,2228,35,143,75,68,485,441,2,38,4,16
E02005680,1537,1219,233,986,8,84,43,41,214,205,0,9,0,12
E02005681,2703,2085,631,1454,33,223,91,132,332,293,10,16,13,30
E02005682,2059,1580,467,1113,7,134,61,73,296,268,9,8,11,42
E02005683,4660,3591,843,2748,70,290,115,175,666,602,17,41,6,43
E02005684,4388,3445,1029,2416,49,289,101,188,562,510,9,34,9,43
E02005685,2906,2209,616,1593,70,221,70,151,371,338,8,19,6,35
E02005686,3319,2373,716,1657,33,258,76,182,592,531,18,30,13,63
E02005687,2415,1854,587,1267,24,148,55,93,354,300,16,29,9,35
E02005688,2614,1991,563,1428,56,159,57,102,372,341,0,16,15,36
E02005689,1591,1295,332,963,11,101,23,78,177,168,1,7,1,7
E02005690,4762,3425,729,2696,65,428,133,295,799,726,20,48,5,45
E02005691,2776,1726,542,1184,21,179,50,129,644,571,35,16,22,206
E02005692,1610,1251,376,875,14,138,56,82,187,166,5,14,2,20
E02005693,5025,3712,918,2794,49,458,172,286,785,740,5,38,2,21
E02005694,2247,1790,514,1276,10,129,48,81,307,274,2,30,1,11
E02005695,3199,2377,598,1779,34,232,86,146,526,460,12,50,4,30
E02005696,3985,2563,563,2000,64,508,213,295,829,769,3,49,8,21
E02005697,5834,4201,1101,3100,71,604,177,427,917,828,8,72,9,41
E02005698,920,689,182,507,6,126,50,76,96,87,1,8,0,3
E02005699,3597,2572,602,1970,39,397,127,270,567,518,5,44,0,22
E02005700,3519,2696,798,1898,30,254,116,138,504,449,10,37,8,35
E02005701,4340,3050,799,2251,33,328,118,210,893,834,10,40,9,36
E02005702,2779,1698,510,1188,14,295,179,116,702,459,126,29,88,70
E02005703,4206,2780,871,1909,20,629,456,173,682,587,27,41,27,95
E02005704,3014,2200,728,1472,12,356,265,91,392,337,14,32,9,54
E02005705,2446,1513,648,865,6,210,122,88,566,454,53,28,31,151
E02005706,4858,3174,1065,2109,13,821,248,573,772,687,25,56,4,78
E02005707,2141,1344,562,782,3,298,74,224,417,374,20,15,8,79
E02005708,4018,2292,988,1304,9,427,158,269,988,852,68,48,20,302
E02005709,2964,2064,564,1500,10,579,452,127,296,244,10,38,4,15
E02005710,5550,3973,1032,2941,9,858,652,206,666,602,8,50,6,44
E02005711,917,618,140,478,3,174,140,34,113,94,1,15,3,9
E02005712,1599,1109,283,826,0,285,245,40,192,164,6,20,2,13
E02005713,676,597,158,439,0,14,13,1,63,56,0,3,4,2
E02005714,664,602,140,462,1,26,20,6,34,28,0,6,0,1
E02005715,9848,7423,1689,5734,34,1315,919,396,1022,919,5,85,13,54
E02005716,1319,1019,255,764,0,170,132,38,120,97,1,18,4,10
E02005717,1038,795,264,531,2,121,106,15,103,86,0,8,9,17
E02005718,2138,1714,409,1305,5,156,120,36,250,217,3,30,0,13
E02005719,2285,1757,482,1275,4,312,229,83,198,174,1,20,3,14
E02005720,2792,2136,601,1535,4,314,200,114,317,278,9,22,8,21
E02005721,1808,1394,365,1029,5,169,88,81,218,195,2,20,1,22
E02005722,4510,3288,1004,2284,11,358,209,149,735,675,11,32,17,118
E02005723,4355,3238,891,2347,10,522,308,214,533,470,16,38,9,52
E02005724,3387,2805,795,2010,7,239,139,100,284,259,2,17,6,52
E02005725,6298,5176,1171,4005,19,431,305,126,617,552,12,47,6,55
E02005726,2079,1404,463,941,6,170,103,67,457,327,73,16,41,42
E02005727,2630,1631,679,952,24,262,100,162,620,516,45,35,24,93
E02005728,2200,1524,720,804,6,202,90,112,401,360,17,14,10,67
E02005729,1842,1340,451,889,10,167,97,70,268,244,4,17,3,57
E02005730,7338,5207,1802,3405,37,836,382,454,1144,1021,29,70,24,114
E02005731,4114,3153,787,2366,12,521,343,178,397,333,7,54,3,31
E02005732,4209,2973,1011,1962,21,398,198,200,734,663,24,37,10,83
E02005733,2872,1965,838,1127,18,245,100,145,551,476,20,41,14,93
E02005734,1585,1206,343,863,1,182,97,85,186,173,2,7,4,10
E02005735,4585,3343,901,2442,17,569,311,258,625,546,7,65,7,31
E02005736,3220,2432,588,1844,5,353,195,158,402,359,12,27,4,28
E02005737,1881,1401,371,1030,8,223,119,104,233,206,2,23,2,16
E02005738,1846,1410,353,1057,3,196,117,79,225,200,3,20,2,12
E02005739,1866,1411,356,1055,2,248,140,108,196,180,1,12,3,9
E02005740,2372,1787,473,1314,2,301,197,104,266,228,3,30,5,16
E02005741,2433,1918,470,1448,5,255,158,97,238,205,5,26,2,17
E02005742,2769,2106,910,1196,19,119,47,72,465,418,4,33,10,60
E02005743,3057,2218,836,1382,18,140,31,109,600,519,30,27,24,81
E02005744,3160,2398,1030,1368,7,174,51,123,510,442,20,43,5,71
E02005745,1999,1452,551,901,6,52,17,35,437,386,24,15,12,52
E02005746,4306,3347,1091,2256,15,213,88,125,687,631,10,39,7,44
E02005747,4925,3566,1172,2394,19,374,138,236,925,844,14,53,14,41
E02005748,2852,2176,711,1465,9,124,39,85,502,439,13,36,14,41
E02005749,4001,3099,979,2120,13,187,72,115,662,589,9,53,11,40
E02005750,4272,3313,1112,2201,14,378,94,284,516,464,10,38,4,51
E02005751,2277,1777,710,1067,19,165,51,114,271,251,8,12,0,45
E02005752,1826,1340,673,667,7,93,17,76,330,277,14,28,11,56
E02005753,12778,9282,2760,6522,63,1283,200,1083,2025,1729,107,120,69,125
E02005754,2709,1828,657,1171,8,220,65,155,614,525,29,33,27,39
E02005755,2433,1771,647,1124,7,175,31,144,433,363,30,27,13,47
E02005756,4734,3158,940,2218,17,246,59,187,1233,680,365,51,137,80
E02005757,3586,2402,863,1539,17,329,59,270,751,645,30,51,25,87
E02005758,4605,3141,1071,2070,20,391,73,318,960,742,114,40,64,93
E02005759,5480,3917,1352,2565,35,363,113,250,1091,976,47,47,21,74
E02005760,2782,1990,717,1273,18,190,58,132,535,340,99,24,72,49
E02005761,2489,1635,717,918,22,130,56,74,602,493,54,36,19,100
E02005762,2809,1816,583,1233,18,238,117,121,710,440,146,29,95,27
E02005763,4358,2856,943,1913,26,271,134,137,1101,800,146,66,89,104
E02005764,4387,3061,1002,2059,12,401,238,163,837,724,56,40,17,76
E02005765,2554,1831,611,1220,14,156,105,51,501,444,19,22,16,52
E02005766,2412,1838,790,1048,10,105,57,48,416,368,15,25,8,43
E02005767,2083,1628,509,1119,15,104,57,47,298,259,14,17,8,38
E02005768,2565,1793,536,1257,14,215,119,96,508,361,69,19,59,35
E02005769,2716,2045,680,1365,18,180,82,98,437,380,12,40,5,36
E02005770,1602,1257,398,859,7,87,52,35,231,208,3,18,2,20
E02005771,1683,1231,318,913,7,121,62,59,318,293,2,19,4,6
E02005772,3401,2481,757,1724,20,187,94,93,688,640,8,34,6,25
E02005773,6432,4621,1344,3277,40,498,273,225,1219,1102,20,85,12,54
E02005774,2420,1730,519,1211,18,223,88,135,424,386,4,26,8,25
E02005775,10650,7197,2104,5093,75,585,294,291,2681,2488,35,136,22,112
E02005776,3988,2911,1037,1874,18,240,157,83,731,640,30,50,11,88
E02005777,6011,4454,1301,3153,39,331,178,153,1153,1067,16,66,4,34
E02005778,5189,3197,977,2220,29,215,117,98,1625,1501,39,43,42,123
E02005779,5827,4202,1263,2939,28,276,140,136,1271,1178,20,61,12,50
E02005780,5689,4322,1160,3162,32,173,92,81,1122,1030,12,69,11,40
E02005781,1667,1266,461,805,16,85,51,34,274,245,7,17,5,26
E02005782,2824,1948,760,1188,13,154,94,60,604,507,37,37,23,105
E02005783,3936,2727,891,1836,14,375,254,121,780,616,69,47,48,40
E02005784,2342,1492,432,1060,7,213,97,116,607,336,154,32,85,23
E02005785,8162,4586,1015,3571,36,808,389,419,2668,1079,878,73,638,64
E02005786,3154,2167,1125,1042,21,210,93,117,658,528,39,61,30,98
E02005787,3506,2350,988,1362,29,204,108,96,785,645,64,45,31,138
E02005788,2863,2038,933,1105,14,193,26,167,522,466,21,26,9,96
E02005789,4743,3430,1417,2013,15,363,49,314,844,728,34,57,25,91
E02005790,3346,2129,1008,1121,15,226,61,165,819,685,83,30,21,157
E02005791,2870,1938,726,1212,8,196,32,164,606,513,55,28,10,122
E02005794,5332,3781,1448,2333,29,326,81,245,1060,922,74,43,21,136
E02005795,3383,2351,882,1469,19,335,67,268,633,564,11,36,22,45
E02005796,2238,1478,727,751,18,210,41,169,470,411,14,27,18,62
E02005797,2140,1510,605,905,11,211,40,171,390,343,7,35,5,18
E02005798,2907,2194,1006,1188,8,199,48,151,435,371,19,33,12,71
E02005799,1930,1533,565,968,8,82,19,63,280,257,0,17,6,27
E02005800,5627,3732,1163,2569,26,358,95,263,1435,1316,22,74,23,76
E02005801,874,602,184,418,4,118,35,83,147,135,1,10,1,3
E02005802,3045,2208,687,1521,11,150,28,122,652,599,8,38,7,24
E02005803,5316,4025,1265,2760,24,255,68,187,972,879,28,51,14,40
E02005804,5398,3367,1071,2296,30,315,70,245,1634,1514,20,77,23,52
E02005805,2950,2273,680,1593,13,146,43,103,496,441,10,32,13,22
E02005806,1672,1211,320,891,14,177,47,130,258,234,1,19,4,12
E02005807,4494,3351,1091,2260,17,271,78,193,803,730,11,50,12,52
E02005808,3488,2554,982,1572,21,250,65,185,610,544,8,47,11,53
E02005809,3459,2800,797,2003,7,191,156,35,404,347,32,20,5,57
E02005810,2479,1894,638,1256,20,176,128,48,341,294,12,28,7,48
E02005811,2840,2196,697,1499,11,169,104,65,423,369,15,29,10,41
E02005812,5369,3901,1058,2843,25,550,386,164,854,797,12,42,3,39
E02005813,7611,5489,1550,3939,54,784,464,320,1239,1155,21,55,8,45
E02005814,1391,1082,342,740,6,154,88,66,143,129,2,10,2,6
E02005815,2214,1711,502,1209,11,126,72,54,348,321,0,21,6,18
E02005816,3140,2606,849,1757,10,144,83,61,357,323,7,19,8,23
E02005817,1617,1283,396,887,9,116,95,21,191,169,3,18,1,18
E02005818,5264,4134,1272,2862,29,357,294,63,703,648,12,31,12,41
E02005819,1283,993,344,649,3,115,89,26,158,140,4,11,3,14
E02005820,646,487,145,342,4,56,46,10,91,84,0,7,0,8
E02005821,5145,3887,1023,2864,31,441,328,113,760,683,4,64,9,26
E02005822,9036,7064,2015,5049,34,727,507,220,1155,1023,11,116,5,56
E02005823,4024,2988,828,2160,17,454,366,88,544,467,9,59,9,21
E02005824,3334,2614,788,1826,17,270,219,51,415,375,4,32,4,18
E02005825,4213,3256,917,2339,19,406,301,105,511,467,7,36,1,21
E02005826,2403,1857,580,1277,10,233,174,59,291,264,0,22,5,12
E02005827,2816,2249,626,1623,8,204,161,43,334,304,1,25,4,21
E02005828,8011,6243,1533,4710,30,530,370,160,1174,1085,8,73,8,34
E02005829,1088,893,302,591,0,84,72,12,106,88,4,13,1,5
E02005830,1216,1004,346,658,4,68,52,16,122,103,3,13,3,18
E02005831,1777,1337,348,989,7,173,136,37,248,231,1,14,2,12
E02005832,3746,2787,800,1987,17,347,247,100,565,509,6,45,5,30
E02005833,1324,1118,336,782,3,75,50,25,117,104,2,9,2,11
E02005834,2957,2313,585,1728,6,292,224,68,329,298,1,25,5,17
E02005835,3519,2791,818,1973,16,269,200,69,411,355,10,44,2,32
E02005836,3393,2737,930,1807,13,203,132,71,397,352,6,30,9,43
E02005837,2805,2264,774,1490,11,152,128,24,329,283,10,27,9,49
E02005838,2206,1779,601,1178,1,177,143,34,224,196,7,19,2,25
E02005839,2717,2071,606,1465,10,227,190,37,388,354,8,23,3,21
E02005840,1647,1352,338,1014,2,79,59,20,197,182,2,12,1,17
E02005842,2591,1937,610,1327,5,256,215,41,367,322,12,27,6,26
E02005843,5385,4095,1170,2925,20,421,321,100,814,765,3,39,7,35
E02005844,3211,2459,732,1727,11,290,217,73,427,373,11,39,4,24
E02005846,2771,2035,580,1455,8,279,223,56,423,374,9,35,5,26
E02005847,5130,3887,1171,2716,21,437,346,91,734,673,7,39,15,51
E02005848,6166,3762,1066,2696,32,760,577,183,1467,1378,29,39,21,145
E02005849,6420,5056,1576,3480,36,414,298,116,844,728,38,63,15,70
E02005850,1853,1526,493,1033,6,115,90,25,194,167,3,23,1,12
E02005851,2951,2277,666,1611,11,253,175,78,394,339,6,44,5,16
E02005852,3071,2487,678,1809,7,165,102,63,384,347,0,35,2,28
E02005853,2580,2028,586,1442,13,200,154,46,326,296,4,18,8,13
E02005856,1568,1325,488,837,6,68,48,20,145,128,4,10,3,24
E02005857,989,764,206,558,4,85,57,28,130,117,1,11,1,6
E02005858,1011,740,226,514,6,84,70,14,162,148,1,13,0,19
E02005859,3103,2406,676,1730,15,235,165,70,433,386,5,34,8,14
E02005860,6403,4584,1373,3211,38,577,429,148,1158,1072,14,64,8,46
E02005861,2835,2091,597,1494,15,194,128,66,520,500,3,15,2,15
E02005862,1732,1185,304,881,4,146,104,42,378,170,130,8,70,19
E02005863,3320,2453,749,1704,10,265,186,79,560,521,8,24,7,32
E02005864,3006,2293,626,1667,21,213,149,64,460,420,11,22,7,19
E02005865,4579,3871,1087,2784,22,191,124,67,454,400,8,40,6,41
E02005866,2760,2089,660,1429,14,217,106,111,418,376,7,24,11,22
E02005868,952,768,241,527,6,68,27,41,93,81,1,11,0,17
E02005869,3246,2437,719,1718,19,387,217,170,385,350,0,31,4,18
E02005870,3186,2349,663,1686,21,316,196,120,472,430,3,33,6,28
E02005871,1316,1058,361,697,7,71,30,41,173,157,1,12,3,7
E02005872,1422,1165,398,767,7,58,35,23,182,152,10,17,3,10
E02005873,2756,2208,665,1543,10,164,123,41,356,314,8,29,5,18
E02005874,1795,1471,466,1005,10,85,53,32,218,192,6,18,2,11
E02005875,1185,962,278,684,8,77,40,37,129,109,3,16,1,9
E02005876,2013,1540,419,1121,7,167,83,84,278,254,2,13,9,21
E02005877,1080,830,249,581,5,65,34,31,174,157,2,15,0,6
E02005878,2500,1873,547,1326,25,186,96,90,400,361,3,33,3,16
E02005879,6529,4715,1300,3415,24,652,377,275,1108,1021,5,74,8,30
E02005880,842,633,189,444,7,82,54,28,110,103,0,7,0,10
E02005881,1615,1223,388,835,3,142,87,55,226,207,2,12,5,21
E02005882,1047,885,252,633,3,60,44,16,88,78,0,8,2,11
E02005883,2587,2001,592,1409,9,239,179,60,314,282,0,28,4,24
E02005884,1963,1554,497,1057,3,136,100,36,257,228,2,25,2,13
E02005885,1765,1290,369,921,6,185,150,35,272,238,4,26,4,12
E02005886,2991,2421,720,1701,7,227,147,80,321,291,0,27,3,15
E02005887,10954,8164,2331,5833,47,985,693,292,1685,1522,12,133,18,73
E02005888,2760,1955,548,1407,9,298,211,87,473,413,5,50,5,25
E02005889,2119,1618,464,1154,3,230,180,50,259,235,2,17,5,9
E02005890,1396,1154,342,812,1,65,48,17,162,150,1,10,1,14
E02005891,3555,2746,713,2033,18,368,262,106,413,371,3,33,6,10
E02005892,7306,5704,1614,4090,22,504,364,140,1035,963,2,66,4,41
E02005893,4890,3790,1085,2705,19,438,271,167,580,521,10,41,8,63
E02005894,2913,2319,733,1586,17,194,122,72,364,316,10,34,4,19
E02005895,3350,2476,875,1601,12,217,157,60,589,525,19,30,15,56
E02005896,3064,2162,781,1381,18,207,158,49,650,590,12,43,5,27
E02005897,4703,3535,1147,2388,18,410,280,130,680,583,23,64,10,60
E02005898,2822,2219,661,1558,6,239,136,103,343,304,4,30,5,15
E02005899,13235,9029,2395,6634,81,1240,918,322,2807,2601,33,151,22,78
E02005900,2966,2314,850,1464,6,151,111,40,454,398,11,35,10,41
E02005901,3476,2733,801,1932,15,229,182,47,480,441,6,27,6,19
E02005902,1285,942,260,682,11,152,133,19,163,148,2,13,0,17
E02005903,1975,1605,484,1121,12,112,91,21,224,193,5,22,4,22
E02005904,3142,2467,710,1757,13,193,135,58,443,408,6,22,7,26
E02005905,2526,2043,715,1328,14,119,71,48,326,282,6,33,5,24
E02005906,2338,1851,632,1219,16,143,75,68,294,253,14,19,8,34
E02005907,2807,2207,611,1596,21,208,86,122,349,312,4,19,14,22
E02005908,2264,1750,563,1187,16,166,58,108,317,277,8,29,3,15
E02005909,1962,1477,449,1028,11,134,74,60,327,300,1,20,6,13
E02005910,8469,6362,1883,4479,55,583,354,229,1413,1314,5,89,5,56
E02005911,2259,1700,532,1168,27,196,95,101,323,290,7,18,8,13
E02005912,4527,3373,972,2401,36,356,213,143,737,659,6,66,6,25
E02005913,1789,1442,496,946,12,104,53,51,219,193,2,21,3,12
E02005914,1717,1279,374,905,14,197,88,109,219,200,1,14,4,8
E02005915,2505,1861,633,1228,30,175,97,78,403,358,10,20,15,36
E02005916,4132,3098,772,2326,37,303,198,105,669,619,4,39,7,25
E02005917,2791,2247,750,1497,17,145,73,72,367,346,1,15,5,15
E02005918,1334,1072,313,759,9,99,37,62,144,128,6,10,0,10
E02005919,4746,3706,1160,2546,26,256,157,99,707,640,11,39,17,51
E02005920,1821,1462,551,911,9,87,49,38,245,221,4,15,5,18
E02005921,1899,1451,547,904,10,121,31,90,285,249,10,13,13,32
E02005922,1260,878,185,693,10,116,20,96,246,229,1,15,1,10
E02005923,4952,3365,822,2543,45,533,128,405,990,928,8,46,8,19
E02005924,14400,9677,2365,7312,166,1364,359,1005,3087,2891,32,139,25,106
E02005925,751,496,110,386,2,168,49,119,77,68,1,7,1,8
E02005926,4125,3207,908,2299,31,223,57,166,607,557,14,30,6,57
E02005927,2613,1945,564,1381,26,205,40,165,431,407,3,19,2,6
E02005928,3539,2655,831,1824,28,222,39,183,581,509,19,41,12,53
E02005929,2266,1731,622,1109,14,136,32,104,318,253,32,21,12,67
E02005930,2835,2053,734,1319,28,219,50,169,492,449,8,18,17,43
E02005931,3398,2301,716,1585,24,263,62,201,734,462,140,35,97,76
E02005932,1066,823,151,672,4,85,11,74,147,139,2,5,1,7
E02005933,5468,3871,946,2925,57,506,131,375,1000,928,14,48,10,34
E02005934,1820,1411,365,1046,16,155,39,116,225,206,1,10,8,13
E02005935,5738,3940,856,3084,63,477,123,354,1199,1113,24,51,11,59
E02005936,4623,3331,1033,2298,54,393,116,277,771,643,54,43,31,74
E02005937,1837,1361,448,913,24,160,67,93,252,225,2,22,3,40
E02005938,861,645,220,425,10,89,22,67,106,100,0,6,0,11
E02005939,7740,5767,1477,4290,105,576,220,356,1241,1142,18,70,11,51
E02005940,1754,1208,386,822,19,126,72,54,387,368,5,12,2,14
E02005941,2926,1873,643,1230,35,214,126,88,740,636,62,34,8,64
E02005942,2888,1886,715,1171,50,202,120,82,676,616,11,29,20,74
E02005943,944,655,252,403,11,96,74,22,174,162,2,9,1,8
E02005944,837,473,151,322,18,204,160,44,139,129,1,8,1,3
E02005945,12690,8029,2249,5780,179,1244,560,684,3118,2874,75,108,61,120
E02005946,2044,1304,385,919,27,205,151,54,483,459,6,13,5,25
E02005947,26629,15632,5200,10432,370,2208,1187,1021,7894,7218,245,257,174,525
E02005948,6636,4078,1211,2867,108,524,258,266,1857,1732,31,69,25,69
E02005949,6764,4201,1304,2897,88,573,332,241,1855,1742,34,58,21,47
E02005950,4505,2416,870,1546,70,521,275,246,1401,1300,13,60,28,97
E02005951,977,561,211,350,12,125,85,40,262,250,1,9,2,17
E02005952,12322,7992,2110,5882,238,1571,844,727,2469,2276,33,129,31,52
E02005953,1225,805,301,504,27,130,89,41,245,227,2,12,4,18
E02005954,6305,4103,1150,2953,138,613,348,265,1401,1300,19,64,18,50
E02005955,5006,3131,798,2333,101,695,422,273,1030,973,10,37,10,49
E02005956,1881,995,277,718,41,536,334,202,299,278,3,14,4,10
E02005957,942,448,126,322,44,299,131,168,146,137,1,3,5,5
E02005958,3785,2908,791,2117,36,256,65,191,563,510,14,32,7,22
E02005959,2294,1688,653,1035,20,192,80,112,335,293,17,15,10,59
E02005960,4384,3314,1003,2311,54,424,131,293,557,496,13,37,11,35
E02005961,3283,2293,788,1505,41,331,83,248,576,513,30,26,7,42
E02005962,2321,1823,601,1222,25,169,35,134,264,232,4,21,7,40
E02005963,4140,2941,979,1962,57,410,103,307,674,605,27,28,14,58
E02005964,2307,1714,571,1143,27,190,48,142,337,300,14,15,8,39
E02005965,2078,1444,506,938,17,156,32,124,395,335,27,22,11,66
E02005966,2736,1876,460,1416,37,319,55,264,487,449,13,22,3,17
E02005967,3545,2391,645,1746,36,501,84,417,583,451,64,34,34,34
E02005968,5640,3475,1080,2395,76,385,69,316,1631,837,477,50,267,73
E02005969,4842,3291,1072,2219,66,541,93,448,909,781,48,49,31,35
E02005970,1048,744,200,544,19,127,22,105,152,135,8,9,0,6
E02005971,1051,776,224,552,13,109,18,91,136,122,5,6,3,17
E02005972,2320,1723,598,1125,21,210,44,166,318,262,32,17,7,48
E02005973,3950,2757,931,1826,31,328,64,264,779,697,30,39,13,55
E02005974,3425,2402,778,1624,36,317,83,234,633,578,14,24,17,37
E02005975,3131,2395,869,1526,23,206,49,157,426,344,52,23,7,81
E02005976,2643,1853,667,1186,18,201,71,130,455,383,32,25,15,116
E02005977,1720,1352,445,907,17,134,37,97,193,161,12,12,8,24
E02005978,2305,1719,569,1150,17,189,57,132,342,310,9,16,7,38
E02005979,3790,2759,852,1907,52,267,101,166,671,606,24,28,13,41
E02005980,4559,2800,933,1867,41,472,133,339,1027,510,333,21,163,219
E02005981,1105,937,295,642,9,49,12,37,106,95,2,6,3,4
E02005982,2256,1666,447,1219,21,175,54,121,382,335,15,24,8,12
E02005983,10847,7554,2125,5429,137,1242,285,957,1797,1598,71,75,53,117
E02005984,2780,2061,696,1365,24,237,59,178,387,327,29,17,14,71
E02005985,1545,1001,301,700,26,285,69,216,219,194,13,6,6,14
E02005986,2770,1897,612,1285,31,357,66,291,420,376,17,19,8,65
E02005987,5790,4138,1119,3019,65,587,128,459,960,880,16,43,21,40
E02005988,1780,1394,348,1046,16,134,21,113,225,184,20,12,9,11
E02005991,3379,2410,712,1698,66,443,71,372,418,356,24,26,12,42
E02005992,11474,8319,2264,6055,128,669,135,534,2273,2112,42,96,23,85
E02005993,3336,2326,773,1553,38,385,76,309,554,498,16,33,7,33
E02005994,2877,1973,711,1262,30,187,35,152,561,477,45,29,10,126
E02005995,2105,1461,527,934,22,179,39,140,349,302,24,16,7,94
E02005996,2993,2116,713,1403,33,243,46,197,524,458,36,17,13,77
E02005997,1713,1316,471,845,20,154,31,123,209,189,4,13,3,14
E02005998,2588,1865,538,1327,28,196,42,154,465,405,21,28,11,34
E02005999,2931,2055,678,1377,43,297,57,240,471,402,31,23,15,65
E02006000,2648,1970,569,1401,42,271,44,227,343,295,13,21,14,22
E02006001,2717,1947,476,1471,50,319,44,275,380,335,9,29,7,21
E02006002,7955,5438,1521,3917,173,913,123,790,1353,1151,82,72,48,78
E02006003,3538,2538,797,1741,37,366,73,293,578,516,20,30,12,19
E02006004,2934,1981,709,1272,38,246,36,210,542,438,64,18,22,127
E02006005,1515,989,185,804,20,123,15,108,373,233,82,13,45,10
E02006006,5126,3123,678,2445,70,419,84,335,1486,553,569,30,334,28
E02006007,2007,1441,457,984,24,172,28,144,319,269,21,18,11,51
E02006008,2836,2037,596,1441,20,265,168,97,488,427,16,39,6,26
E02006009,4416,3053,921,2132,20,358,194,164,951,470,303,32,146,34
E02006010,3308,2316,900,1416,24,342,226,116,562,501,23,31,7,64
E02006011,1594,1188,419,769,8,122,85,37,246,223,5,12,6,30
E02006012,4235,3125,1126,1999,15,396,269,127,656,596,12,44,4,43
E02006013,3755,2643,968,1675,6,353,260,93,671,592,33,32,14,82
E02006014,2656,1906,850,1056,13,159,101,58,498,430,31,35,2,80
E02006015,4117,2995,1010,1985,26,368,92,276,696,622,30,33,11,32
E02006016,3103,2263,857,1406,19,231,65,166,518,442,33,35,8,72
E02006017,3653,2411,856,1555,23,289,132,157,846,775,26,35,10,84
E02006018,5366,3950,1185,2765,23,489,120,369,849,757,20,55,17,55
E02006019,1925,1400,476,924,14,168,31,137,333,287,13,24,9,10
E02006020,2977,2009,678,1331,18,274,74,200,642,472,92,19,59,34
E02006021,3162,2392,863,1529,27,254,84,170,444,376,23,39,6,45
E02006022,2882,2007,637,1370,14,204,38,166,621,420,130,17,54,36
E02006023,4562,3477,1171,2306,26,408,291,117,586,501,26,48,11,65
E02006024,2741,2045,614,1431,13,282,187,95,380,344,9,21,6,21
E02006025,6382,4582,1472,3110,32,673,435,238,1039,929,12,78,20,56
E02006026,2329,1783,656,1127,15,149,89,60,344,292,14,31,7,38
E02006027,1532,1235,527,708,9,94,63,31,181,161,5,13,2,13
E02006028,3712,2608,933,1675,28,270,85,185,731,648,29,42,12,75
E02006029,7262,5198,1472,3726,48,818,306,512,1159,1058,20,73,8,39
E02006030,3371,2179,574,1605,27,466,151,315,675,617,12,43,3,24
E02006031,1452,1024,275,749,9,156,57,99,253,218,5,18,12,10
E02006032,2513,1835,520,1315,22,315,113,202,323,298,4,19,2,18
E02006033,11508,8330,2558,5772,80,893,282,611,2107,1880,50,129,48,98
E02006034,6439,4926,1402,3524,32,411,104,307,1024,904,25,63,32,46
E02006035,4600,3713,1174,2539,21,268,88,180,560,501,15,41,3,38
E02006036,2738,1979,603,1376,14,250,86,164,460,403,6,46,5,35
E02006037,3730,2805,927,1878,13,321,99,222,549,456,43,44,6,42
E02006038,2391,1752,669,1083,15,204,62,142,381,344,8,21,8,39
E02006039,2962,2184,858,1326,19,224,78,146,496,440,9,28,19,39
E02006040,3401,2497,1020,1477,12,237,70,167,561,503,17,37,4,94
E02006041,2725,1812,860,952,23,269,86,183,534,469,19,40,6,87
E02006042,2048,1518,676,842,27,182,36,146,280,250,13,13,4,41
E02006043,3073,1982,938,1044,37,254,34,220,681,585,59,31,6,119
E02006044,2282,1606,904,702,25,160,28,132,418,387,11,16,4,73
E02006045,5677,3850,1642,2208,97,601,66,535,1060,943,31,76,10,69
E02006046,3307,2419,1084,1335,33,282,31,251,522,463,14,41,4,51
E02006047,4132,3066,1055,2011,25,258,71,187,699,619,23,47,10,84
E02006048,2714,2034,725,1309,13,209,57,152,418,363,20,30,5,40
E02006049,1688,1355,413,942,10,74,25,49,247,223,9,13,2,2
E02006050,3560,2596,837,1759,24,334,95,239,569,521,6,40,2,37
E02006051,2926,2273,878,1395,20,182,46,136,378,341,8,22,7,73
E02006052,4119,3020,987,2033,45,269,64,205,731,660,20,39,12,54
E02006053,3918,2826,871,1955,34,406,132,274,640,587,4,45,4,12
E02006054,4700,3512,1226,2286,51,317,82,235,752,667,19,60,6,68
E02006055,3325,2345,718,1627,52,300,84,216,598,547,5,45,1,30
E02006056,3619,2618,929,1689,26,321,97,224,594,518,30,40,6,60
E02006057,3225,2288,872,1416,39,247,60,187,610,544,11,45,10,41
E02006058,3382,2587,963,1624,43,206,60,146,507,459,7,39,2,39
E02006059,2323,1720,736,984,12,138,38,100,358,310,25,22,1,95
E02006060,5215,3848,1230,2618,60,365,93,272,890,822,6,53,9,52
E02006061,3794,2931,933,1998,24,243,124,119,554,506,8,35,5,42
E02006062,3393,2615,877,1738,26,198,101,97,503,439,22,31,11,51
E02006063,2233,1883,730,1153,11,87,53,34,232,196,4,26,6,20
E02006064,3013,2230,709,1521,18,161,88,73,574,509,11,49,5,30
E02006065,4221,2821,811,2010,51,411,205,206,917,839,19,53,6,21
E02006066,1860,1475,520,955,14,152,102,50,199,161,8,26,4,20
E02006067,2272,1640,664,976,14,182,114,68,381,301,23,44,13,55
E02006068,5135,3768,1032,2736,27,511,312,199,785,702,6,66,11,44
E02006069,7655,5473,1544,3929,41,730,396,334,1355,1206,19,116,14,56
E02006070,3144,2243,571,1672,15,230,121,109,642,586,11,39,6,14
E02006071,1579,1244,379,865,3,80,37,43,239,221,0,16,2,13
E02006072,2390,1994,780,1214,15,102,49,53,236,206,3,17,10,43
E02006073,1923,1284,353,931,7,291,178,113,330,291,6,32,1,11
E02006074,3844,2680,795,1885,34,350,173,177,745,669,8,49,19,35
E02006075,2138,1506,616,890,20,134,40,94,373,323,27,21,2,105
E02006076,2957,2100,839,1261,33,241,71,170,507,415,26,55,11,76
E02006077,2098,1582,576,1006,16,180,59,121,296,260,5,29,2,24
E02006078,2263,1644,580,1064,25,191,47,144,372,340,7,18,7,31
E02006079,3849,2586,877,1709,24,398,130,268,778,703,14,55,6,63
E02006080,5640,3951,1016,2935,41,420,123,297,1149,682,277,55,135,79
E02006081,1825,1317,506,811,16,162,50,112,288,254,9,17,8,42
E02006082,2060,1511,596,915,15,208,47,161,294,249,9,30,6,32
E02006083,1606,1205,410,795,18,178,74,104,192,165,4,19,4,13
E02006084,2017,1525,600,925,17,168,46,122,269,230,15,16,8,38
E02006085,1436,1065,317,748,17,155,68,87,190,157,12,18,3,9
E02006086,3651,2715,756,1959,41,348,116,232,528,466,15,38,9,19
E02006087,2386,1589,399,1190,31,302,93,209,448,383,18,35,12,16
E02006088,3021,2162,576,1586,24,295,108,187,523,443,34,33,13,17
E02006089,7299,4940,1364,3576,80,895,313,582,1295,1145,50,83,17,89
E02006090,2933,2104,552,1552,28,307,103,204,475,412,16,34,13,19
E02006091,2396,1779,663,1116,19,226,79,147,307,256,15,23,13,65
E02006092,10028,8071,2058,6013,84,555,189,366,1263,1082,52,102,27,55
E02006093,3278,2415,797,1618,20,324,134,190,470,418,9,35,8,49
E02006094,1115,852,361,491,6,101,39,62,133,106,9,13,5,23
E02006095,3640,2673,879,1794,28,345,109,236,559,511,6,38,4,35
E02006096,3346,2319,652,1667,46,392,133,259,568,527,4,34,3,21
E02006097,2901,2022,642,1380,29,366,127,239,459,422,11,22,4,25
E02006098,2738,2034,862,1172,16,200,86,114,411,350,21,38,2,77
E02006099,1513,1112,389,723,7,119,77,42,248,222,6,19,1,27
E02006100,3272,2400,698,1702,14,294,191,103,511,462,10,27,12,53
E02006101,2085,1467,584,883,32,211,130,81,341,304,13,22,2,34
E02006102,1701,1188,336,852,10,274,212,62,215,191,2,20,2,14
E02006103,2158,1623,599,1024,27,181,124,57,311,272,8,21,10,16
E02006104,4955,3586,914,2672,27,449,300,149,858,776,6,63,13,35
E02006105,6340,4270,1241,3029,42,701,441,260,1277,1167,19,81,10,50
E02006106,4355,2951,897,2054,33,466,324,142,867,739,48,53,27,38
E02006107,3691,2491,730,1761,32,605,472,133,536,480,6,43,7,27
E02006108,11770,8439,2464,5975,93,934,589,345,2189,1988,27,144,30,115
E02006109,6582,4882,1393,3489,43,424,263,161,1194,1080,30,65,19,39
E02006110,3711,2543,719,1824,25,536,381,155,566,518,3,34,11,41
E02006111,4332,3166,1027,2139,20,376,243,133,700,619,22,55,4,70
E02006112,2693,1946,733,1213,14,199,131,68,491,435,9,20,27,43
E02006113,3858,2489,900,1589,22,429,48,381,849,752,16,70,11,69
E02006114,2054,1200,486,714,21,269,38,231,513,435,29,27,22,51
E02006115,1552,1021,380,641,7,222,21,201,269,217,19,13,20,33
E02006116,4190,3141,1242,1899,20,266,58,208,686,579,31,65,11,77
E02006117,2434,1681,767,914,8,249,45,204,409,328,39,32,10,87
E02006118,1380,1140,344,796,9,79,60,19,141,127,4,8,2,11
E02006119,3839,2931,800,2131,19,392,232,160,475,429,6,34,6,22
E02006120,2688,2133,564,1569,13,180,94,86,351,320,2,29,0,11
E02006121,901,719,197,522,4,71,56,15,101,86,1,13,1,6
E02006122,1715,1353,384,969,5,153,105,48,195,167,7,19,2,9
E02006123,1233,989,249,740,3,118,73,45,116,102,0,14,0,7
E02006124,759,525,153,372,15,148,92,56,68,62,2,4,0,3
E02006125,1607,1202,348,854,10,190,133,57,185,165,4,15,1,20
E02006126,2583,2061,558,1503,8,224,153,71,281,249,1,29,2,9
E02006127,2335,1906,455,1451,13,175,95,80,230,208,2,19,1,11
E02006128,5290,4315,1280,3035,23,436,243,193,487,435,6,40,6,29
E02006129,9917,7288,2002,5286,47,1271,718,553,1261,1167,10,70,14,50
E02006130,4491,3530,1011,2519,31,413,224,189,497,465,4,24,4,20
E02006131,5541,4422,1375,3047,39,377,177,200,624,557,27,37,3,79
E02006132,892,706,211,495,10,94,51,43,77,68,2,6,1,5
E02006133,4614,3529,1140,2389,30,455,200,255,564,503,14,44,3,36
E02006134,2265,1887,587,1300,4,122,56,66,222,195,11,8,8,30
E02006135,1246,1061,304,757,6,59,21,38,111,107,0,3,1,9
E02006136,4041,3087,1048,2039,28,264,126,138,596,498,22,43,33,66
E02006137,4665,3631,979,2652,23,326,124,202,652,594,18,36,4,33
E02006138,2698,2037,604,1433,8,218,81,137,420,379,3,34,4,15
E02006139,5896,4216,1248,2968,38,524,209,315,1091,1007,10,68,6,27
E02006140,1203,866,256,610,6,153,58,95,169,152,1,16,0,9
E02006141,15084,11036,3125,7911,69,1242,502,740,2640,2434,27,156,23,97
E02006142,675,575,153,422,2,18,11,7,71,62,2,7,0,9
E02006143,5045,3760,915,2845,39,338,140,198,872,799,13,53,7,36
E02006144,1273,932,289,643,4,173,74,99,150,132,3,14,1,14
E02006145,3751,2928,857,2071,13,229,102,127,560,514,6,30,10,21
E02006146,2409,1940,631,1309,16,160,72,88,277,249,5,19,4,16
E02006147,6500,4519,1205,3314,52,628,200,428,1264,1159,31,64,10,37
E02006148,1414,1183,388,795,6,75,17,58,134,113,5,15,1,16
E02006149,8092,6142,1691,4451,44,871,167,704,949,853,17,65,14,86
E02006150,4964,3969,1218,2751,37,487,126,361,431,399,2,28,2,40
E02006151,4518,3508,971,2537,25,448,131,317,509,460,5,43,1,28
E02006152,2393,1871,545,1326,16,206,47,159,284,259,4,17,4,16
E02006153,2589,1972,620,1352,11,189,81,108,391,311,36,22,22,26
E02006154,2066,1741,579,1162,12,121,33,88,181,158,4,18,1,11
E02006155,1481,1124,323,801,6,179,42,137,167,155,1,10,1,5
E02006156,3491,2746,853,1893,14,249,97,152,456,410,13,21,12,26
E02006157,4524,3529,1037,2492,29,407,189,218,531,463,22,40,6,28
E02006158,1231,1038,323,715,1,56,20,36,129,113,3,10,3,7
E02006159,1665,1299,417,882,6,184,77,107,169,158,1,7,3,7
E02006160,2297,1773,534,1239,6,273,110,163,230,204,0,22,4,15
E02006161,4194,3220,872,2348,6,415,219,196,522,469,2,41,10,31
E02006162,1671,1319,436,883,9,161,71,90,163,142,3,14,4,19
E02006163,2872,2109,587,1522,10,424,220,204,319,285,3,29,2,10
E02006164,7506,5214,1397,3817,28,1062,525,537,1163,1073,6,67,17,39
E02006165,2443,1862,554,1308,4,278,142,136,280,254,0,25,1,19
E02006166,1722,1411,416,995,3,113,54,59,175,159,0,13,3,20
E02006167,2563,1859,530,1329,10,373,181,192,299,253,5,32,9,22
E02006168,10638,7910,2281,5629,31,1202,596,606,1412,1274,10,110,18,83
E02006169,3861,2836,903,1933,17,328,126,202,651,560,25,47,19,29
E02006170,1308,1049,375,674,6,96,42,54,142,130,2,9,1,15
E02006171,1339,1040,360,680,1,154,68,86,132,119,1,7,5,12
E02006172,1871,1530,531,999,9,160,76,84,158,139,3,12,4,14
E02006173,1743,1360,527,833,7,118,49,69,229,197,11,15,6,29
E02006174,5558,4171,1237,2934,34,550,205,345,746,673,21,50,2,57
E02006175,2871,2051,618,1433,29,373,128,245,397,341,13,27,16,21
E02006176,2113,1508,556,952,10,180,60,120,361,306,27,16,12,54
E02006177,2285,1847,604,1243,8,189,76,113,227,195,8,22,2,14
E02006178,1596,1244,357,887,2,191,45,146,153,129,1,17,6,6
E02006179,4296,3397,932,2465,21,392,203,189,461,419,7,29,6,25
E02006180,1849,1412,448,964,6,240,82,158,170,151,1,17,1,21
E02006181,2718,2083,663,1420,14,325,124,201,276,250,6,17,3,20
E02006182,1368,1110,387,723,3,103,43,60,134,117,6,9,2,18
E02006183,1373,1083,351,732,8,98,43,55,169,147,5,12,5,15
E02006184,1118,880,273,607,3,115,20,95,116,100,1,14,1,4
E02006185,3569,2715,888,1827,15,447,212,235,358,322,8,26,2,34
E02006186,3324,2599,861,1738,13,306,167,139,363,318,13,27,5,43
E02006187,2191,1706,675,1031,9,199,86,113,240,203,9,20,8,37
E02006188,1427,1187,387,800,3,105,63,42,116,98,5,12,1,16
E02006189,2863,2195,733,1462,7,245,137,108,383,341,11,26,5,33
E02006190,4649,3522,1069,2453,12,440,180,260,643,590,5,40,8,32
E02006191,4722,3540,1097,2443,21,504,267,237,616,559,9,46,2,41
E02006192,4284,3316,1101,2215,12,312,146,166,600,530,30,37,3,44
E02006193,4174,3002,836,2166,21,436,199,237,680,632,6,37,5,35
E02006194,1244,886,273,613,9,169,69,100,171,158,5,8,0,9
E02006195,3760,2940,1012,1928,22,283,122,161,474,410,16,40,8,41
E02006196,4496,3439,911,2528,15,364,129,235,651,548,25,50,28,27
E02006197,15202,11501,3282,8219,92,1325,466,859,2181,1972,38,140,31,103
E02006198,9446,7216,1903,5313,50,635,249,386,1499,1182,132,75,110,46
E02006199,3008,2347,726,1621,8,254,106,148,375,327,14,21,13,24
E02006200,1258,924,223,701,10,198,60,138,117,108,1,8,0,9
E02006201,2596,2258,685,1573,13,73,25,48,225,199,4,21,1,27
E02006202,2034,1600,612,988,6,140,76,64,252,203,16,22,11,36
E02006203,1190,888,249,639,10,158,67,91,126,116,2,8,0,8
E02006204,2771,2195,861,1334,13,230,98,132,303,266,3,26,8,30
E02006205,1754,1507,610,897,5,67,30,37,165,145,3,12,5,10
E02006206,1836,1440,440,1000,4,192,89,103,189,162,4,19,4,11
E02006207,1593,1321,467,854,8,116,64,52,131,110,4,15,2,17
E02006208,4567,3656,1186,2470,14,305,127,178,547,485,4,51,7,45
E02006209,4661,3769,1243,2526,9,304,157,147,543,495,7,40,1,36
E02006210,2296,1786,852,934,11,118,47,71,331,257,7,44,23,50
E02006211,1703,1446,557,889,2,94,64,30,147,128,6,10,3,14
E02006212,1909,1586,534,1052,0,135,88,47,176,150,14,12,0,12
E02006213,3515,2642,877,1765,15,278,143,135,529,482,3,34,10,51
E02006214,3460,2788,863,1925,17,260,135,125,369,322,14,29,4,26
E02006215,2213,1890,680,1210,7,105,66,39,192,164,4,23,1,19
E02006216,2397,1980,674,1306,14,154,84,70,224,197,7,18,2,25
E02006217,3111,2477,705,1772,12,286,207,79,319,289,0,21,9,17
E02006218,8625,6444,1718,4726,54,1016,623,393,1068,961,6,89,12,43
E02006219,3389,2726,652,2074,17,279,181,98,352,313,6,31,2,15
E02006220,900,705,203,502,1,79,60,19,107,99,1,6,1,8
E02006221,4450,3299,738,2561,33,505,321,184,598,535,1,57,5,15
E02006222,784,553,134,419,1,115,93,22,108,98,0,10,0,7
E02006223,809,564,133,431,3,178,114,64,61,54,0,7,0,3
E02006224,2742,2006,414,1592,15,258,160,98,449,429,3,16,1,14
E02006225,1056,892,235,657,2,56,28,28,103,96,1,6,0,3
E02006226,4373,3278,838,2440,24,498,320,178,550,510,9,28,3,23
E02006227,2102,1516,585,931,11,221,133,88,282,248,16,9,9,72
E02006228,1885,1291,468,823,8,165,102,63,399,368,9,9,13,22
E02006229,1809,1318,477,841,14,185,110,75,272,245,4,20,3,20
E02006230,4721,3311,1125,2186,27,562,386,176,776,656,55,38,27,45
E02006231,4918,3577,1049,2528,23,533,316,217,752,662,32,47,11,33
E02006232,2042,1517,548,969,7,199,134,65,282,239,6,26,11,37
E02006233,8743,6116,1877,4239,61,1113,692,421,1389,1265,15,89,20,64
E02006234,1521,1089,327,762,4,162,119,43,248,220,5,14,9,18
E02006235,2456,1857,733,1124,12,187,99,88,344,287,34,20,3,56
E02006236,2722,2109,808,1301,19,157,100,57,399,358,11,18,12,38
E02006237,2621,1791,671,1120,8,199,131,68,480,324,96,17,43,143
E02006238,4403,2878,878,2000,42,474,151,323,895,788,47,53,7,114
E02006239,5073,1739,522,1217,19,344,110,234,2629,2364,148,31,86,342
E02006240,3759,1722,583,1139,24,247,71,176,1571,1397,87,29,58,195
E02006241,5085,3437,1026,2411,62,627,235,392,910,825,18,40,27,49
E02006242,2602,1764,561,1203,33,190,64,126,525,463,30,24,8,90
E02006243,6957,4291,1207,3084,133,883,338,545,1432,1265,73,83,11,218
E02006245,1424,1006,300,706,6,240,203,37,155,140,1,12,2,17
E02006246,1846,1466,455,1011,11,135,91,44,226,210,2,13,1,8
E02006247,4993,3453,977,2476,31,678,427,251,807,752,14,35,6,24
E02006248,2071,1603,480,1123,17,200,123,77,239,217,7,14,1,12
E02006249,1908,1360,453,907,17,149,105,44,355,325,7,21,2,27
E02006250,3753,2317,636,1681,37,422,266,156,946,875,11,48,12,31
E02006251,17897,12284,3292,8992,117,1653,977,676,3714,3453,38,189,34,129
E02006252,2888,2185,610,1575,12,199,109,90,473,441,7,24,1,19
E02006253,6856,5204,1487,3717,31,459,257,202,1128,1056,21,42,9,34
E02006254,10542,7777,2020,5757,66,1026,648,378,1631,1509,20,90,12,42
E02006255,2474,1736,477,1259,10,173,98,75,534,498,7,27,2,21
E02006256,2486,1644,447,1197,20,320,192,128,484,447,5,28,4,18
E02006257,1013,708,209,499,5,171,131,40,123,110,4,7,2,6
E02006258,8063,5632,1478,4154,55,869,537,332,1461,1356,24,71,10,46
E02006259,1483,930,252,678,9,321,138,183,206,186,4,15,1,17
E02006260,1646,1123,271,852,9,276,231,45,226,214,5,4,3,12
E02006261,4305,3114,1207,1907,32,388,246,142,700,627,24,41,8,71
E02006262,2828,2139,868,1271,26,178,95,83,441,386,22,22,11,44
E02006263,2599,1884,851,1033,36,182,131,51,422,345,52,19,6,75
E02006264,2316,1757,624,1133,25,186,120,66,310,268,21,17,4,38
E02006265,2014,1563,600,963,17,152,96,56,257,204,32,18,3,25
E02006266,3385,2441,882,1559,38,333,241,92,537,486,15,20,16,36
E02006267,3645,2676,996,1680,25,264,187,77,620,553,28,30,9,60
E02006268,1576,1164,367,797,16,203,144,59,182,156,6,12,8,11
E02006269,1961,1573,487,1086,13,118,82,36,237,214,7,13,3,20
E02006270,6686,4981,1477,3504,82,639,453,186,940,855,15,59,11,44
E02006271,6549,4465,1255,3210,34,565,318,247,1442,876,350,67,149,43
E02006272,3022,2412,740,1672,12,238,150,88,336,293,15,24,4,24
E02006273,2109,1573,544,1029,9,200,89,111,289,237,18,16,18,38
E02006274,2856,1738,544,1194,20,232,111,121,790,391,229,24,146,76
E02006275,1533,973,280,693,20,285,140,145,247,222,7,14,4,8
E02006276,3805,2658,850,1808,43,440,208,232,598,520,24,48,6,66
E02006277,4219,3086,847,2239,53,388,156,232,666,598,17,45,6,26
E02006278,10415,7335,2133,5202,101,928,379,549,1941,1767,36,109,29,110
E02006279,4831,3484,1069,2415,50,465,206,259,798,683,26,74,15,34
E02006280,4170,2784,972,1812,43,371,167,204,864,774,42,32,16,108
E02006281,8804,6201,1739,4462,101,788,346,442,1618,1440,49,107,22,96
E02006282,1715,1268,511,757,13,133,65,68,255,218,14,20,3,46
E02006283,2757,2006,571,1435,25,228,95,133,421,391,9,18,3,77
E02006284,1609,1154,290,864,15,231,111,120,193,176,0,14,3,16
E02006285,1175,866,180,686,12,162,72,90,130,120,1,8,1,5
E02006286,7357,5082,1207,3875,47,1010,513,497,1194,1105,15,61,13,24
E02006287,2153,1523,768,755,19,212,62,150,351,308,19,20,4,48
E02006288,3680,2571,1008,1563,25,325,66,259,651,552,53,37,9,108
E02006289,2618,1848,739,1109,23,313,35,278,395,343,25,21,6,39
E02006290,4569,3290,1155,2135,36,428,49,379,751,671,25,42,13,64
E02006291,2500,1836,728,1108,9,262,40,222,361,338,5,11,7,32
E02006292,2493,1812,697,1115,15,216,69,147,409,371,15,11,12,41
E02006293,4110,2669,942,1727,36,328,52,276,970,684,177,24,85,107
E02006294,4486,3395,1237,2158,27,330,47,283,656,582,33,31,10,78
E02006295,1956,1598,474,1124,13,115,29,86,217,203,6,7,1,13
E02006296,7691,6095,1779,4316,35,352,127,225,1158,1074,23,53,8,51
E02006297,2621,2058,641,1417,10,169,89,80,356,327,11,14,4,28
E02006298,4397,3068,798,2270,18,418,137,281,869,803,10,48,8,24
E02006299,1744,1355,493,862,7,131,31,100,237,212,8,14,3,14
E02006300,2058,1387,388,999,7,253,55,198,397,365,11,19,2,14
E02006301,6669,4829,1232,3597,43,565,164,401,1201,1077,49,64,11,31
E02006302,2402,1809,643,1166,12,168,97,71,379,328,10,31,10,34
E02006303,1814,1322,436,886,3,212,147,65,262,234,1,27,0,15
E02006304,1433,1146,374,772,4,103,44,59,175,157,2,16,0,5
E02006305,5042,3762,1172,2590,25,391,220,171,829,761,6,58,4,35
E02006306,2704,2077,649,1428,10,201,117,84,404,368,3,22,11,12
E02006307,1008,853,337,516,4,54,22,32,90,78,0,10,2,7
E02006308,7262,5328,1601,3727,30,566,286,280,1280,1167,10,97,6,58
E02006309,1018,709,259,450,3,106,58,48,194,173,5,14,2,6
E02006310,1326,1055,316,739,4,81,35,46,175,154,3,18,0,11
E02006311,4638,3398,1145,2253,30,431,228,203,728,671,8,44,5,51
E02006312,2627,1961,719,1242,10,245,116,129,384,345,5,31,3,27
E02006313,3709,2750,895,1855,6,287,133,154,629,543,36,38,12,37
E02006314,3768,2646,980,1666,29,295,177,118,755,671,33,49,2,43
E02006315,2435,1753,755,998,29,198,142,56,388,333,20,28,7,67
E02006316,3620,2497,929,1568,30,343,211,132,722,679,14,23,6,28
E02006317,1019,767,245,522,4,82,30,52,164,152,5,6,1,2
E02006318,2629,1915,567,1348,28,162,67,95,492,450,13,23,6,32
E02006319,2244,1608,443,1165,26,232,76,156,370,349,1,18,2,8
E02006320,1348,940,198,742,23,165,47,118,214,195,8,8,3,6
E02006321,2767,2048,592,1456,20,152,47,105,525,493,7,20,5,22
E02006322,1526,1137,326,811,10,117,37,80,253,231,6,15,1,9
E02006323,3685,2448,706,1742,44,398,126,272,772,724,13,26,9,23
E02006324,2132,1477,429,1048,28,256,99,157,358,304,23,23,8,13
E02006325,1986,1584,490,1094,15,85,27,58,273,249,7,13,4,29
E02006326,1930,1374,399,975,16,157,47,110,368,342,10,13,3,15
E02006327,1444,1085,328,757,12,82,27,55,245,224,8,13,0,20
E02006328,6103,4379,1169,3210,73,452,162,290,1133,1049,33,46,5,66
E02006329,5164,3737,1201,2536,53,395,140,255,933,843,40,38,12,46
E02006330,3643,2670,774,1896,33,302,97,205,599,538,36,24,1,39
E02006331,2239,1666,499,1167,15,140,42,98,405,377,2,19,7,13
E02006332,8806,6004,1473,4531,115,616,293,323,1991,1844,13,87,47,80
E02006333,5149,3631,1128,2503,51,416,156,260,989,872,52,55,10,62
E02006334,2361,1791,626,1165,20,137,52,85,365,327,12,25,1,48
E02006335,1441,1175,359,816,10,62,20,42,184,176,1,6,1,10
E02006336,982,770,183,587,9,85,15,70,114,96,3,12,3,4
E02006337,1871,1571,490,1081,11,70,18,52,209,194,2,11,2,10
E02006338,1131,898,264,634,10,78,15,63,136,120,3,11,2,9
E02006339,2300,1587,396,1191,41,296,65,231,355,323,5,24,3,21
E02006341,4378,3031,803,2228,53,467,136,331,797,741,10,44,2,30
E02006342,9872,6976,1926,5050,106,761,205,556,1946,1779,51,98,18,83
E02006343,3763,2778,825,1953,32,227,54,173,672,571,62,30,9,54
E02006344,3766,2722,939,1783,37,326,179,147,617,462,103,39,13,64
E02006345,3358,2143,650,1493,40,289,134,155,853,350,262,22,219,33
E02006346,3014,2346,827,1519,26,216,104,112,379,327,19,14,19,47
E02006347,2353,1718,448,1270,13,213,67,146,392,268,59,22,43,17
E02006348,3328,2434,761,1673,45,321,205,116,490,430,27,23,10,38
E02006349,1618,1115,292,823,59,166,104,62,267,241,9,13,4,11
E02006350,3574,2302,649,1653,84,600,435,165,562,505,24,23,10,26
E02006351,2492,1738,521,1217,49,278,194,84,406,370,6,23,7,21
E02006352,975,684,187,497,26,106,85,21,153,136,4,10,3,6
E02006353,950,702,203,499,13,151,58,93,81,74,1,3,3,3
E02006354,2616,2001,652,1349,30,160,106,54,397,358,11,20,8,28
E02006355,7783,5164,1332,3832,153,772,551,221,1648,1529,34,63,22,46
E02006356,15675,10566,2917,7649,232,1260,766,494,3471,3148,94,166,63,146
E02006357,1534,1190,349,841,20,151,82,69,164,148,4,9,3,9
E02006358,11128,7524,2123,5401,192,866,560,306,2461,2277,44,107,33,85
E02006359,3198,2330,722,1608,59,243,155,88,536,487,17,19,13,30
E02006360,6711,4920,1325,3595,132,527,341,186,1010,884,63,45,18,122
E02006361,2059,1477,579,898,32,168,90,78,326,285,20,20,1,56
E02006362,1868,1485,484,1001,12,131,22,109,210,187,6,14,3,30
E02006363,1195,966,313,653,5,67,14,53,147,133,5,8,1,10
E02006364,13142,9304,2516,6788,151,1049,279,770,2555,2365,37,126,27,83
E02006365,4517,3301,1009,2292,36,273,61,212,865,792,38,29,6,42
E02006366,1917,1593,534,1059,8,90,19,71,204,186,3,9,6,22
E02006367,1487,1145,373,772,6,158,30,128,164,145,5,11,3,14
E02006368,1739,1347,441,906,6,156,31,125,211,165,23,16,7,19
E02006369,2247,1579,601,978,16,177,37,140,426,299,58,18,51,49
E02006370,6356,4655,1365,3290,92,516,112,404,1014,909,20,65,20,79
E02006371,4813,3408,1011,2397,49,483,91,392,816,748,18,42,8,57
E02006372,1143,766,223,543,14,218,30,188,134,116,7,8,3,11
E02006373,2366,1602,585,1017,29,225,39,186,424,380,15,17,12,86
E02006374,3492,2500,805,1695,39,394,156,238,505,425,19,31,30,54
E02006375,1526,1260,345,915,9,93,28,65,153,134,6,12,1,11
E02006376,4566,3442,967,2475,83,412,165,247,605,546,21,34,4,24
E02006377,2210,1733,494,1239,13,174,43,131,278,244,4,20,10,12
E02006378,1845,1467,418,1049,19,123,49,74,213,182,11,13,7,23
E02006379,957,654,167,487,22,189,47,142,88,79,1,8,0,4
E02006380,4694,3312,858,2454,39,403,166,237,890,834,11,34,11,50
E02006381,5056,3979,966,3013,44,244,97,147,758,710,9,33,6,31
E02006382,1352,897,232,665,15,251,83,168,178,154,13,9,2,11
E02006383,3976,2864,839,2025,41,313,115,198,671,620,18,24,9,87
E02006384,7520,5373,1417,3956,86,671,221,450,1350,1255,31,52,12,40
E02006385,6499,4482,1243,3239,114,709,259,450,1151,1061,12,66,12,43
E02006386,8636,6423,1645,4778,112,568,178,390,1458,1345,25,70,18,75
E02006387,2086,1541,374,1167,31,212,56,156,286,269,2,14,1,16
E02006388,5434,3812,987,2825,96,637,230,407,849,795,11,35,8,40
E02006389,3699,2647,699,1948,48,402,177,225,569,529,10,26,4,33
E02006390,1096,883,250,633,2,118,25,93,89,81,3,4,1,4
E02006391,1492,1112,279,833,15,96,35,61,255,236,6,9,4,14
E02006392,4789,3335,966,2369,58,526,190,336,839,781,9,38,11,31
E02006393,5803,3912,911,3001,63,471,262,209,1317,1236,30,27,24,40
E02006394,3861,2438,759,1679,30,284,163,121,1046,967,44,24,11,63
E02006395,7561,5210,1145,4065,105,519,296,223,1683,1587,20,49,27,44
E02006396,4617,3298,933,2365,69,480,223,257,718,642,14,33,29,52
E02006397,2652,1771,551,1220,30,153,64,89,615,536,52,20,7,83
E02006398,5877,4268,1095,3173,88,526,297,229,949,896,16,29,8,46
E02006399,5846,4340,1136,3204,87,457,259,198,916,826,16,53,21,46
E02006400,7557,5244,1455,3789,99,840,280,560,1312,1189,50,51,22,62
E02006401,2312,1751,506,1245,22,192,127,65,332,282,30,16,4,15
E02006402,3347,2619,834,1785,47,227,143,84,433,360,40,30,3,21
E02006403,1554,952,249,703,53,254,73,181,279,255,5,13,6,16
E02006404,1603,1016,257,759,37,300,74,226,241,223,4,13,1,9
E02006405,4181,3134,881,2253,76,356,132,224,569,521,9,31,8,46
E02006406,9967,6727,1815,4912,138,1011,371,640,2007,1873,34,79,21,84
E02006407,1689,1282,350,932,15,122,39,83,246,226,5,9,6,24
E02006408,5529,4029,983,3046,67,267,96,171,1141,1080,24,28,9,25
E02006409,1132,790,211,579,13,182,37,145,142,136,0,4,2,5
E02006410,3760,2530,666,1864,61,471,164,307,670,627,8,31,4,28
E02006411,1045,828,294,534,10,71,20,51,125,109,4,9,3,11
E02006412,3302,2447,714,1733,44,249,91,158,527,475,12,29,11,35
E02006413,1821,1341,391,950,19,210,56,154,235,217,6,11,1,16
E02006414,2424,1785,471,1314,33,246,74,172,332,299,6,25,2,28
E02006415,2869,2164,660,1504,39,226,64,162,412,372,10,25,5,28
E02006416,3456,2631,837,1794,21,223,65,158,518,451,35,27,5,63
E02006417,2810,2051,520,1531,21,245,49,196,462,411,24,18,9,31
E02006418,1634,1330,386,944,12,97,26,71,188,168,7,12,1,7
E02006419,2023,1434,339,1095,20,259,39,220,297,240,29,17,11,13
E02006420,5056,3759,968,2791,52,379,86,293,833,672,74,42,45,33
E02006421,2674,2114,599,1515,28,160,68,92,328,284,15,16,13,44
E02006422,1106,941,242,699,8,36,14,22,116,101,3,8,4,5
E02006423,7823,5537,1389,4148,124,789,193,596,1330,1192,42,75,21,43
E02006424,1123,922,267,655,6,54,20,34,136,114,4,14,4,5
E02006425,10926,8109,1985,6124,153,755,135,620,1859,1523,167,77,92,50
E02006426,2376,1703,445,1258,37,235,67,168,388,329,19,33,7,13
E02006427,2341,1550,370,1180,28,199,56,143,536,240,166,24,106,28
E02006429,2749,2047,600,1447,42,202,119,83,446,420,3,21,2,12
E02006430,2595,1876,505,1371,44,294,127,167,353,314,16,17,6,28
E02006431,4421,3269,965,2304,53,398,245,153,623,560,31,23,9,78
E02006432,1991,1590,467,1123,13,162,93,69,209,187,10,10,2,17
E02006433,4969,3778,1258,2520,52,419,220,199,655,580,38,32,5,65
E02006434,1348,951,271,680,11,230,149,81,141,125,11,5,0,15
E02006435,2715,2009,640,1369,24,236,123,113,408,361,23,15,9,38
E02006436,2422,1756,494,1262,24,263,164,99,343,290,27,16,10,36
E02006437,3581,2601,831,1770,35,316,178,138,584,442,106,27,9,45
E02006438,3737,2745,787,1958,38,365,167,198,523,460,26,29,8,66
E02006439,2818,2087,602,1485,45,285,139,146,389,341,17,24,7,12
E02006440,1194,953,283,670,8,103,45,58,122,114,4,3,1,8
E02006441,8431,5976,1706,4270,137,759,391,368,1493,1332,33,94,34,66
E02006442,2353,1887,608,1279,20,146,80,66,259,223,19,10,7,41
E02006443,1867,1243,381,862,35,306,215,91,271,239,11,8,13,12
E02006444,1449,1113,349,764,17,112,84,28,192,178,3,8,3,15
E02006445,6475,4481,1353,3128,93,622,435,187,1167,1007,82,63,15,112
E02006446,2290,1702,590,1112,32,172,123,49,344,295,30,10,9,40
E02006447,1614,1265,373,892,10,103,58,45,199,175,6,12,6,37
E02006448,2172,1650,559,1091,25,169,121,48,302,272,13,13,4,26
E02006449,2172,1571,530,1041,41,231,176,55,292,268,10,9,5,37
E02006450,2862,2057,747,1310,30,242,179,63,418,335,52,15,16,115
E02006451,4203,2972,948,2024,46,487,304,183,613,486,85,35,7,85
E02006453,3425,2366,823,1543,54,364,205,159,502,437,32,30,3,139
E02006454,2601,1912,600,1312,24,285,206,79,343,310,8,22,3,37
E02006455,2710,1848,535,1313,31,330,203,127,471,421,14,25,11,30
E02006456,3076,2134,549,1585,38,336,211,125,543,496,8,35,4,25
E02006457,3213,2450,735,1715,32,217,134,83,476,422,16,27,11,38
E02006458,4457,3274,882,2392,62,315,167,148,762,711,13,24,14,44
E02006459,5025,3174,789,2385,65,742,448,294,1001,899,30,52,20,43
E02006460,1537,1117,273,844,23,170,123,47,217,196,6,13,2,10
E02006461,2157,1557,528,1029,28,181,107,74,355,331,15,7,2,36
E02006462,2378,1666,455,1211,58,233,127,106,399,364,15,19,1,22
E02006463,14192,9856,2551,7305,167,1119,626,493,2946,2731,56,125,34,104
E02006464,2210,1625,452,1173,32,194,98,96,341,299,18,17,7,18
E02006465,965,750,241,509,10,55,23,32,139,122,6,9,2,11
E02006466,2902,2046,589,1457,29,367,271,96,442,393,14,24,11,18
E02006467,2014,1542,440,1102,20,173,103,70,243,208,13,7,15,36
E02006468,2752,2202,683,1519,8,225,173,52,304,261,12,28,3,13
E02006469,6231,4450,1087,3363,52,740,445,295,957,882,16,43,16,32
E02006470,8103,6028,1570,4458,51,824,560,264,1149,1019,20,91,19,51
E02006471,8113,6054,1597,4457,72,764,461,303,1174,1092,20,55,7,49
E02006472,2415,1829,579,1250,20,224,152,72,318,287,7,18,6,24
E02006473,8086,6254,1638,4616,49,735,484,251,993,912,12,63,6,55
E02006474,3802,2939,886,2053,21,299,199,100,504,448,5,32,19,39
E02006475,1353,1148,361,787,5,68,49,19,124,107,0,14,3,8
E02006476,1366,1026,260,766,10,157,124,33,170,152,5,12,1,3
E02006477,2936,2431,752,1679,20,161,106,55,311,271,5,32,3,13
E02006478,1025,845,197,648,8,54,29,25,114,104,1,6,3,4
E02006479,8199,6183,1778,4405,52,766,524,242,1152,1027,8,91,26,46
E02006480,1022,794,232,562,1,92,75,17,128,116,0,8,4,7
E02006481,894,699,163,536,4,74,56,18,108,89,1,16,2,9
E02006482,8019,5952,1482,4470,56,627,388,239,1352,1234,15,91,12,32
E02006483,3009,2286,701,1585,15,290,211,79,399,369,1,23,6,19
E02006484,1771,1345,347,998,11,145,95,50,258,233,2,18,5,12
E02006485,2489,2013,596,1417,16,189,135,54,260,219,9,30,2,11
E02006486,981,810,242,568,8,56,35,21,100,86,4,8,2,7
E02006487,2724,2081,611,1470,27,306,213,93,292,261,1,28,2,18
E02006488,1006,814,289,525,3,53,43,10,121,105,6,6,4,15
E02006489,4884,3793,1100,2693,27,385,238,147,664,598,9,52,5,15
E02006490,925,727,216,511,4,71,53,18,119,107,1,11,0,4
E02006492,11331,8497,2352,6145,94,771,402,369,1905,1577,125,95,108,64
E02006493,5397,4006,1071,2935,55,484,265,219,834,783,4,38,9,18
E02006494,8070,5867,1578,4289,85,829,445,384,1249,1149,7,81,12,40
E02006495,2312,1754,512,1242,25,177,97,80,344,294,10,24,16,12
E02006496,2780,1993,570,1423,29,247,142,105,504,459,6,36,3,7
E02006497,3197,2278,631,1647,37,322,178,144,538,502,8,26,2,22
E02006498,1950,1422,366,1056,32,191,81,110,296,280,4,10,2,9
E02006499,1161,972,299,673,6,63,29,34,109,97,3,9,0,11
E02006500,4581,3233,901,2332,41,400,222,178,831,711,70,37,13,76
E02006501,1551,1212,357,855,5,116,78,38,202,174,8,16,4,16
E02006502,1854,1437,434,1003,16,180,123,57,212,191,10,9,2,9
E02006503,2820,2233,753,1480,22,176,113,63,351,310,16,22,3,38
E02006504,2855,2167,743,1424,14,234,125,109,380,334,18,21,7,60
E02006505,2908,2202,761,1441,23,249,63,186,400,358,3,36,3,34
E02006506,2133,1591,449,1142,13,222,106,116,294,271,1,17,5,13
E02006507,3969,2968,932,2036,57,402,80,322,521,465,8,37,11,21
E02006508,3700,2584,881,1703,30,316,77,239,710,637,9,39,25,60
E02006509,3487,2501,736,1765,37,362,85,277,548,507,16,23,2,39
E02006510,2962,2227,754,1473,37,247,55,192,423,377,16,25,5,28
E02006511,4720,3356,1091,2265,68,438,108,330,799,724,29,35,11,59
E02006512,9822,6596,2115,4481,132,1137,195,942,1901,1757,32,95,17,56
E02006513,3032,2320,649,1671,55,158,22,136,473,422,7,33,11,26
E02006514,5331,3730,1229,2501,76,401,44,357,1084,1013,14,50,7,40
E02006515,3386,2490,870,1620,43,325,63,262,494,437,15,28,14,34
E02006516,8510,6711,1777,4934,53,454,137,317,1216,1037,82,59,38,76
E02006517,3179,2137,734,1403,33,263,40,223,693,611,24,42,16,53
E02006518,2999,2152,840,1312,33,321,45,276,420,372,15,24,9,73
E02006519,3174,2399,804,1595,23,210,154,56,520,478,0,34,8,22
E02006520,1754,1396,450,946,23,96,55,41,219,196,6,13,4,20
E02006521,1530,1210,399,811,10,122,99,23,176,165,1,9,1,12
E02006522,2566,1951,722,1229,27,158,103,55,384,346,9,27,2,46
E02006523,10705,7912,2179,5733,100,829,399,430,1785,1617,43,96,29,79
E02006524,757,487,168,319,1,182,151,31,80,75,0,5,0,7
E02006525,8550,5828,1686,4142,93,812,507,305,1737,1593,20,110,14,80
E02006526,3790,2996,852,2144,24,319,195,124,428,394,1,29,4,23
E02006527,4039,2990,925,2065,31,355,216,139,630,580,9,34,7,33
E02006528,6067,4180,1207,2973,65,588,326,262,1207,1125,12,55,15,27
E02006529,10939,8220,2351,5869,140,906,559,347,1615,1462,47,89,17,58
E02006530,16314,12456,3291,9165,163,1166,669,497,2444,2266,34,134,10,85
E02006531,3522,2374,675,1699,33,386,251,135,707,668,4,31,4,22
E02006532,2374,1805,558,1247,24,155,81,74,356,308,18,24,6,34
E02006533,1350,1053,300,753,11,107,56,51,165,153,3,9,0,14
E02006534,1495,1136,306,830,4,130,99,31,213,196,3,13,1,12
E02006535,2262,1735,520,1215,10,215,136,79,289,264,0,24,1,13
E02006536,1446,1155,337,818,12,72,48,24,153,122,15,12,4,54
E02006537,5269,3709,1046,2663,44,587,388,199,894,833,7,47,7,35
E02006538,3822,2840,793,2047,23,279,151,128,648,585,3,55,5,32
E02006539,1981,1465,413,1052,7,186,110,76,305,268,8,27,2,18
E02006540,2244,1624,430,1194,15,182,101,81,404,383,2,18,1,19
E02006541,3629,2556,712,1844,21,369,222,147,656,603,10,39,4,27
E02006542,2588,1807,642,1165,19,179,103,76,480,433,27,12,8,103
E02006543,1864,1404,434,970,13,113,61,52,304,252,25,21,6,30
E02006544,3607,2708,867,1841,22,265,143,122,575,524,10,31,10,37
E02006545,3946,2614,669,1945,73,419,230,189,824,770,6,43,5,16
E02006546,2830,2140,638,1502,25,238,106,132,404,375,7,18,4,23
E02006547,2398,1733,527,1206,30,183,85,98,419,373,18,26,2,33
E02006548,2726,2068,564,1504,32,180,63,117,421,386,5,24,6,25
E02006549,1401,1115,415,700,6,85,35,50,186,167,1,17,1,9
E02006550,2415,1888,525,1363,22,129,56,73,356,315,12,27,2,20
E02006551,1973,1532,555,977,14,123,44,79,290,273,2,15,0,14
E02006552,3394,2244,671,1573,34,288,115,173,804,732,13,49,10,24
E02006553,2286,1691,500,1191,22,173,74,99,372,343,1,23,5,28
E02006554,1184,939,332,607,3,57,27,30,168,152,2,12,2,17
E02006555,3125,2154,604,1550,34,300,139,161,623,561,7,47,8,14
E02006556,1841,1507,513,994,11,62,25,37,254,234,3,14,3,7
E02006557,1496,1035,277,758,21,176,85,91,254,233,1,19,1,10
E02006558,5961,3584,1119,2465,55,535,220,315,1735,1602,29,79,25,52
E02006559,1239,964,373,591,7,52,16,36,206,189,5,8,4,10
E02006560,1952,1374,446,928,16,101,34,67,443,405,19,17,2,18
E02006561,1942,1351,475,876,23,212,53,159,315,278,20,13,4,41
E02006562,1761,1370,528,842,5,121,22,99,202,171,10,17,4,63
E02006563,2459,1700,682,1018,10,253,50,203,420,335,58,24,3,76
E02006564,2878,1830,673,1157,34,484,95,389,483,416,19,32,16,47
E02006565,3614,2188,818,1370,28,429,132,297,780,649,77,27,27,189
E02006566,4311,2788,896,1892,54,352,85,267,1023,899,59,45,20,94
E02006567,2859,2058,759,1299,28,297,90,207,425,354,29,30,12,51
E02006568,8882,5843,1747,4096,125,971,196,775,1865,1663,68,95,39,78
E02006569,2770,1722,666,1056,14,257,79,178,739,393,193,24,129,38
E02006570,13354,9281,2711,6570,162,1233,292,941,2530,2292,57,135,46,148
E02006571,3206,2348,723,1625,28,270,60,210,522,478,12,29,3,38
E02006572,5215,3362,991,2371,50,596,168,428,1155,1053,33,63,6,52
E02006573,3614,2656,1002,1654,32,274,48,226,596,533,20,33,10,56
E02006574,3583,2486,736,1750,28,298,58,240,752,688,22,32,10,19
E02006575,22005,14896,3303,11593,297,2114,1182,932,4595,4275,32,254,34,103
E02006576,2560,1821,500,1321,11,177,99,78,540,512,6,19,3,11
E02006577,2535,1570,350,1220,25,492,407,85,426,397,4,19,6,22
E02006578,33342,23567,5362,18205,484,3359,2097,1262,5767,5374,68,278,47,165
E02006579,4970,3464,825,2639,81,601,406,195,799,735,8,52,4,25
E02006580,1470,1011,242,769,8,236,182,54,205,183,4,11,7,10
E02006581,4534,3046,736,2310,45,628,433,195,795,745,14,25,11,20
E02006582,1377,1033,220,813,16,84,54,30,232,223,2,6,1,12
E02006583,1295,910,229,681,11,156,109,47,211,201,1,8,1,7
E02006584,716,417,52,365,8,188,179,9,100,94,0,6,0,3
E02006585,2010,1416,336,1080,22,303,255,48,258,242,4,12,0,11
E02006586,680,444,70,374,9,131,117,14,88,79,2,6,1,8
E02006587,1740,1095,219,876,14,349,191,158,275,250,4,18,3,7
E02006588,2705,1872,519,1353,32,303,108,195,448,386,29,28,5,50
E02006589,4104,3176,827,2349,35,231,55,176,640,610,7,20,3,22
E02006590,2990,2125,651,1474,24,345,53,292,442,383,17,36,6,54
E02006591,3538,2588,783,1805,36,398,90,308,498,450,5,40,3,18
E02006592,2670,1980,659,1321,21,233,45,188,380,294,56,21,9,56
E02006593,11672,8517,2312,6205,114,1142,268,874,1826,1697,37,76,16,73
E02006594,1150,917,268,649,11,92,23,69,125,120,1,2,2,5
E02006595,2873,2102,683,1419,16,226,39,187,396,306,65,18,7,133
E02006596,2664,2068,468,1600,47,173,15,158,363,324,10,22,7,13
E02006597,4053,2980,889,2091,48,432,81,351,538,471,23,39,5,55
E02006598,2506,1828,567,1261,18,200,50,150,410,358,18,29,5,50
E02006599,1841,1431,579,852,7,115,18,97,235,198,14,17,6,53
E02006600,3594,2542,858,1684,22,480,99,381,492,413,21,39,19,58
E02006601,3432,2518,907,1611,20,316,98,218,537,477,21,32,7,41
E02006602,3750,2442,740,1702,27,286,66,220,911,856,20,30,5,84
E02006603,2430,1930,654,1276,9,146,39,107,323,296,3,22,2,22
E02006604,8073,5881,1712,4169,114,725,144,581,1278,1178,14,69,17,75
E02006605,2296,1656,501,1155,19,176,79,97,378,333,13,21,11,67
E02006606,1728,1406,390,1016,15,53,11,42,228,217,0,8,3,26
E02006607,3256,2420,669,1751,40,265,67,198,502,445,16,39,2,29
E02006608,1450,1161,354,807,16,85,29,56,171,155,0,15,1,17
E02006609,2974,2073,748,1325,35,275,46,229,492,411,43,25,13,99
E02006610,2832,1878,604,1274,32,276,83,193,505,437,35,17,16,141
E02006611,2698,2035,675,1360,23,218,37,181,389,345,13,23,8,33
E02006612,8791,6269,1749,4520,122,651,104,547,1685,1573,20,82,10,64
E02006613,1442,1026,305,721,19,209,16,193,175,155,4,16,0,13
E02006614,4654,3336,1019,2317,66,410,54,356,782,724,10,38,10,60
E02006615,3088,2250,548,1702,46,262,81,181,519,481,2,32,4,11
E02006616,1122,897,252,645,14,91,9,82,108,102,2,4,0,12
E02006617,5878,4194,1102,3092,90,548,97,451,1011,920,13,66,12,35
E02006618,3449,2624,747,1877,39,267,53,214,497,468,4,23,2,22
E02006619,4354,3054,855,2199,55,418,77,341,737,648,30,47,12,90
E02006620,2199,1726,606,1120,16,174,29,145,262,240,7,15,0,21
E02006621,2098,1728,503,1225,16,75,29,46,269,247,4,17,1,10
E02006622,1572,1264,331,933,2,87,19,68,209,195,1,12,1,10
E02006623,3027,2243,596,1647,25,282,93,189,467,432,4,30,1,10
E02006624,2509,2030,554,1476,13,117,49,68,335,308,3,19,5,14
E02006625,4378,3229,813,2416,50,246,105,141,832,760,5,54,13,21
E02006626,2904,2168,562,1606,34,243,75,168,440,398,1,36,5,19
E02006627,2913,2301,629,1672,16,180,68,112,409,376,1,27,5,7
E02006628,2635,1894,509,1385,15,195,66,129,507,459,4,39,5,24
E02006629,3045,2065,520,1545,22,267,106,161,675,617,6,47,5,16
E02006630,2953,1859,508,1351,24,247,83,164,798,738,9,45,6,25
E02006631,15370,10564,2694,7870,122,969,375,594,3597,3280,68,210,39,118
E02006632,1874,1426,441,985,4,88,30,58,344,325,1,17,1,12
E02006633,4027,3199,1006,2193,24,207,86,121,578,540,3,30,5,19
E02006634,3109,2027,814,1213,35,309,47,262,538,430,78,19,11,200
E02006635,4538,2925,936,1989,41,670,103,567,757,604,86,47,20,145
E02006636,2660,1755,607,1148,31,353,63,290,405,333,35,21,16,116
E02006637,5389,3711,870,2841,79,766,100,666,794,694,24,53,23,39
E02006638,4662,3261,977,2284,60,674,76,598,629,516,45,43,25,38
E02006639,2656,1951,708,1243,16,301,43,258,338,254,21,35,28,50
E02006640,2169,1403,514,889,39,228,35,193,391,301,37,18,35,108
E02006641,3903,2757,875,1882,44,465,51,414,556,441,42,35,38,81
E02006642,2237,1458,452,1006,16,248,53,195,485,242,141,12,90,30
E02006643,6940,3211,688,2523,75,945,249,696,2668,801,1103,50,714,41
E02006644,2439,1851,605,1246,30,225,80,145,308,263,12,24,9,25
E02006645,4788,3376,920,2456,56,389,71,318,927,845,22,42,18,40
E02006646,1849,1434,429,1005,19,130,43,87,245,208,6,25,6,21
E02006647,1964,1550,611,939,13,105,22,83,268,225,13,23,7,28
E02006648,1928,1407,506,901,22,125,6,119,325,262,22,19,22,49
E02006649,2184,1561,438,1123,11,240,42,198,358,306,19,18,15,14
E02006650,7234,5085,1277,3808,60,522,193,329,1513,876,379,62,196,54
E02006651,3318,2229,735,1494,25,280,48,232,708,394,151,31,132,76
E02006652,4280,3180,794,2386,33,385,66,319,665,593,31,27,14,17
E02006653,3930,2881,736,2145,39,402,54,348,596,520,18,41,17,12
E02006654,6568,4739,1320,3419,49,757,82,675,980,842,34,69,35,43
E02006655,3135,2189,759,1430,31,337,45,292,514,442,30,22,20,64
E02006656,1088,876,194,682,7,79,8,71,125,106,3,15,1,1
E02006657,3732,2673,641,2032,51,477,73,404,473,430,10,17,16,58
E02006658,1507,1184,307,877,11,100,15,85,204,174,8,12,10,8
E02006659,3612,2604,729,1875,25,238,38,200,715,425,167,30,93,30
E02006660,8877,6308,1684,4624,70,875,133,742,1532,1238,145,82,67,92
E02006661,5045,2540,662,1878,47,562,240,322,1851,569,745,20,517,45
E02006662,1252,820,211,609,9,157,96,61,253,148,64,8,33,13
E02006663,5785,3821,919,2902,85,667,330,337,1178,841,177,41,119,34
E02006664,5314,3681,1032,2649,43,466,263,203,1030,828,105,49,48,94
E02006665,2686,1743,688,1055,31,330,153,177,507,425,37,26,19,75
E02006666,1192,813,210,603,8,174,90,84,179,145,17,8,9,18
E02006667,747,414,126,288,4,229,165,64,93,79,2,8,4,7
E02006668,1481,1020,370,650,9,224,151,73,216,179,13,19,5,12
E02006669,3593,2246,806,1440,20,403,258,145,795,648,83,27,37,129
E02006670,5993,3801,1133,2668,71,787,493,294,1268,1105,46,75,42,66
E02006671,7663,4883,1440,3443,87,918,535,383,1671,1430,79,100,62,104
E02006672,6015,4059,1262,2797,84,544,300,244,1250,951,160,63,76,78
E02006673,4953,3152,999,2153,56,564,343,221,1081,879,79,73,50,100
E02006674,1513,995,312,683,18,205,115,90,279,232,17,14,16,16
E02006675,1956,1474,544,930,15,145,80,65,277,236,15,16,10,45
E02006676,2031,1370,572,798,15,179,100,79,371,308,30,24,9,96
E02006677,2981,2103,737,1366,24,246,158,88,552,462,36,29,25,56
E02006678,924,681,194,487,2,102,11,91,130,112,3,14,1,9
E02006679,5102,4003,1103,2900,24,368,43,325,653,575,30,35,13,54
E02006680,3604,2676,724,1952,15,372,46,326,515,458,8,41,8,26
E02006681,1911,1487,576,911,5,126,26,100,261,236,10,9,6,32
E02006682,2932,2263,788,1475,6,232,32,200,411,379,7,22,3,20
E02006683,1676,1320,307,1013,10,115,10,105,209,184,6,12,7,22
E02006684,9349,6722,1817,4905,56,881,122,759,1634,1479,31,101,23,56
E02006685,2067,1561,431,1130,15,159,18,141,320,288,7,22,3,12
E02006686,815,622,180,442,4,89,5,84,97,87,0,9,1,3
E02006687,2139,1563,405,1158,17,201,29,172,343,316,3,19,5,15
E02006688,1504,1180,343,837,12,94,12,82,205,187,6,12,0,13
E02006689,4238,3052,832,2220,27,278,43,235,852,755,23,58,16,29
E02006690,3164,2396,738,1658,13,280,40,240,432,360,18,43,11,43
E02006691,4078,3004,743,2261,19,389,48,341,644,569,15,42,18,22
E02006692,3161,1972,516,1456,23,273,47,226,871,383,270,26,192,22
E02006693,1148,798,213,585,12,113,25,88,213,182,8,15,8,12
E02006694,3282,2243,697,1546,22,325,53,272,639,542,38,28,31,53
E02006695,3933,2537,862,1675,31,353,65,288,882,708,90,36,48,130
E02006696,2026,1695,538,1157,8,86,48,38,223,202,8,11,2,14
E02006697,3370,2569,911,1658,29,274,164,110,442,380,16,35,11,56
E02006698,1946,1532,481,1051,17,183,110,73,192,172,6,13,1,22
E02006699,1103,925,286,639,9,61,35,26,99,89,1,9,0,9
E02006700,3011,2331,676,1655,14,218,132,86,417,381,8,27,1,31
E02006701,1694,1395,427,968,7,92,66,26,182,171,4,6,1,18
E02006702,1221,933,302,631,13,130,43,87,133,120,1,11,1,12
E02006703,1673,1425,436,989,10,98,35,63,130,117,5,8,0,10
E02006704,4793,3352,939,2413,35,487,306,181,890,812,21,46,11,29
E02006705,1790,1379,407,972,9,172,59,113,218,190,7,20,1,12
E02006706,5676,4378,1343,3035,46,519,201,318,689,615,18,50,6,44
E02006707,1247,1071,314,757,4,60,25,35,109,97,0,12,0,3
E02006708,2717,2061,568,1493,37,321,124,197,286,264,3,17,2,12
E02006709,6648,5159,1384,3775,56,526,211,315,866,786,12,62,6,41
E02006710,2998,2179,949,1230,19,268,32,236,472,418,12,31,11,60
E02006711,2986,2334,930,1404,18,197,58,139,374,323,16,29,6,63
E02006712,2855,1875,657,1218,26,252,94,158,665,615,5,37,8,37
E02006713,5488,3722,1148,2574,90,775,146,629,855,784,4,53,14,46
E02006714,2052,1462,526,936,19,140,29,111,394,347,16,22,9,37
E02006715,1711,1305,450,855,16,160,36,124,220,196,4,18,2,10
E02006716,891,628,217,411,13,160,27,133,86,73,1,9,3,4
E02006717,2236,1592,535,1057,26,185,34,151,399,370,10,16,3,34
E02006718,3211,2469,776,1693,36,270,32,238,420,392,6,20,2,16
E02006719,4144,2984,1018,1966,45,355,62,293,690,611,19,53,7,70
E02006720,2442,1783,715,1068,21,207,39,168,369,328,16,24,1,62
E02006721,4827,3662,991,2671,23,470,307,163,651,607,4,39,1,21
E02006722,1883,1361,332,1029,17,248,181,67,246,228,4,12,2,11
E02006723,1193,814,172,642,1,241,189,52,128,117,0,9,2,9
E02006724,7574,5458,1483,3975,49,953,687,266,1054,963,5,79,7,60
E02006725,2242,1524,428,1096,15,354,267,87,342,307,8,25,2,7
E02006726,1557,1109,284,825,5,213,138,75,216,193,6,16,1,14
E02006727,4466,3399,850,2549,26,474,316,158,545,505,2,31,7,22
E02006728,1324,1062,324,738,6,110,74,36,142,128,1,9,4,4
E02006729,7719,5713,1485,4228,45,912,602,310,1033,939,13,77,4,16
E02006730,1283,915,231,684,10,180,136,44,177,163,2,12,0,1
E02006731,2040,1580,400,1180,12,208,127,81,231,211,2,17,1,9
E02006732,1284,1078,291,787,3,73,44,29,120,110,0,9,1,10
E02006733,1575,1253,418,835,4,112,68,44,199,173,6,13,7,7
E02006734,2710,2038,606,1432,31,210,74,136,416,374,7,32,3,15
E02006735,679,410,87,323,6,188,79,109,70,60,1,5,4,5
E02006736,8039,5824,1449,4375,100,746,292,454,1318,1224,8,79,7,51
E02006737,1804,1389,398,991,14,138,56,82,252,229,3,17,3,11
E02006738,2377,1668,401,1267,38,351,163,188,309,280,1,25,3,11
E02006739,2302,1671,517,1154,23,123,44,79,467,441,4,20,2,18
E02006740,7992,5615,1586,4029,67,611,181,430,1632,1509,12,100,11,67
E02006741,1297,990,224,766,5,101,30,71,193,178,3,12,0,8
E02006742,1788,1265,416,849,17,205,78,127,291,255,6,20,10,10
E02006743,5929,4476,1187,3289,66,514,189,325,839,776,8,45,10,34
E02006744,8679,6084,1791,4293,92,737,230,507,1684,1563,19,97,5,82
E02006745,2691,2051,662,1389,18,198,73,125,409,362,7,32,8,15
E02006746,5670,4512,1339,3173,68,311,87,224,753,666,17,64,6,26
E02006747,1012,801,228,573,6,51,15,36,145,131,0,13,1,9
E02006748,7676,5398,1591,3807,66,809,306,503,1326,1215,18,76,17,77
E02006749,3516,2428,706,1722,25,493,118,375,554,512,7,34,1,16
E02006750,2809,2060,624,1436,12,344,60,284,368,339,8,17,4,25
E02006751,1471,1089,353,736,6,187,30,157,168,143,4,14,7,21
E02006752,764,660,206,454,3,47,8,39,47,38,0,4,5,7
E02006753,3709,3012,809,2203,22,211,58,153,433,387,5,35,6,31
E02006754,1859,1418,579,839,10,133,25,108,259,221,10,18,10,39
E02006755,1843,1469,565,904,13,111,26,85,225,188,19,16,2,25
E02006756,2085,1616,467,1149,14,131,32,99,305,284,2,14,5,19
E02006757,2123,1591,555,1036,8,178,33,145,301,242,23,23,13,45
E02006758,3357,2085,555,1530,30,303,63,240,904,853,15,25,11,35
E02006759,4445,3331,1090,2241,35,434,63,371,610,546,19,42,3,35
E02006760,2550,1810,641,1169,21,252,36,216,445,373,31,34,7,22
E02006761,3845,2580,782,1798,31,533,71,462,663,603,18,35,7,38
E02006762,1977,1427,468,959,18,237,28,209,276,258,5,11,2,19
E02006763,2359,1611,507,1104,17,251,43,208,465,436,5,21,3,15
E02006764,2558,1889,540,1349,12,334,43,291,305,279,9,17,0,18
E02006765,2441,1753,627,1126,19,235,39,196,388,332,24,20,12,46
E02006766,2431,1831,647,1184,11,142,28,114,398,345,27,15,11,49
E02006767,3316,2569,904,1665,21,252,117,135,431,368,11,38,14,43
E02006768,2120,1635,520,1115,14,191,89,102,269,241,0,26,2,11
E02006769,1331,1090,340,750,3,49,27,22,173,151,7,14,1,16
E02006770,7298,5361,1704,3657,43,699,312,387,1144,1059,5,72,8,51
E02006771,1853,1424,524,900,5,142,64,78,245,223,4,17,1,37
E02006772,1970,1573,466,1107,14,160,82,78,216,197,4,14,1,7
E02006773,1538,1168,385,783,16,136,67,69,206,177,7,19,3,12
E02006774,2211,1706,553,1153,10,169,88,81,313,293,0,18,2,13
E02006775,3463,2444,719,1725,34,437,214,223,535,496,4,30,5,13
E02006776,3467,2682,818,1864,33,309,138,171,427,401,0,25,1,16
E02006777,2234,1743,696,1047,10,142,57,85,314,276,4,29,5,25
E02006778,1657,1332,430,902,8,134,63,71,171,157,2,12,0,12
E02006779,4140,3233,1084,2149,30,284,138,146,568,515,4,39,10,25
E02006780,701,566,199,367,6,61,35,26,59,49,1,5,4,9
E02006781,1234,420,257,163,10,214,139,75,446,299,66,20,61,144
E02006782,1286,935,274,661,9,159,30,129,173,153,2,17,1,10
E02006783,1373,786,184,602,15,348,117,231,214,204,0,7,3,10
E02006784,1262,740,181,559,10,275,88,187,230,212,2,13,3,7
E02006785,798,634,176,458,6,73,11,62,80,70,0,9,1,5
E02006786,954,577,137,440,13,169,96,73,186,170,1,7,8,9
E02006787,2715,1957,539,1418,27,354,109,245,358,342,3,11,2,19
E02006788,1113,700,156,544,13,224,149,75,166,149,2,13,2,10
E02006789,3198,2534,757,1777,34,219,65,154,389,327,26,24,12,22
E02006790,2203,1584,477,1107,14,238,149,89,333,290,16,17,10,34
E02006791,1419,721,244,477,18,167,95,72,498,467,8,21,2,15
E02006792,14167,7322,1998,5324,198,1383,700,683,5145,4911,29,176,29,119
E02006793,4367,2459,678,1781,48,822,485,337,1001,943,5,39,14,37
E02006794,3098,1456,354,1102,58,730,428,302,820,777,4,27,12,34
E02006795,1172,767,251,516,6,45,19,26,344,327,0,11,6,10
E02006796,5640,3618,1035,2583,64,550,319,231,1376,988,197,50,141,32
E02006798,2997,1286,331,955,35,822,500,322,822,783,4,33,2,32
E02006799,2391,1414,364,1050,23,456,345,111,485,452,5,20,8,13
E02006800,2733,1655,464,1191,45,243,154,89,769,729,5,32,3,21
E02006801,37256,20413,4845,15568,629,4666,2504,2162,11212,10446,236,420,110,336
E02006802,13191,7612,1953,5659,274,1853,1017,836,3357,3143,16,176,22,95
E02006803,1371,1109,257,852,3,96,79,17,155,124,4,22,5,8
E02006804,3049,2255,627,1628,12,430,374,56,325,286,9,29,1,27
E02006805,923,643,213,430,7,97,34,63,169,146,2,19,2,7
E02006806,2607,1936,518,1418,9,287,178,109,358,323,2,31,2,17
E02006807,1142,941,270,671,4,37,31,6,150,140,2,6,2,10
E02006808,2146,1745,517,1228,10,116,79,37,259,237,3,15,4,16
E02006809,1895,1462,479,983,7,133,76,57,271,254,1,14,2,22
E02006810,1570,1187,418,769,5,199,177,22,163,147,3,11,2,16
E02006811,1459,1206,337,869,5,93,41,52,138,128,1,9,0,17
E02006812,1185,941,263,678,4,116,66,50,110,96,1,8,5,14
E02006813,4032,3120,665,2455,10,356,298,58,530,486,4,32,8,16
E02006814,2173,1747,450,1297,8,155,129,26,251,231,1,16,3,12
E02006815,1339,924,227,697,5,249,212,37,152,142,1,6,3,9
E02006816,1279,1057,344,713,14,71,41,30,125,105,2,16,2,12
E02006817,3080,2346,678,1668,22,288,182,106,412,379,0,25,8,12
E02006818,1785,1456,411,1045,6,88,62,26,229,202,5,21,1,6
E02006819,2638,1816,466,1350,16,415,272,143,377,341,4,30,2,14
E02006820,5795,4832,1332,3500,26,297,186,111,622,573,7,41,1,18
E02006821,4896,3471,856,2615,38,515,277,238,843,736,34,61,12,29
E02006822,2881,2055,576,1479,18,456,260,196,334,287,5,36,6,18
E02006823,2361,1892,663,1229,23,183,58,125,231,210,7,4,10,32
E02006824,2222,1815,570,1245,14,121,47,74,248,211,16,15,6,24
E02006825,1823,1150,439,711,13,133,29,104,243,206,16,16,5,284
E02006826,4056,2524,801,1723,66,461,185,276,877,780,41,47,9,128
E02006827,4203,3307,979,2328,18,380,214,166,465,426,2,28,9,33
E02006828,2846,2344,637,1707,11,172,80,92,307,281,0,24,2,12
E02006829,2480,1936,585,1351,15,221,90,131,295,255,5,32,3,13
E02006830,910,618,141,477,9,209,132,77,68,59,1,8,0,6
E02006831,1223,1001,270,731,8,80,37,43,121,102,7,11,1,13
E02006832,1739,1350,378,972,19,136,50,86,223,195,3,22,3,11
E02006833,4427,3311,994,2317,43,410,70,340,603,497,53,38,15,60
E02006834,1126,761,190,571,3,239,202,37,116,102,3,9,2,7
E02006835,1527,1187,349,838,6,129,92,37,195,177,3,15,0,10
E02006836,1716,1327,422,905,15,97,49,48,259,242,5,8,4,18
E02006837,4336,3378,1090,2288,32,271,106,165,617,565,21,23,8,38
E02006838,1725,1353,444,909,12,121,25,96,214,181,14,11,8,25
E02006839,2937,2187,749,1438,23,216,131,85,432,379,21,19,13,79
E02006840,2698,2014,613,1401,19,95,17,78,550,504,5,40,1,20
E02006841,12098,8561,2054,6507,46,1793,1378,415,1634,1458,10,139,27,64
E02006842,1438,997,230,767,5,202,139,63,221,201,1,18,1,13
E02006843,23737,16888,4157,12731,98,2110,1489,621,4533,4220,17,242,54,108
E02006844,11871,7740,1997,5743,51,1050,686,364,2967,2738,20,159,50,63
E02006845,2683,2002,433,1569,17,119,47,72,526,465,7,51,3,19
E02006846,2857,2023,438,1585,19,202,80,122,600,548,6,43,3,13
E02006847,1274,1001,121,880,32,52,29,23,183,170,3,8,2,6
E02006848,1102,739,96,643,26,68,25,43,265,248,1,16,0,4
E02006849,2665,1935,354,1581,43,203,117,86,474,427,11,29,7,10
E02006850,17824,12956,3575,9381,123,1393,743,650,3242,3003,37,172,30,110
E02006851,30739,21077,6234,14843,206,2963,1705,1258,6292,5892,41,313,46,201
E02006852,4340,2875,861,2014,14,352,264,88,1070,1004,8,48,10,29
E02006853,2770,1442,351,1091,47,454,161,293,796,757,3,29,7,31
E02006854,103850,62690,13487,49203,1150,5167,2506,2661,34312,33048,121,930,213,531
E02006855,2673,1635,499,1136,27,358,242,116,628,576,16,33,3,25
E02006856,9650,5858,1762,4096,107,772,456,316,2745,2511,66,125,43,168
E02006857,4492,3000,785,2215,37,433,269,164,1003,935,8,52,8,19
E02006858,1879,1160,333,827,21,174,79,95,515,486,5,21,3,9
E02006859,1879,1361,246,1115,9,153,121,32,342,322,1,17,2,14
E02006860,2832,2124,729,1395,12,285,114,171,369,338,2,25,4,42
E02006861,4066,2512,675,1837,21,430,269,161,1072,1007,9,51,5,31
E02006862,1848,1443,288,1155,14,123,91,32,254,228,2,19,5,14
E02006863,1512,1093,174,919,5,111,62,49,294,270,5,11,8,9
E02006864,3153,2355,729,1626,41,230,97,133,508,466,14,23,5,19
E02006865,4627,3190,897,2293,48,358,156,202,1016,942,10,52,12,15
E02006866,912,712,219,493,12,74,56,18,111,93,3,12,3,3
E02006867,7186,5511,1621,3890,55,478,356,122,1100,983,36,78,3,42
E02006868,11241,7482,1951,5531,43,1423,868,555,1902,1711,11,139,41,391
E02006869,2140,1669,438,1231,8,274,227,47,170,157,2,10,1,19
E02006870,6656,4522,1579,2943,34,686,113,573,1331,1213,32,71,15,83
E02006871,2509,2080,613,1467,9,125,76,49,273,232,4,31,6,22
E02006872,7086,5505,1949,3556,57,514,360,154,922,814,14,76,18,88
E02006873,3202,2256,515,1741,89,298,93,205,540,477,23,21,19,19
E02006874,4069,2986,824,2162,55,400,115,285,580,513,33,29,5,48
E02006875,81883,55797,12249,43548,362,6693,4801,1892,18556,17491,71,881,113,475
E02006876,18737,13234,2837,10397,92,2338,1821,517,2972,2769,12,168,23,101
E02006877,7633,5430,1280,4150,79,671,232,439,1401,1286,11,87,17,52
E02006878,1440,913,158,755,29,131,30,101,353,332,3,17,1,14
E02006879,6562,3740,1016,2724,38,594,347,247,2134,1983,20,96,35,56
E02006880,4332,2752,787,1965,27,246,143,103,1271,1144,30,70,27,36
E02006881,2335,1804,567,1237,9,158,50,108,346,323,2,19,2,18
E02006882,4343,2990,1006,1984,55,299,160,139,968,927,3,29,9,31
E02006883,2860,1727,466,1261,22,181,86,95,909,858,9,32,10,21
E02006884,4161,3291,1041,2250,11,316,123,193,513,445,4,54,10,30
E02006885,2772,1541,462,1079,37,109,41,68,1051,990,13,43,5,34
E02006886,6894,4599,1422,3177,73,569,148,421,1486,913,371,53,149,167
E02006887,26343,18047,4217,13830,226,1619,981,638,6290,5947,24,284,35,161
E02006888,2781,1693,446,1247,22,393,250,143,654,600,4,45,5,19
E02006889,5509,3701,1019,2682,45,703,497,206,1022,939,9,64,10,38
E02006890,1754,1043,296,747,9,159,97,62,530,486,1,38,5,13
E02006891,1893,1508,484,1024,7,79,48,31,279,243,8,23,5,20
E02006892,3046,2340,738,1602,8,125,91,34,539,478,11,42,8,34
E02006893,1816,1390,402,988,5,241,195,46,169,149,2,15,3,11
E02006894,6770,4870,1716,3154,39,859,629,230,936,850,9,47,30,66
E02006895,5089,3240,843,2397,65,675,328,347,1068,992,10,48,18,41
E02006896,15133,9586,2712,6874,167,1875,1039,836,3379,3160,17,162,40,126
E02006897,9933,6714,1783,4931,86,1091,609,482,1970,1850,7,98,15,72
E02006898,12863,8933,2430,6503,120,1124,716,408,2605,2456,12,117,20,81
E02006899,52339,37956,9961,27995,478,4178,2452,1726,9387,8763,54,486,84,340
E02006900,7677,5020,1672,3348,65,1140,680,460,1371,1277,5,63,26,81
E02006901,5719,4162,1309,2853,48,534,334,200,913,841,5,58,9,62
E02006902,50449,31735,7223,24512,319,4449,2180,2269,13642,12932,40,584,86,304
E02006903,3517,2888,879,2009,15,215,169,46,369,328,11,27,3,30
E02006904,28983,18848,4797,14051,169,2880,1792,1088,6921,6482,36,352,51,165
E02006905,11061,7382,1786,5596,68,1118,799,319,2431,2271,16,125,19,62
E02006906,4126,3288,929,2359,21,256,179,77,534,478,3,47,6,27
E02006907,14028,9402,2676,6726,134,1394,829,565,2989,2701,37,217,34,109
E02006908,1685,1128,325,803,7,199,125,74,341,311,2,27,1,10
E02006909,2096,1724,501,1223,7,140,66,74,200,169,5,20,6,25
E02006910,6949,5348,1382,3966,35,763,436,327,742,657,11,68,6,61
E02006911,3435,2773,987,1786,18,164,97,67,454,423,2,20,9,26
E02006912,30014,18808,4403,14405,206,2653,1156,1497,8171,7696,46,374,55,176
E02006913,5842,3471,967,2504,39,862,456,406,1412,1302,8,88,14,58
E02006914,10842,7055,1732,5323,66,821,310,511,2841,2683,3,137,18,59
E02006915,4565,2832,830,2002,24,637,296,341,1030,968,2,52,8,42
E02006916,1555,830,192,638,10,254,84,170,455,433,4,15,3,6
E02006917,20560,13650,3071,10579,102,1263,525,738,5418,5091,16,281,30,127
E02006918,1450,479,129,350,31,365,174,191,562,529,2,21,10,13
E02006919,2255,1725,501,1224,14,183,109,74,325,288,4,25,8,8
E02006920,1503,1164,323,841,3,126,75,51,199,181,1,11,6,11
E02006921,1086,339,143,196,7,315,147,168,414,390,3,14,7,11
E02006922,3188,2296,674,1622,11,349,224,125,502,462,8,29,3,30
E02006924,3067,2092,626,1466,47,204,117,87,708,673,7,20,8,16
E02006925,4305,3164,942,2222,45,401,253,148,669,634,2,30,3,26
E02006926,1450,1142,182,960,13,77,65,12,207,197,1,9,0,11
E02006927,2600,1577,455,1122,35,520,353,167,443,417,4,17,5,25
E02006928,2507,1139,281,858,54,601,368,233,682,657,3,15,7,31
E02006929,7662,4022,1088,2934,113,1409,768,641,2060,1935,16,86,23,58
E02006930,3039,1430,388,1042,58,706,401,305,815,772,2,33,8,30
E02006931,5168,2652,776,1876,60,974,557,417,1424,1339,14,54,17,58
E02006932,26556,17446,4528,12918,175,3134,583,2551,5682,5362,20,234,66,119
E02006933,16764,10433,2442,7991,106,1896,400,1496,4220,3971,9,200,40,109
E02006934,28433,21195,5141,16054,138,2092,451,1641,4866,4528,37,269,32,142
W02000001,3005,2362,964,1398,3,265,230,35,321,269,1,40,11,54
W02000002,1272,979,470,509,9,78,69,9,174,143,3,19,9,32
W02000003,3772,2697,879,1818,5,449,376,73,572,488,12,60,12,49
W02000004,2058,1498,594,904,8,219,177,42,290,252,6,22,10,43
W02000005,2177,1576,719,857,8,185,145,40,349,299,8,37,5,59
W02000006,4629,3534,1318,2216,11,498,377,121,529,451,8,59,11,57
W02000007,2611,1839,637,1202,7,191,147,44,543,356,90,37,60,31
W02000008,2092,1523,553,970,5,173,141,32,350,306,10,25,9,41
W02000009,2566,1860,692,1168,5,272,227,45,383,340,6,35,2,46
W02000010,6196,4095,1449,2646,20,568,322,246,1431,1324,15,80,12,82
W02000011,6432,4825,1547,3278,19,624,368,256,861,736,32,76,17,103
W02000012,2945,2152,790,1362,5,316,171,145,425,363,8,40,14,47
W02000013,1702,1309,484,825,3,136,71,65,241,195,6,34,6,13
W02000014,4618,3368,1198,2170,20,478,292,186,703,613,10,65,15,49
W02000015,4486,3340,1189,2151,12,588,324,264,506,438,12,45,11,40
W02000016,4075,3130,1178,1952,6,453,250,203,421,355,13,41,12,65
W02000017,1779,1365,581,784,4,208,118,90,173,151,5,15,2,29
W02000018,2285,1721,796,925,7,236,126,110,293,250,3,29,11,28
W02000019,3702,2617,1177,1440,8,401,173,228,597,504,13,65,15,79
W02000020,2522,1752,863,889,13,311,156,155,395,324,14,48,9,51
W02000021,3605,2474,1088,1386,19,483,256,227,555,474,12,53,16,74
W02000022,2221,1647,788,859,8,182,89,93,325,275,8,40,2,59
W02000023,2080,1419,789,630,5,191,81,110,410,350,19,27,14,55
W02000024,2196,1562,899,663,6,220,115,105,346,263,15,59,9,62
W02000025,3456,2407,1064,1343,14,391,202,189,569,497,11,52,9,75
W02000026,2742,1923,913,1010,9,273,131,142,487,426,30,24,7,50
W02000027,7808,5185,1635,3550,52,738,272,466,1752,1588,17,123,24,81
W02000028,1891,1408,447,961,15,182,76,106,279,256,1,18,4,7
W02000029,1409,1101,398,703,6,69,37,32,214,201,1,10,2,19
W02000030,2364,1848,596,1252,18,139,62,77,336,312,0,19,5,23
W02000031,2522,1867,556,1311,35,173,90,83,420,372,12,34,2,27
W02000032,2135,1565,556,1009,16,138,53,85,388,356,3,28,1,28
W02000033,4873,3674,1012,2662,32,334,156,178,788,713,14,53,8,45
W02000034,2723,2101,628,1473,18,150,76,74,405,338,16,38,13,49
W02000035,1749,1374,439,935,14,139,78,61,205,177,2,23,3,17
W02000036,2618,1968,599,1369,25,180,93,87,427,393,6,23,5,18
W02000037,3587,2774,845,1929,31,246,126,120,517,468,3,41,5,19
W02000038,3125,2418,828,1590,15,199,92,107,462,423,3,32,4,31
W02000039,2023,1543,502,1041,12,151,63,88,294,257,2,34,1,23
W02000040,2249,1681,893,788,7,111,55,56,384,338,4,33,9,66
W02000041,3500,2511,1062,1449,25,320,99,221,573,471,22,44,36,71
W02000042,743,572,156,416,10,21,7,14,125,104,4,16,1,15
W02000043,2410,1777,497,1280,30,187,112,75,389,352,2,33,2,27
W02000044,863,711,233,478,3,22,10,12,121,107,2,10,2,6
W02000045,5567,4038,1113,2925,60,447,238,209,969,877,13,68,11,53
W02000047,2206,1612,438,1174,24,233,146,87,319,288,1,28,2,18
W02000049,1359,1029,391,638,5,106,84,22,202,169,13,17,3,17
W02000050,8004,6354,1671,4683,88,434,274,160,1079,951,24,94,10,49
W02000051,3214,2485,800,1685,34,177,119,58,472,399,22,44,7,46
W02000052,2199,1549,535,1014,12,271,176,95,333,290,7,29,7,34
W02000053,2609,1987,773,1214,15,195,113,82,361,318,4,38,1,51
W02000054,1943,1394,526,868,8,186,112,74,322,272,11,35,4,33
W02000055,3674,2806,959,1847,13,348,193,155,450,401,6,37,6,57
W02000056,1810,1357,617,740,6,165,114,51,250,215,9,17,9,32
W02000057,2878,2017,811,1206,23,368,271,97,425,384,7,27,7,45
W02000058,1329,991,298,693,9,106,71,35,207,180,4,17,6,16
W02000059,1749,1389,455,934,6,144,95,49,195,163,5,20,7,15
W02000060,4200,3172,945,2227,34,434,327,107,529,457,4,58,10,31
W02000061,4958,3550,958,2592,16,548,390,158,819,746,6,56,11,25
W02000062,1083,887,286,601,5,81,46,35,103,95,1,6,1,7
W02000063,2197,1764,662,1102,20,155,112,43,221,187,5,25,4,37
W02000064,2887,2357,637,1720,16,244,159,85,252,231,1,20,0,18
W02000065,2159,1770,473,1297,10,183,112,71,183,166,1,14,2,13
W02000066,11706,8877,2181,6696,68,1150,695,455,1560,1416,14,119,11,51
W02000067,778,635,182,453,0,46,33,13,93,77,0,15,1,4
W02000068,5219,3544,1014,2530,40,475,286,189,1129,1062,11,52,4,31
W02000069,2292,1825,560,1265,18,155,105,50,283,246,3,28,6,11
W02000070,4323,3499,930,2569,32,183,124,59,567,501,5,55,6,42
W02000071,1138,942,301,641,4,57,39,18,125,106,0,14,5,10
W02000072,11239,9002,2080,6922,71,872,558,314,1221,1084,8,121,8,73
W02000073,8122,6576,1951,4625,47,609,424,185,839,733,10,85,11,51
W02000074,2712,2142,584,1558,12,224,159,65,298,268,2,25,3,36
W02000075,988,826,310,516,6,43,30,13,102,88,4,9,1,11
W02000076,1357,1088,390,698,4,85,68,17,161,140,4,14,3,19
W02000077,1482,1165,396,769,8,119,97,22,168,138,5,20,5,22
W02000080,1745,1331,394,937,8,234,194,40,156,136,0,18,2,16
W02000081,1148,781,228,553,1,183,155,28,180,167,1,9,3,3
W02000082,1134,818,210,608,3,184,152,32,116,97,5,13,1,13
W02000083,1332,967,292,675,3,196,159,37,157,134,0,14,9,9
W02000084,902,714,216,498,2,90,72,18,91,71,1,14,5,5
W02000085,8790,6593,1951,4642,30,961,760,201,1125,998,11,109,7,81
W02000086,1696,1179,321,858,3,286,229,57,217,199,1,17,0,11
W02000087,882,492,151,341,3,270,250,20,104,94,2,6,2,13
W02000088,10041,7563,2028,5535,74,1059,823,236,1280,1131,32,111,6,65
W02000089,4081,2574,715,1859,21,663,541,122,798,733,11,49,5,25
W02000090,1127,881,307,574,7,127,108,19,104,94,0,7,3,8
W02000091,1821,1416,376,1040,7,208,167,41,181,160,4,14,3,9
W02000092,2189,1491,438,1053,4,376,319,57,300,275,4,21,0,18
W02000093,2333,1718,555,1163,8,288,231,57,301,275,3,19,4,18
W02000094,1478,1031,305,726,4,302,274,28,128,116,0,7,5,13
W02000095,2348,1739,700,1039,12,216,166,50,350,313,8,18,11,31
W02000096,2740,2045,711,1334,8,314,228,86,322,286,6,27,3,51
W02000097,3370,2583,1424,1159,9,175,112,63,535,471,10,40,14,68
W02000098,1520,1211,536,675,8,60,39,21,219,193,7,16,3,22
W02000099,5770,3859,1415,2444,28,613,280,333,1198,1082,25,75,16,72
W02000100,2511,1785,920,865,11,274,185,89,386,332,8,39,7,55
W02000101,1871,1363,589,774,3,135,89,46,341,296,14,24,7,29
W02000102,2101,1688,947,741,9,130,100,30,252,214,4,32,2,22
W02000103,1724,1316,738,578,3,148,109,39,216,181,6,24,5,41
W02000104,5167,3582,1483,2099,15,646,415,231,867,758,17,81,11,57
W02000105,2827,1886,696,1190,7,426,278,148,482,429,3,47,3,26
W02000106,2525,1856,1013,843,10,163,116,47,451,411,6,32,2,45
W02000107,3978,2883,1602,1281,11,320,198,122,654,561,26,60,7,110
W02000108,2218,1638,907,731,6,181,109,72,352,309,3,32,8,41
W02000109,3965,2854,1163,1691,10,300,185,115,742,673,6,61,2,59
W02000110,2819,2147,1145,1002,6,139,81,58,466,414,16,29,7,61
W02000111,4302,3128,1554,1574,14,319,195,124,736,608,25,96,7,105
W02000113,5307,3538,1394,2144,21,608,343,265,1037,771,95,91,80,103
W02000114,2442,1828,826,1002,10,181,74,107,353,300,7,32,14,70
W02000116,1975,1481,711,770,7,83,24,59,373,329,13,26,5,31
W02000117,6616,4214,1638,2576,22,374,118,256,1913,1807,11,74,21,93
W02000118,3848,2566,961,1605,10,314,95,219,911,803,17,66,25,47
W02000120,2856,2253,1076,1177,11,101,41,60,436,387,4,36,9,55
W02000122,2018,1588,804,784,8,84,28,56,278,232,7,35,4,60
W02000123,3717,2773,1401,1372,19,214,79,135,652,559,7,51,35,59
W02000124,4181,3093,1381,1712,15,367,152,215,642,577,16,41,8,64
W02000125,2560,2098,1054,1044,7,124,47,77,287,250,2,32,3,44
W02000126,2959,2407,1278,1129,14,127,61,66,348,269,19,54,6,63
W02000127,3390,2567,1230,1337,4,330,177,153,436,343,13,64,16,53
W02000128,3116,2245,1023,1222,16,276,186,90,510,332,86,40,52,69
W02000129,2564,2005,933,1072,7,175,117,58,320,277,6,32,5,57
W02000130,8030,6002,2073,3929,14,742,452,290,1189,1009,39,120,21,83
W02000131,3442,2525,891,1634,2,422,267,155,462,372,19,60,11,31
W02000132,3265,2426,1040,1386,6,244,164,80,524,445,21,53,5,65
W02000133,2647,1960,876,1084,8,242,170,72,385,331,5,38,11,52
W02000134,2314,1780,675,1105,6,250,176,74,255,208,4,37,6,23
W02000135,2456,1794,623,1171,8,329,250,79,305,260,9,33,3,20
W02000136,2321,1758,725,1033,13,165,88,77,347,294,26,19,8,38
W02000137,1655,1164,384,780,4,291,243,48,182,150,5,23,4,14
W02000138,5055,3645,1189,2456,12,610,392,218,750,664,9,72,5,38
W02000139,1819,1388,590,798,0,171,106,65,235,208,7,18,2,25
W02000140,4150,3045,1019,2026,5,429,291,138,626,545,27,51,3,45
W02000141,3106,2120,783,1337,4,282,195,87,619,547,16,50,6,81
W02000142,2113,1483,747,736,11,146,106,40,433,392,8,29,4,40
W02000143,2325,1802,954,848,5,143,88,55,320,263,9,32,16,55
W02000144,2849,2279,1122,1157,9,152,99,53,359,312,3,42,2,50
W02000145,2886,2318,1125,1193,9,160,119,41,357,296,3,56,2,42
W02000146,2009,1698,863,835,4,66,39,27,205,166,6,31,2,36
W02000147,3579,2935,1115,1820,11,177,113,64,425,356,13,41,15,31
W02000148,3575,2851,967,1884,8,235,166,69,438,382,11,42,3,43
W02000149,9349,7106,2600,4506,24,754,526,228,1357,1177,28,141,11,108
W02000151,1307,1036,376,660,1,169,139,30,88,75,0,13,0,13
W02000152,2407,1856,602,1254,7,251,191,60,263,225,6,27,5,30
W02000153,1770,1455,691,764,3,89,69,20,194,152,5,33,4,29
W02000154,3348,2656,932,1724,5,310,208,102,343,293,4,41,5,34
W02000156,4201,3108,1056,2052,7,330,249,81,716,662,9,40,5,40
W02000157,1848,1510,616,894,1,133,109,24,180,140,7,24,9,24
W02000158,1030,840,305,535,2,65,44,21,114,98,1,12,3,9
W02000159,1196,975,392,583,5,88,72,16,114,95,5,9,5,14
W02000160,1156,945,318,627,3,81,65,16,110,97,3,8,2,17
W02000161,4464,3498,1139,2359,5,363,262,101,558,495,13,32,18,40
W02000162,1558,1266,476,790,2,109,86,23,167,149,2,13,3,14
W02000163,1517,1127,359,768,5,149,108,41,220,191,1,20,8,16
W02000164,5287,4320,1404,2916,1,406,294,112,518,462,3,45,8,42
W02000165,4207,3250,1062,2188,11,425,307,118,490,417,4,62,7,31
W02000166,2617,1973,602,1371,5,338,289,49,272,241,0,30,1,29
W02000167,2516,1714,566,1148,6,333,231,102,439,385,2,48,4,24
W02000168,1472,1103,341,762,7,176,125,51,167,156,1,8,2,19
W02000169,2351,1907,619,1288,5,206,147,59,214,173,7,28,6,19
W02000170,5082,4137,1015,3122,10,336,222,114,551,498,6,39,8,48
W02000171,2936,2355,655,1700,5,247,157,90,301,275,2,22,2,28
W02000172,3412,2630,771,1859,3,377,228,149,375,325,8,40,2,27
W02000173,1427,1163,266,897,4,91,63,28,154,132,5,13,4,15
W02000174,1635,1346,428,918,6,131,101,30,138,115,2,18,3,14
W02000175,3337,2441,671,1770,5,428,268,160,427,380,1,41,5,36
W02000176,5386,4431,1351,3080,9,445,292,153,470,412,3,53,2,31
W02000177,10986,8376,2345,6031,34,1245,829,416,1265,1136,4,119,6,66
W02000178,1470,942,263,679,4,371,278,93,143,126,1,14,2,10
W02000179,1577,1267,406,861,4,117,79,38,175,157,2,14,2,14
W02000180,3795,2651,789,1862,3,657,479,178,451,395,5,50,1,33
W02000181,7032,5325,1450,3875,16,734,500,234,902,807,6,87,2,55
W02000182,2081,1653,504,1149,7,189,114,75,218,180,1,36,1,14
W02000183,3527,2548,828,1720,9,426,251,175,511,447,1,56,7,33
W02000184,3379,2603,735,1868,6,436,294,142,312,271,0,37,4,22
W02000185,986,780,272,508,4,79,61,18,116,101,0,11,4,7
W02000186,923,553,179,374,2,291,263,28,67,59,0,8,0,10
W02000187,753,598,201,397,4,60,21,39,83,71,2,10,0,8
W02000188,4212,2961,815,2146,18,428,251,177,744,648,5,88,3,61
W02000189,2796,2144,647,1497,9,270,181,89,345,312,11,20,2,28
W02000190,875,709,237,472,3,41,21,20,107,84,1,21,1,15
W02000191,2855,1951,588,1363,11,309,188,121,544,487,4,41,12,40
W02000192,19500,13646,3967,9679,62,2110,1254,856,3514,3170,26,289,29,168
W02000193,3320,2388,776,1612,11,265,151,114,619,548,5,58,8,37
W02000194,6706,5145,1571,3574,6,385,265,120,1112,1004,13,86,9,58
W02000195,1150,912,348,564,2,75,59,16,137,122,1,10,4,24
W02000196,1000,782,232,550,3,88,73,15,117,102,1,14,0,10
W02000197,1936,1565,692,873,4,102,65,37,213,183,5,23,2,52
W02000198,2151,1585,533,1052,3,164,119,45,373,323,4,39,7,26
W02000200,1064,848,325,523,0,140,93,47,70,60,0,10,0,6
W02000201,1284,1059,419,640,1,111,91,20,104,93,0,5,6,9
W02000202,3257,2529,879,1650,2,364,261,103,323,287,1,35,0,39
W02000203,1696,1373,481,892,1,164,104,60,139,116,1,20,2,19
W02000204,976,810,272,538,0,69,48,21,94,76,6,10,2,3
W02000205,3128,2502,847,1655,12,332,198,134,264,236,0,27,1,18
W02000206,5275,4122,1273,2849,6,649,408,241,458,380,5,60,13,40
W02000207,671,542,187,355,1,60,50,10,63,55,2,5,1,5
W02000208,4857,3583,1083,2500,10,620,458,162,614,536,10,58,10,30
W02000209,836,682,294,388,0,96,69,27,51,44,3,2,2,7
W02000210,832,667,195,472,1,87,64,23,71,62,1,6,2,6
W02000211,3531,2773,913,1860,9,359,230,129,362,320,4,34,4,28
W02000212,1361,1129,334,795,4,134,92,42,88,77,1,9,1,6
W02000213,2155,1787,574,1213,3,188,127,61,169,152,2,14,1,8
W02000214,2483,1805,492,1313,5,410,314,96,240,217,2,20,1,23
W02000215,5522,4371,1360,3011,5,625,435,190,485,415,9,58,3,36
W02000216,2536,2025,631,1394,4,210,128,82,274,237,5,30,2,23
W02000217,8299,6922,1947,4975,17,576,352,224,745,655,4,73,13,39
W02000218,985,784,264,520,0,65,34,31,130,114,2,13,1,6
W02000219,2148,1816,558,1258,3,139,55,84,179,152,2,19,6,11
W02000220,1337,1099,347,752,2,92,20,72,139,123,3,13,0,5
W02000221,1536,1235,382,853,4,115,39,76,172,148,0,23,1,10
W02000222,1014,835,233,602,0,74,36,38,98,78,2,15,3,7
W02000223,1742,1408,373,1035,8,125,44,81,185,164,2,16,3,16
W02000224,2994,2325,611,1714,9,253,80,173,381,324,3,46,8,26
W02000225,3202,2526,687,1839,5,329,142,187,327,280,0,41,6,15
W02000226,4323,3525,879,2646,12,255,95,160,517,435,8,70,4,14
W02000227,1082,812,241,571,2,145,66,79,118,106,0,7,5,5
W02000228,5182,4209,1052,3157,11,332,112,220,594,503,21,54,16,36
W02000229,742,587,153,434,1,75,20,55,73,63,2,6,2,6
W02000230,4103,3359,873,2486,11,229,83,146,476,405,10,52,9,28
W02000231,10124,7893,2119,5774,24,846,240,606,1297,1145,9,126,17,64
W02000232,13029,11053,2572,8481,21,643,242,401,1243,1108,12,108,15,69
W02000233,746,561,151,410,1,76,3,73,97,77,1,13,6,11
W02000234,1528,1247,309,938,8,89,22,67,163,132,2,26,3,21
W02000235,2910,2254,726,1528,7,159,47,112,458,411,3,40,4,32
W02000236,1451,1124,370,754,9,85,30,55,219,188,5,19,7,14
W02000237,1894,1549,517,1032,3,86,48,38,226,191,4,23,8,30
W02000238,2523,2040,757,1283,4,95,69,26,346,298,10,34,4,38
W02000239,5101,3969,1152,2817,12,394,226,168,672,598,13,41,20,54
W02000240,4643,3620,926,2694,9,316,163,153,676,584,15,70,7,22
W02000241,4650,3403,967,2436,11,316,167,149,884,803,10,64,7,36
W02000242,1749,1444,478,966,2,125,56,69,157,135,1,12,9,21
W02000243,1516,1106,286,820,3,236,168,68,164,133,8,20,3,7
W02000244,1691,1354,394,960,3,104,44,60,211,189,2,19,1,19
W02000245,2744,2120,470,1650,10,230,111,119,377,327,5,42,3,7
W02000246,1384,1164,325,839,3,68,38,30,142,119,3,19,1,7
W02000247,2060,1586,522,1064,2,125,107,18,328,233,62,19,14,19
W02000248,4485,3301,779,2522,9,422,234,188,731,650,9,61,11,22
W02000249,2038,1478,382,1096,4,182,115,67,345,298,12,33,2,29
W02000250,4985,3869,950,2919,13,258,152,106,820,543,148,41,88,25
W02000251,3341,2518,637,1881,9,287,152,135,513,458,3,50,2,14
W02000252,2394,1865,610,1255,3,259,159,100,249,222,1,23,3,18
W02000253,3046,2376,785,1591,1,251,150,101,403,371,3,26,3,15
W02000254,2000,1606,506,1100,3,133,61,72,240,217,0,21,2,18
W02000255,1946,1534,537,997,1,180,98,82,218,207,0,11,0,13
W02000256,2103,1649,563,1086,0,166,68,98,267,238,0,28,1,21
W02000257,2000,1571,532,1039,6,162,65,97,242,225,0,15,2,19
W02000258,903,750,292,458,2,44,18,26,102,94,0,6,2,5
W02000259,715,550,190,360,7,61,20,41,87,82,0,5,0,10
W02000260,1243,1011,397,614,2,85,45,40,139,125,0,12,2,6
W02000261,2407,1981,690,1291,3,133,68,65,273,243,0,28,2,17
W02000262,993,817,246,571,2,37,17,20,126,119,2,5,0,11
W02000263,2472,2099,623,1476,1,108,61,47,253,219,3,28,3,11
W02000264,784,615,229,386,0,51,21,30,113,103,0,7,3,5
W02000265,2709,2199,710,1489,2,162,98,64,321,285,1,32,3,25
W02000266,911,735,198,537,0,88,52,36,79,69,1,9,0,9
W02000267,2095,1784,551,1233,2,86,46,40,212,187,0,24,1,11
W02000268,2204,1848,588,1260,1,92,48,44,249,217,0,31,1,14
W02000269,1725,1390,479,911,4,97,50,47,220,189,2,29,0,14
W02000270,1717,1412,462,950,7,81,40,41,205,183,1,19,2,12
W02000271,1862,1533,507,1026,3,139,88,51,177,163,0,14,0,10
W02000272,5499,4487,1344,3143,12,309,139,170,636,566,7,53,10,55
W02000273,4128,3156,939,2217,7,247,122,125,678,626,6,42,4,40
W02000274,2949,2460,712,1748,5,188,115,73,284,253,0,26,5,12
W02000275,1020,801,262,539,2,96,56,40,115,100,0,14,1,6
W02000276,2676,2136,620,1516,3,196,116,80,323,286,0,36,1,18
W02000277,8403,6758,1903,4855,17,562,278,284,1028,925,2,89,12,38
W02000278,2018,1738,461,1277,2,88,48,40,179,147,6,18,8,11
W02000279,1383,1129,313,816,1,79,37,42,164,147,5,12,0,10
W02000280,3292,2694,732,1962,13,208,107,101,364,306,8,47,3,13
W02000281,10413,8698,2343,6355,15,591,299,292,1067,950,12,101,4,42
W02000282,3891,3226,877,2349,10,255,141,114,376,317,6,45,8,24
W02000284,4549,3065,994,2071,13,683,372,311,759,723,3,30,3,29
W02000285,2294,1747,561,1186,6,234,116,118,284,255,4,21,4,23
W02000286,7916,6068,1773,4295,15,872,417,455,904,802,10,80,12,57
W02000287,2592,2040,664,1376,3,286,136,150,248,212,7,25,4,15
W02000288,2534,1994,631,1363,5,275,122,153,241,221,0,18,2,19
W02000289,1173,949,312,637,2,94,30,64,123,112,5,6,0,5
W02000290,2328,1818,564,1254,0,278,203,75,214,186,5,19,4,18
W02000291,1093,862,310,552,2,117,81,36,105,89,2,9,5,7
W02000292,1137,867,219,648,2,131,99,32,131,105,0,23,3,6
W02000293,1530,1162,369,793,2,170,137,33,190,176,0,14,0,6
W02000294,1014,820,247,573,2,88,53,35,101,89,0,12,0,3
W02000295,4542,3682,1036,2646,12,366,202,164,467,419,2,41,5,15
W02000296,1483,1152,308,844,2,143,99,44,177,153,7,16,1,9
W02000297,2333,1913,566,1347,6,173,122,51,227,204,0,18,5,14
W02000298,3378,2643,704,1939,10,350,225,125,363,321,1,41,0,12
W02000299,1499,1177,325,852,5,176,124,52,134,117,0,16,1,7
W02000300,3493,2852,810,2042,6,300,205,95,328,286,0,39,3,7
W02000301,3207,2595,676,1919,7,250,155,95,338,303,0,30,5,17
W02000302,5313,4414,1252,3162,8,334,211,123,515,460,9,36,10,42
W02000303,2417,1963,602,1361,4,194,120,74,235,214,0,19,2,21
W02000304,1685,1303,401,902,3,161,90,71,208,185,0,17,6,10
W02000305,678,533,156,377,3,68,52,16,70,58,0,11,1,4
W02000306,2116,1664,470,1194,7,188,116,72,237,211,4,21,1,20
W02000307,864,667,192,475,3,73,39,34,114,89,2,21,2,7
W02000308,1243,978,264,714,2,125,80,45,136,122,0,13,1,2
W02000309,4141,3211,844,2367,19,425,281,144,464,421,2,36,5,22
W02000310,2044,1570,398,1172,8,155,107,48,289,245,10,33,1,22
W02000311,3759,2812,759,2053,28,420,272,148,472,407,6,53,6,27
W02000312,1734,1406,357,1049,9,135,83,52,175,155,3,17,0,9
W02000313,5535,4462,1083,3379,11,388,235,153,647,581,3,55,8,27
W02000314,2608,1910,549,1361,7,367,206,161,312,279,2,26,5,12
W02000315,1801,1329,430,899,1,255,138,117,210,189,2,16,3,6
W02000316,2543,1937,588,1349,3,343,189,154,246,221,0,21,4,14
W02000317,3687,2901,863,2038,11,464,244,220,298,272,0,19,7,13
W02000318,2362,1755,565,1190,2,315,155,160,276,245,4,25,2,14
W02000319,2171,1643,516,1127,2,237,130,107,266,244,2,16,4,23
W02000320,3325,2485,766,1719,6,354,180,174,467,423,4,33,7,13
W02000321,2573,1986,684,1302,5,255,116,139,303,265,2,32,4,24
W02000322,908,698,268,430,2,98,46,52,107,91,5,10,1,3
W02000323,1734,1353,461,892,2,186,70,116,184,168,4,11,1,9
W02000324,996,751,209,542,1,143,75,68,92,80,0,11,1,9
W02000325,1141,783,233,550,4,225,109,116,117,100,2,13,2,12
W02000326,4758,3685,1139,2546,14,581,243,338,456,410,6,33,7,22
W02000327,2551,2094,575,1519,6,213,86,127,223,203,1,17,2,15
W02000328,3049,2470,663,1807,12,284,115,169,263,236,2,17,8,20
W02000329,2389,1709,433,1276,11,388,173,215,269,243,5,15,6,12
W02000330,3687,3102,759,2343,14,259,109,150,291,256,1,30,4,21
W02000331,678,457,96,361,2,156,68,88,62,55,1,3,3,1
W02000332,8150,6015,1624,4391,41,1156,569,587,901,802,8,80,11,37
W02000333,959,737,177,560,25,109,46,63,84,69,4,9,2,4
W02000334,707,602,159,443,6,70,27,43,27,24,0,1,2,2
W02000335,8001,6171,1612,4559,37,799,342,457,958,855,2,90,11,36
W02000336,7360,5646,1939,3707,18,643,271,372,970,821,40,92,17,83
W02000337,1286,962,321,641,7,163,58,105,136,110,2,22,2,18
W02000338,2041,1554,601,953,6,222,84,138,244,216,0,24,4,15
W02000339,4986,3746,1320,2426,36,461,103,358,669,591,24,48,6,74
W02000340,3013,2169,936,1233,11,206,75,131,552,479,12,48,13,75
W02000341,4176,3348,1189,2159,19,248,103,145,506,445,13,43,5,55
W02000342,2624,2150,872,1278,8,166,48,118,268,233,8,23,4,32
W02000343,5156,3765,1029,2736,32,589,171,418,725,646,6,63,10,45
W02000344,2709,2160,715,1445,10,207,99,108,308,264,12,23,9,24
W02000345,2464,1920,562,1358,20,278,109,169,228,207,7,14,0,18
W02000346,2024,1703,438,1265,3,111,41,70,191,163,1,22,5,16
W02000347,3764,2800,794,2006,31,287,137,150,614,550,3,54,7,32
W02000348,1560,1221,355,866,8,137,72,65,184,171,0,13,0,10
W02000349,996,665,170,495,7,197,128,69,120,107,0,11,2,7
W02000350,5679,4425,1146,3279,23,491,240,251,708,636,6,54,12,32
W02000351,570,426,104,322,2,82,42,40,52,43,0,9,0,8
W02000352,2614,1892,479,1413,17,287,126,161,397,352,6,31,8,21
W02000353,1959,1527,440,1087,10,171,83,88,239,210,4,19,6,12
W02000354,705,501,142,359,1,102,50,52,97,87,1,8,1,4
W02000355,2347,1741,481,1260,7,244,150,94,341,312,1,28,0,14
W02000356,1131,821,186,635,7,159,86,73,135,115,2,14,4,9
W02000357,2214,1626,453,1173,12,203,99,104,353,328,1,22,2,20
W02000358,2865,2324,594,1730,13,203,86,117,307,280,1,22,4,18
W02000359,2255,1628,456,1172,14,251,136,115,348,325,3,16,4,14
W02000360,12463,9278,2347,6931,73,1188,550,638,1847,1671,24,136,16,77
W02000361,8448,6369,1671,4698,49,1014,542,472,967,868,6,79,14,49
W02000362,1236,1004,271,733,7,80,41,39,130,115,4,7,4,15
W02000363,1280,869,236,633,10,215,123,92,179,163,0,16,0,7
W02000364,6499,4705,1212,3493,44,756,360,396,951,863,8,66,14,43
W02000365,2410,1709,372,1337,10,342,183,159,333,305,0,24,4,16
W02000366,12237,9174,2075,7099,71,823,439,384,2109,1947,12,134,16,60
W02000367,1309,1052,314,738,8,60,30,30,162,146,1,13,2,27
W02000368,877,714,205,509,5,46,26,20,104,93,1,10,0,8
W02000369,6622,4807,1033,3774,25,480,227,253,1269,1181,3,78,7,41
W02000370,960,786,218,568,2,41,21,20,118,108,3,7,0,13
W02000371,7904,6346,1699,4647,39,432,240,192,1046,959,10,69,8,41
W02000372,2536,2088,620,1468,6,134,67,67,288,253,5,19,11,20
W02000373,2021,1546,344,1202,6,236,138,98,219,199,3,17,0,14
W02000374,945,778,268,510,1,48,19,29,105,91,2,10,2,13
W02000375,2134,1471,334,1137,13,249,123,126,393,363,0,28,2,8
W02000376,4606,3700,982,2718,12,303,152,151,574,524,3,40,7,17
W02000377,6065,4591,1043,3548,15,501,220,281,918,835,6,73,4,40
W02000378,1250,1018,309,709,5,41,26,15,177,147,6,22,2,9
W02000379,549,300,67,233,6,161,41,120,78,73,0,4,1,4
W02000380,1711,1384,430,954,7,94,58,36,212,179,10,20,3,14
W02000381,904,676,164,512,4,125,94,31,93,83,0,10,0,6
W02000382,1307,955,247,708,4,136,83,53,195,184,0,10,1,17
W02000383,906,691,183,508,4,106,78,28,102,94,0,8,0,3
W02000384,12305,9152,2214,6938,48,728,369,359,2305,2132,16,146,11,72
W02000385,1462,1137,320,817,6,62,34,28,250,227,2,20,1,7
W02000386,2645,2122,605,1517,9,141,89,52,344,304,3,31,6,29
W02000387,2407,1960,516,1444,14,96,49,47,320,290,4,22,4,17
W02000388,3014,2278,571,1707,13,339,180,159,372,316,5,49,2,12
W02000389,1569,1196,355,841,4,141,81,60,212,193,1,14,4,16
W02000390,1079,876,270,606,6,58,33,25,134,120,1,13,0,5
W02000391,4625,3390,940,2450,12,354,191,163,835,773,2,53,7,34
W02000392,6221,4871,1321,3550,24,278,118,160,997,915,6,72,4,51
W02000393,828,604,160,444,4,122,101,21,92,86,1,5,0,6
W02000394,2737,1642,491,1151,12,185,102,83,877,809,10,47,11,21
W02000395,3590,2513,679,1834,11,402,184,218,645,584,3,54,4,19
W02000396,2267,1383,406,977,11,221,106,115,644,598,2,37,7,8
W02000397,1793,1390,318,1072,2,178,102,76,210,185,4,19,2,13
W02000398,36392,23924,5931,17993,183,2105,1038,1067,9935,9261,44,562,68,245
W02000399,5306,3387,906,2481,19,355,167,188,1500,1383,9,96,12,45
W02000400,5446,3967,1011,2956,11,345,176,169,1073,977,1,89,6,50
W02000401,965,742,225,517,1,82,31,51,132,118,0,12,2,8
W02000402,7067,5015,1181,3834,43,538,210,328,1423,1312,9,90,12,48
W02000403,2689,1918,458,1460,9,368,185,183,380,342,4,30,4,14
W02000404,5847,4360,1033,3327,15,518,190,328,906,843,3,55,5,48
W02000405,604,370,79,291,2,164,137,27,66,61,0,2,3,2
W02000406,5941,4050,1014,3036,22,687,344,343,1130,1025,4,88,13,52
W02000407,2004,1390,361,1029,10,285,160,125,305,273,1,30,1,14
W02000408,2262,1552,414,1138,13,188,88,100,492,456,2,30,4,17
W02000409,1049,788,201,587,2,149,118,31,102,90,0,10,2,8
W02000410,1235,828,254,574,2,114,48,66,282,253,3,23,3,9
W02000411,1067,741,186,555,2,173,97,76,148,135,0,12,1,3
W02000412,5263,3858,1092,2766,21,563,296,267,779,714,3,59,3,42
W02000414,2205,1631,916,715,17,116,73,43,396,330,20,31,15,45
W02000415,3734,2881,838,2043,5,433,255,178,398,350,5,38,5,17
W02000416,3057,2452,940,1512,0,289,241,48,287,249,2,36,0,29
W02000417,1594,1254,472,782,0,194,148,46,133,106,2,22,3,13
W02000418,4463,3539,1544,1995,6,295,192,103,565,468,19,61,17,58
W02000419,1653,1294,375,919,11,97,63,34,233,202,8,21,2,18
W02000420,14882,10821,2962,7859,71,1522,1242,280,2334,2153,21,138,22,134
W02000421,4135,3133,1537,1596,11,191,54,137,706,626,10,58,12,94
W02000422,13458,9361,2227,7134,59,963,476,487,2987,2791,10,174,12,88
W02000423,12446,8532,1821,6711,58,925,456,469,2829,2599,10,202,18,102
E33000001,994,742,201,541,5,178,144,34,62,57,0,4,1,7
E33000002,330,205,34,171,0,69,58,11,55,52,0,3,0,1
E33000003,777,527,117,410,6,159,128,31,85,76,0,7,2,0
E33000004,354,255,85,170,1,62,48,14,35,29,0,6,0,1
E33000005,670,479,108,371,1,100,69,31,87,77,0,9,1,3
E33000006,377,246,56,190,1,75,61,14,54,50,0,4,0,1
E33000007,449,333,104,229,4,58,39,19,50,43,4,3,0,4
E33000008,2952,2421,573,1848,9,298,241,57,214,190,0,22,2,10
E33000009,203,161,51,110,2,21,12,9,16,15,0,1,0,3
E33000010,580,486,110,376,1,54,32,22,38,32,1,5,0,1
E33000011,593,482,127,355,1,69,38,31,40,35,0,4,1,1
E33000012,338,245,60,185,0,58,42,16,34,30,1,2,1,1
E33000013,319,251,65,186,0,28,22,6,40,37,0,2,1,0
E33000014,343,254,52,202,1,52,44,8,34,33,0,1,0,2
E33000015,230,158,44,114,0,34,24,10,34,26,1,6,1,4
E33000016,454,364,83,281,3,39,27,12,47,44,0,3,0,1
E33000017,248,197,62,135,1,30,20,10,18,16,0,2,0,2
E33000018,251,196,54,142,0,31,18,13,24,21,0,3,0,0
E33000019,270,174,49,125,2,55,40,15,38,32,1,4,1,1
E33000020,464,373,86,287,1,55,47,8,31,25,0,6,0,4
E33000021,413,311,80,231,0,58,45,13,44,40,0,4,0,0
E33000022,419,325,65,260,2,56,45,11,36,36,0,0,0,0
E33000023,700,489,129,360,4,126,101,25,77,67,0,6,4,4
E33000024,266,201,58,143,0,34,27,7,30,28,1,1,0,1
E33000025,285,186,39,147,2,42,32,10,54,50,0,3,1,1
E33000026,310,207,59,148,2,60,48,12,40,37,1,1,1,1
E33000027,461,326,74,252,2,77,56,21,52,46,0,6,0,4
E33000028,370,255,49,206,0,61,47,14,50,46,0,3,1,4
E33000029,727,546,107,439,1,115,89,26,64,60,0,4,0,1
E33000030,271,187,54,133,0,57,44,13,27,22,1,4,0,0
E33000031,640,472,85,387,2,84,67,17,80,75,0,4,1,2
E33000032,288,205,56,149,1,44,32,12,34,32,0,1,1,4
E33000033,1112,746,150,596,1,178,144,34,180,161,1,18,0,7
E33000034,210,182,46,136,1,11,8,3,13,10,0,3,0,3
E33000035,509,397,67,330,2,57,40,17,49,48,1,0,0,4
E33000036,683,411,113,298,1,122,97,25,147,141,1,5,0,2
E33000037,650,527,144,383,3,42,29,13,74,69,0,5,0,4
E33000038,295,239,59,180,1,27,23,4,28,24,0,3,1,0
E33000039,199,144,26,118,3,32,19,13,18,15,0,3,0,2
E33000040,355,229,69,160,0,84,67,17,42,40,0,2,0,0
E33000041,193,162,36,126,0,14,9,5,17,15,0,2,0,0
E33000042,492,347,80,267,1,66,50,16,77,70,0,7,0,1
E33000043,1253,925,227,698,1,186,137,49,134,122,1,10,1,7
E33000044,822,638,126,512,4,92,71,21,88,83,0,5,0,0
E33000045,349,260,54,206,1,56,48,8,31,29,0,1,1,1
E33000046,393,345,69,276,0,24,17,7,22,20,0,2,0,2
E33000047,412,319,83,236,1,43,35,8,46,44,0,1,1,3
E33000048,713,515,102,413,3,127,93,34,63,56,0,5,2,5
E33000049,826,619,124,495,2,110,74,36,93,85,0,7,1,2
E33000050,463,373,70,303,1,43,36,7,42,38,0,4,0,4
E33000051,1011,785,166,619,8,126,90,36,86,77,1,8,0,6
E33000052,894,654,158,496,4,137,116,21,96,90,0,4,2,3
E33000053,347,251,54,197,2,65,49,16,29,25,0,3,1,0
E33000054,1569,1138,273,865,3,229,177,52,190,178,2,10,0,9
E33000055,611,503,103,400,1,46,37,9,59,54,0,5,0,2
E33000056,494,393,86,307,0,53,40,13,48,42,0,6,0,0
E33000057,863,696,137,559,0,77,45,32,84,72,0,12,0,6
E33000058,454,345,86,259,1,62,50,12,42,36,0,6,0,4
E33000059,1093,806,173,633,3,176,139,37,105,95,0,8,2,3
E33000060,379,250,56,194,1,72,56,16,53,50,0,3,0,3
E33000061,220,143,22,121,0,39,31,8,36,34,1,1,0,2
E33000062,209,159,43,116,0,15,14,1,34,31,0,3,0,1
E33000063,7937,5080,1118,3962,31,1410,1103,307,1376,1263,11,92,10,40
E33000064,251,179,42,137,1,37,30,7,31,25,0,5,1,3
E33000065,1184,830,179,651,2,239,188,51,110,95,0,14,1,3
E33000066,763,530,112,418,4,123,105,18,101,88,1,10,2,5
E33000067,695,490,96,394,4,66,47,19,132,125,1,6,0,3
E33000068,681,536,139,397,1,66,51,15,78,70,0,8,0,0
E33000069,406,283,58,225,1,60,48,12,61,54,0,6,1,1
E33000070,1015,522,117,405,4,295,242,53,183,165,0,14,4,11
E33000071,271,185,44,141,0,50,43,7,33,30,1,2,0,3
E33000072,721,521,137,384,4,141,125,16,53,52,0,1,0,2
E33000073,310,190,38,152,0,52,35,17,60,47,6,5,2,8
E33000074,699,567,141,426,3,58,50,8,71,67,0,4,0,0
E33000075,635,427,112,315,1,141,119,22,62,54,0,8,0,4
E33000076,738,581,131,450,3,101,87,14,50,43,0,6,1,3
E33000077,590,480,121,359,2,51,40,11,56,52,0,4,0,1
E33000078,3523,2737,490,2247,18,257,177,80,500,441,8,51,0,11
E33000079,214,157,41,116,0,24,22,2,32,28,0,4,0,1
E33000080,390,321,84,237,2,26,22,4,37,34,1,2,0,4
E33000081,529,380,81,299,2,65,45,20,81,69,0,11,1,1
E33000082,232,166,40,126,1,36,29,7,27,21,0,5,1,2
E33000083,1596,1242,262,980,5,150,118,32,195,182,0,11,2,4
E33000084,688,550,115,435,3,29,23,6,104,97,1,6,0,2
E33000085,262,211,35,176,1,16,11,5,34,33,0,1,0,0
E33000086,283,196,69,127,0,22,15,7,64,59,0,4,1,1
E33000087,348,225,48,177,2,39,25,14,76,70,0,6,0,6
E33000088,503,383,77,306,0,35,28,7,81,74,0,5,2,4
E33000089,453,312,77,235,1,38,27,11,95,81,0,13,1,7
E33000090,362,287,71,216,4,28,22,6,42,38,0,3,1,1
E33000091,437,318,72,246,3,46,37,9,64,53,3,8,0,6
E33000092,303,205,44,161,2,51,40,11,43,40,1,2,0,2
E33000093,1823,1461,254,1207,10,137,102,35,210,170,3,35,2,5
E33000094,401,232,57,175,1,105,84,21,62,58,0,4,0,1
E33000095,431,328,85,243,1,70,56,14,30,26,0,4,0,2
E33000096,905,728,208,520,1,76,56,20,97,93,0,4,0,3
E33000097,433,277,58,219,4,74,57,17,75,72,0,1,2,3
E33000098,388,290,55,235,3,25,20,5,67,59,1,5,2,3
E33000099,724,450,107,343,5,111,94,17,151,139,1,5,6,7
E33000100,327,160,33,127,1,61,56,5,102,92,0,7,3,3
E33000101,243,166,53,113,1,35,27,8,39,37,0,2,0,2
E33000102,561,349,78,271,3,57,35,22,145,137,1,5,2,7
E33000103,567,372,66,306,1,75,61,14,116,105,1,8,2,3
E33000104,296,195,53,142,1,32,27,5,68,65,0,2,1,0
E33000105,321,174,42,132,1,44,34,10,94,87,1,6,0,8
E33000106,728,457,103,354,3,105,79,26,161,147,1,11,2,2
E33000107,3101,2200,665,1535,16,149,107,42,712,667,4,27,14,24
E33000108,2030,1671,371,1300,9,180,135,45,162,140,5,16,1,8
E33000109,2672,1747,504,1243,13,412,326,86,489,439,1,38,11,11
E33000110,249,168,36,132,0,27,24,3,52,47,0,5,0,2
E33000111,687,525,108,417,0,37,28,9,122,111,0,10,1,3
E33000112,2368,1814,477,1337,9,133,86,47,400,373,0,25,2,12
E33000113,228,159,44,115,0,29,19,10,40,39,0,1,0,0
E33000114,503,402,127,275,0,58,48,10,41,35,0,5,1,2
E33000115,233,137,29,108,1,39,25,14,50,44,0,6,0,6
E33000116,938,576,137,439,0,152,121,31,207,191,1,11,4,3
E33000117,891,638,160,478,2,37,25,12,211,203,2,6,0,3
E33000118,5192,3930,869,3061,19,408,297,111,811,744,5,57,5,24
E33000119,512,337,81,256,7,67,50,17,100,95,0,5,0,1
E33000120,619,480,106,374,1,38,30,8,97,91,1,4,1,3
E33000121,234,139,34,105,0,39,35,4,54,47,2,5,0,2
E33000122,327,237,62,175,2,38,31,7,49,45,0,4,0,1
E33000123,391,310,65,245,0,28,23,5,50,46,0,3,1,3
E33000124,873,681,156,525,3,92,74,18,93,81,1,11,0,4
E33000125,1798,1305,333,972,10,206,162,44,270,245,1,19,5,7
E33000126,445,308,70,238,2,55,43,12,79,69,0,8,2,1
E33000127,584,418,98,320,2,62,42,20,96,88,0,4,4,6
E33000128,250,128,36,92,4,35,27,8,78,67,4,3,4,5
E33000129,538,424,91,333,4,29,14,15,79,72,0,6,1,2
E33000130,245,109,25,84,0,71,57,14,64,62,0,2,0,1
E33000131,621,428,104,324,4,50,38,12,136,125,1,9,1,3
E33000132,558,362,87,275,1,82,58,24,112,106,0,5,1,1
E33000133,686,527,133,394,2,60,46,14,94,87,0,7,0,3
E33000134,2197,1598,343,1255,7,277,203,74,305,280,5,19,1,10
E33000135,923,629,163,466,3,173,137,36,112,102,0,9,1,6
E33000136,236,193,37,156,0,26,18,8,17,17,0,0,0,0
E33000137,229,179,41,138,1,32,29,3,16,15,0,1,0,1
E33000138,229,180,51,129,1,30,23,7,17,13,0,4,0,1
E33000139,302,241,64,177,2,22,18,4,37,28,0,9,0,0
E33000140,121,100,15,85,0,11,8,3,9,9,0,0,0,1
E33000141,384,298,69,229,2,55,48,7,28,28,0,0,0,1
E33000142,622,494,115,379,1,61,46,15,62,59,0,3,0,4
E33000143,233,167,37,130,0,42,36,6,20,14,0,6,0,4
E33000144,201,140,40,100,0,43,32,11,18,16,0,2,0,0
E33000145,360,272,58,214,3,40,35,5,43,40,0,3,0,2
E33000146,494,314,71,243,3,109,96,13,65,61,0,2,2,3
E33000147,417,305,55,250,1,41,33,8,69,65,0,4,0,1
E33000148,447,328,74,254,3,72,53,19,42,39,0,3,0,2
E33000149,551,402,69,333,1,77,59,18,70,63,0,7,0,1
E33000150,369,288,53,235,1,31,22,9,48,41,0,7,0,1
E33000151,1731,1261,264,997,6,199,153,46,254,226,0,26,2,11
E33000152,264,165,42,123,0,62,45,17,34,27,2,4,1,3
E33000153,4691,3310,692,2618,15,510,365,145,835,762,2,69,2,21
E33000154,411,306,80,226,1,56,46,10,48,42,0,6,0,0
E33000155,578,452,94,358,1,63,46,17,58,50,0,7,1,4
E33000156,2166,1622,338,1284,5,247,196,51,287,264,0,21,2,5
E33000157,511,442,104,338,1,29,22,7,36,30,0,5,1,3
E33000158,236,180,38,142,0,30,24,6,25,24,0,1,0,1
E33000159,2153,1569,324,1245,6,211,152,59,358,329,1,22,6,9
E33000160,2692,1846,385,1461,4,333,246,87,489,451,3,33,2,20
E33000161,643,437,85,352,2,84,67,17,116,112,0,4,0,4
E33000162,1112,697,132,565,4,124,89,35,284,264,0,20,0,3
E33000163,915,766,171,595,2,64,42,22,78,68,1,8,1,5
E33000164,497,272,47,225,4,142,117,25,78,75,0,3,0,1
E33000165,227,183,56,127,1,18,13,5,24,17,0,7,0,1
E33000166,210,130,25,105,0,52,42,10,26,23,0,3,0,2
E33000167,204,146,32,114,0,32,24,8,25,23,0,2,0,1
E33000168,217,163,43,120,0,28,17,11,23,20,1,1,1,3
E33000169,215,147,37,110,1,31,20,11,33,28,0,4,1,3
E33000170,221,154,35,119,1,36,29,7,30,25,0,4,1,0
E33000171,856,613,145,468,3,123,89,34,112,95,1,13,3,5
E33000172,2874,2276,492,1784,18,239,176,63,330,297,1,27,5,11
E33000173,2290,1868,406,1462,9,167,125,42,243,220,1,22,0,3
E33000174,867,598,152,446,4,144,111,33,117,102,1,13,1,4
E33000175,384,275,66,209,1,48,33,15,59,56,0,3,0,1
E33000176,731,583,126,457,0,72,57,15,72,67,0,4,1,4
E33000177,417,252,57,195,2,87,72,15,69,65,0,2,2,7
E33000178,567,473,108,365,2,50,44,6,38,29,1,8,0,4
E33000179,267,189,51,138,1,35,26,9,42,42,0,0,0,0
E33000180,414,324,89,235,1,34,23,11,54,47,2,5,0,1
E33000181,280,187,51,136,0,43,35,8,47,45,0,2,0,3
E33000182,1624,1314,331,983,8,191,154,37,101,89,1,11,0,10
E33000183,634,440,140,300,1,146,128,18,45,39,0,6,0,2
E33000184,234,181,37,144,0,40,32,8,13,10,0,3,0,0
E33000185,460,328,75,253,1,93,75,18,36,31,0,5,0,2
E33000186,327,246,54,192,2,43,33,10,36,35,0,1,0,0
E33000187,840,617,147,470,2,127,97,30,93,79,2,12,0,1
E33000188,212,135,27,108,0,53,43,10,24,20,0,1,3,0
E33000189,299,217,46,171,0,61,50,11,18,17,0,1,0,3
E33000190,306,198,59,139,1,77,62,15,28,25,0,3,0,2
E33000191,554,320,76,244,4,171,129,42,56,53,0,3,0,3
E33000192,248,152,34,118,1,75,66,9,20,19,0,1,0,0
E33000193,599,411,89,322,2,133,106,27,50,47,0,3,0,3
E33000194,1148,778,205,573,1,271,201,70,95,88,0,6,1,3
E33000195,1128,800,147,653,1,160,112,48,160,148,0,11,1,7
E33000196,767,574,125,449,1,98,67,31,92,83,0,6,3,2
E33000197,961,691,172,519,6,144,113,31,119,108,2,9,0,1
E33000198,1115,874,261,613,2,166,117,49,69,62,0,6,1,4
E33000199,262,175,42,133,0,54,44,10,32,30,0,2,0,1
E33000200,228,164,49,115,3,43,35,8,16,11,2,3,0,2
E33000201,276,187,54,133,2,49,40,9,33,29,1,3,0,5
E33000202,278,180,48,132,0,64,49,15,32,31,0,1,0,2
E33000203,854,558,152,406,2,211,171,40,80,75,0,5,0,3
E33000204,546,444,101,343,4,58,39,19,37,34,0,3,0,3
E33000205,303,228,55,173,4,49,33,16,22,20,1,0,1,0
E33000206,215,163,32,131,1,17,14,3,28,26,0,2,0,6
E33000207,210,140,33,107,1,39,28,11,29,23,0,6,0,1
E33000208,345,256,59,197,1,48,35,13,38,33,0,5,0,2
E33000209,554,357,108,249,2,141,116,25,53,45,0,8,0,1
E33000210,241,178,37,141,1,35,23,12,26,22,0,2,2,1
E33000211,688,488,116,372,3,104,70,34,90,83,1,6,0,3
E33000212,1615,1283,264,1019,5,178,109,69,141,119,2,17,3,8
E33000213,436,355,76,279,1,41,24,17,39,33,0,6,0,0
E33000214,999,725,130,595,2,141,86,55,129,121,1,7,0,2
E33000215,295,211,54,157,0,45,21,24,38,37,0,1,0,1
E33000216,230,135,43,92,0,56,33,23,39,29,0,6,4,0
E33000217,1916,1285,327,958,3,358,215,143,264,232,2,27,3,6
E33000218,280,175,42,133,0,68,42,26,37,35,0,1,1,0
E33000219,466,343,94,249,1,72,45,27,48,44,0,3,1,2
E33000220,1192,872,209,663,2,185,114,71,123,112,0,10,1,10
E33000221,130,98,22,76,0,16,9,7,16,13,0,2,1,0
E33000222,1503,1273,308,965,5,113,61,52,106,88,2,14,2,6
E33000223,223,114,34,80,0,38,23,15,70,62,3,4,1,1
E33000224,4709,3612,866,2746,12,516,302,214,552,489,22,36,5,17
E33000225,796,622,141,481,0,87,62,25,81,66,0,15,0,6
E33000226,673,521,128,393,4,75,41,34,67,58,1,3,5,6
E33000227,287,238,61,177,0,16,9,7,31,26,0,4,1,2
E33000228,870,592,132,460,0,156,108,48,121,108,0,13,0,1
E33000229,1617,1095,210,885,5,202,131,71,308,285,0,22,1,7
E33000230,312,248,58,190,2,33,15,18,27,25,0,2,0,2
E33000231,254,215,64,151,1,24,14,10,13,12,0,0,1,1
E33000232,313,212,69,143,2,70,45,25,27,23,0,4,0,2
E33000233,214,153,46,107,0,43,28,15,18,12,0,5,1,0
E33000234,628,527,121,406,2,46,25,21,50,41,1,7,1,3
E33000235,292,193,55,138,0,65,39,26,32,31,0,1,0,2
E33000236,2028,1528,273,1255,10,208,103,105,276,252,4,19,1,6
E33000237,699,542,77,465,1,72,32,40,82,71,0,11,0,2
E33000238,2939,2308,435,1873,10,296,147,149,315,265,2,44,4,10
E33000239,760,561,163,398,1,135,71,64,62,50,0,10,2,1
E33000240,685,511,106,405,1,68,41,27,100,94,0,5,1,5
E33000241,1994,1417,267,1150,2,238,132,106,331,296,1,33,1,6
E33000242,349,231,58,173,0,78,39,39,40,34,2,3,1,0
E33000243,320,257,56,201,2,25,13,12,34,33,0,0,1,2
E33000244,212,147,38,109,0,49,36,13,15,13,0,2,0,1
E33000245,777,586,117,469,0,116,69,47,75,68,0,6,1,0
E33000246,219,154,36,118,0,42,24,18,21,20,0,1,0,2
E33000247,249,186,54,132,1,37,18,19,24,18,1,4,1,1
E33000248,450,304,71,233,0,84,55,29,55,49,0,4,2,7
E33000249,535,410,98,312,2,60,40,20,62,56,0,5,1,1
E33000250,1060,802,187,615,5,120,76,44,128,106,1,21,0,5
E33000251,656,481,129,352,1,100,50,50,71,65,1,5,0,3
E33000252,197,107,25,82,1,39,26,13,50,47,0,3,0,0
E33000253,227,162,51,111,0,35,23,12,27,23,0,2,2,3
E33000254,606,394,103,291,2,119,72,47,90,78,1,7,4,1
E33000255,470,401,106,295,2,41,28,13,25,22,0,3,0,1
E33000256,376,322,78,244,1,26,12,14,26,21,0,5,0,1
E33000257,2837,1914,465,1449,4,618,395,223,298,266,0,30,2,3
E33000258,729,596,168,428,3,86,66,20,36,33,0,2,1,8
E33000259,491,343,99,244,1,92,58,34,53,46,1,6,0,2
E33000260,891,670,153,517,0,126,77,49,86,80,0,6,0,9
E33000261,609,409,84,325,1,101,70,31,94,88,0,6,0,4
E33000262,6565,5033,817,4216,14,806,502,304,696,613,1,72,10,16
E33000263,1060,770,154,616,0,196,125,71,90,82,0,7,1,4
E33000264,1112,804,154,650,1,187,122,65,120,108,1,9,2,0
E33000265,916,674,157,517,2,136,90,46,103,93,0,8,2,1
E33000266,1065,779,183,596,5,158,103,55,122,118,0,4,0,1
E33000267,326,252,68,184,0,43,22,21,29,25,0,4,0,2
E33000268,606,458,118,340,2,92,53,39,54,49,0,5,0,0
E33000269,1587,1280,319,961,3,140,61,79,159,146,2,8,3,5
E33000270,402,298,75,223,3,29,14,15,70,64,0,3,3,2
E33000271,1373,1153,254,899,6,95,49,46,111,101,1,9,0,8
E33000272,1426,1029,268,761,2,203,93,110,185,171,1,12,1,7
E33000273,401,263,50,213,1,72,39,33,60,55,0,5,0,5
E33000274,671,513,129,384,2,80,36,44,71,63,1,7,0,5
E33000275,417,300,78,222,2,65,26,39,49,46,0,3,0,1
E33000276,446,399,68,331,1,17,11,6,28,23,0,5,0,1
E33000277,1073,927,282,645,2,58,24,34,84,77,0,6,1,2
E33000278,1281,1018,261,757,5,114,57,57,134,120,3,11,0,10
E33000279,222,164,33,131,0,27,13,14,28,22,2,3,1,3
E33000280,335,276,63,213,0,37,21,16,21,20,0,1,0,1
E33000281,330,235,43,192,0,51,30,21,43,42,0,1,0,1
E33000282,617,526,152,374,1,47,13,34,39,31,0,8,0,4
E33000283,237,151,41,110,3,45,26,19,38,32,0,4,2,0
E33000284,320,255,49,206,0,27,9,18,36,35,0,1,0,2
E33000285,519,359,91,268,2,69,31,38,88,84,0,3,1,1
E33000286,269,205,62,143,1,30,11,19,29,26,0,3,0,4
E33000287,309,193,49,144,3,60,26,34,53,52,0,1,0,0
E33000288,256,206,57,149,0,25,12,13,23,20,0,3,0,2
E33000289,253,216,57,159,1,14,6,8,21,17,0,3,1,1
E33000290,487,349,78,271,1,53,16,37,82,71,2,7,2,2
E33000291,360,272,73,199,1,49,19,30,34,33,0,1,0,4
E33000292,371,289,58,231,1,42,23,19,34,31,0,2,1,5
E33000293,358,274,66,208,0,42,16,26,39,38,0,1,0,3
E33000294,517,427,112,315,3,35,9,26,50,44,0,4,2,2
E33000295,7824,6182,1385,4797,32,591,276,315,971,806,56,82,27,48
E33000296,1035,716,179,537,7,170,73,97,135,121,0,14,0,7
E33000297,255,192,48,144,0,31,14,17,32,30,0,2,0,0
E33000298,213,155,27,128,1,23,12,11,32,28,3,0,1,2
E33000299,795,653,150,503,1,71,35,36,65,59,0,5,1,5
E33000300,573,444,101,343,1,56,26,30,66,57,0,9,0,6
E33000301,319,237,48,189,0,46,25,21,35,34,0,0,1,1
E33000302,779,608,143,465,1,90,39,51,73,68,1,1,3,7
E33000303,406,316,74,242,2,43,14,29,44,35,0,9,0,1
E33000304,570,359,86,273,0,100,53,47,106,97,1,5,3,5
E33000305,743,501,120,381,3,122,57,65,116,105,0,10,1,1
E33000306,357,256,60,196,2,43,21,22,54,53,1,0,0,2
E33000307,457,364,89,275,1,47,21,26,42,40,1,0,1,3
E33000308,266,217,55,162,0,23,13,10,25,21,0,4,0,1
E33000309,239,193,61,132,4,18,14,4,23,20,0,3,0,1
E33000310,456,363,114,249,2,26,14,12,62,58,0,4,0,3
E33000311,384,264,76,188,3,45,17,28,67,62,1,3,1,5
E33000312,774,594,151,443,3,91,41,50,83,76,0,5,2,3
E33000313,228,172,42,130,0,17,6,11,37,34,0,3,0,2
E33000314,488,352,76,276,2,50,23,27,79,67,1,11,0,5
E33000315,394,296,81,215,1,30,15,15,66,58,1,7,0,1
E33000316,495,373,82,291,2,43,20,23,71,64,0,6,1,6
E33000317,764,623,151,472,7,43,20,23,85,78,0,6,1,6
E33000318,656,442,111,331,2,87,47,40,121,107,0,13,1,4
E33000319,239,161,39,122,1,31,18,13,41,39,0,1,1,5
E33000320,288,212,66,146,5,30,14,16,39,36,0,3,0,2
E33000321,227,167,42,125,0,28,9,19,32,27,0,5,0,0
E33000322,209,163,33,130,0,20,10,10,25,24,0,1,0,1
E33000323,223,149,46,103,1,28,17,11,45,43,0,2,0,0
E33000324,227,180,53,127,3,14,7,7,30,23,0,6,1,0
E33000325,261,218,55,163,4,11,7,4,27,22,0,5,0,1
E33000326,343,240,61,179,0,45,24,21,58,53,1,4,0,0
E33000327,672,519,124,395,6,58,34,24,84,75,1,8,0,5
E33000328,1580,1353,416,937,8,48,21,27,166,159,0,6,1,5
E33000329,413,357,97,260,0,22,9,13,34,29,1,3,1,0
E33000330,410,321,90,231,1,25,13,12,60,56,0,4,0,3
E33000331,420,364,65,299,4,15,7,8,32,28,0,4,0,5
E33000332,1562,1353,345,1008,2,83,45,38,119,113,1,5,0,5
E33000333,501,409,126,283,2,33,20,13,54,45,1,8,0,3
E33000334,1240,855,199,656,8,187,101,86,185,171,0,13,1,5
E33000335,575,457,125,332,1,59,29,30,54,50,0,3,1,4
E33000336,407,314,79,235,1,38,22,16,52,47,0,5,0,2
E33000337,539,440,119,321,2,37,21,16,58,54,0,4,0,2
E33000338,290,206,73,133,1,36,25,11,44,37,3,3,1,3
E33000339,588,449,141,308,2,42,27,15,90,76,0,11,3,5
E33000340,270,185,53,132,0,20,7,13,65,59,2,4,0,0
E33000341,230,184,45,139,1,8,4,4,37,37,0,0,0,0
E33000342,222,183,68,115,0,15,9,6,21,17,0,4,0,3
E33000343,488,372,82,290,3,42,19,23,62,56,4,0,2,9
E33000344,847,689,174,515,6,71,37,34,72,62,1,9,0,9
E33000345,572,423,123,300,2,84,57,27,57,50,0,6,1,6
E33000346,745,558,125,433,9,98,51,47,74,67,1,6,0,6
E33000347,157,125,27,98,1,17,12,5,13,13,0,0,0,1
E33000348,619,514,110,404,2,44,28,16,54,45,1,7,1,5
E33000349,324,228,52,176,2,60,32,28,31,26,0,5,0,3
E33000350,474,386,105,281,5,42,22,20,39,36,0,3,0,2
E33000351,248,168,55,113,2,25,8,17,52,46,0,5,1,1
E33000352,891,710,163,547,2,93,48,45,83,72,1,10,0,3
E33000353,264,221,49,172,1,15,6,9,26,24,0,2,0,1
E33000354,1529,1353,381,972,1,74,35,39,99,90,0,9,0,2
E33000355,612,529,160,369,1,33,17,16,42,40,1,1,0,7
E33000356,496,410,94,316,1,32,20,12,52,45,0,7,0,1
E33000357,434,350,79,271,0,42,23,19,38,36,0,2,0,4
E33000358,229,174,35,139,3,23,13,10,28,26,0,2,0,1
E33000359,467,346,71,275,4,57,33,24,54,47,3,4,0,6
E33000360,3308,2679,597,2082,8,201,122,79,411,366,11,31,3,9
E33000361,1010,745,158,587,1,153,94,59,99,93,0,6,0,12
E33000362,550,395,106,289,1,65,35,30,87,72,0,13,2,2
E33000363,350,279,60,219,1,28,14,14,39,34,0,5,0,3
E33000364,280,191,42,149,0,47,20,27,41,39,0,2,0,1
E33000365,205,139,15,124,0,22,14,8,41,37,0,3,1,3
E33000366,316,247,58,189,0,29,14,15,40,35,0,5,0,0
E33000367,205,123,28,95,8,39,29,10,30,28,0,2,0,5
E33000368,389,318,79,239,1,27,13,14,41,34,1,6,0,2
E33000369,398,244,61,183,2,89,48,41,62,57,0,4,1,1
E33000370,202,140,26,114,1,28,11,17,31,28,0,3,0,2
E33000371,231,183,34,149,2,13,9,4,32,25,0,7,0,1
E33000372,714,500,112,388,5,106,63,43,93,81,0,12,0,10
E33000373,404,297,74,223,2,52,28,24,50,45,0,4,1,3
E33000374,484,363,91,272,4,56,37,19,60,57,0,3,0,1
E33000375,744,546,152,394,2,104,61,43,86,81,0,5,0,6
E33000376,271,202,61,141,0,34,19,15,31,27,0,3,1,4
E33000377,227,172,30,142,1,21,12,9,33,29,1,2,1,0
E33000378,271,217,46,171,2,13,5,8,37,33,0,3,1,2
E33000379,233,169,39,130,2,18,6,12,39,32,0,7,0,5
E33000380,430,345,71,274,0,33,14,19,50,45,1,4,0,2
E33000381,469,399,79,320,1,19,9,10,47,42,0,1,4,3
E33000382,213,178,35,143,0,13,7,6,22,18,0,4,0,0
E33000383,389,316,75,241,0,37,19,18,35,24,4,7,0,1
E33000384,613,438,95,343,1,67,42,25,106,98,1,6,1,1
E33000385,272,246,60,186,0,15,6,9,11,9,0,2,0,0
E33000386,264,198,56,142,0,33,25,8,33,30,0,3,0,0
E33000387,215,184,47,137,1,10,6,4,20,17,1,2,0,0
E33000388,212,155,26,129,1,18,10,8,37,35,0,2,0,1
E33000389,220,162,38,124,1,25,12,13,32,29,0,3,0,0
E33000390,750,588,182,406,2,24,10,14,127,112,2,13,0,9
E33000391,811,711,182,529,0,36,21,15,63,58,0,5,0,1
E33000392,952,726,185,541,4,85,41,44,132,118,0,12,2,5
E33000393,880,665,186,479,3,117,61,56,93,78,0,13,2,2
E33000394,277,212,46,166,2,30,19,11,32,28,0,3,1,1
E33000395,320,246,58,188,0,32,19,13,41,35,1,3,2,1
E33000396,721,559,137,422,4,57,29,28,97,89,2,6,0,4
E33000397,505,352,70,282,1,77,43,34,75,63,2,6,4,0
E33000398,1486,1133,237,896,5,120,54,66,224,202,3,16,3,4
E33000399,2225,1827,386,1441,12,100,43,57,271,234,0,36,1,15
E33000400,644,557,124,433,4,26,10,16,52,46,0,5,1,5
E33000401,565,443,137,306,2,32,12,20,86,78,3,4,1,2
E33000402,236,189,38,151,1,18,7,11,28,24,0,4,0,0
E33000403,705,536,126,410,2,54,27,27,109,105,0,4,0,4
E33000404,583,445,80,365,1,36,13,23,98,83,1,10,4,3
E33000405,303,217,50,167,0,41,21,20,44,41,0,3,0,1
E33000406,790,616,145,471,2,65,36,29,103,93,2,8,0,4
E33000407,337,271,77,194,1,22,9,13,41,36,2,2,1,2
E33000408,585,461,113,348,2,25,11,14,92,81,2,9,0,5
E33000409,220,168,49,119,0,10,2,8,37,31,3,3,0,5
E33000410,304,243,49,194,1,14,10,4,41,37,2,2,0,5
E33000411,312,227,65,162,2,21,16,5,59,51,0,7,1,3
E33000412,503,372,87,285,1,41,27,14,84,74,1,9,0,5
E33000413,342,217,43,174,2,49,39,10,72,68,0,2,2,2
E33000414,243,165,62,103,1,23,17,6,51,47,1,3,0,3
E33000415,523,347,74,273,0,37,25,12,139,123,8,7,1,0
E33000416,217,177,37,140,0,10,8,2,29,27,1,1,0,1
E33000417,284,241,36,205,0,5,1,4,37,32,1,4,0,1
E33000418,256,209,54,155,1,16,14,2,29,27,0,2,0,1
E33000419,262,196,42,154,1,18,10,8,44,38,1,1,4,3
E33000420,312,208,50,158,1,40,33,7,59,54,1,4,0,4
E33000421,1489,1242,284,958,8,83,60,23,151,123,13,14,1,5
E33000422,672,513,135,378,2,67,40,27,90,80,1,9,0,0
E33000423,612,435,94,341,0,64,45,19,107,93,1,12,1,6
E33000424,340,261,68,193,0,26,18,8,48,47,0,0,1,5
E33000425,248,161,45,116,1,34,25,9,50,42,2,4,2,2
E33000426,222,157,27,130,1,23,12,11,40,37,0,3,0,1
E33000427,462,344,109,235,2,43,26,17,68,66,0,0,2,5
E33000428,374,283,55,228,1,35,24,11,54,49,2,3,0,1
E33000429,284,211,58,153,0,16,12,4,56,47,1,8,0,1
E33000430,203,142,43,99,0,24,19,5,35,30,0,5,0,2
E33000431,483,340,74,266,0,40,22,18,102,90,1,11,0,1
E33000432,235,183,52,131,0,15,12,3,34,31,0,3,0,3
E33000433,369,289,95,194,0,31,21,10,45,40,0,5,0,4
E33000434,310,225,59,166,1,21,14,7,62,60,0,2,0,1
E33000435,241,179,47,132,0,21,13,8,37,34,1,1,1,4
E33000436,310,236,58,178,1,7,3,4,63,57,0,6,0,3
E33000437,420,314,83,231,1,18,11,7,84,72,3,9,0,3
E33000438,293,232,57,175,0,26,16,10,32,26,0,5,1,3
E33000439,687,500,110,390,3,80,50,30,101,91,1,7,2,3
E33000440,361,267,71,196,2,35,25,10,56,49,0,6,1,1
E33000441,462,357,86,271,2,25,13,12,76,71,1,4,0,2
E33000442,502,381,88,293,0,34,21,13,80,66,2,10,2,7
E33000443,376,272,68,204,0,34,20,14,66,61,1,4,0,4
E33000444,452,339,60,279,1,27,16,11,81,74,0,7,0,4
E33000445,355,263,68,195,2,25,16,9,61,51,4,6,0,4
E33000446,397,291,65,226,3,34,23,11,68,58,1,8,1,1
E33000447,1030,834,230,604,5,62,49,13,125,106,2,15,2,4
E33000448,542,444,120,324,1,44,31,13,50,44,1,5,0,3
E33000449,565,405,89,316,2,69,51,18,86,77,1,7,1,3
E33000450,955,808,197,611,3,40,20,20,97,87,0,10,0,7
E33000451,627,516,111,405,1,21,11,10,89,76,0,13,0,0
E33000452,445,352,80,272,1,25,20,5,61,56,1,4,0,6
E33000453,202,159,42,117,2,10,2,8,30,29,0,1,0,1
E33000454,769,531,133,398,2,90,66,24,143,116,3,22,2,3
E33000455,3274,2366,430,1936,10,237,160,77,655,583,5,64,3,6
E33000456,286,227,63,164,1,25,15,10,31,26,0,4,1,2
E33000457,1211,1026,293,733,2,42,29,13,138,129,0,8,1,3
E33000458,547,445,100,345,1,18,12,6,83,75,2,5,1,0
E33000459,666,533,126,407,1,78,28,50,50,42,0,8,0,4
E33000460,340,224,72,152,0,62,41,21,51,49,0,1,1,3
E33000461,213,162,51,111,0,28,14,14,18,16,1,1,0,5
E33000462,304,242,56,186,1,28,12,16,30,23,0,7,0,3
E33000463,277,220,48,172,0,25,12,13,30,25,0,3,2,2
E33000464,394,289,70,219,2,54,26,28,47,42,0,3,2,2
E33000465,392,272,76,196,2,70,45,25,47,45,0,2,0,1
E33000466,474,367,91,276,0,65,48,17,41,34,1,4,2,1
E33000467,258,188,63,125,0,49,19,30,21,20,0,1,0,0
E33000468,398,320,79,241,0,42,21,21,34,33,0,1,0,2
E33000469,539,398,80,318,1,77,48,29,60,53,1,6,0,3
E33000470,878,707,187,520,2,82,55,27,84,77,0,5,2,3
E33000471,567,406,98,308,2,79,57,22,77,67,0,10,0,3
E33000472,376,301,91,210,0,33,10,23,40,36,0,4,0,2
E33000473,293,200,52,148,0,46,26,20,47,43,0,3,1,0
E33000474,481,357,100,257,0,56,24,32,67,63,0,4,0,1
E33000475,341,280,85,195,0,23,16,7,34,27,1,3,3,4
E33000476,212,167,50,117,0,19,9,10,25,25,0,0,0,1
E33000477,263,211,39,172,0,28,12,16,23,22,0,1,0,1
E33000478,774,594,156,438,0,75,41,34,104,96,1,6,1,1
E33000479,286,242,61,181,1,23,10,13,19,17,0,2,0,1
E33000480,339,250,76,174,1,40,18,22,45,41,0,3,1,3
E33000481,723,521,145,376,1,115,72,43,84,77,0,7,0,2
E33000482,425,328,92,236,2,33,19,14,57,53,0,4,0,5
E33000483,150,111,33,78,0,20,9,11,17,16,0,1,0,2
E33000484,371,299,70,229,0,31,18,13,38,33,0,4,1,3
E33000485,193,155,60,95,0,12,12,0,20,13,5,2,0,6
E33000486,954,580,199,381,4,113,32,81,245,222,11,8,4,12
E33000487,563,447,128,319,2,65,46,19,45,37,0,8,0,4
E33000488,1131,931,281,650,4,99,67,32,93,86,0,7,0,4
E33000489,303,241,59,182,0,27,22,5,30,26,0,4,0,5
E33000490,447,358,63,295,0,36,24,12,49,44,0,4,1,4
E33000491,276,221,44,177,0,13,9,4,41,38,0,3,0,1
E33000492,460,340,101,239,0,62,38,24,56,52,1,3,0,2
E33000493,382,262,64,198,0,73,50,23,45,40,1,3,1,2
E33000494,237,156,42,114,0,58,40,18,22,21,0,1,0,1
E33000495,473,325,95,230,1,85,56,29,61,55,1,4,1,1
E33000496,361,269,69,200,0,54,40,14,38,34,1,3,0,0
E33000497,504,389,105,284,1,61,44,17,51,45,1,5,0,2
E33000498,529,396,108,288,2,83,61,22,45,40,0,4,1,3
E33000499,1396,1150,283,867,1,150,116,34,92,82,1,9,0,3
E33000500,609,398,111,287,1,98,63,35,106,100,0,4,2,6
E33000501,260,180,58,122,7,26,19,7,44,37,1,6,0,3
E33000502,503,382,113,269,0,39,20,19,77,71,0,6,0,5
E33000503,323,227,68,159,2,42,26,16,51,45,0,4,2,1
E33000504,269,169,55,114,1,9,8,1,85,82,0,3,0,5
E33000505,950,708,182,526,3,57,29,28,172,159,4,8,1,10
E33000506,396,256,84,172,0,15,11,4,117,108,2,7,0,8
E33000507,1369,956,293,663,2,24,13,11,379,356,4,16,3,8
E33000508,163,110,42,68,0,12,9,3,34,31,1,2,0,7
E33000509,223,111,40,71,0,21,15,6,84,83,1,0,0,7
E33000510,388,326,78,248,2,18,8,10,39,37,2,0,0,3
E33000511,156,84,26,58,0,15,10,5,50,49,0,1,0,7
E33000512,332,232,64,168,0,12,10,2,84,78,3,3,0,4
E33000513,1824,1589,362,1227,5,72,45,27,148,123,2,22,1,10
E33000514,289,226,64,162,0,25,15,10,37,30,0,7,0,1
E33000515,1440,1180,262,918,3,119,83,36,130,116,1,12,1,8
E33000516,726,597,176,421,1,60,35,25,64,57,1,6,0,4
E33000517,340,253,55,198,0,49,33,16,38,34,2,2,0,0
E33000518,261,195,51,144,0,36,21,15,30,21,0,9,0,0
E33000519,1632,1199,245,954,4,154,105,49,263,247,0,15,1,12
E33000520,321,236,48,188,0,48,40,8,37,35,0,2,0,0
E33000521,219,155,48,107,2,32,28,4,30,27,0,3,0,0
E33000522,257,202,47,155,1,34,26,8,19,18,0,1,0,1
E33000523,411,285,60,225,0,54,49,5,68,62,0,6,0,4
E33000524,210,126,25,101,0,46,33,13,37,36,0,1,0,1
E33000525,572,456,112,344,1,77,61,16,36,34,0,2,0,2
E33000526,772,593,169,424,3,105,84,21,71,67,0,4,0,0
E33000527,585,485,89,396,1,49,33,16,50,44,0,6,0,0
E33000528,312,232,63,169,2,40,36,4,35,35,0,0,0,3
E33000529,1082,821,168,653,2,108,72,36,144,135,1,8,0,7
E33000530,1135,891,214,677,1,142,105,37,97,79,0,18,0,4
E33000531,1230,1026,263,763,1,106,73,33,90,79,1,8,2,7
E33000532,388,320,78,242,0,32,25,7,36,32,2,1,1,0
E33000533,201,176,48,128,1,9,6,3,13,10,0,3,0,2
E33000534,2365,1755,319,1436,5,237,170,67,361,321,0,38,2,7
E33000535,440,351,73,278,1,32,24,8,53,48,0,5,0,3
E33000536,443,357,82,275,1,43,26,17,40,34,0,6,0,2
E33000537,362,304,113,191,0,23,17,6,29,23,1,5,0,6
E33000538,355,255,80,175,0,50,41,9,48,45,0,2,1,2
E33000539,798,558,164,394,9,108,86,22,117,110,0,7,0,6
E33000540,242,195,54,141,1,23,15,8,23,20,0,2,1,0
E33000541,262,184,34,150,0,21,15,6,56,51,1,4,0,1
E33000542,213,156,42,114,0,26,20,6,29,21,1,7,0,2
E33000543,314,247,82,165,0,34,22,12,31,30,0,1,0,2
E33000544,263,199,62,137,0,30,23,7,31,29,0,2,0,3
E33000545,334,273,59,214,0,31,14,17,28,25,1,2,0,2
E33000546,572,428,107,321,0,66,38,28,74,65,1,7,1,4
E33000547,563,409,110,299,0,66,44,22,84,78,0,4,2,4
E33000548,854,640,180,460,1,123,90,33,90,80,0,10,0,0
E33000549,296,204,48,156,0,27,14,13,60,57,0,3,0,5
E33000550,299,231,57,174,1,24,17,7,42,40,0,2,0,1
E33000551,537,438,96,342,1,32,23,9,65,59,0,0,6,1
E33000552,287,221,53,168,2,26,17,9,37,35,0,2,0,1
E33000553,409,315,52,263,2,36,25,11,53,49,0,4,0,3
E33000554,271,213,57,156,0,33,20,13,25,20,0,5,0,0
E33000555,532,451,98,353,1,35,21,14,40,35,0,5,0,5
E33000556,320,212,57,155,3,56,37,19,49,45,0,4,0,0
E33000557,540,405,104,301,1,67,51,16,64,60,1,3,0,3
E33000558,235,175,45,130,1,34,28,6,25,22,1,2,0,0
E33000559,284,234,43,191,0,22,17,5,28,27,0,0,1,0
E33000560,351,283,91,192,1,26,17,9,38,34,0,4,0,3
E33000561,312,232,52,180,1,46,32,14,33,32,0,1,0,0
E33000562,1144,847,185,662,4,148,101,47,141,130,1,9,1,4
E33000563,970,750,229,521,2,98,68,30,107,86,7,14,0,13
E33000564,687,562,128,434,4,46,34,12,72,66,0,4,2,3
E33000565,256,191,51,140,3,32,19,13,29,28,1,0,0,1
E33000566,766,558,143,415,2,110,82,28,92,80,2,10,0,4
E33000567,234,163,32,131,0,50,41,9,18,16,0,2,0,3
E33000568,726,606,161,445,2,54,28,26,63,58,1,3,1,1
E33000569,502,372,94,278,2,46,24,22,80,76,0,3,1,2
E33000570,512,347,154,193,4,65,17,48,89,82,0,5,2,7
E33000571,1525,1284,358,926,6,82,37,45,143,130,1,12,0,10
E33000572,281,191,55,136,0,29,6,23,58,55,0,3,0,3
E33000573,268,224,55,169,0,16,12,4,26,22,0,3,1,2
E33000574,446,338,92,246,0,47,33,14,59,53,2,4,0,2
E33000575,415,322,84,238,0,43,30,13,48,41,0,6,1,2
E33000576,248,191,62,129,0,27,21,6,29,25,0,4,0,1
E33000577,716,488,154,334,2,138,95,43,86,81,1,4,0,2
E33000578,325,228,64,164,0,35,27,8,59,58,0,1,0,3
E33000579,250,186,67,119,0,35,24,11,23,22,1,0,0,6
E33000580,377,321,101,220,0,25,19,6,27,23,0,4,0,4
E33000581,605,416,115,301,1,97,68,29,80,72,0,8,0,11
E33000582,290,222,69,153,0,29,20,9,37,34,0,3,0,2
E33000583,775,652,161,491,0,55,37,18,64,59,0,4,1,4
E33000584,370,271,72,199,2,52,39,13,45,41,0,3,1,0
E33000585,364,199,56,143,5,46,34,12,101,91,4,5,1,13
E33000586,918,637,188,449,5,127,102,25,139,129,3,6,1,10
E33000587,408,256,78,178,0,57,45,12,73,63,6,3,1,22
E33000588,334,245,83,162,3,32,20,12,51,42,2,5,2,3
E33000589,234,158,52,106,1,31,22,9,40,38,0,2,0,4
E33000590,280,170,58,112,3,54,39,15,49,45,1,1,2,4
E33000591,269,149,48,101,2,57,43,14,49,38,4,5,2,12
E33000592,302,193,64,129,1,39,12,27,65,58,3,4,0,4
E33000593,277,168,57,111,1,49,16,33,55,46,2,7,0,4
E33000594,208,123,27,96,1,35,10,25,44,38,1,4,1,5
E33000595,417,267,93,174,2,72,23,49,72,67,1,3,1,4
E33000596,244,162,61,101,1,33,7,26,46,38,2,6,0,2
E33000597,890,648,176,472,7,167,131,36,67,54,3,10,0,1
E33000598,785,607,110,497,2,70,53,17,105,89,1,15,0,1
E33000599,295,250,54,196,1,21,12,9,21,20,0,1,0,2
E33000600,551,372,62,310,3,116,80,36,55,51,0,3,1,5
E33000601,489,345,84,261,3,69,54,15,70,64,0,4,2,2
E33000602,1083,827,182,645,1,143,100,43,108,95,0,11,2,4
E33000603,416,308,86,222,1,52,38,14,54,45,0,7,2,1
E33000604,405,344,65,279,3,24,17,7,31,30,0,1,0,3
E33000605,1062,823,181,642,4,121,84,37,110,97,0,11,2,4
E33000606,822,657,169,488,4,89,68,21,71,66,0,5,0,1
E33000607,1317,994,219,775,3,167,100,67,146,134,0,11,1,7
E33000608,306,222,54,168,0,40,35,5,41,37,1,1,2,3
E33000609,211,121,26,95,1,46,37,9,43,43,0,0,0,0
E33000610,244,186,50,136,1,29,22,7,28,25,0,3,0,0
E33000611,213,148,38,110,0,42,33,9,21,20,0,1,0,2
E33000612,296,192,39,153,1,72,58,14,28,26,1,1,0,3
E33000613,519,327,78,249,1,115,80,35,73,68,1,4,0,3
E33000614,652,509,137,372,1,92,71,21,49,40,0,8,1,1
E33000615,642,419,111,308,0,142,116,26,79,66,2,11,0,2
E33000616,482,319,90,229,1,84,57,27,76,62,6,7,1,2
E33000617,493,366,114,252,2,70,44,26,52,49,0,3,0,3
E33000618,293,186,48,138,0,72,54,18,33,31,0,1,1,2
E33000619,266,208,53,155,1,32,22,10,23,20,0,3,0,2
E33000620,459,377,80,297,0,54,44,10,27,25,0,2,0,1
E33000621,210,151,45,106,0,34,28,6,23,22,0,1,0,2
E33000622,1025,839,190,649,2,64,33,31,115,97,4,13,1,5
E33000623,536,413,114,299,3,48,30,18,63,51,2,10,0,9
E33000624,338,253,79,174,1,41,20,21,40,35,1,2,2,3
E33000625,216,150,43,107,2,29,16,13,33,28,0,4,1,2
E33000626,277,209,59,150,1,27,15,12,37,29,4,2,2,3
E33000627,505,362,92,270,0,58,42,16,79,74,0,5,0,6
E33000628,2032,1675,443,1232,5,144,88,56,176,158,2,11,5,32
E33000629,520,383,114,269,2,46,35,11,83,79,0,3,1,6
E33000630,3062,2660,400,2260,12,138,100,38,230,206,7,15,2,22
E33000631,590,453,131,322,0,56,41,15,77,66,0,11,0,4
E33000632,336,227,84,143,3,37,13,24,63,57,1,5,0,6
E33000633,583,421,138,283,4,69,33,36,86,81,0,4,1,3
E33000634,333,227,83,144,4,33,6,27,65,60,0,4,1,4
E33000635,206,141,54,87,1,24,5,19,37,33,0,1,3,3
E33000636,291,183,60,123,2,40,19,21,60,50,3,5,2,6
E33000637,209,152,60,92,1,15,11,4,36,30,1,3,2,5
E33000638,223,149,52,97,1,23,13,10,46,44,0,2,0,4
E33000639,217,157,61,96,0,21,12,9,32,31,0,1,0,7
E33000640,436,288,117,171,4,62,27,35,76,69,0,5,2,6
E33000641,656,409,114,295,1,114,52,62,129,120,7,2,0,3
E33000642,805,594,204,390,3,83,43,40,110,91,1,15,3,15
E33000643,236,180,53,127,2,28,11,17,23,21,0,2,0,3
E33000644,235,186,54,132,1,24,10,14,23,21,0,2,0,1
E33000645,904,583,145,438,9,131,67,64,177,168,1,8,0,4
E33000646,280,158,73,85,0,28,14,14,71,67,1,2,1,23
E33000647,665,467,101,366,2,94,51,43,101,90,1,10,0,1
E33000648,328,245,62,183,1,41,23,18,39,32,1,5,1,2
E33000649,665,532,132,400,2,50,24,26,77,70,0,7,0,4
E33000650,207,157,47,110,1,27,16,11,22,19,1,2,0,0
E33000651,432,317,87,230,0,63,36,27,51,46,0,5,0,1
E33000652,498,341,98,243,1,81,48,33,71,62,0,9,0,4
E33000653,710,457,132,325,5,114,74,40,128,109,3,16,0,6
E33000654,366,262,67,195,2,41,22,19,61,52,0,7,2,0
E33000655,365,258,58,200,1,51,32,19,53,48,0,4,1,2
E33000656,874,685,160,525,5,70,30,40,107,90,2,14,1,7
E33000657,453,362,114,248,0,39,21,18,50,45,0,4,1,2
E33000658,412,257,70,187,0,54,30,24,100,93,5,1,1,1
E33000659,279,200,57,143,1,44,36,8,34,30,0,4,0,0
E33000660,420,310,71,239,0,45,36,9,65,62,0,3,0,0
E33000661,608,420,104,316,1,102,84,18,83,74,0,9,0,2
E33000662,309,197,49,148,0,75,59,16,35,33,0,2,0,2
E33000663,377,242,57,185,1,91,69,22,43,37,0,3,3,0
E33000664,443,335,79,256,2,53,45,8,50,44,0,5,1,3
E33000665,338,216,46,170,2,76,57,19,44,39,0,5,0,0
E33000666,1023,503,117,386,6,132,87,45,371,324,2,33,12,11
E33000667,887,678,182,496,1,117,83,34,86,79,0,6,1,5
E33000668,238,166,35,131,2,29,22,7,41,33,2,6,0,0
E33000669,363,248,62,186,0,64,48,16,49,49,0,0,0,2
E33000670,1160,751,134,617,4,142,109,33,254,236,0,17,1,9
E33000671,502,364,94,270,1,53,43,10,81,70,1,9,1,3
E33000672,365,252,63,189,2,66,49,17,43,39,0,4,0,2
E33000673,576,478,81,397,2,42,30,12,53,50,0,2,1,1
E33000674,585,444,136,308,3,88,63,25,49,41,0,8,0,1
E33000675,3069,2508,589,1919,5,360,209,151,182,168,1,13,0,14
E33000676,284,208,53,155,1,42,31,11,33,33,0,0,0,0
E33000677,1055,697,132,565,1,225,142,83,132,124,0,8,0,0
E33000678,363,294,63,231,0,45,28,17,23,23,0,0,0,1
E33000679,395,322,83,239,1,45,23,22,26,21,1,4,0,1
E33000680,377,220,54,166,2,67,35,32,86,83,0,3,0,2
E33000681,327,229,53,176,2,62,41,21,34,33,0,0,1,0
E33000682,393,303,97,206,2,63,43,20,23,17,1,4,1,2
E33000683,389,263,70,193,1,50,29,21,68,61,1,6,0,7
E33000684,691,557,135,422,2,80,45,35,50,47,1,2,0,2
E33000685,431,327,85,242,0,63,44,19,40,37,0,3,0,1
E33000686,928,664,133,531,3,170,106,64,87,80,0,7,0,4
E33000687,358,288,80,208,3,34,16,18,31,27,0,4,0,2
E33000688,300,219,44,175,0,52,29,23,28,25,0,3,0,1
E33000689,265,205,50,155,2,21,12,9,36,34,0,2,0,1
E33000690,299,194,42,152,1,43,22,21,58,49,0,6,3,3
E33000691,218,144,33,111,0,49,23,26,23,21,0,1,1,2
E33000692,326,212,66,146,0,60,34,26,53,49,0,3,1,1
E33000693,418,340,85,255,0,44,23,21,31,29,0,2,0,3
E33000694,401,300,68,232,1,55,23,32,41,39,0,1,1,4
E33000695,242,170,42,128,0,33,15,18,38,31,0,6,1,1
E33000696,357,272,59,213,0,41,20,21,43,39,0,4,0,1
E33000697,203,130,32,98,0,39,23,16,32,29,0,3,0,2
E33000698,273,219,51,168,0,23,9,14,31,29,0,2,0,0
E33000699,232,174,41,133,4,33,23,10,21,15,0,4,2,0
E33000700,374,252,64,188,2,59,32,27,60,54,1,5,0,1
E33000701,955,740,161,579,1,140,74,66,68,59,1,7,1,6
E33000702,844,674,164,510,0,85,62,23,83,77,1,5,0,2
E33000703,175,102,33,69,1,25,21,4,42,41,0,1,0,5
E33000704,192,134,48,86,1,8,7,1,44,43,0,1,0,5
E33000705,181,107,40,67,3,16,8,8,47,45,1,1,0,8
E33000706,212,131,34,97,0,13,9,4,46,39,1,3,3,22
E33000707,377,203,71,132,0,33,21,12,136,132,0,1,3,5
E33000708,392,315,67,248,0,24,16,8,52,45,0,6,1,1
E33000709,390,287,80,207,0,52,36,16,49,44,2,3,0,2
E33000710,434,310,74,236,0,55,38,17,68,63,1,4,0,1
E33000711,212,140,37,103,2,23,11,12,43,36,2,5,0,4
E33000712,364,265,75,190,2,33,24,9,63,58,0,5,0,1
E33000713,474,362,98,264,1,38,26,12,71,59,0,11,1,2
E33000714,282,220,66,154,1,29,14,15,31,26,2,2,1,1
E33000715,202,177,52,125,1,11,6,5,13,13,0,0,0,0
E33000716,689,452,113,339,0,76,48,28,156,132,1,12,11,5
E33000717,945,809,210,599,3,42,25,17,82,74,0,8,0,9
E33000718,1194,1013,252,761,0,76,51,25,99,83,3,12,1,6
E33000719,888,749,176,573,0,65,45,20,72,63,0,8,1,2
E33000720,2413,2022,488,1534,5,132,77,55,240,224,1,14,1,14
E33000721,5328,4723,1173,3550,9,241,141,100,339,298,3,37,1,16
E33000722,246,178,39,139,4,22,11,11,36,32,0,3,1,6
E33000723,319,229,49,180,5,33,23,10,52,47,0,4,1,0
E33000724,229,189,47,142,0,23,8,15,17,13,0,2,2,0
E33000725,301,216,53,163,0,31,21,10,49,47,0,2,0,5
E33000726,200,145,52,93,0,32,15,17,22,22,0,0,0,1
E33000727,1229,992,248,744,7,102,43,59,120,103,1,14,2,8
E33000728,519,411,101,310,2,58,34,24,46,45,0,1,0,2
E33000729,253,199,42,157,4,21,9,12,28,22,3,3,0,1
E33000730,532,425,70,355,3,33,11,22,67,61,0,6,0,4
E33000731,428,294,87,207,4,40,18,22,87,80,1,4,2,3
E33000732,349,248,72,176,2,40,22,18,55,53,0,2,0,4
E33000733,490,392,104,288,2,43,26,17,51,43,0,7,1,2
E33000734,276,178,36,142,0,49,33,16,44,40,1,3,0,5
E33000735,727,543,129,414,1,76,49,27,97,90,2,5,0,10
E33000736,830,693,192,501,4,46,13,33,85,77,0,8,0,2
E33000737,324,256,63,193,0,29,17,12,39,34,0,5,0,0
E33000738,1164,979,238,741,4,68,24,44,104,95,0,9,0,9
E33000739,1133,877,204,673,2,88,48,40,154,135,8,11,0,12
E33000740,530,383,88,295,2,53,30,23,89,79,0,9,1,3
E33000741,202,153,46,107,1,28,15,13,20,18,1,1,0,0
E33000742,743,596,148,448,2,68,37,31,73,60,1,12,0,4
E33000743,203,154,44,110,2,25,15,10,22,18,0,4,0,0
E33000744,228,181,42,139,0,16,10,6,30,28,0,2,0,1
E33000745,389,258,50,208,3,45,26,19,79,72,2,4,1,4
E33000746,464,335,86,249,1,62,31,31,64,60,0,3,1,2
E33000747,288,229,57,172,0,17,6,11,37,35,0,2,0,5
E33000748,282,241,47,194,3,16,9,7,21,19,0,2,0,1
E33000749,509,415,84,331,1,24,11,13,67,56,2,7,2,2
E33000750,510,381,96,285,2,49,22,27,78,67,1,9,1,0
E33000751,414,295,79,216,0,44,25,19,73,69,0,4,0,2
E33000752,308,250,43,207,2,20,8,12,35,33,0,1,1,1
E33000753,400,290,95,195,2,63,43,20,41,39,0,2,0,4
E33000754,331,268,70,198,1,30,16,14,30,25,3,2,0,2
E33000755,425,226,71,155,0,93,49,44,105,97,0,7,1,1
E33000756,237,181,41,140,0,26,12,14,27,27,0,0,0,3
E33000757,448,324,69,255,3,58,36,22,58,52,1,2,3,5
E33000758,891,630,109,521,3,77,43,34,173,159,0,14,0,8
E33000759,608,458,74,384,0,51,28,23,96,86,2,6,2,3
E33000760,270,233,63,170,0,16,9,7,19,19,0,0,0,2
E33000761,255,212,65,147,0,25,18,7,18,17,0,1,0,0
E33000762,760,646,181,465,3,25,14,11,85,79,0,5,1,1
E33000763,982,767,177,590,2,62,32,30,143,138,1,2,2,8
E33000764,391,304,75,229,0,44,21,23,42,37,0,5,0,1
E33000765,362,289,76,213,0,27,13,14,46,44,0,2,0,0
E33000766,872,689,136,553,1,72,37,35,104,96,1,5,2,6
E33000767,404,319,80,239,1,31,19,12,53,50,0,3,0,0
E33000768,489,401,95,306,3,37,16,21,47,42,1,3,1,1
E33000769,396,310,80,230,1,39,18,21,44,43,0,1,0,2
E33000770,894,760,139,621,1,40,22,18,86,78,1,4,3,7
E33000771,446,356,92,264,0,39,21,18,45,41,0,3,1,6
E33000772,284,223,46,177,3,19,11,8,38,30,0,8,0,1
E33000773,1235,1010,193,817,4,81,40,41,137,126,0,10,1,3
E33000774,343,258,58,200,3,26,19,7,54,48,0,5,1,2
E33000775,220,154,39,115,1,23,20,3,41,39,0,1,1,1
E33000776,243,163,33,130,2,42,35,7,35,32,0,3,0,1
E33000777,233,152,45,107,1,20,15,5,60,57,0,3,0,0
E33000778,253,159,36,123,2,28,18,10,64,59,0,3,2,0
E33000779,578,336,61,275,1,63,45,18,175,162,0,11,2,3
E33000780,466,350,71,279,1,22,17,5,90,86,0,4,0,3
E33000781,646,411,106,305,3,67,56,11,158,146,2,8,2,7
E33000782,614,487,71,416,3,47,38,9,76,69,0,6,1,1
E33000783,345,262,61,201,1,25,16,9,57,48,0,9,0,0
E33000784,319,207,48,159,0,37,20,17,75,68,1,6,0,0
E33000785,1194,937,206,731,7,68,51,17,181,162,1,17,1,1
E33000786,485,414,82,332,3,20,14,6,46,41,1,4,0,2
E33000787,403,286,68,218,3,31,24,7,82,76,1,4,1,1
E33000788,455,295,67,228,2,68,53,15,90,83,0,6,1,0
E33000789,408,325,80,245,1,30,24,6,50,46,0,4,0,2
E33000790,353,248,49,199,1,32,24,8,70,56,0,13,1,2
E33000791,441,306,54,252,4,49,42,7,79,73,0,6,0,3
E33000792,649,429,92,337,1,69,49,20,143,134,0,8,1,7
E33000793,223,142,31,111,2,34,26,8,45,41,0,3,1,0
E33000794,637,251,58,193,4,103,81,22,272,257,0,9,6,7
E33000795,454,262,56,206,0,49,35,14,141,133,0,7,1,2
E33000796,253,160,31,129,2,23,18,5,67,64,0,3,0,1
E33000797,208,99,31,68,1,48,40,8,58,55,0,3,0,2
E33000798,235,143,36,107,0,27,21,6,62,59,0,2,1,3
E33000799,1097,561,124,437,9,213,156,57,307,277,0,21,9,7
E33000800,608,432,105,327,8,80,61,19,87,79,1,7,0,1
E33000801,366,174,35,139,3,78,54,24,107,104,0,2,1,4
E33000802,365,179,55,124,1,83,59,24,101,96,0,2,3,1
E33000803,1001,764,184,580,6,96,58,38,129,115,0,11,3,6
E33000804,302,188,70,118,0,80,62,18,33,31,0,2,0,1
E33000805,384,288,55,233,0,30,19,11,65,60,0,4,1,1
E33000806,330,180,39,141,1,53,34,19,94,92,0,2,0,2
E33000807,393,323,62,261,0,32,22,10,38,31,2,4,1,0
E33000808,272,154,34,120,0,48,40,8,66,62,0,4,0,4
E33000809,866,570,126,444,3,59,40,19,225,212,0,10,3,9
E33000810,515,319,89,230,2,90,76,14,101,89,1,11,0,3
E33000811,393,314,57,257,0,21,16,5,57,52,0,5,0,1
E33000812,371,307,78,229,0,24,22,2,39,38,0,1,0,1
E33000813,609,408,95,313,2,61,46,15,138,132,0,4,2,0
E33000814,391,254,85,169,3,47,36,11,82,78,0,4,0,5
E33000815,454,278,67,211,1,98,78,20,71,64,2,5,0,6
E33000816,517,379,76,303,2,62,42,20,71,70,0,1,0,3
E33000817,620,439,91,348,5,29,16,13,144,130,1,11,2,3
E33000818,294,155,50,105,2,21,13,8,113,107,1,4,1,3
E33000819,1421,914,210,704,6,194,143,51,300,279,0,21,0,7
E33000820,233,116,23,93,0,35,26,9,80,74,1,5,0,2
E33000821,565,440,83,357,1,27,16,11,97,94,0,3,0,0
E33000822,301,180,36,144,0,42,34,8,78,70,0,8,0,1
E33000823,262,197,36,161,2,48,31,17,14,10,0,4,0,1
E33000824,327,217,60,157,1,72,49,23,37,34,0,3,0,0
E33000825,1474,1130,283,847,7,105,74,31,225,215,0,9,1,7
E33000826,647,492,103,389,6,61,45,16,86,83,0,3,0,2
E33000827,340,272,59,213,0,34,27,7,34,29,0,5,0,0
E33000828,370,291,60,231,1,37,27,10,37,34,0,2,1,4
E33000829,485,341,60,281,3,16,10,6,122,116,3,3,0,3
E33000830,1805,1374,262,1112,3,136,105,31,281,258,0,23,0,11
E33000831,306,180,39,141,4,33,25,8,88,84,0,4,0,1
E33000832,1330,918,197,721,7,89,59,30,310,284,1,23,2,6
E33000833,1529,1117,258,859,2,127,91,36,278,252,0,25,1,5
E33000834,475,280,52,228,2,64,39,25,126,112,0,8,6,3
E33000835,2166,1687,255,1432,13,118,82,36,331,305,0,26,0,17
E33000836,805,516,125,391,6,88,58,30,189,178,1,10,0,6
E33000837,498,350,82,268,0,68,49,19,77,66,1,6,4,3
E33000838,808,633,158,475,1,107,85,22,65,55,0,10,0,2
E33000839,618,478,104,374,0,63,36,27,74,56,1,16,1,3
E33000840,533,419,105,314,1,59,51,8,50,44,0,4,2,4
E33000841,318,231,80,151,1,65,40,25,20,20,0,0,0,1
E33000842,336,235,87,148,1,60,54,6,35,33,0,2,0,5
E33000843,562,439,96,343,0,70,57,13,45,40,0,5,0,8
E33000844,373,296,78,218,0,38,32,6,38,29,2,1,6,1
E33000845,315,252,75,177,1,22,19,3,39,35,0,4,0,1
E33000846,369,295,86,209,0,29,27,2,42,35,0,4,3,3
E33000847,321,250,74,176,2,27,26,1,38,34,1,3,0,4
E33000848,708,551,127,424,0,83,64,19,69,64,0,4,1,5
E33000849,291,174,54,120,0,92,76,16,24,24,0,0,0,1
E33000850,303,202,50,152,1,71,62,9,29,24,0,5,0,0
E33000851,229,161,38,123,1,27,24,3,40,34,0,4,2,0
E33000852,373,214,54,160,2,112,76,36,41,33,0,3,5,4
E33000853,1334,1010,201,809,0,145,120,25,179,164,0,15,0,0
E33000854,258,188,53,135,2,39,34,5,28,24,0,3,1,1
E33000855,339,222,41,181,3,92,80,12,21,20,0,1,0,1
E33000856,381,249,62,187,1,87,76,11,39,36,1,2,0,5
E33000857,335,238,54,184,3,70,66,4,21,16,0,5,0,3
E33000858,249,197,60,137,1,28,20,8,22,22,0,0,0,1
E33000859,351,258,84,174,1,50,45,5,42,34,2,2,4,0
E33000860,380,331,81,250,0,17,15,2,29,27,0,2,0,3
E33000861,651,447,111,336,6,111,93,18,82,75,2,5,0,5
E33000862,263,172,30,142,1,49,40,9,39,37,0,2,0,2
E33000863,494,332,88,244,3,107,80,27,48,44,0,4,0,4
E33000864,341,226,48,178,3,59,49,10,49,44,0,3,2,4
E33000865,294,206,51,155,3,49,41,8,32,30,0,2,0,4
E33000866,341,156,41,115,1,103,76,27,74,67,0,6,1,7
E33000867,366,229,62,167,1,53,42,11,78,72,0,5,1,5
E33000868,269,170,52,118,3,66,42,24,30,28,0,2,0,0
E33000869,401,254,78,176,1,51,36,15,88,78,0,10,0,7
E33000870,619,394,108,286,1,146,114,32,78,72,1,5,0,0
E33000871,332,214,42,172,1,64,46,18,51,43,2,3,3,2
E33000872,295,174,59,115,4,52,40,12,61,58,0,1,2,4
E33000873,423,348,108,240,2,29,25,4,39,34,0,5,0,5
E33000874,287,239,47,192,0,13,12,1,31,24,0,4,3,4
E33000875,467,326,78,248,1,59,47,12,80,74,0,3,3,1
E33000876,288,193,55,138,0,60,52,8,34,27,1,6,0,1
E33000877,378,214,61,153,1,51,35,16,108,93,10,5,0,4
E33000878,242,174,61,113,1,31,21,10,35,34,0,1,0,1
E33000879,304,187,44,143,0,31,21,10,85,74,0,11,0,1
E33000880,333,201,67,134,1,30,17,13,94,92,0,2,0,7
E33000881,251,177,53,124,0,26,20,6,48,42,0,5,1,0
E33000882,586,362,94,268,5,151,93,58,64,50,4,10,0,4
E33000883,291,188,43,145,1,74,61,13,24,22,0,2,0,4
E33000884,278,194,39,155,0,54,43,11,29,22,3,4,0,1
E33000885,377,262,55,207,2,78,66,12,31,30,0,1,0,4
E33000886,282,193,55,138,1,53,49,4,33,26,0,7,0,2
E33000887,411,332,67,265,0,44,40,4,33,29,0,4,0,2
E33000888,239,169,50,119,0,40,34,6,26,21,0,5,0,4
E33000889,438,362,103,259,0,51,47,4,22,21,0,1,0,3
E33000890,299,222,36,186,0,51,43,8,23,20,0,2,1,3
E33000891,288,223,46,177,1,44,35,9,15,13,0,2,0,5
E33000892,277,201,46,155,1,49,39,10,23,23,0,0,0,3
E33000893,375,228,48,180,0,119,88,31,24,18,0,4,2,4
E33000894,266,192,54,138,1,38,33,5,34,31,0,3,0,1
E33000895,277,229,60,169,1,38,34,4,8,8,0,0,0,1
E33000896,637,552,157,395,1,45,38,7,35,34,0,1,0,4
E33000897,334,258,78,180,0,43,29,14,30,28,1,1,0,3
E33000898,3766,2893,623,2270,12,475,376,99,373,343,2,25,3,13
E33000899,267,246,95,151,0,6,5,1,12,11,0,1,0,3
E33000900,424,366,95,271,0,28,25,3,29,27,0,2,0,1
E33000901,271,236,60,176,4,15,13,2,13,12,0,1,0,3
E33000902,526,400,93,307,2,51,46,5,65,64,0,1,0,8
E33000903,399,297,62,235,3,53,41,12,45,39,0,3,3,1
E33000904,315,220,56,164,1,74,55,19,17,13,0,4,0,3
E33000905,227,181,49,132,0,24,18,6,22,20,1,1,0,0
E33000906,400,265,64,201,2,63,40,23,67,59,0,8,0,3
E33000907,466,351,75,276,0,64,50,14,46,44,0,2,0,5
E33000908,432,332,90,242,3,45,39,6,48,44,0,3,1,4
E33000909,352,265,66,199,0,32,17,15,43,40,0,3,0,12
E33000910,323,243,59,184,1,40,35,5,38,35,2,1,0,1
E33000911,285,225,80,145,0,23,22,1,34,29,0,3,2,3
E33000912,552,405,106,299,1,90,70,20,53,44,0,9,0,3
E33000913,331,258,70,188,0,49,43,6,19,19,0,0,0,5
E33000914,357,297,72,225,0,33,25,8,26,20,0,6,0,1
E33000915,230,170,37,133,0,34,26,8,26,23,1,2,0,0
E33000916,296,237,72,165,0,23,17,6,32,30,0,2,0,4
E33000917,274,183,48,135,0,65,37,28,24,20,0,4,0,2
E33000918,300,175,37,138,0,88,75,13,37,34,0,2,1,0
E33000919,529,339,83,256,3,142,128,14,43,38,0,4,1,2
E33000920,360,300,88,212,1,29,26,3,30,28,0,2,0,0
E33000921,510,406,131,275,5,67,61,6,30,26,1,3,0,2
E33000922,250,149,33,116,0,76,67,9,23,20,0,3,0,2
E33000923,569,368,94,274,2,159,139,20,31,25,0,5,1,9
E33000924,268,179,79,100,1,37,31,6,43,39,1,3,0,8
E33000925,386,283,99,184,1,48,44,4,50,44,0,6,0,4
E33000926,231,184,63,121,1,32,28,4,14,13,0,1,0,0
E33000927,435,339,121,218,2,42,39,3,48,45,1,2,0,4
E33000928,579,444,101,343,1,78,61,17,52,46,0,6,0,4
E33000929,521,371,94,277,1,116,98,18,28,25,0,1,2,5
E33000930,271,213,66,147,1,24,21,3,29,26,0,3,0,4
E33000931,393,299,81,218,1,47,33,14,42,41,0,1,0,4
E33000932,503,353,97,256,0,100,76,24,45,38,0,6,1,5
E33000933,373,307,97,210,2,36,25,11,27,26,0,1,0,1
E33000934,644,460,116,344,1,100,72,28,81,74,0,6,1,2
E33000935,868,628,144,484,1,156,123,33,80,71,0,7,2,3
E33000936,1314,847,223,624,8,291,244,47,159,142,0,15,2,9
E33000937,420,332,104,228,0,31,24,7,56,51,1,4,0,1
E33000938,236,162,47,115,0,22,21,1,50,46,0,4,0,2
E33000939,238,191,66,125,0,15,12,3,32,26,0,4,2,0
E33000940,401,302,75,227,2,50,43,7,46,44,0,2,0,1
E33000941,438,358,91,267,0,25,19,6,52,47,2,3,0,3
E33000942,242,204,69,135,1,12,9,3,22,20,2,0,0,3
E33000943,407,264,72,192,1,76,70,6,60,56,0,4,0,6
E33000944,530,315,67,248,2,133,112,21,76,66,3,5,2,4
E33000945,976,665,126,539,3,228,203,25,80,73,0,7,0,0
E33000946,434,310,65,245,0,67,61,6,50,46,0,4,0,7
E33000947,398,282,70,212,1,51,34,17,63,60,0,3,0,1
E33000948,262,156,33,123,1,85,81,4,20,15,1,4,0,0
E33000949,302,137,33,104,3,140,131,9,20,18,0,2,0,2
E33000950,250,188,47,141,1,45,40,5,15,11,1,1,2,1
E33000951,560,413,94,319,3,84,72,12,58,49,0,8,1,2
E33000952,431,306,86,220,1,47,34,13,75,66,0,8,1,2
E33000953,586,419,114,305,0,92,83,9,68,60,2,6,0,7
E33000954,287,230,68,162,0,25,23,2,27,25,0,2,0,5
E33000955,377,260,68,192,1,66,60,6,46,42,0,4,0,4
E33000956,278,215,87,128,0,20,18,2,39,38,0,1,0,4
E33000957,301,193,57,136,1,42,34,8,64,62,0,2,0,1
E33000958,283,203,58,145,0,34,30,4,45,38,1,4,2,1
E33000959,418,291,61,230,0,35,30,5,86,78,0,3,5,6
E33000960,342,237,73,164,1,43,34,9,58,53,2,3,0,3
E33000961,285,236,78,158,0,18,14,4,27,27,0,0,0,4
E33000962,883,595,135,460,7,125,95,30,148,138,0,10,0,8
E33000963,316,251,72,179,0,31,27,4,33,32,1,0,0,1
E33000964,348,259,66,193,3,33,23,10,51,41,5,5,0,2
E33000965,252,198,55,143,2,12,9,3,40,39,0,1,0,0
E33000966,270,167,48,119,0,56,51,5,44,40,0,3,1,3
E33000967,6770,5219,1158,4061,37,601,468,133,883,807,4,65,7,30
E33000968,676,464,132,332,1,75,51,24,133,113,0,18,2,3
E33000969,252,179,41,138,0,29,24,5,40,35,1,2,2,4
E33000970,362,279,92,187,2,34,28,6,42,39,0,3,0,5
E33000971,429,325,83,242,1,59,50,9,38,36,0,2,0,6
E33000972,970,788,228,560,3,69,53,16,109,101,0,7,1,1
E33000973,333,258,64,194,0,32,29,3,41,38,0,3,0,2
E33000974,296,175,37,138,6,75,64,11,39,35,0,4,0,1
E33000975,729,471,115,356,2,129,116,13,122,104,2,15,1,5
E33000976,290,189,38,151,1,67,57,10,24,22,0,2,0,9
E33000977,319,263,77,186,1,32,27,5,22,20,0,2,0,1
E33000978,443,229,46,183,2,135,97,38,75,69,0,5,1,2
E33000979,249,159,42,117,0,67,59,8,20,18,1,1,0,3
E33000980,738,613,117,496,2,52,46,6,69,59,4,5,1,2
E33000981,298,208,53,155,0,66,61,5,22,19,1,2,0,2
E33000982,544,409,113,296,0,46,41,5,81,78,0,3,0,8
E33000983,253,187,72,115,1,15,12,3,45,40,1,4,0,5
E33000984,498,307,86,221,7,98,92,6,84,78,0,6,0,2
E33000985,329,226,71,155,0,45,38,7,57,51,2,4,0,1
E33000986,282,225,64,161,0,17,13,4,37,32,0,5,0,3
E33000987,359,162,53,109,6,38,25,13,150,145,0,5,0,3
E33000988,372,221,46,175,2,31,26,5,116,109,0,4,3,2
E33000989,243,192,64,128,0,9,7,2,33,27,0,6,0,9
E33000990,298,153,47,106,2,9,6,3,134,129,0,3,2,0
E33000991,257,140,41,99,0,15,11,4,99,95,0,3,1,3
E33000992,667,508,124,384,7,72,59,13,78,72,2,3,1,2
E33000993,455,322,72,250,2,87,80,7,42,40,0,2,0,2
E33000994,303,216,62,154,0,46,32,14,39,36,0,3,0,2
E33000995,363,247,55,192,0,72,52,20,41,35,0,4,2,3
E33000996,1083,827,195,632,2,160,131,29,90,80,1,8,1,4
E33000997,452,364,89,275,2,29,26,3,52,50,2,0,0,5
E33000998,332,197,71,126,1,93,78,15,39,37,0,2,0,2
E33000999,311,214,50,164,0,68,60,8,27,24,0,3,0,2
E33001000,406,272,60,212,0,87,77,10,39,37,0,1,1,8
E33001001,978,692,136,556,4,168,149,19,107,88,2,17,0,7
E33001002,242,155,39,116,1,53,48,5,32,28,0,2,2,1
E33001003,264,172,45,127,2,49,46,3,41,38,0,3,0,0
E33001004,365,261,87,174,0,60,54,6,38,37,0,0,1,6
E33001005,297,212,33,179,0,56,47,9,27,26,0,1,0,2
E33001006,777,425,101,324,2,95,77,18,247,237,0,8,2,8
E33001007,250,150,45,105,4,24,21,3,69,65,0,4,0,3
E33001008,307,209,69,140,1,24,16,8,70,69,0,1,0,3
E33001009,284,159,48,111,1,31,23,8,91,85,1,5,0,2
E33001010,549,406,94,312,0,45,35,10,97,92,0,5,0,1
E33001011,273,134,41,93,3,32,19,13,102,97,0,4,1,2
E33001012,323,187,42,145,2,41,25,16,89,79,1,8,1,4
E33001013,291,147,47,100,2,37,25,12,101,92,1,7,1,4
E33001014,467,274,69,205,2,110,90,20,76,69,0,7,0,5
E33001015,235,159,41,118,0,27,18,9,49,46,0,3,0,0
E33001016,523,361,76,285,0,84,72,12,78,73,3,2,0,0
E33001017,221,133,31,102,2,45,37,8,38,34,0,4,0,3
E33001018,467,272,62,210,4,89,71,18,100,91,0,9,0,2
E33001019,282,214,47,167,0,38,32,6,29,27,0,1,1,1
E33001020,366,185,53,132,1,61,38,23,114,107,1,6,0,5
E33001021,261,127,38,89,1,33,24,9,98,88,0,8,2,2
E33001022,497,352,93,259,1,99,83,16,42,36,0,5,1,3
E33001023,370,281,59,222,1,47,44,3,39,32,0,7,0,2
E33001024,300,214,58,156,3,42,34,8,35,27,0,8,0,6
E33001025,281,184,33,151,1,46,41,5,47,44,0,1,2,3
E33001026,674,481,123,358,1,84,76,8,105,90,0,6,9,3
E33001027,448,330,87,243,2,72,59,13,44,42,1,1,0,0
E33001028,333,230,66,164,0,78,71,7,20,17,0,3,0,5
E33001029,386,284,72,212,5,55,45,10,40,37,0,3,0,2
E33001030,971,818,213,605,2,66,50,16,82,71,1,10,0,3
E33001031,320,227,47,180,1,54,40,14,36,27,2,7,0,2
E33001032,322,250,74,176,2,44,43,1,24,21,1,2,0,2
E33001033,397,342,79,263,1,28,24,4,24,24,0,0,0,2
E33001034,407,280,77,203,3,89,76,13,33,32,0,1,0,2
E33001035,299,119,23,96,1,121,63,58,53,52,0,1,0,5
E33001036,545,393,97,296,1,79,56,23,69,56,5,7,1,3
E33001037,423,183,65,118,2,65,31,34,171,164,3,4,0,2
E33001038,372,288,75,213,0,31,24,7,50,45,1,3,1,3
E33001039,363,231,58,173,2,41,26,15,85,76,2,4,3,4
E33001040,376,232,59,173,1,36,16,20,107,95,1,10,1,0
E33001041,384,254,81,173,0,44,22,22,82,77,1,3,1,4
E33001042,512,356,102,254,6,68,57,11,77,69,0,4,4,5
E33001043,389,283,60,223,3,51,44,7,48,44,0,4,0,4
E33001044,331,172,44,128,0,58,43,15,100,93,1,5,1,1
E33001045,508,360,95,265,5,53,42,11,87,77,0,7,3,3
E33001046,986,686,177,509,6,111,93,18,176,164,0,10,2,7
E33001047,587,385,91,294,2,74,48,26,123,117,2,4,0,3
E33001048,262,138,47,91,1,36,24,12,87,82,1,4,0,0
E33001049,362,253,60,193,1,54,43,11,53,49,2,2,0,1
E33001050,305,183,42,141,0,54,45,9,62,59,0,2,1,6
E33001051,516,359,88,271,2,69,55,14,85,77,2,5,1,1
E33001052,684,437,79,358,3,135,94,41,107,104,0,3,0,2
E33001053,784,613,133,480,1,32,24,8,134,126,0,8,0,4
E33001054,223,145,35,110,0,27,14,13,45,42,0,3,0,6
E33001055,775,525,104,421,5,73,47,26,171,141,1,5,24,1
E33001056,645,403,108,295,3,79,64,15,153,147,1,5,0,7
E33001057,745,513,121,392,6,157,124,33,66,61,1,2,2,3
E33001058,274,165,45,120,1,78,53,25,25,23,0,2,0,5
E33001059,1024,669,171,498,5,190,149,41,155,140,0,12,3,5
E33001060,723,566,132,434,1,77,60,17,75,70,0,5,0,4
E33001061,401,265,56,209,0,80,72,8,53,48,0,5,0,3
E33001062,409,249,74,175,0,107,94,13,53,49,0,4,0,0
E33001063,325,245,65,180,2,46,43,3,30,26,0,4,0,2
E33001064,262,140,41,99,2,88,80,8,30,29,0,1,0,2
E33001065,623,421,125,296,0,116,99,17,83,69,1,13,0,3
E33001066,294,207,59,148,0,48,39,9,37,34,0,3,0,2
E33001067,456,260,71,189,2,145,119,26,48,46,0,2,0,1
E33001068,249,187,52,135,0,28,24,4,34,27,0,3,4,0
E33001069,303,172,41,131,0,73,58,15,54,50,0,4,0,4
E33001070,326,188,49,139,0,87,74,13,48,41,0,6,1,3
E33001071,430,252,60,192,2,103,86,17,67,60,3,4,0,6
E33001072,226,139,45,94,1,44,37,7,40,38,0,2,0,2
E33001073,396,335,92,243,0,29,28,1,32,26,0,5,1,0
E33001074,736,548,143,405,2,114,88,26,70,66,0,4,0,2
E33001075,580,352,104,248,2,141,115,26,80,74,1,4,1,5
E33001076,694,471,107,364,2,119,82,37,95,83,2,9,1,7
E33001077,266,134,23,111,1,109,100,9,21,21,0,0,0,1
E33001078,579,349,78,271,1,173,152,21,52,48,1,2,1,4
E33001079,494,329,107,222,6,94,70,24,64,59,0,4,1,1
E33001080,387,206,72,134,1,91,77,14,86,80,1,5,0,3
E33001081,249,128,30,98,0,79,70,9,42,37,0,5,0,0
E33001082,460,288,59,229,1,71,57,14,96,93,0,2,1,4
E33001083,250,123,31,92,2,94,66,28,31,28,0,3,0,0
E33001084,394,202,60,142,1,59,46,13,131,127,1,2,1,1
E33001085,414,285,82,203,2,52,37,15,69,62,0,7,0,6
E33001086,228,106,27,79,0,78,51,27,41,35,0,6,0,3
E33001087,276,209,58,151,0,40,31,9,27,25,0,2,0,0
E33001088,235,147,37,110,0,62,58,4,25,23,0,2,0,1
E33001089,291,142,34,108,5,96,78,18,45,41,0,4,0,3
E33001090,734,556,110,446,2,84,70,14,86,73,0,12,1,6
E33001091,523,331,75,256,1,126,101,25,60,48,2,9,1,5
E33001092,404,341,78,263,0,21,16,5,31,29,0,2,0,11
E33001093,368,323,102,221,2,13,7,6,25,23,0,2,0,5
E33001094,265,168,34,134,0,53,46,7,44,41,0,3,0,0
E33001095,228,161,32,129,0,47,32,15,20,20,0,0,0,0
E33001096,285,211,56,155,2,55,45,10,16,15,0,1,0,1
E33001097,298,245,62,183,1,28,25,3,24,24,0,0,0,0
E33001098,640,519,150,369,4,60,41,19,54,48,0,5,1,3
E33001099,418,341,90,251,3,24,22,2,48,45,0,3,0,2
E33001100,501,412,133,279,1,25,19,6,53,44,2,5,2,10
E33001101,664,519,116,403,1,64,53,11,77,66,0,11,0,3
E33001102,299,237,77,160,0,26,20,6,33,27,2,3,1,3
E33001103,386,288,71,217,1,42,31,11,48,38,0,7,3,7
E33001104,525,429,140,289,1,30,21,9,63,58,0,5,0,2
E33001105,427,349,80,269,3,17,9,8,54,51,2,1,0,4
E33001106,246,199,42,157,0,17,15,2,30,27,1,2,0,0
E33001107,418,264,75,189,0,62,49,13,87,74,1,10,2,5
E33001108,365,295,67,228,1,23,18,5,42,35,1,5,1,4
E33001109,257,185,45,140,4,21,16,5,43,43,0,0,0,4
E33001110,278,215,74,141,1,31,28,3,29,25,0,1,3,2
E33001111,453,272,61,211,2,84,69,15,86,74,0,12,0,9
E33001112,231,151,44,107,2,34,26,8,43,37,0,5,1,1
E33001113,326,242,57,185,3,39,36,3,39,35,2,2,0,3
E33001114,476,393,102,291,1,38,33,5,39,32,1,4,2,5
E33001115,284,195,46,149,0,54,31,23,33,30,0,3,0,2
E33001116,429,324,85,239,2,38,35,3,60,56,0,4,0,5
E33001117,325,216,59,157,0,86,74,12,20,18,0,1,1,3
E33001118,1490,1125,241,884,1,222,183,39,134,122,0,11,1,8
E33001119,306,219,57,162,1,50,41,9,33,28,0,5,0,3
E33001120,276,194,44,150,1,42,40,2,37,33,0,3,1,2
E33001121,227,174,63,111,1,12,8,4,34,32,0,2,0,6
E33001122,297,227,51,176,3,27,23,4,36,33,0,3,0,4
E33001123,414,338,92,246,0,27,26,1,46,40,0,5,1,3
E33001124,501,358,95,263,2,58,48,10,79,65,1,12,1,4
E33001125,337,226,63,163,4,50,40,10,52,49,0,3,0,5
E33001126,562,462,123,339,0,40,35,5,49,45,1,3,0,11
E33001127,234,174,52,122,1,24,19,5,31,28,0,1,2,4
E33001128,285,191,40,151,1,68,58,10,23,23,0,0,0,2
E33001129,543,394,96,298,1,94,83,11,49,47,0,2,0,5
E33001130,733,457,76,381,6,84,57,27,185,172,0,13,0,1
E33001131,458,308,65,243,3,78,62,16,65,54,3,4,4,4
E33001132,531,399,115,284,4,58,46,12,58,47,1,9,1,12
E33001133,478,362,66,296,0,72,44,28,44,38,0,6,0,0
E33001134,589,435,129,306,2,65,51,14,85,75,3,7,0,2
E33001135,244,209,51,158,1,17,15,2,16,16,0,0,0,1
E33001136,488,409,109,300,0,42,30,12,35,31,1,3,0,2
E33001137,308,241,64,177,3,23,15,8,39,35,0,4,0,2
E33001138,285,194,51,143,1,61,44,17,26,23,0,3,0,3
E33001139,330,247,70,177,1,33,26,7,48,47,0,1,0,1
E33001140,290,186,45,141,2,58,49,9,43,39,0,4,0,1
E33001141,405,323,64,259,0,44,35,9,36,30,0,6,0,2
E33001142,457,303,73,230,2,98,87,11,49,45,0,4,0,5
E33001143,471,360,103,257,1,48,35,13,60,57,0,3,0,2
E33001144,575,391,109,282,4,89,63,26,82,72,4,6,0,9
E33001145,259,180,63,117,1,31,23,8,42,40,0,2,0,5
E33001146,595,381,117,264,2,58,38,20,143,127,5,11,0,11
E33001147,470,313,102,211,2,76,39,37,76,69,1,6,0,3
E33001148,400,316,91,225,0,28,21,7,54,46,1,6,1,2
E33001149,367,304,81,223,1,19,14,5,42,39,0,3,0,1
E33001150,341,212,47,165,1,57,47,10,63,59,0,3,1,8
E33001151,467,337,87,250,0,66,53,13,59,59,0,0,0,5
E33001152,666,526,154,372,1,73,55,18,64,58,0,6,0,2
E33001153,1987,1438,332,1106,4,309,248,61,232,204,3,25,0,4
E33001154,642,511,138,373,1,63,55,8,63,57,0,6,0,4
E33001155,329,238,35,203,1,51,44,7,38,32,3,3,0,1
E33001156,428,263,51,212,3,110,79,31,50,46,0,4,0,2
E33001157,439,328,73,255,0,55,46,9,50,44,0,6,0,6
E33001158,1260,883,194,689,3,197,164,33,169,146,3,14,6,8
E33001159,281,168,22,146,3,70,59,11,39,36,0,3,0,1
E33001160,377,278,78,200,1,57,45,12,40,38,0,2,0,1
E33001161,409,322,73,249,2,48,38,10,35,21,4,10,0,2
E33001162,251,192,44,148,0,29,27,2,29,26,0,3,0,1
E33001163,698,523,106,417,3,93,82,11,75,64,0,11,0,4
E33001164,638,510,142,368,4,64,55,9,59,57,0,1,1,1
E33001165,610,496,135,361,5,44,32,12,65,61,0,4,0,0
E33001166,445,318,70,248,1,48,37,11,74,68,1,5,0,4
E33001167,455,335,90,245,0,48,32,16,70,63,0,7,0,2
E33001168,315,184,40,144,2,91,72,19,34,33,0,1,0,4
E33001169,655,491,134,357,3,62,41,21,93,85,0,8,0,6
E33001170,334,231,70,161,0,65,61,4,36,32,1,3,0,2
E33001171,362,221,62,159,3,94,68,26,41,38,0,3,0,3
E33001172,284,196,45,151,1,48,38,10,38,35,0,3,0,1
E33001173,243,152,41,111,0,55,49,6,31,26,0,5,0,5
E33001174,281,206,45,161,1,43,38,5,31,28,0,3,0,0
E33001175,363,292,75,217,1,42,39,3,26,20,0,6,0,2
E33001176,527,435,126,309,6,35,28,7,43,40,0,3,0,8
E33001177,370,258,59,199,1,66,58,8,44,41,0,2,1,1
E33001178,382,270,64,206,2,72,56,16,37,31,0,6,0,1
E33001179,297,213,40,173,1,47,38,9,33,30,0,3,0,3
E33001180,351,234,48,186,2,72,52,20,41,35,0,6,0,2
E33001181,310,190,38,152,2,71,34,37,46,44,0,2,0,1
E33001182,521,360,80,280,1,89,69,20,70,63,1,6,0,1
E33001183,339,225,57,168,1,67,39,28,44,42,1,0,1,2
E33001184,553,400,90,310,1,65,52,13,82,73,1,7,1,5
E33001185,311,220,54,166,2,52,34,18,34,30,1,3,0,3
E33001186,309,178,30,148,1,79,63,16,50,45,1,4,0,1
E33001187,322,226,42,184,1,37,23,14,58,49,1,8,0,0
E33001188,312,206,57,149,0,62,56,6,43,39,0,4,0,1
E33001189,487,389,100,289,1,46,31,15,50,46,0,4,0,1
E33001190,909,646,156,490,2,140,109,31,120,114,0,6,0,1
E33001191,641,462,116,346,1,62,44,18,112,106,2,4,0,4
E33001192,323,220,46,174,2,44,36,8,54,46,1,5,2,3
E33001193,455,318,75,243,1,80,63,17,52,44,0,8,0,4
E33001194,759,521,140,381,1,134,103,31,97,85,8,4,0,6
E33001195,505,333,59,274,4,99,73,26,67,60,0,7,0,2
E33001196,258,186,58,128,2,39,29,10,30,27,1,2,0,1
E33001197,617,399,115,284,1,127,101,26,87,85,1,1,0,3
E33001198,392,291,80,211,1,62,49,13,35,32,0,2,1,3
E33001199,493,385,114,271,3,61,46,15,43,39,0,4,0,1
E33001200,256,171,44,127,2,51,41,10,30,28,0,2,0,2
E33001201,342,208,46,162,9,65,47,18,59,52,0,6,1,1
E33001202,661,407,105,302,3,154,124,30,95,84,3,5,3,2
E33001203,281,193,41,152,3,58,44,14,27,21,0,6,0,0
E33001204,353,190,53,137,1,92,57,35,68,60,0,7,1,2
E33001205,313,176,43,133,1,89,54,35,47,41,0,6,0,0
E33001206,239,143,32,111,0,62,53,9,34,23,1,7,3,0
E33001207,528,342,84,258,4,94,72,22,86,79,0,4,3,2
E33001208,280,198,74,124,0,52,37,15,30,24,2,4,0,0
E33001209,520,310,62,248,1,127,97,30,77,66,4,6,1,5
E33001210,284,189,47,142,1,41,28,13,50,43,1,3,3,3
E33001211,834,691,210,481,2,68,45,23,66,58,5,2,1,7
E33001212,372,223,62,161,3,55,34,21,87,78,0,8,1,4
E33001213,630,450,123,327,3,138,108,30,38,31,1,6,0,1
E33001214,563,457,111,346,3,63,49,14,39,35,0,4,0,1
E33001215,272,230,65,165,0,20,11,9,21,20,0,1,0,1
E33001216,437,293,67,226,2,78,58,20,62,62,0,0,0,2
E33001217,303,240,76,164,0,28,21,7,34,29,0,5,0,1
E33001218,355,273,93,180,0,45,36,9,33,31,0,2,0,4
E33001219,317,247,75,172,0,40,30,10,27,23,1,2,1,3
E33001220,388,336,88,248,1,25,21,4,20,16,0,4,0,6
E33001221,283,190,45,145,0,42,29,13,47,44,0,3,0,4
E33001222,411,269,79,190,1,112,97,15,28,28,0,0,0,1
E33001223,256,201,40,161,1,41,30,11,13,10,0,3,0,0
E33001224,474,294,79,215,3,138,93,45,31,27,0,4,0,8
E33001225,401,283,76,207,0,87,75,12,25,20,1,4,0,6
E33001226,346,264,88,176,1,54,46,8,26,22,0,4,0,1
E33001227,366,237,60,177,1,81,70,11,43,39,1,3,0,4
E33001228,640,487,95,392,2,85,64,21,61,54,0,5,2,5
E33001229,308,208,40,168,4,59,47,12,36,34,1,1,0,1
E33001230,467,309,62,247,4,100,57,43,50,46,0,4,0,4
E33001231,306,222,51,171,3,50,43,7,29,24,0,5,0,2
E33001232,698,555,140,415,1,94,74,20,48,44,0,2,2,0
E33001233,433,278,53,225,3,107,93,14,44,40,1,3,0,1
E33001234,618,470,119,351,2,95,82,13,46,42,0,2,2,5
E33001235,273,200,55,145,2,48,41,7,20,19,0,1,0,3
E33001236,301,200,50,150,0,47,34,13,53,47,0,4,2,1
E33001237,298,204,38,166,1,58,43,15,32,27,2,3,0,3
E33001238,2693,2106,523,1583,6,326,240,86,250,225,8,17,0,5
E33001239,238,161,43,118,0,49,39,10,27,24,1,2,0,1
E33001240,753,500,121,379,0,188,158,30,64,61,0,3,0,1
E33001241,1420,1003,239,764,6,294,222,72,114,108,0,5,1,3
E33001242,271,196,64,132,2,44,35,9,29,28,0,0,1,0
E33001243,493,341,85,256,4,115,63,52,31,26,0,4,1,2
E33001244,642,415,104,311,2,190,173,17,31,30,0,1,0,4
E33001245,441,311,91,220,0,96,77,19,32,25,0,6,1,2
E33001246,465,369,75,294,1,68,58,10,24,20,1,3,0,3
E33001247,356,264,60,204,0,68,60,8,22,18,0,4,0,2
E33001248,614,459,102,357,4,100,83,17,49,42,0,7,0,2
E33001249,713,508,100,408,1,162,142,20,39,33,3,3,0,3
E33001250,326,208,49,159,1,99,94,5,18,16,0,2,0,0
E33001251,490,379,89,290,0,79,71,8,29,29,0,0,0,3
E33001252,338,276,76,200,0,31,25,6,28,18,1,3,6,3
E33001253,333,287,80,207,0,23,22,1,21,16,0,5,0,2
E33001254,356,249,58,191,4,61,36,25,40,32,0,3,5,2
E33001255,382,249,71,178,2,109,100,9,19,15,0,4,0,3
E33001256,369,292,71,221,1,50,45,5,22,16,1,5,0,4
E33001257,482,342,111,231,1,115,94,21,19,14,0,1,4,5
E33001258,655,516,126,390,2,80,52,28,54,49,1,4,0,3
E33001259,448,314,82,232,1,81,61,20,47,39,0,7,1,5
E33001260,390,294,57,237,1,53,34,19,38,36,0,1,1,4
E33001261,451,377,121,256,0,38,26,12,31,29,0,2,0,5
E33001262,237,211,69,142,1,11,6,5,12,9,0,1,2,2
E33001263,275,221,50,171,0,34,25,9,18,15,0,3,0,2
E33001264,269,202,63,139,0,40,25,15,26,24,1,1,0,1
E33001265,225,190,55,135,0,16,9,7,15,12,2,1,0,4
E33001266,254,205,47,158,0,27,21,6,21,19,0,2,0,1
E33001267,458,386,98,288,0,30,15,15,39,32,2,4,1,3
E33001268,367,320,100,220,0,16,8,8,28,27,0,1,0,3
E33001269,342,277,68,209,0,23,11,12,35,34,0,1,0,7
E33001270,411,325,98,227,1,42,26,16,42,39,0,1,2,1
E33001271,381,318,97,221,1,29,18,11,32,28,0,3,1,1
E33001272,818,573,148,425,3,123,71,52,113,100,2,11,0,6
E33001273,395,278,77,201,1,60,31,29,54,50,0,2,2,2
E33001274,369,255,47,208,1,83,41,42,26,20,1,4,1,4
E33001275,410,281,74,207,2,91,51,40,35,30,3,0,2,1
E33001276,274,199,27,172,0,64,37,27,8,7,0,1,0,3
E33001277,386,211,53,158,1,137,86,51,36,28,0,4,4,1
E33001278,320,243,56,187,0,48,31,17,29,21,0,8,0,0
E33001279,424,309,66,243,0,80,48,32,33,27,1,4,1,2
E33001280,761,527,131,396,3,110,60,50,118,105,0,11,2,3
E33001281,335,232,50,182,0,58,25,33,45,37,2,5,1,0
E33001282,450,315,93,222,1,87,37,50,47,41,1,5,0,0
E33001283,524,428,122,306,0,54,33,21,40,36,0,4,0,2
E33001284,273,226,58,168,0,21,11,10,25,21,0,4,0,1
E33001285,280,230,69,161,0,14,8,6,36,33,0,3,0,0
E33001286,271,189,44,145,3,30,12,18,46,38,0,6,2,3
E33001287,660,453,131,322,1,137,74,63,62,53,1,8,0,7
E33001288,261,176,48,128,2,46,11,35,34,31,0,2,1,3
E33001289,261,184,56,128,1,42,18,24,26,25,0,0,1,8
E33001290,390,271,83,188,1,57,38,19,60,52,0,5,3,1
E33001291,267,224,67,157,1,22,13,9,17,16,0,1,0,3
E33001292,310,219,66,153,2,62,40,22,26,21,0,4,1,1
E33001293,261,199,55,144,1,38,23,15,22,21,0,1,0,1
E33001294,1247,825,159,666,1,251,167,84,167,155,3,6,3,3
E33001295,381,294,64,230,0,53,36,17,34,32,0,2,0,0
E33001296,443,316,69,247,4,64,34,30,55,46,1,7,1,4
E33001297,269,155,37,118,0,89,43,46,23,17,0,4,2,2
E33001298,256,176,46,130,0,55,32,23,23,21,1,1,0,2
E33001299,420,306,67,239,1,77,41,36,36,35,0,0,1,0
E33001300,422,336,65,271,1,33,23,10,49,46,1,2,0,3
E33001301,284,194,41,153,0,65,44,21,24,19,0,3,2,1
E33001302,330,187,40,147,1,101,65,36,38,36,0,2,0,3
E33001303,638,399,95,304,2,142,86,56,91,86,0,5,0,4
E33001304,460,317,73,244,0,96,64,32,47,43,0,3,1,0
E33001305,347,240,48,192,1,69,46,23,37,35,0,1,1,0
E33001306,468,336,77,259,0,95,51,44,37,33,1,2,1,0
E33001307,235,172,45,127,0,44,31,13,19,18,0,1,0,0
E33001308,270,186,52,134,0,59,38,21,24,21,0,3,0,1
E33001309,203,127,33,94,5,43,23,20,27,26,0,0,1,1
E33001310,318,221,79,142,2,47,21,26,46,41,0,4,1,2
E33001311,260,188,54,134,0,29,16,13,36,34,0,2,0,7
E33001312,257,195,53,142,1,23,15,8,36,31,1,2,2,2
E33001313,269,184,46,138,1,52,29,23,32,26,0,2,4,0
E33001314,350,238,53,185,0,88,46,42,22,18,2,0,2,2
E33001315,472,301,70,231,1,116,62,54,48,45,0,2,1,6
E33001316,235,169,62,107,0,29,12,17,35,33,0,2,0,2
E33001317,281,187,64,123,0,45,23,22,47,42,0,4,1,2
E33001318,239,166,41,125,1,33,18,15,39,29,2,7,1,0
E33001319,1028,821,234,587,1,67,34,33,132,124,0,7,1,7
E33001320,303,184,42,142,1,53,31,22,64,60,0,3,1,1
E33001321,429,241,63,178,1,74,37,37,105,94,0,10,1,8
E33001322,497,331,77,254,2,47,18,29,110,104,0,6,0,7
E33001323,733,447,130,317,2,147,80,67,133,120,1,12,0,4
E33001324,300,193,34,159,0,72,39,33,34,28,1,5,0,1
E33001325,481,347,81,266,1,94,60,34,34,32,0,1,1,5
E33001326,444,341,79,262,3,69,44,25,30,28,1,1,0,1
E33001327,308,227,62,165,1,51,28,23,29,26,0,2,1,0
E33001328,477,320,78,242,1,108,69,39,47,39,2,3,3,1
E33001329,263,177,49,128,0,38,18,20,47,39,2,2,4,1
E33001330,286,238,57,181,0,27,14,13,20,17,1,1,1,1
E33001331,239,172,51,121,1,47,23,24,18,17,1,0,0,1
E33001332,329,249,56,193,0,36,22,14,41,35,2,4,0,3
E33001333,261,190,45,145,1,51,26,25,19,14,0,5,0,0
E33001334,317,197,47,150,2,66,31,35,51,46,3,2,0,1
E33001335,478,340,96,244,2,87,46,41,45,43,1,1,0,4
E33001336,490,327,101,226,2,103,48,55,56,48,2,6,0,2
E33001337,367,242,73,169,5,52,31,21,64,52,0,9,3,4
E33001338,261,183,52,131,0,33,16,17,39,38,0,1,0,6
E33001339,256,186,46,140,0,28,19,9,40,35,0,4,1,2
E33001340,265,167,38,129,0,65,43,22,30,29,0,1,0,3
E33001341,257,191,48,143,0,47,35,12,16,12,0,4,0,3
E33001342,393,301,73,228,0,63,40,23,27,20,2,4,1,2
E33001343,292,206,50,156,1,35,22,13,49,40,3,6,0,1
E33001344,719,615,169,446,5,35,18,17,62,57,0,5,0,2
E33001345,226,202,56,146,0,15,12,3,9,9,0,0,0,0
E33001346,296,217,61,156,0,25,13,12,52,44,0,8,0,2
E33001347,228,162,51,111,0,39,24,15,21,20,1,0,0,6
E33001348,382,323,91,232,0,27,18,9,31,25,0,4,2,1
E33001349,304,231,57,174,0,53,30,23,20,14,0,4,2,0
E33001350,270,181,40,141,0,57,38,19,32,30,0,2,0,0
E33001351,331,247,52,195,2,57,41,16,25,21,1,2,1,0
E33001352,469,388,119,269,0,52,31,21,25,18,0,4,3,4
E33001353,344,243,55,188,1,72,41,31,25,22,0,3,0,3
E33001354,315,229,71,158,1,62,27,35,15,12,0,1,2,8
E33001355,345,252,45,207,0,64,41,23,27,22,0,4,1,2
E33001356,534,439,108,331,1,47,24,23,44,39,2,3,0,3
E33001357,314,258,86,172,0,20,15,5,29,27,0,2,0,7
E33001358,314,268,76,192,0,19,12,7,26,24,0,2,0,1
E33001359,629,497,126,371,2,65,35,30,60,57,0,2,1,5
E33001360,257,223,62,161,0,14,8,6,20,18,0,2,0,0
E33001361,354,269,65,204,0,59,29,30,24,19,1,4,0,2
E33001362,284,198,38,160,0,56,15,41,28,21,0,6,1,2
E33001363,385,273,53,220,1,85,33,52,26,23,1,2,0,0
E33001364,335,204,43,161,0,102,51,51,26,23,0,3,0,3
E33001365,681,527,138,389,2,98,59,39,50,47,0,2,1,4
E33001366,250,163,45,118,0,51,36,15,32,28,1,3,0,4
E33001367,272,199,50,149,0,42,17,25,28,27,0,1,0,3
E33001368,609,473,140,333,1,79,36,43,56,52,0,4,0,0
E33001369,542,428,117,311,1,71,36,35,41,33,0,8,0,1
E33001370,673,483,120,363,2,108,56,52,78,74,0,3,1,2
E33001371,303,258,85,173,0,27,17,10,17,15,0,0,2,1
E33001372,379,301,87,214,1,50,22,28,26,23,1,2,0,1
E33001373,273,198,51,147,2,48,31,17,21,18,0,2,1,4
E33001374,655,553,139,414,2,63,42,21,36,31,2,3,0,1
E33001375,1060,805,206,599,3,169,108,61,80,74,2,4,0,3
E33001376,645,476,131,345,2,96,56,40,63,61,0,2,0,8
E33001377,459,329,79,250,1,94,48,46,33,29,2,2,0,2
E33001378,329,232,43,189,2,67,43,24,28,25,0,2,1,0
E33001379,306,214,65,149,3,58,25,33,30,25,0,5,0,1
E33001380,273,227,78,149,1,35,16,19,10,9,1,0,0,0
E33001381,247,161,42,119,0,54,29,25,31,29,0,1,1,1
E33001382,315,239,79,160,0,39,15,24,36,29,0,5,2,1
E33001383,265,188,54,134,0,39,23,16,33,28,0,3,2,5
E33001384,330,225,33,192,1,66,41,25,33,24,2,6,1,5
E33001385,283,226,53,173,0,42,29,13,15,13,2,0,0,0
E33001386,278,227,59,168,1,30,19,11,20,18,0,2,0,0
E33001387,285,228,72,156,1,30,14,16,26,21,0,4,1,0
E33001388,256,220,61,159,0,22,12,10,13,10,0,3,0,1
E33001389,528,407,107,300,3,81,42,39,37,30,2,5,0,0
E33001390,285,246,71,175,0,25,18,7,13,10,0,1,2,1
E33001391,277,209,45,164,0,48,25,23,17,15,0,2,0,3
E33001392,702,575,142,433,0,73,32,41,49,44,1,3,1,5
E33001393,341,252,42,210,0,58,34,24,27,22,0,5,0,4
E33001394,696,576,114,462,0,56,23,33,57,48,2,6,1,7
E33001395,251,191,52,139,1,24,17,7,32,28,0,4,0,3
E33001396,292,211,58,153,2,50,28,22,26,22,0,3,1,3
E33001397,265,208,43,165,2,29,15,14,25,20,0,4,1,1
E33001398,234,169,56,113,0,31,21,10,34,28,0,6,0,0
E33001399,342,248,68,180,0,56,31,25,36,35,0,1,0,2
E33001400,454,374,110,264,1,44,27,17,33,31,1,1,0,2
E33001401,341,268,78,190,4,39,17,22,27,21,0,5,1,3
E33001402,321,224,60,164,2,59,31,28,33,31,0,2,0,3
E33001403,358,260,81,179,0,66,40,26,31,25,1,5,0,1
E33001404,335,249,56,193,1,50,22,28,33,29,0,4,0,2
E33001405,591,477,115,362,2,65,32,33,44,37,0,5,2,3
E33001406,373,302,94,208,0,46,27,19,25,24,0,0,1,0
E33001407,643,524,148,376,1,71,37,34,44,39,0,5,0,3
E33001408,361,255,73,182,4,56,31,25,40,38,0,2,0,6
E33001409,265,217,67,150,0,30,14,16,17,15,0,2,0,1
E33001410,363,289,101,188,0,43,26,17,27,24,0,3,0,4
E33001411,778,595,177,418,2,106,60,46,72,66,0,4,2,3
E33001412,489,387,108,279,1,49,35,14,51,49,1,1,0,1
E33001413,333,244,77,167,0,52,27,25,36,32,1,2,1,1
E33001414,474,330,75,255,3,78,56,22,62,59,0,2,1,1
E33001415,575,416,138,278,3,99,59,40,54,43,0,9,2,3
E33001416,351,278,56,222,4,31,13,18,38,37,0,1,0,0
E33001417,361,312,70,242,1,11,5,6,35,31,0,4,0,2
E33001418,483,400,95,305,2,48,26,22,28,21,0,5,2,5
E33001419,383,241,61,180,1,81,46,35,58,53,0,3,2,2
E33001420,797,545,114,431,6,132,58,74,110,101,1,7,1,4
E33001421,586,455,130,325,1,67,31,36,60,53,1,6,0,3
E33001422,342,232,57,175,0,71,39,32,33,29,0,3,1,6
E33001423,333,239,54,185,1,40,19,21,50,48,0,1,1,3
E33001424,553,416,88,328,1,72,37,35,61,54,0,7,0,3
E33001425,248,166,31,135,1,51,23,28,26,16,1,6,3,4
E33001426,441,327,92,235,2,63,31,32,46,40,0,6,0,3
E33001427,455,351,87,264,2,53,27,26,44,40,0,4,0,5
E33001428,419,322,75,247,3,56,30,26,32,27,0,5,0,6
E33001429,429,283,61,222,7,37,20,17,99,87,2,7,3,3
E33001430,451,294,76,218,6,56,27,29,93,86,2,4,1,2
E33001431,408,276,75,201,4,71,33,38,55,53,1,1,0,2
E33001432,322,235,47,188,1,36,21,15,47,42,3,2,0,3
E33001433,367,279,82,197,1,38,19,19,44,34,2,7,1,5
E33001434,339,292,82,210,1,13,8,5,32,30,0,2,0,1
E33001435,483,398,110,288,2,39,20,19,37,31,0,4,2,7
E33001436,262,179,46,133,0,17,6,11,63,56,0,5,2,3
E33001437,331,256,57,199,1,31,17,14,41,37,0,4,0,2
E33001438,718,512,125,387,1,118,48,70,83,72,0,10,1,4
E33001439,328,227,53,174,4,38,20,18,54,53,0,1,0,5
E33001440,295,223,56,167,0,32,12,20,37,29,1,7,0,3
E33001441,289,187,60,127,1,53,6,47,41,40,0,1,0,7
E33001442,324,210,58,152,0,52,21,31,55,50,2,3,0,7
E33001443,281,196,49,147,3,50,30,20,31,25,1,4,1,1
E33001444,441,347,84,263,0,40,23,17,52,43,0,8,1,2
E33001445,271,219,47,172,0,28,17,11,21,17,0,4,0,3
E33001446,706,582,149,433,2,66,31,35,54,48,0,5,1,2
E33001447,348,260,54,206,0,49,25,24,33,26,0,6,1,6
E33001448,345,288,62,226,2,27,8,19,23,22,0,1,0,5
E33001449,176,123,31,92,0,38,21,17,14,12,0,1,1,1
E33001450,239,199,62,137,0,21,7,14,19,16,0,2,1,0
E33001451,420,321,65,256,0,40,16,24,54,50,1,3,0,5
E33001452,278,215,44,171,3,34,19,15,24,22,0,2,0,2
E33001453,267,200,62,138,1,28,15,13,36,31,2,3,0,2
E33001454,316,253,95,158,1,29,14,15,32,30,0,2,0,1
E33001455,365,246,49,197,1,83,47,36,33,28,0,5,0,2
E33001456,512,410,121,289,0,60,28,32,38,35,0,2,1,4
E33001457,294,190,45,145,0,60,28,32,42,40,0,2,0,2
E33001458,419,313,84,229,2,34,10,24,67,57,0,10,0,3
E33001459,453,322,88,234,0,40,21,19,84,79,0,5,0,7
E33001460,2342,1787,478,1309,5,104,50,54,430,385,2,33,10,16
E33001461,246,189,56,133,1,20,6,14,36,34,0,2,0,0
E33001462,305,198,48,150,1,58,23,35,45,41,0,3,1,3
E33001463,316,177,79,98,1,23,13,10,106,101,0,4,1,9
E33001464,455,356,74,282,0,46,24,22,51,44,0,6,1,2
E33001465,517,346,95,251,3,43,21,22,120,111,0,6,3,5
E33001466,590,437,118,319,6,64,33,31,79,68,1,9,1,4
E33001467,357,219,54,165,2,32,16,16,99,89,1,8,1,5
E33001468,659,481,132,349,4,73,37,36,95,88,2,4,1,6
E33001469,621,442,110,332,2,102,59,43,74,71,2,1,0,1
E33001470,422,278,70,208,2,59,34,25,74,69,0,2,3,9
E33001471,269,148,44,104,1,33,14,19,85,76,1,7,1,2
E33001472,312,205,72,133,2,30,8,22,71,68,0,3,0,4
E33001473,396,248,71,177,2,27,13,14,111,102,0,8,1,8
E33001474,274,185,55,130,1,15,5,10,67,62,0,4,1,6
E33001475,312,182,62,120,1,72,45,27,54,44,1,6,3,3
E33001476,275,190,40,150,1,50,31,19,33,31,0,1,1,1
E33001477,541,373,91,282,3,113,59,54,50,43,1,5,1,2
E33001478,328,225,51,174,1,71,43,28,30,25,1,3,1,1
E33001479,669,439,107,332,3,123,88,35,87,76,2,8,1,17
E33001480,318,235,55,180,1,28,13,15,54,51,0,2,1,0
E33001481,500,381,95,286,3,43,22,21,68,60,0,6,2,5
E33001482,294,202,70,132,5,36,20,16,45,42,2,1,0,6
E33001483,289,209,73,136,4,23,12,11,46,37,1,8,0,7
E33001484,247,190,44,146,1,24,14,10,29,23,0,6,0,3
E33001485,250,190,58,132,0,25,10,15,32,21,1,8,2,3
E33001486,277,205,53,152,3,40,23,17,25,24,0,1,0,4
E33001487,283,223,51,172,4,19,13,6,35,30,0,5,0,2
E33001488,607,454,75,379,4,71,28,43,75,65,2,8,0,3
E33001489,394,309,66,243,2,46,26,20,33,26,0,7,0,4
E33001490,276,147,26,121,0,87,59,28,39,32,1,5,1,3
E33001491,347,224,66,158,0,66,43,23,54,44,1,8,1,3
E33001492,324,233,50,183,1,66,49,17,21,18,2,0,1,3
E33001493,425,313,83,230,1,41,25,16,64,59,0,5,0,6
E33001494,330,268,60,208,1,28,16,12,27,27,0,0,0,6
E33001495,637,425,101,324,5,84,45,39,117,106,3,6,2,6
E33001496,659,506,126,380,3,60,29,31,82,70,0,12,0,8
E33001497,340,259,60,199,1,13,4,9,60,55,0,4,1,7
E33001498,421,299,98,201,4,36,21,15,71,66,0,5,0,11
E33001499,720,588,172,416,3,45,17,28,76,65,1,9,1,8
E33001500,359,276,65,211,2,33,19,14,48,43,0,4,1,0
E33001501,337,267,86,181,1,22,8,14,42,33,0,8,1,5
E33001502,393,282,70,212,2,80,42,38,28,24,0,2,2,1
E33001503,292,193,48,145,0,61,40,21,33,30,0,2,1,5
E33001504,589,434,119,315,0,93,35,58,57,52,0,4,1,5
E33001505,351,241,51,190,2,54,32,22,50,41,0,8,1,4
E33001506,399,284,73,211,2,45,24,21,67,53,10,4,0,1
E33001507,791,681,189,492,2,32,17,15,66,57,0,9,0,10
E33001508,308,238,87,151,2,17,7,10,48,45,0,3,0,3
E33001509,540,481,106,375,0,22,9,13,32,28,1,3,0,5
E33001510,330,249,68,181,1,31,14,17,49,43,0,6,0,0
E33001511,288,247,69,178,1,15,4,11,25,21,0,2,2,0
E33001512,407,272,63,209,0,69,34,35,59,53,0,6,0,7
E33001513,320,281,81,200,0,10,5,5,28,28,0,0,0,1
E33001514,328,268,87,181,0,20,9,11,37,27,1,5,4,3
E33001515,280,242,84,158,1,16,2,14,19,13,0,6,0,2
E33001516,385,320,81,239,1,31,10,21,31,27,0,4,0,2
E33001517,389,292,85,207,3,56,15,41,35,31,0,4,0,3
E33001518,306,221,63,158,1,33,12,21,43,38,1,3,1,8
E33001519,543,330,69,261,3,135,50,85,63,48,1,11,3,12
E33001520,510,380,89,291,0,55,21,34,72,64,0,7,1,3
E33001521,269,184,29,155,4,46,18,28,34,27,1,6,0,1
E33001522,296,232,46,186,0,28,15,13,26,19,0,6,1,10
E33001523,530,406,84,322,4,41,18,23,71,57,2,8,4,8
E33001524,284,234,44,190,4,25,7,18,16,14,0,0,2,5
E33001525,311,239,66,173,1,26,8,18,43,32,2,6,3,2
E33001526,332,249,66,183,1,25,10,15,55,48,0,6,1,2
E33001527,259,159,47,112,1,27,10,17,68,60,2,6,0,4
E33001528,736,486,118,368,9,84,43,41,155,134,0,18,3,2
E33001529,522,437,108,329,4,33,14,19,47,43,0,4,0,1
E33001530,329,280,103,177,2,21,10,11,24,22,1,1,0,2
E33001531,286,196,52,144,1,56,29,27,26,22,0,3,1,7
E33001532,1589,1279,324,955,5,169,84,85,128,110,3,13,2,8
E33001533,390,341,82,259,1,12,4,8,29,23,1,4,1,7
E33001534,339,280,77,203,0,8,5,3,48,45,0,2,1,3
E33001535,448,371,93,278,6,24,11,13,41,34,0,6,1,6
E33001536,373,296,100,196,1,35,13,22,35,31,0,4,0,6
E33001537,499,365,94,271,3,81,32,49,46,43,0,2,1,4
E33001538,501,348,81,267,2,75,34,41,74,71,0,3,0,2
E33001539,324,285,75,210,4,4,2,2,29,24,1,3,1,2
E33001540,555,426,138,288,2,32,18,14,91,78,5,8,0,4
E33001541,378,333,110,223,1,6,2,4,32,26,2,3,1,6
E33001542,637,498,142,356,6,43,22,21,88,73,2,13,0,2
E33001543,386,311,95,216,1,29,8,21,40,34,1,5,0,5
E33001544,270,210,60,150,1,25,10,15,33,29,1,3,0,1
E33001545,315,198,70,128,0,39,13,26,77,73,0,4,0,1
E33001546,372,305,97,208,0,32,13,19,32,26,3,3,0,3
E33001547,351,246,74,172,0,31,14,17,72,67,3,2,0,2
E33001548,312,167,26,141,0,97,68,29,39,37,0,2,0,9
E33001549,598,431,110,321,6,82,49,33,76,67,0,8,1,3
E33001550,305,191,42,149,2,63,35,28,42,37,0,4,1,7
E33001551,535,437,114,323,0,32,14,18,61,57,0,2,2,5
E33001552,607,472,140,332,1,48,26,22,82,68,1,10,3,4
E33001553,356,245,48,197,3,48,25,23,54,44,0,7,3,6
E33001554,419,294,85,209,1,71,45,26,52,42,1,6,3,1
E33001555,285,229,64,165,0,29,16,13,26,24,0,2,0,1
E33001556,331,260,74,186,1,38,29,9,29,27,1,1,0,3
E33001557,275,191,58,133,0,29,12,17,53,48,1,4,0,2
E33001558,272,205,70,135,2,6,4,2,58,52,2,4,0,1
E33001559,271,223,59,164,0,12,6,6,32,27,1,2,2,4
E33001560,706,561,141,420,3,47,19,28,91,78,1,10,2,4
E33001561,306,215,68,147,1,47,21,26,42,38,1,3,0,1
E33001562,353,274,62,212,1,37,17,20,41,34,2,4,1,0
E33001563,388,282,101,181,2,46,29,17,55,54,0,1,0,3
E33001564,289,243,76,167,1,17,5,12,28,18,0,9,1,0
E33001565,809,676,161,515,4,45,27,18,78,73,0,4,1,6
E33001566,348,242,46,196,1,59,34,25,39,34,0,5,0,7
E33001567,265,193,49,144,0,28,15,13,41,35,2,2,2,3
E33001568,320,243,104,139,0,20,11,9,46,29,13,2,2,11
E33001569,1113,936,288,648,4,53,26,27,115,105,1,9,0,5
E33001570,242,181,81,100,1,11,6,5,44,38,3,0,3,5
E33001571,342,260,80,180,2,23,15,8,54,44,1,9,0,3
E33001572,705,580,174,406,0,40,29,11,77,70,0,5,2,8
E33001573,330,231,60,171,1,46,29,17,49,38,3,8,0,3
E33001574,329,286,62,224,2,12,8,4,27,24,0,3,0,2
E33001575,526,426,118,308,2,27,14,13,62,54,1,7,0,9
E33001576,394,282,75,207,0,22,10,12,84,67,8,9,0,6
E33001577,325,293,100,193,1,6,3,3,18,15,0,3,0,7
E33001578,312,280,92,188,0,4,3,1,26,23,0,3,0,2
E33001579,358,285,115,170,0,28,18,10,40,37,1,2,0,5
E33001580,253,186,54,132,0,17,10,7,48,39,6,3,0,2
E33001581,442,330,87,243,1,40,23,17,66,58,0,8,0,5
E33001582,420,367,77,290,3,8,2,6,41,40,0,1,0,1
E33001583,156,127,26,101,0,6,5,1,20,16,0,4,0,3
E33001584,499,402,111,291,1,29,14,15,63,60,0,3,0,4
E33001585,774,641,153,488,1,52,30,22,77,72,1,4,0,3
E33001586,370,312,86,226,1,16,8,8,39,34,0,5,0,2
E33001587,276,203,55,148,1,37,30,7,32,28,0,3,1,3
E33001588,305,247,52,195,1,29,21,8,26,23,0,2,1,2
E33001589,417,298,76,222,4,37,24,13,70,61,2,5,2,8
E33001590,373,281,61,220,3,46,32,14,41,36,0,3,2,2
E33001591,1120,883,217,666,3,100,52,48,129,116,0,12,1,5
E33001592,290,200,29,171,1,37,30,7,49,38,0,10,1,3
E33001593,734,573,155,418,3,89,53,36,66,58,0,8,0,3
E33001594,863,729,154,575,1,36,23,13,95,87,0,7,1,2
E33001595,386,291,71,220,1,38,25,13,54,51,0,3,0,2
E33001596,347,272,63,209,1,22,8,14,49,44,1,4,0,3
E33001597,389,308,79,229,1,33,23,10,44,39,0,3,2,3
E33001598,349,286,84,202,0,28,16,12,34,29,0,5,0,1
E33001599,313,263,91,172,1,22,19,3,23,21,1,1,0,4
E33001600,288,250,40,210,0,9,5,4,29,26,0,2,1,0
E33001601,326,273,103,170,1,14,6,8,36,30,0,6,0,2
E33001602,550,463,146,317,1,27,20,7,54,52,0,2,0,5
E33001603,311,240,67,173,0,29,18,11,40,34,0,4,2,2
E33001604,410,358,105,253,2,13,11,2,37,32,0,5,0,0
E33001605,694,593,158,435,1,38,26,12,53,44,0,8,1,9
E33001606,289,220,60,160,0,40,27,13,27,18,2,7,0,2
E33001607,335,294,96,198,0,5,4,1,33,28,0,4,1,3
E33001608,635,473,129,344,1,55,26,29,103,93,1,7,2,3
E33001609,405,293,61,232,0,71,49,22,35,30,0,5,0,6
E33001610,394,316,57,259,2,40,26,14,32,26,0,4,2,4
E33001611,374,285,63,222,4,49,30,19,36,31,0,5,0,0
E33001612,330,242,38,204,1,53,44,9,33,26,0,7,0,1
E33001613,236,161,39,122,0,48,34,14,25,23,0,2,0,2
E33001614,255,174,44,130,1,39,22,17,40,37,0,3,0,1
E33001615,336,241,71,170,0,38,25,13,55,46,1,8,0,2
E33001616,336,271,58,213,0,22,13,9,40,39,0,0,1,3
E33001617,298,176,39,137,0,67,34,33,54,49,0,5,0,1
E33001618,290,213,69,144,0,26,11,15,49,43,0,6,0,2
E33001619,305,267,63,204,1,11,5,6,23,20,0,3,0,3
E33001620,420,375,119,256,0,12,9,3,28,25,0,3,0,5
E33001621,571,437,126,311,1,66,35,31,65,60,2,3,0,2
E33001622,364,276,67,209,0,34,23,11,47,38,0,8,1,7
E33001623,329,220,55,165,0,57,34,23,50,43,2,5,0,2
E33001624,724,631,155,476,1,30,21,9,52,43,1,6,2,10
E33001625,340,283,91,192,0,26,13,13,28,26,0,2,0,3
E33001626,278,224,66,158,1,20,13,7,28,26,0,0,2,5
E33001627,408,298,73,225,3,63,43,20,44,37,0,6,1,0
E33001628,448,351,82,269,1,52,30,22,42,38,2,2,0,2
E33001629,444,355,60,295,4,25,12,13,57,48,0,9,0,3
E33001630,388,282,75,207,2,52,32,20,50,44,0,5,1,2
E33001631,314,230,79,151,1,32,15,17,48,39,2,7,0,3
E33001632,276,190,43,147,3,43,24,19,40,35,0,5,0,0
E33001633,283,214,68,146,0,26,10,16,41,40,0,1,0,2
E33001634,499,342,96,246,1,88,38,50,63,56,0,7,0,5
E33001635,288,198,60,138,0,46,34,12,43,41,0,1,1,1
E33001636,378,260,48,212,1,49,27,22,68,58,0,9,1,0
E33001637,611,460,117,343,0,63,41,22,85,77,0,8,0,3
E33001638,310,243,78,165,0,25,11,14,40,38,0,0,2,2
E33001639,504,366,82,284,0,50,29,21,86,79,0,4,3,2
E33001640,430,348,77,271,1,27,16,11,51,46,0,5,0,3
E33001641,679,492,145,347,3,89,43,46,93,72,2,17,2,2
E33001642,713,546,135,411,2,85,42,43,76,68,0,7,1,4
E33001643,552,488,143,345,2,14,5,9,36,33,1,2,0,12
E33001644,292,244,72,172,0,19,8,11,29,28,0,1,0,0
E33001645,346,307,88,219,0,13,6,7,24,21,0,3,0,2
E33001646,434,347,102,245,1,34,19,15,46,39,0,7,0,6
E33001647,302,208,60,148,0,45,14,31,45,40,2,3,0,4
E33001648,380,300,87,213,3,22,15,7,46,40,0,6,0,9
E33001649,370,262,65,197,2,47,26,21,57,48,0,9,0,2
E33001650,472,347,84,263,0,56,31,25,63,58,0,5,0,6
E33001651,608,508,120,388,3,17,7,10,75,64,0,9,2,5
E33001652,622,489,123,366,2,54,24,30,75,70,0,4,1,2
E33001653,296,203,49,154,3,41,18,23,46,40,0,3,3,3
E33001654,350,272,74,198,2,38,22,16,35,33,0,2,0,3
E33001655,406,308,74,234,1,56,23,33,40,34,0,5,1,1
E33001656,295,237,71,166,0,20,11,9,38,33,2,3,0,0
E33001657,293,234,63,171,0,23,13,10,34,28,0,4,2,2
E33001658,563,441,98,343,0,70,51,19,47,40,1,6,0,5
E33001659,344,254,84,170,0,47,21,26,37,34,0,3,0,6
E33001660,558,401,112,289,4,77,47,30,74,67,1,6,0,2
E33001661,463,375,105,270,0,32,19,13,52,45,0,7,0,4
E33001662,288,221,70,151,1,18,10,8,47,41,0,4,2,1
E33001663,250,195,58,137,1,13,3,10,40,34,0,3,3,1
E33001664,352,287,81,206,1,22,9,13,40,35,1,3,1,2
E33001665,527,472,99,373,2,8,3,5,45,43,0,2,0,0
E33001666,420,326,79,247,1,36,20,16,53,47,0,6,0,4
E33001667,285,237,87,150,1,6,2,4,38,31,0,5,2,3
E33001668,488,413,100,313,3,18,9,9,47,43,0,4,0,7
E33001669,268,245,53,192,0,3,2,1,19,18,0,1,0,1
E33001670,411,326,92,234,1,12,3,9,56,49,3,3,1,16
E33001671,362,321,51,270,1,1,0,1,38,36,1,0,1,1
E33001672,907,774,148,626,2,34,20,14,93,81,0,11,1,4
E33001673,366,314,38,276,0,6,2,4,42,40,0,2,0,4
E33001674,391,355,68,287,0,3,1,2,33,33,0,0,0,0
E33001675,358,316,102,214,2,4,1,3,32,29,0,3,0,4
E33001676,869,726,236,490,2,39,13,26,100,91,1,6,2,2
E33001677,386,308,82,226,0,22,7,15,55,45,1,5,4,1
E33001678,353,292,100,192,1,20,4,16,37,32,0,5,0,3
E33001679,526,411,80,331,2,27,19,8,86,76,3,5,2,0
E33001680,343,247,78,169,5,19,11,8,63,52,1,5,5,9
E33001681,218,133,52,81,0,13,8,5,64,55,2,3,4,8
E33001682,316,243,90,153,1,20,12,8,47,40,3,2,2,5
E33001683,756,566,121,445,1,54,38,16,130,119,3,4,4,5
E33001684,620,531,128,403,1,32,20,12,51,41,0,8,2,5
E33001685,376,294,93,201,0,32,27,5,48,40,1,5,2,2
E33001686,337,270,107,163,0,13,10,3,45,43,1,1,0,9
E33001687,274,227,65,162,0,15,8,7,31,26,0,4,1,1
E33001688,491,407,113,294,0,24,17,7,53,47,0,6,0,7
E33001689,289,255,65,190,0,7,4,3,27,21,2,4,0,0
E33001690,415,304,85,219,1,44,18,26,61,56,1,3,1,5
E33001691,294,250,77,173,2,18,6,12,23,21,1,1,0,1
E33001692,256,195,40,155,2,23,17,6,32,28,1,3,0,4
E33001693,893,625,151,474,3,97,65,32,163,148,9,3,3,5
E33001694,304,229,42,187,1,15,7,8,54,48,0,2,4,5
E33001695,408,296,84,212,0,49,32,17,62,60,0,2,0,1
E33001696,681,525,134,391,0,66,43,23,86,79,1,6,0,4
E33001697,286,192,49,143,0,41,33,8,52,52,0,0,0,1
E33001698,426,368,71,297,0,17,11,6,35,32,0,3,0,6
E33001699,353,238,64,174,0,76,67,9,37,32,1,4,0,2
E33001700,301,226,54,172,0,45,19,26,29,26,1,2,0,1
E33001701,293,186,43,143,0,12,10,2,92,83,0,7,2,3
E33001702,569,457,131,326,1,26,17,9,81,72,4,5,0,4
E33001703,268,190,50,140,0,30,24,6,48,39,1,6,2,0
E33001704,300,210,57,153,1,10,8,2,75,65,4,5,1,4
E33001705,396,258,59,199,1,35,18,17,98,92,0,4,2,4
E33001706,2705,2122,544,1578,5,141,99,42,414,359,10,37,8,23
E33001707,753,609,168,441,1,52,35,17,85,76,1,8,0,6
E33001708,220,141,38,103,0,18,13,5,60,57,0,3,0,1
E33001709,1160,789,168,621,3,94,59,35,264,220,3,37,4,10
E33001710,787,575,116,459,2,82,65,17,120,112,1,7,0,8
E33001711,293,207,58,149,0,39,33,6,42,34,2,6,0,5
E33001712,490,362,85,277,1,44,32,12,80,75,0,5,0,3
E33001713,219,163,44,119,0,19,17,2,35,28,0,7,0,2
E33001714,281,214,52,162,0,29,21,8,36,31,0,3,2,2
E33001715,235,185,53,132,0,14,11,3,35,28,1,6,0,1
E33001716,290,226,61,165,0,9,7,2,51,46,1,4,0,4
E33001717,231,176,51,125,1,14,10,4,39,35,0,4,0,1
E33001718,513,402,128,274,1,33,17,16,75,68,1,6,0,2
E33001719,245,219,71,148,0,3,3,0,20,18,0,2,0,3
E33001720,276,216,60,156,2,20,15,5,34,33,0,1,0,4
E33001721,231,192,60,132,1,6,4,2,32,29,0,3,0,0
E33001722,416,359,116,243,0,20,13,7,31,27,1,3,0,6
E33001723,370,297,91,206,0,24,19,5,41,35,2,3,1,8
E33001724,289,251,79,172,0,11,6,5,26,17,1,7,1,1
E33001725,380,244,57,187,2,60,47,13,72,70,0,0,2,2
E33001726,268,188,48,140,0,24,16,8,52,51,0,1,0,4
E33001727,274,177,38,139,1,27,22,5,67,61,2,2,2,2
E33001728,240,155,56,99,0,27,22,5,52,44,0,4,4,6
E33001729,417,265,91,174,0,50,37,13,98,92,0,6,0,4
E33001730,702,493,117,376,3,79,71,8,121,103,0,15,3,6
E33001731,303,194,48,146,2,76,68,8,31,26,1,2,2,0
E33001732,527,393,86,307,2,40,28,12,91,85,1,5,0,1
E33001733,693,476,144,332,3,61,45,16,145,133,0,11,1,8
E33001734,299,236,79,157,0,18,14,4,41,34,3,3,1,4
E33001735,480,343,78,265,2,25,15,10,103,94,1,7,1,7
E33001736,442,335,116,219,1,39,25,14,61,51,2,7,1,6
E33001737,551,445,118,327,2,23,14,9,76,68,2,4,2,5
E33001738,241,209,73,136,0,15,11,4,16,11,0,4,1,1
E33001739,352,293,75,218,0,23,13,10,34,30,0,4,0,2
E33001740,344,274,90,184,0,35,19,16,34,28,0,6,0,1
E33001741,292,226,63,163,0,26,14,12,35,31,1,3,0,5
E33001742,516,424,101,323,4,25,15,10,59,58,0,1,0,4
E33001743,268,225,57,168,0,24,14,10,15,14,0,0,1,4
E33001744,325,216,46,170,0,65,42,23,43,41,0,2,0,1
E33001745,294,257,68,189,1,19,7,12,15,14,1,0,0,2
E33001746,273,230,77,153,2,11,2,9,28,24,0,4,0,2
E33001747,567,475,105,370,4,43,18,25,43,35,3,5,0,2
E33001748,232,184,46,138,3,22,11,11,21,20,0,1,0,2
E33001749,665,477,126,351,4,105,49,56,76,68,1,7,0,3
E33001750,538,403,111,292,1,81,40,41,50,45,0,5,0,3
E33001751,453,338,80,258,0,82,30,52,31,25,0,5,1,2
E33001752,293,200,53,147,1,47,17,30,41,39,0,2,0,4
E33001753,345,265,65,200,4,43,23,20,30,23,0,7,0,3
E33001754,282,237,68,169,1,20,10,10,23,20,0,3,0,1
E33001755,338,316,84,232,0,7,2,5,15,11,1,3,0,0
E33001756,273,232,71,161,0,15,6,9,22,20,0,2,0,4
E33001757,762,597,176,421,2,64,30,34,97,89,3,5,0,2
E33001758,709,562,129,433,2,74,40,34,67,58,0,8,1,4
E33001759,533,404,116,288,1,62,19,43,56,53,0,2,1,10
E33001760,307,243,77,166,0,38,16,22,25,22,0,1,2,1
E33001761,257,190,52,138,0,28,18,10,35,30,0,3,2,4
E33001762,286,214,48,166,2,43,22,21,26,23,1,2,0,1
E33001763,239,180,67,113,0,29,12,17,28,25,0,3,0,2
E33001764,509,370,104,266,1,78,53,25,54,44,1,6,3,6
E33001765,423,337,86,251,1,50,31,19,30,24,0,6,0,5
E33001766,262,213,77,136,1,24,19,5,23,22,0,1,0,1
E33001767,1030,778,182,596,2,117,85,32,127,114,1,12,0,6
E33001768,321,244,68,176,0,40,25,15,34,27,1,6,0,3
E33001769,241,184,52,132,1,12,3,9,38,34,2,2,0,6
E33001770,872,687,160,527,1,85,56,29,97,85,1,9,2,2
E33001771,323,265,90,175,0,22,14,8,35,27,1,5,2,1
E33001772,666,594,168,426,1,23,12,11,47,47,0,0,0,1
E33001773,370,278,78,200,0,44,24,20,47,39,1,7,0,1
E33001774,381,302,73,229,1,25,10,15,52,46,0,6,0,1
E33001775,240,177,56,121,0,32,20,12,29,24,1,4,0,2
E33001776,263,188,45,143,0,37,17,20,36,35,0,1,0,2
E33001777,416,336,101,235,0,35,23,12,45,37,0,6,2,0
E33001778,469,390,86,304,2,32,15,17,44,40,0,4,0,1
E33001779,269,194,51,143,0,37,26,11,37,33,0,4,0,1
E33001780,294,242,59,183,0,24,19,5,28,26,0,2,0,0
E33001781,252,196,53,143,3,28,18,10,24,22,0,2,0,1
E33001782,261,205,49,156,1,24,12,12,29,27,0,1,1,2
E33001783,281,232,68,164,0,20,13,7,29,28,0,1,0,0
E33001784,434,333,82,251,1,47,29,18,52,48,0,3,1,1
E33001785,225,177,60,117,0,21,11,10,27,26,0,1,0,0
E33001786,346,276,92,184,0,35,16,19,29,27,0,2,0,6
E33001787,369,260,75,185,0,61,36,25,46,43,0,2,1,2
E33001788,259,180,47,133,2,34,21,13,43,40,0,3,0,0
E33001789,313,242,66,176,0,33,16,17,31,27,2,2,0,7
E33001790,270,201,53,148,0,50,19,31,17,16,0,1,0,2
E33001791,281,231,69,162,1,16,4,12,31,27,0,3,1,2
E33001792,354,301,71,230,0,18,11,7,34,29,0,5,0,1
E33001793,328,234,73,161,1,43,26,17,46,42,0,4,0,4
E33001794,858,671,196,475,1,95,54,41,86,79,1,5,1,5
E33001795,272,218,58,160,0,20,11,9,34,32,0,2,0,0
E33001796,534,419,109,310,1,51,26,25,56,44,0,11,1,7
E33001797,391,338,72,266,0,19,9,10,31,22,3,5,1,3
E33001798,371,293,68,225,1,32,13,19,44,41,0,2,1,1
E33001799,339,258,75,183,2,32,9,23,45,41,3,1,0,2
E33001800,302,229,67,162,0,27,13,14,43,40,0,3,0,3
E33001801,563,417,110,307,0,70,42,28,70,67,0,3,0,6
E33001802,450,335,94,241,1,40,26,14,72,67,0,5,0,2
E33001803,442,348,81,267,1,43,30,13,48,40,0,8,0,2
E33001804,545,419,120,299,1,42,13,29,74,70,0,3,1,9
E33001805,380,286,80,206,0,44,25,19,43,37,0,5,1,7
E33001806,787,581,164,417,1,63,29,34,137,129,1,7,0,5
E33001807,504,423,77,346,0,32,19,13,49,42,1,5,1,0
E33001808,482,364,79,285,1,34,21,13,81,77,0,4,0,2
E33001809,268,214,62,152,0,29,6,23,24,21,1,0,2,1
E33001810,249,198,69,129,0,18,8,10,26,22,2,2,0,7
E33001811,1153,709,210,499,2,130,75,55,308,296,1,11,0,4
E33001812,265,199,46,153,0,41,19,22,21,19,0,2,0,4
E33001813,491,393,134,259,0,45,16,29,44,41,1,2,0,9
E33001814,326,255,90,165,1,28,17,11,36,30,2,3,1,6
E33001815,365,296,94,202,0,23,14,9,42,40,0,2,0,4
E33001816,431,323,91,232,4,47,23,24,48,40,1,7,0,9
E33001817,293,252,92,160,0,21,12,9,15,12,0,3,0,5
E33001818,359,260,68,192,1,51,25,26,45,40,0,3,2,2
E33001819,579,448,109,339,2,65,45,20,63,56,0,7,0,1
E33001820,448,374,102,272,0,15,9,6,56,44,1,5,6,3
E33001821,277,229,68,161,0,13,7,6,30,29,0,1,0,5
E33001822,250,187,34,153,3,26,19,7,33,28,0,5,0,1
E33001823,290,234,44,190,1,23,20,3,30,24,0,6,0,2
E33001824,862,735,219,516,0,46,30,16,78,75,0,3,0,3
E33001825,367,259,62,197,1,44,28,16,58,55,0,3,0,5
E33001826,420,333,70,263,0,46,33,13,40,35,0,3,2,1
E33001827,336,247,72,175,0,58,51,7,30,30,0,0,0,1
E33001828,284,216,53,163,1,37,27,10,27,14,1,11,1,3
E33001829,419,336,114,222,1,35,32,3,41,35,0,4,2,6
E33001830,333,266,82,184,3,31,24,7,30,21,1,6,2,3
E33001831,366,276,75,201,1,48,40,8,34,21,1,12,0,7
E33001832,469,360,109,251,1,52,37,15,51,50,0,1,0,5
E33001833,473,388,130,258,0,51,41,10,29,25,0,4,0,5
E33001834,256,202,65,137,0,21,17,4,30,30,0,0,0,3
E33001835,1167,890,200,690,2,116,69,47,149,128,2,13,6,10
E33001836,382,310,108,202,2,26,16,10,40,31,1,8,0,4
E33001837,369,312,101,211,2,19,14,5,33,29,1,3,0,3
E33001838,1280,1026,272,754,6,82,50,32,159,140,3,14,2,7
E33001839,559,346,89,257,1,142,64,78,68,65,2,1,0,2
E33001840,253,178,57,121,0,36,22,14,38,36,0,1,1,1
E33001841,266,151,44,107,1,43,27,16,67,61,1,5,0,4
E33001842,237,181,45,136,1,34,30,4,20,19,0,1,0,1
E33001843,452,343,124,219,2,32,21,11,70,65,0,3,2,5
E33001844,616,406,97,309,4,99,72,27,103,94,0,7,2,4
E33001845,265,180,55,125,0,27,17,10,56,54,0,2,0,2
E33001846,266,188,59,129,0,28,23,5,49,46,2,1,0,1
E33001847,249,194,61,133,0,29,22,7,24,21,0,3,0,2
E33001848,288,201,73,128,0,38,30,8,48,45,0,3,0,1
E33001849,285,225,73,152,0,12,11,1,44,38,0,5,1,4
E33001850,431,325,106,219,3,36,24,12,55,53,0,1,1,12
E33001851,342,277,75,202,0,23,17,6,38,29,0,8,1,4
E33001852,352,291,106,185,0,26,23,3,34,31,0,1,2,1
E33001853,318,258,77,181,1,15,10,5,44,42,0,1,1,0
E33001854,511,377,104,273,1,60,49,11,70,57,0,11,2,3
E33001855,559,427,121,306,2,71,64,7,54,49,0,4,1,5
E33001856,426,323,96,227,1,57,55,2,40,34,0,6,0,5
E33001857,296,203,57,146,1,63,51,12,27,25,0,2,0,2
E33001858,283,208,63,145,0,39,30,9,36,33,1,2,0,0
E33001859,260,178,56,122,0,35,30,5,43,37,0,6,0,4
E33001860,384,315,110,205,0,41,29,12,25,22,1,2,0,3
E33001861,361,270,73,197,1,40,30,10,48,44,1,3,0,2
E33001862,569,440,133,307,0,56,39,17,62,60,0,1,1,11
E33001863,311,248,75,173,0,40,36,4,22,21,1,0,0,1
E33001864,258,200,65,135,0,31,24,7,25,21,0,4,0,2
E33001865,238,175,45,130,0,33,28,5,27,24,0,3,0,3
E33001866,517,406,143,263,0,45,39,6,60,47,0,10,3,6
E33001867,273,208,53,155,0,27,25,2,36,32,2,2,0,2
E33001868,464,346,80,266,1,41,28,13,71,63,5,3,0,5
E33001869,417,355,119,236,0,29,25,4,31,31,0,0,0,2
E33001870,298,240,63,177,0,28,25,3,27,25,0,2,0,3
E33001871,517,354,74,280,2,78,64,14,81,79,0,1,1,2
E33001872,264,197,49,148,0,33,27,6,32,30,0,2,0,2
E33001873,294,241,71,170,0,24,21,3,28,23,1,3,1,1
E33001874,412,321,102,219,0,52,42,10,36,34,0,2,0,3
E33001875,287,227,70,157,1,31,25,6,27,26,0,1,0,1
E33001876,349,272,61,211,1,48,37,11,26,21,1,4,0,2
E33001877,275,193,54,139,0,62,50,12,19,17,0,2,0,1
E33001878,377,245,66,179,1,89,81,8,40,36,2,1,1,2
E33001879,322,241,69,172,1,39,30,9,38,36,0,2,0,3
E33001880,323,269,68,201,0,25,19,6,28,25,0,2,1,1
E33001881,435,347,97,250,2,44,30,14,39,34,3,2,0,3
E33001882,336,290,81,209,0,26,18,8,17,14,0,3,0,3
E33001883,509,378,94,284,1,58,36,22,70,65,1,3,1,2
E33001884,275,223,55,168,0,18,13,5,32,26,0,5,1,2
E33001885,440,369,107,262,1,21,15,6,42,38,0,4,0,7
E33001886,309,235,54,181,1,35,27,8,36,31,0,1,4,2
E33001887,667,442,109,333,0,130,92,38,95,82,9,3,1,0
E33001888,263,201,46,155,1,28,23,5,33,33,0,0,0,0
E33001889,800,589,176,413,1,125,108,17,83,76,0,7,0,2
E33001890,650,492,162,330,3,84,61,23,59,50,1,7,1,12
E33001891,274,200,65,135,0,35,20,15,35,28,0,7,0,4
E33001892,298,216,65,151,1,52,35,17,29,26,0,3,0,0
E33001893,298,218,59,159,1,45,21,24,32,30,0,2,0,2
E33001894,335,251,80,171,1,38,29,9,44,39,1,4,0,1
E33001895,285,233,63,170,1,26,19,7,22,22,0,0,0,3
E33001896,246,205,42,163,1,21,19,2,19,18,0,1,0,0
E33001897,717,591,143,448,3,63,51,12,57,51,2,3,1,3
E33001898,600,496,105,391,1,44,36,8,56,46,0,10,0,3
E33001899,366,309,77,232,1,27,23,4,29,27,0,1,1,0
E33001900,324,293,60,233,0,13,8,5,16,11,0,5,0,2
E33001901,280,231,68,163,1,21,17,4,27,23,0,4,0,0
E33001902,448,359,89,270,0,45,37,8,40,35,0,5,0,4
E33001903,228,177,60,117,1,27,19,8,21,19,0,2,0,2
E33001904,387,295,114,181,1,46,29,17,42,37,0,1,4,3
E33001905,372,300,65,235,0,37,26,11,32,29,0,3,0,3
E33001906,332,254,57,197,0,52,42,10,20,19,1,0,0,6
E33001907,580,445,148,297,2,77,66,11,49,45,2,0,2,7
E33001908,288,222,69,153,0,41,35,6,24,21,0,3,0,1
E33001909,300,240,78,162,0,23,14,9,34,27,1,5,1,3
E33001910,344,278,96,182,6,32,24,8,21,17,2,2,0,7
E33001911,445,362,92,270,1,33,29,4,46,42,0,4,0,3
E33001912,306,227,91,136,0,32,26,6,39,33,4,1,1,8
E33001913,338,280,79,201,0,32,22,10,22,19,0,3,0,4
E33001914,329,284,93,191,0,21,14,7,22,17,1,4,0,2
E33001915,312,255,101,154,3,32,16,16,19,15,1,2,1,3
E33001916,292,226,66,160,1,22,17,5,41,36,0,5,0,2
E33001917,286,224,56,168,0,36,29,7,25,21,1,3,0,1
E33001918,444,343,83,260,0,50,34,16,50,45,2,3,0,1
E33001919,235,190,66,124,0,26,19,7,18,16,0,2,0,1
E33001920,1119,899,250,649,0,120,90,30,97,85,1,9,2,3
E33001921,240,190,46,144,0,32,12,20,16,13,1,2,0,2
E33001922,302,223,51,172,0,32,20,12,44,43,0,1,0,3
E33001923,582,432,125,307,2,102,62,40,45,38,0,7,0,1
E33001924,376,312,96,216,2,39,25,14,21,19,0,2,0,2
E33001925,499,378,117,261,1,57,42,15,57,49,0,6,2,6
E33001926,695,543,154,389,1,73,54,19,73,70,1,1,1,5
E33001927,313,240,70,170,0,37,34,3,32,28,0,2,2,4
E33001928,304,242,60,182,0,31,18,13,29,27,0,2,0,2
E33001929,365,277,77,200,2,27,19,8,53,45,1,3,4,6
E33001930,309,230,73,157,1,34,24,10,38,37,0,1,0,6
E33001931,346,250,79,171,1,47,25,22,39,36,1,2,0,9
E33001932,332,273,86,187,0,26,17,9,29,24,0,5,0,4
E33001933,625,479,138,341,0,60,34,26,83,79,0,4,0,3
E33001934,399,303,84,219,0,42,33,9,50,47,3,0,0,4
E33001935,476,364,112,252,3,49,24,25,56,51,2,3,0,4
E33001936,288,236,59,177,1,25,17,8,26,23,1,2,0,0
E33001937,237,197,56,141,1,19,15,4,18,15,1,2,0,2
E33001938,327,251,58,193,1,17,11,6,56,51,0,5,0,2
E33001939,604,503,178,325,1,41,29,12,55,44,4,7,0,4
E33001940,360,273,95,178,2,31,25,6,51,45,2,4,0,3
E33001941,343,281,90,191,0,25,19,6,34,29,0,2,3,3
E33001942,417,320,98,222,0,43,30,13,49,42,1,6,0,5
E33001943,712,527,127,400,3,85,58,27,96,83,2,11,0,1
E33001944,542,414,108,306,1,56,34,22,69,61,0,7,1,2
E33001945,335,210,50,160,0,59,42,17,64,54,2,7,1,2
E33001946,271,180,46,134,0,57,43,14,31,24,0,4,3,3
E33001947,366,309,86,223,1,26,17,9,28,24,0,4,0,2
E33001948,258,198,68,130,0,26,18,8,30,28,1,1,0,4
E33001949,413,356,103,253,2,22,14,8,33,24,2,6,1,0
E33001950,407,344,97,247,1,25,15,10,34,32,0,0,2,3
E33001951,295,230,35,195,0,26,16,10,36,35,0,0,1,3
E33001952,421,252,59,193,0,105,78,27,62,61,0,1,0,2
E33001953,257,183,43,140,1,46,33,13,25,25,0,0,0,2
E33001954,266,204,50,154,0,38,27,11,24,24,0,0,0,0
E33001955,239,185,38,147,0,31,25,6,21,20,0,1,0,2
E33001956,232,170,43,127,0,44,32,12,16,16,0,0,0,2
E33001957,339,263,63,200,0,48,35,13,26,21,0,5,0,2
E33001958,581,432,103,329,0,71,44,27,77,72,3,2,0,1
E33001959,250,208,64,144,1,24,19,5,17,13,1,3,0,0
E33001960,430,323,101,222,2,44,29,15,58,49,0,7,2,3
E33001961,228,162,69,93,1,12,8,4,48,48,0,0,0,5
E33001962,312,202,84,118,3,28,12,16,68,61,2,2,3,11
E33001963,256,190,85,105,0,17,9,8,46,37,3,3,3,3
E33001964,254,142,54,88,2,18,4,14,70,66,0,2,2,22
E33001965,362,269,116,153,1,34,11,23,54,51,2,1,0,4
E33001966,378,268,111,157,2,51,27,24,51,44,2,4,1,6
E33001967,351,286,130,156,0,17,3,14,40,37,0,3,0,8
E33001968,397,317,127,190,1,30,15,15,41,39,0,2,0,8
E33001969,424,342,112,230,1,30,22,8,45,36,2,6,1,6
E33001970,354,267,121,146,1,15,7,8,66,55,0,7,4,5
E33001971,244,194,104,90,1,11,6,5,37,29,3,1,4,1
E33001972,375,255,118,137,0,20,5,15,87,79,1,6,1,13
E33001973,280,178,100,78,1,12,8,4,81,75,0,4,2,8
E33001974,294,188,88,100,2,6,3,3,79,70,5,3,1,19
E33001975,256,203,120,83,2,9,1,8,31,24,5,2,0,11
E33001976,333,158,84,74,2,15,2,13,142,129,1,10,2,16
E33001977,324,245,136,109,5,12,4,8,46,37,2,6,1,16
E33001978,599,475,139,336,5,43,10,33,65,60,0,5,0,11
E33001979,363,250,97,153,0,27,6,21,73,65,0,7,1,13
E33001980,592,448,157,291,1,51,11,40,80,73,0,6,1,12
E33001981,263,187,68,119,0,23,5,18,49,41,0,7,1,4
E33001982,366,277,123,154,1,24,4,20,60,56,1,3,0,4
E33001983,448,284,116,168,0,46,9,37,109,97,2,8,2,9
E33001984,527,425,168,257,2,37,22,15,47,38,2,6,1,16
E33001985,359,289,118,171,1,15,10,5,43,36,1,4,2,11
E33001986,563,453,135,318,0,53,36,17,50,43,0,6,1,7
E33001987,286,228,113,115,2,17,11,6,29,26,2,0,1,10
E33001988,301,242,77,165,1,17,9,8,36,33,1,2,0,5
E33001989,250,174,81,93,0,29,13,16,37,29,2,6,0,10
E33001990,306,239,108,131,1,24,14,10,36,30,0,5,1,6
E33001991,369,305,137,168,1,9,8,1,42,33,4,5,0,12
E33001992,565,450,135,315,0,55,36,19,51,47,0,4,0,9
E33001993,378,306,82,224,1,36,26,10,31,29,0,2,0,4
E33001994,249,202,82,120,1,26,19,7,17,13,1,3,0,3
E33001995,365,270,104,166,0,60,10,50,35,33,0,2,0,0
E33001996,348,280,66,214,1,31,22,9,34,29,0,5,0,2
E33001997,268,223,74,149,1,13,9,4,30,25,2,3,0,1
E33001998,523,438,132,306,2,34,23,11,47,42,0,5,0,2
E33001999,307,241,93,148,1,30,24,6,32,26,6,0,0,3
E33002000,347,287,95,192,0,22,18,4,35,29,1,5,0,3
E33002001,520,410,122,288,0,42,29,13,61,55,0,4,2,7
E33002002,405,299,79,220,0,59,43,16,45,42,0,3,0,2
E33002003,379,293,105,188,0,35,22,13,46,42,0,4,0,5
E33002004,470,347,94,253,0,66,49,17,56,53,1,1,1,1
E33002005,699,533,152,381,0,73,48,25,89,77,1,9,2,4
E33002006,368,273,82,191,2,25,11,14,66,60,1,5,0,2
E33002007,697,552,155,397,1,71,52,19,69,64,1,4,0,4
E33002008,240,173,49,124,0,20,13,7,47,42,0,4,1,0
E33002009,565,391,111,280,0,89,76,13,82,79,1,1,1,3
E33002010,309,237,45,192,0,33,23,10,37,29,1,7,0,2
E33002011,1207,982,272,710,1,91,53,38,128,114,1,12,1,5
E33002012,413,376,84,292,0,13,10,3,23,21,0,2,0,1
E33002013,315,266,79,187,1,18,12,6,29,22,0,7,0,1
E33002014,577,442,149,293,0,50,37,13,80,74,0,6,0,5
E33002015,432,335,105,230,0,35,29,6,56,49,0,7,0,6
E33002016,605,447,127,320,2,47,36,11,108,104,0,3,1,1
E33002017,442,350,102,248,2,40,29,11,45,32,1,12,0,5
E33002018,383,327,111,216,1,14,12,2,39,34,1,4,0,2
E33002019,398,327,98,229,0,29,24,5,40,35,0,5,0,2
E33002020,340,273,74,199,2,32,20,12,31,30,0,1,0,2
E33002021,335,253,65,188,0,42,32,10,37,34,0,3,0,3
E33002022,642,510,136,374,0,67,45,22,60,52,0,6,2,5
E33002023,369,310,93,217,3,29,22,7,22,22,0,0,0,5
E33002024,419,338,91,247,0,32,21,11,47,43,2,2,0,2
E33002025,293,179,73,106,0,34,20,14,65,52,10,2,1,15
E33002026,362,257,73,184,1,51,35,16,49,47,0,2,0,4
E33002027,1100,643,147,496,5,80,35,45,350,154,108,9,79,22
E33002028,393,261,90,171,1,47,26,21,76,66,2,6,2,8
E33002029,267,159,71,88,2,37,29,8,61,49,2,5,5,8
E33002030,521,344,117,227,2,80,47,33,86,73,5,3,5,9
E33002031,332,218,68,150,1,57,39,18,52,42,1,3,6,4
E33002032,322,193,53,140,0,59,45,14,56,44,1,5,6,14
E33002033,312,223,62,161,1,40,29,11,38,33,2,1,2,10
E33002034,276,187,64,123,2,35,25,10,49,40,2,7,0,3
E33002035,402,319,125,194,3,33,28,5,42,40,1,1,0,5
E33002036,424,315,111,204,4,38,27,11,50,40,2,4,4,17
E33002037,240,184,67,117,1,29,20,9,22,19,1,2,0,4
E33002038,460,303,106,197,3,89,64,25,59,51,1,7,0,6
E33002039,252,196,55,141,0,21,15,6,29,28,1,0,0,6
E33002040,256,181,58,123,0,41,33,8,33,31,0,2,0,1
E33002041,229,143,51,92,1,26,18,8,51,40,5,3,3,8
E33002042,283,230,65,165,0,22,19,3,28,26,0,2,0,3
E33002043,468,329,90,239,0,57,41,16,78,62,3,11,2,4
E33002044,301,228,90,138,2,24,18,6,45,38,4,3,0,2
E33002045,229,139,55,84,0,14,5,9,58,52,3,2,1,18
E33002046,379,259,91,168,0,31,13,18,74,64,3,5,2,15
E33002047,263,134,64,70,2,20,14,6,77,48,16,3,10,30
E33002048,258,148,55,93,0,30,13,17,61,50,5,1,5,19
E33002049,363,199,96,103,0,24,13,11,91,79,6,3,3,49
E33002050,246,147,80,67,1,19,6,13,68,51,7,2,8,11
E33002051,407,259,117,142,1,48,40,8,92,72,9,9,2,7
E33002052,433,268,93,175,0,88,27,61,69,65,2,2,0,8
E33002053,751,483,151,332,2,152,49,103,102,92,4,6,0,12
E33002054,416,293,116,177,1,53,14,39,61,52,2,7,0,8
E33002055,356,229,81,148,0,66,14,52,53,48,0,5,0,8
E33002056,264,188,55,133,0,41,13,28,30,28,1,1,0,5
E33002057,399,293,88,205,2,49,19,30,49,43,3,3,0,6
E33002058,545,343,125,218,1,107,34,73,88,81,3,2,2,6
E33002059,246,164,54,110,1,37,10,27,38,31,1,6,0,6
E33002060,513,282,135,147,0,80,29,51,120,112,4,3,1,31
E33002061,317,239,107,132,0,35,14,21,35,27,5,3,0,8
E33002062,278,152,67,85,1,33,7,26,73,61,7,2,3,19
E33002063,340,219,90,129,1,45,7,38,64,57,3,3,1,11
E33002064,283,175,66,109,0,47,6,41,54,49,0,2,3,7
E33002065,410,277,97,180,1,58,11,47,71,68,1,2,0,3
E33002066,369,241,93,148,1,40,11,29,75,62,6,7,0,12
E33002067,600,377,161,216,3,69,27,42,126,109,9,6,2,25
E33002068,330,201,91,110,1,26,11,15,85,81,2,2,0,17
E33002069,266,96,52,44,1,23,9,14,111,106,4,1,0,35
E33002070,232,95,64,31,1,6,2,4,78,71,6,0,1,52
E33002071,453,284,111,173,1,69,26,43,87,69,5,9,4,12
E33002072,330,185,92,93,0,27,6,21,83,70,6,3,4,35
E33002073,419,241,86,155,0,31,18,13,98,79,8,8,3,49
E33002074,359,221,78,143,0,43,8,35,77,62,7,7,1,18
E33002075,344,192,85,107,0,59,21,38,78,70,2,4,2,15
E33002076,316,159,75,84,1,34,19,15,90,73,13,1,3,32
E33002077,300,220,53,167,0,54,46,8,23,21,0,2,0,3
E33002078,346,204,58,146,0,99,85,14,42,36,0,5,1,1
E33002079,294,164,50,114,1,83,62,21,39,31,1,6,1,7
E33002080,417,303,86,217,0,51,37,14,60,53,0,6,1,3
E33002081,535,388,110,278,2,82,67,15,56,55,0,0,1,7
E33002082,383,308,85,223,1,24,16,8,47,40,1,6,0,3
E33002083,411,261,76,185,0,82,59,23,63,50,1,12,0,5
E33002084,428,335,93,242,1,49,39,10,41,36,0,4,1,2
E33002085,324,245,66,179,0,28,19,9,47,44,2,1,0,4
E33002086,245,166,50,116,0,40,30,10,35,29,1,5,0,4
E33002087,335,231,56,175,1,69,60,9,33,28,1,4,0,1
E33002088,317,213,42,171,2,54,38,16,44,37,0,4,3,4
E33002089,265,174,42,132,0,51,42,9,36,29,0,7,0,4
E33002090,463,294,69,225,0,105,97,8,59,53,2,4,0,5
E33002091,494,396,103,293,0,38,32,6,54,45,2,5,2,6
E33002092,364,331,93,238,0,3,3,0,28,25,0,0,3,2
E33002093,312,266,65,201,0,11,10,1,35,31,0,3,1,0
E33002094,303,283,54,229,0,11,9,2,9,7,0,2,0,0
E33002095,361,319,86,233,1,15,11,4,25,21,0,4,0,1
E33002096,306,201,61,140,3,68,43,25,34,30,0,4,0,0
E33002097,512,384,97,287,3,70,37,33,51,46,2,3,0,4
E33002098,563,410,102,308,0,91,63,28,58,51,2,4,1,4
E33002099,1046,808,148,660,2,127,87,40,105,94,0,11,0,4
E33002100,307,206,51,155,1,55,44,11,37,31,1,4,1,8
E33002101,262,195,61,134,0,40,33,7,25,22,0,3,0,2
E33002102,412,299,67,232,2,62,59,3,46,43,0,2,1,3
E33002103,324,282,72,210,0,13,7,6,27,22,0,5,0,2
E33002104,540,373,91,282,0,104,86,18,60,48,1,9,2,3
E33002105,455,364,92,272,0,53,39,14,33,27,0,4,2,5
E33002106,320,235,68,167,0,55,47,8,26,20,0,3,3,4
E33002107,718,560,196,364,2,66,59,7,77,66,0,5,6,13
E33002108,321,264,75,189,0,22,18,4,31,29,0,2,0,4
E33002109,1032,843,224,619,3,64,49,15,114,99,2,13,0,8
E33002110,831,656,164,492,1,88,62,26,82,73,0,9,0,4
E33002111,253,197,63,134,1,32,29,3,21,18,0,2,1,2
E33002112,322,254,62,192,0,44,34,10,22,16,1,3,2,2
E33002113,386,284,79,205,0,78,60,18,21,18,0,3,0,3
E33002114,325,235,83,152,0,54,34,20,32,29,0,3,0,4
E33002115,277,208,70,138,0,26,19,7,39,35,2,0,2,4
E33002116,259,172,56,116,1,52,32,20,33,29,2,2,0,1
E33002117,309,225,62,163,1,46,32,14,33,31,1,1,0,4
E33002118,387,306,95,211,0,38,22,16,42,35,0,2,5,1
E33002119,416,299,64,235,2,44,16,28,65,58,1,6,0,6
E33002120,374,312,91,221,0,18,10,8,38,33,0,4,1,6
E33002121,329,242,84,158,1,41,22,19,41,38,0,3,0,4
E33002122,689,541,126,415,2,66,40,26,74,66,1,7,0,6
E33002123,333,233,89,144,2,26,18,8,63,62,0,1,0,9
E33002124,635,408,111,297,1,73,51,22,134,117,6,7,4,19
E33002125,649,529,133,396,1,42,23,19,71,67,0,4,0,6
E33002126,328,188,80,108,0,22,17,5,98,94,0,3,1,20
E33002127,253,190,74,116,0,10,8,2,36,34,1,1,0,17
E33002128,1159,871,238,633,3,114,63,51,149,132,1,9,7,22
E33002129,307,236,73,163,1,15,4,11,44,43,0,1,0,11
E33002130,331,201,84,117,1,40,13,27,78,69,2,2,5,11
E33002131,515,432,122,310,2,16,12,4,62,57,1,4,0,3
E33002132,496,369,99,270,1,67,39,28,54,51,1,2,0,5
E33002133,383,285,79,206,0,40,21,19,51,44,1,5,1,7
E33002134,1074,834,220,614,0,142,85,57,90,85,1,4,0,8
E33002135,292,196,51,145,2,51,26,25,39,35,2,0,2,4
E33002136,238,167,55,112,0,19,14,5,47,38,4,4,1,5
E33002137,279,242,75,167,0,15,8,7,15,15,0,0,0,7
E33002138,464,380,122,258,1,45,29,16,33,32,0,0,1,5
E33002139,612,508,155,353,1,35,14,21,60,54,0,6,0,8
E33002140,298,252,86,166,0,14,11,3,28,26,1,1,0,4
E33002141,597,491,160,331,1,37,26,11,61,50,1,8,2,7
E33002142,544,418,107,311,1,70,44,26,50,42,1,6,1,5
E33002143,334,254,93,161,1,37,30,7,41,38,1,2,0,1
E33002144,353,265,80,185,2,33,18,15,47,45,1,1,0,6
E33002145,439,361,127,234,2,8,6,2,57,45,3,8,1,11
E33002146,314,262,103,159,2,9,5,4,37,30,6,1,0,4
E33002147,256,200,63,137,0,19,11,8,30,27,1,0,2,7
E33002148,361,226,80,146,1,28,12,16,102,98,3,1,0,4
E33002149,709,355,90,265,1,106,69,37,231,127,60,6,38,16
E33002150,302,189,75,114,4,23,11,12,75,66,2,6,1,11
E33002151,439,277,135,142,1,37,11,26,104,91,5,8,0,20
E33002152,243,157,60,97,1,22,9,13,52,34,6,0,12,11
E33002153,321,195,80,115,3,23,7,16,93,81,7,5,0,7
E33002154,284,157,72,85,4,31,9,22,80,61,13,1,5,12
E33002155,344,236,91,145,6,53,27,26,40,36,0,4,0,9
E33002156,288,161,67,94,3,13,4,9,100,92,6,2,0,11
E33002157,409,259,99,160,2,60,22,38,76,55,6,9,6,12
E33002158,222,123,76,47,0,20,8,12,71,60,8,3,0,8
E33002159,379,268,129,139,5,25,7,18,69,60,0,4,5,12
E33002160,330,230,90,140,0,30,14,16,68,61,2,3,2,2
E33002161,237,172,101,71,0,15,7,8,42,36,3,1,2,8
E33002162,459,362,160,202,1,41,21,20,46,45,1,0,0,9
E33002163,293,211,91,120,0,43,19,24,34,31,2,1,0,5
E33002164,253,199,70,129,2,14,10,4,33,30,1,2,0,5
E33002165,744,503,178,325,1,92,63,29,111,104,0,7,0,37
E33002166,401,279,94,185,5,33,12,21,74,65,3,3,3,10
E33002167,444,359,109,250,2,28,12,16,50,45,0,5,0,5
E33002168,357,270,96,174,0,48,18,30,37,30,2,3,2,2
E33002169,415,282,92,190,2,46,27,19,75,70,2,3,0,10
E33002170,295,219,80,139,2,30,12,18,41,35,4,2,0,3
E33002171,262,153,38,115,2,66,36,30,34,34,0,0,0,7
E33002172,227,176,69,107,0,11,6,5,36,33,0,2,1,4
E33002173,239,190,79,111,1,12,5,7,31,22,2,4,3,5
E33002174,257,211,67,144,1,13,4,9,28,27,0,1,0,4
E33002175,517,392,145,247,1,39,16,23,78,69,1,4,4,7
E33002176,238,186,56,130,2,22,13,9,21,14,5,2,0,7
E33002177,360,239,58,181,2,70,45,25,46,39,1,5,1,3
E33002178,573,407,121,286,7,96,66,30,58,48,2,7,1,5
E33002179,498,405,110,295,1,48,32,16,42,37,1,4,0,2
E33002180,377,286,68,218,1,45,29,16,38,35,0,3,0,7
E33002181,234,195,46,149,0,16,11,5,19,16,0,3,0,4
E33002182,268,209,44,165,0,32,18,14,26,21,2,3,0,1
E33002183,378,301,78,223,0,44,21,23,29,26,0,3,0,4
E33002184,396,319,116,203,0,28,20,8,43,42,1,0,0,6
E33002185,452,302,125,177,2,42,18,24,97,78,5,14,0,9
E33002186,337,223,64,159,1,28,13,15,72,63,4,3,2,13
E33002187,310,230,100,130,4,15,10,5,51,49,2,0,0,10
E33002188,231,194,76,118,0,5,3,2,26,23,1,1,1,6
E33002189,348,251,88,163,1,22,12,10,64,53,5,2,4,10
E33002190,282,197,64,133,1,46,19,27,30,27,0,3,0,8
E33002191,513,383,144,239,1,35,19,16,83,76,1,4,2,11
E33002192,201,105,35,70,1,22,7,15,68,63,4,0,1,5
E33002193,450,317,105,212,4,36,21,15,85,77,3,4,1,8
E33002194,306,190,87,103,1,20,4,16,77,65,3,9,0,18
E33002195,258,179,94,85,2,19,8,11,49,42,0,5,2,9
E33002196,371,234,107,127,4,49,14,35,73,57,5,10,1,11
E33002197,253,186,98,88,0,10,4,6,47,45,1,1,0,10
E33002198,483,305,122,183,3,44,23,21,112,97,4,4,7,19
E33002199,307,220,69,151,2,39,16,23,41,38,0,2,1,5
E33002200,444,334,156,178,2,28,10,18,67,55,4,6,2,13
E33002201,633,460,170,290,0,90,40,50,80,75,1,1,3,3
E33002202,952,746,173,573,1,92,57,35,106,98,1,6,1,7
E33002203,235,154,43,111,0,36,16,20,41,37,0,3,1,4
E33002204,254,151,33,118,0,46,17,29,54,52,1,1,0,3
E33002205,245,179,62,117,0,26,8,18,37,33,0,3,1,3
E33002206,645,548,138,410,5,44,27,17,44,34,1,7,2,4
E33002207,716,531,151,380,0,88,59,29,88,80,2,4,2,9
E33002208,248,182,64,118,0,42,19,23,19,17,1,1,0,5
E33002209,299,177,48,129,1,67,30,37,51,46,2,3,0,3
E33002210,1957,1542,325,1217,4,156,87,69,244,216,7,19,2,11
E33002211,233,160,50,110,0,35,17,18,37,32,0,3,2,1
E33002212,340,281,78,203,3,31,15,16,20,18,1,1,0,5
E33002213,643,493,142,351,3,63,36,27,75,66,0,9,0,9
E33002214,439,343,106,237,0,49,25,24,45,39,2,4,0,2
E33002215,376,293,66,227,1,36,21,15,42,34,0,8,0,4
E33002216,666,516,123,393,1,60,39,21,85,79,1,4,1,4
E33002217,326,271,77,194,2,25,11,14,26,25,0,1,0,2
E33002218,277,211,52,159,0,38,20,18,26,22,0,2,2,2
E33002219,280,201,47,154,0,48,31,17,30,28,0,2,0,1
E33002220,316,231,61,170,0,45,27,18,39,39,0,0,0,1
E33002221,338,256,61,195,0,45,31,14,34,32,0,2,0,3
E33002222,329,241,58,183,0,47,20,27,41,34,1,5,1,0
E33002223,270,212,52,160,0,29,21,8,25,20,1,4,0,4
E33002224,269,201,48,153,0,40,28,12,28,25,0,3,0,0
E33002225,240,161,30,131,0,34,22,12,44,40,0,4,0,1
E33002226,243,177,55,122,0,43,28,15,22,19,0,1,2,1
E33002227,396,311,78,233,1,47,35,12,35,30,1,4,0,2
E33002228,408,322,88,234,0,50,26,24,33,28,0,5,0,3
E33002229,304,220,58,162,1,35,24,11,45,37,1,6,1,3
E33002230,242,183,64,119,0,23,13,10,34,29,0,3,2,2
E33002231,475,367,88,279,0,53,30,23,53,48,0,5,0,2
E33002232,439,345,89,256,1,48,36,12,38,34,0,4,0,7
E33002233,725,604,153,451,1,56,30,26,62,52,2,7,1,2
E33002234,492,391,86,305,1,55,30,25,43,38,3,1,1,2
E33002235,302,211,54,157,2,43,32,11,42,33,0,9,0,4
E33002236,386,291,74,217,3,39,23,16,49,47,0,2,0,4
E33002237,454,391,94,297,1,24,6,18,34,31,0,3,0,4
E33002238,336,304,93,211,0,6,2,4,22,21,0,1,0,4
E33002239,283,220,76,144,1,24,10,14,33,29,1,3,0,5
E33002240,326,260,75,185,0,28,15,13,28,22,0,2,4,10
E33002241,380,273,75,198,2,64,41,23,38,36,0,2,0,3
E33002242,479,408,113,295,2,24,10,14,44,38,1,4,1,1
E33002243,347,195,49,146,1,88,67,21,59,53,0,4,2,4
E33002244,316,177,32,145,1,55,43,12,81,75,0,6,0,2
E33002245,456,336,86,250,1,58,45,13,56,53,0,3,0,5
E33002246,368,256,47,209,1,48,31,17,61,54,1,5,1,2
E33002247,402,249,46,203,1,47,41,6,100,93,1,5,1,5
E33002248,241,165,40,125,0,31,14,17,45,41,0,4,0,0
E33002249,238,152,36,116,0,47,34,13,33,32,0,1,0,6
E33002250,329,265,71,194,1,30,24,6,33,29,1,3,0,0
E33002251,630,415,83,332,4,94,67,27,110,99,0,10,1,7
E33002252,316,225,73,152,0,58,47,11,29,28,0,1,0,4
E33002253,541,369,104,265,0,98,73,25,73,69,1,3,0,1
E33002254,405,360,103,257,3,18,17,1,21,17,0,3,1,3
E33002255,221,146,27,119,1,46,42,4,27,20,1,5,1,1
E33002256,333,290,95,195,1,21,16,5,19,15,0,3,1,2
E33002257,370,323,76,247,2,14,5,9,30,27,0,1,2,1
E33002258,334,262,93,169,0,28,15,13,36,32,1,3,0,8
E33002259,435,346,91,255,1,34,15,19,51,41,0,8,2,3
E33002260,354,308,89,219,1,17,8,9,25,21,2,2,0,3
E33002261,286,233,66,167,2,22,14,8,26,21,1,4,0,3
E33002262,317,252,86,166,1,25,9,16,32,27,1,2,2,7
E33002263,425,285,84,201,2,71,44,27,60,53,0,7,0,7
E33002264,404,330,95,235,1,38,19,19,30,23,0,7,0,5
E33002265,315,255,57,198,0,24,14,10,36,30,1,5,0,0
E33002266,453,393,123,270,3,28,15,13,27,26,0,1,0,2
E33002267,238,187,35,152,1,25,15,10,25,21,0,4,0,0
E33002268,2179,1651,344,1307,12,163,110,53,340,303,4,33,0,13
E33002269,1036,832,214,618,6,65,44,21,131,128,0,3,0,2
E33002270,267,195,63,132,4,30,21,9,38,35,0,3,0,0
E33002271,490,377,87,290,1,36,27,9,73,67,0,4,2,3
E33002272,1933,1201,339,862,9,295,229,66,413,385,3,22,3,15
E33002273,336,260,59,201,1,39,27,12,36,31,0,5,0,0
E33002274,273,201,57,144,2,33,17,16,35,31,0,4,0,2
E33002275,470,335,120,215,3,70,51,19,61,55,0,4,2,1
E33002276,691,437,141,296,4,129,97,32,109,95,0,14,0,12
E33002277,1871,1254,322,932,13,277,199,78,321,289,1,30,1,6
E33002278,204,137,41,96,3,19,13,6,43,43,0,0,0,2
E33002279,356,229,78,151,3,57,38,19,59,54,0,4,1,8
E33002280,571,493,125,368,2,21,14,7,50,44,0,6,0,5
E33002281,268,154,37,117,2,38,28,10,74,69,0,3,2,0
E33002282,212,182,48,134,0,10,8,2,15,14,0,0,1,5
E33002283,303,209,54,155,3,39,29,10,48,47,0,1,0,4
E33002284,212,143,25,118,1,25,17,8,43,43,0,0,0,0
E33002285,231,164,38,126,1,18,4,14,47,44,0,3,0,1
E33002286,446,308,91,217,2,66,35,31,67,66,0,1,0,3
E33002287,315,234,70,164,0,24,16,8,55,45,0,8,2,2
E33002288,537,412,122,290,2,42,28,14,78,69,0,7,2,3
E33002289,551,408,101,307,3,49,34,15,88,81,0,7,0,3
E33002290,389,316,105,211,5,31,24,7,36,34,0,2,0,1
E33002291,265,185,46,139,0,31,20,11,49,44,0,4,1,0
E33002292,706,525,135,390,2,88,62,26,85,74,0,10,1,6
E33002293,353,281,57,224,1,15,7,8,54,49,1,4,0,2
E33002294,434,343,102,241,3,46,36,10,40,36,0,3,1,2
E33002295,236,181,67,114,1,31,24,7,23,23,0,0,0,0
E33002296,332,254,63,191,4,39,29,10,33,30,0,3,0,2
E33002297,298,240,88,152,1,20,13,7,34,29,1,4,0,3
E33002298,249,194,78,116,1,34,25,9,19,18,0,1,0,1
E33002299,859,683,165,518,1,82,56,26,88,83,0,5,0,5
E33002300,375,297,95,202,0,41,28,13,37,31,0,6,0,0
E33002301,657,482,149,333,1,77,57,20,96,90,0,5,1,1
E33002302,311,221,73,148,0,42,27,15,44,40,0,4,0,4
E33002303,229,137,43,94,1,36,26,10,55,49,0,6,0,0
E33002304,281,193,48,145,2,32,20,12,53,47,0,6,0,1
E33002305,673,528,138,390,5,60,38,22,73,58,0,11,4,7
E33002306,217,159,44,115,0,34,30,4,22,21,0,1,0,2
E33002307,232,149,50,99,3,32,23,9,46,46,0,0,0,2
E33002308,1008,776,248,528,5,73,45,28,142,137,1,2,2,12
E33002309,955,741,221,520,1,81,51,30,125,114,0,9,2,7
E33002310,448,280,100,180,2,87,60,27,76,65,1,6,4,3
E33002311,323,280,78,202,2,21,13,8,19,16,0,3,0,1
E33002312,264,194,59,135,1,31,23,8,38,25,3,7,3,0
E33002313,491,354,102,252,3,74,59,15,60,57,1,2,0,0
E33002314,238,191,46,145,2,22,19,3,18,17,0,1,0,5
E33002315,522,411,117,294,1,38,22,16,64,62,0,1,1,8
E33002316,636,512,171,341,7,60,48,12,55,46,4,5,0,2
E33002317,4981,4047,1072,2975,9,383,283,100,519,466,2,41,10,23
E33002318,211,167,49,118,1,15,9,6,26,20,1,1,4,2
E33002319,275,203,58,145,1,33,28,5,38,34,0,4,0,0
E33002320,297,211,54,157,0,39,22,17,46,43,1,2,0,1
E33002321,633,504,158,346,0,52,41,11,74,65,1,6,2,3
E33002322,214,174,40,134,0,9,3,6,30,30,0,0,0,1
E33002323,427,358,77,281,2,33,22,11,33,32,0,1,0,1
E33002324,214,163,53,110,0,20,19,1,30,25,1,4,0,1
E33002325,437,329,73,256,0,47,37,10,59,52,2,5,0,2
E33002326,331,253,87,166,2,30,15,15,46,40,0,5,1,0
E33002327,509,413,129,284,1,35,27,8,57,48,3,5,1,3
E33002328,216,154,51,103,0,30,14,16,30,29,0,1,0,2
E33002329,304,207,54,153,0,37,24,13,58,55,0,3,0,2
E33002330,253,198,49,149,1,18,11,7,32,27,0,5,0,4
E33002331,399,289,55,234,2,22,15,7,85,82,0,3,0,1
E33002332,2796,2043,428,1615,6,293,200,93,436,402,2,26,6,18
E33002333,252,201,56,145,1,27,21,6,22,20,0,2,0,1
E33002334,408,340,71,269,4,22,15,7,41,39,0,2,0,1
E33002335,345,245,57,188,0,34,27,7,65,59,0,5,1,1
E33002336,542,369,90,279,1,76,39,37,94,89,0,5,0,2
E33002337,573,452,108,344,1,62,41,21,55,52,0,2,1,3
E33002338,310,213,59,154,4,40,26,14,51,42,0,9,0,2
E33002339,625,470,137,333,2,60,43,17,90,76,1,7,6,3
E33002340,479,392,119,273,2,39,26,13,43,38,0,5,0,3
E33002341,359,294,91,203,2,31,19,12,30,28,0,2,0,2
E33002342,407,346,100,246,1,25,13,12,33,29,0,4,0,2
E33002343,572,477,149,328,2,33,17,16,54,52,0,2,0,6
E33002344,478,354,92,262,0,56,36,20,68,60,0,8,0,0
E33002345,204,146,38,108,1,23,18,5,34,29,2,3,0,0
E33002346,523,389,97,292,2,47,37,10,85,78,0,6,1,0
E33002347,340,239,75,164,2,55,40,15,43,38,0,4,1,1
E33002348,362,253,76,177,2,49,31,18,55,49,1,5,0,3
E33002349,288,219,71,148,0,31,20,11,37,34,0,2,1,1
E33002350,328,243,58,185,2,24,14,10,58,49,2,7,0,1
E33002351,383,308,75,233,2,27,13,14,45,41,0,2,2,1
E33002352,295,177,62,115,4,38,27,11,75,67,0,7,1,1
E33002353,389,295,75,220,3,28,21,7,59,57,0,2,0,4
E33002354,863,606,177,429,2,94,62,32,155,141,0,13,1,6
E33002355,305,263,68,195,3,18,9,9,21,19,1,1,0,0
E33002356,274,208,54,154,1,29,19,10,33,28,1,2,2,3
E33002357,265,194,40,154,1,19,10,9,48,46,0,2,0,3
E33002358,220,160,54,106,0,28,20,8,29,26,0,3,0,3
E33002359,298,221,65,156,0,21,14,7,54,49,0,4,1,2
E33002360,1239,1016,315,701,2,87,50,37,132,113,1,16,2,2
E33002361,497,392,98,294,2,36,18,18,64,62,0,2,0,3
E33002362,320,272,85,187,0,13,9,4,34,27,0,5,2,1
E33002363,276,224,61,163,0,19,11,8,32,28,0,3,1,1
E33002364,259,214,49,165,2,17,8,9,26,22,0,4,0,0
E33002365,233,180,50,130,0,25,13,12,28,24,0,3,1,0
E33002366,205,159,36,123,1,10,6,4,34,30,0,4,0,1
E33002367,276,224,67,157,1,13,7,6,36,31,0,5,0,2
E33002368,292,223,62,161,0,27,17,10,40,37,2,0,1,2
E33002369,426,349,117,232,3,29,14,15,41,35,1,5,0,4
E33002370,1931,1440,371,1069,10,198,107,91,274,253,1,17,3,9
E33002371,292,218,60,158,3,28,17,11,41,38,0,3,0,2
E33002372,554,380,106,274,3,55,32,23,107,94,4,7,2,9
E33002373,331,191,45,146,3,54,33,21,81,78,1,2,0,2
E33002374,1172,847,225,622,7,79,47,32,228,212,0,14,2,11
E33002375,573,462,111,351,2,50,23,27,54,52,0,1,1,5
E33002376,1049,736,158,578,6,105,55,50,198,185,0,13,0,4
E33002377,243,175,30,145,0,26,10,16,41,40,0,1,0,1
E33002378,187,144,48,96,0,17,12,5,26,26,0,0,0,0
E33002379,726,535,144,391,2,73,45,28,111,102,0,9,0,5
E33002380,1665,1112,294,818,7,239,105,134,299,283,1,13,2,8
E33002381,925,567,144,423,4,184,80,104,165,156,1,6,2,5
E33002382,228,159,54,105,1,27,14,13,39,35,0,4,0,2
E33002383,192,131,26,105,1,17,7,10,43,37,0,5,1,0
E33002384,343,213,43,170,0,27,8,19,101,96,0,4,1,2
E33002385,435,303,76,227,3,38,13,25,90,83,0,5,2,1
E33002386,312,197,48,149,1,54,25,29,57,53,0,4,0,3
E33002387,363,253,61,192,5,43,19,24,61,58,0,2,1,1
E33002388,355,194,53,141,6,43,13,30,111,100,1,9,1,1
E33002389,155,86,25,61,1,25,6,19,42,38,0,1,3,1
E33002390,286,162,55,107,2,59,28,31,60,55,1,3,1,3
E33002391,274,203,55,148,1,27,11,16,43,40,0,3,0,0
E33002392,595,454,87,367,7,56,28,28,77,73,0,4,0,1
E33002393,615,404,111,293,4,103,43,60,101,96,0,5,0,3
E33002394,221,154,45,109,0,22,7,15,42,37,0,3,2,3
E33002395,429,283,61,222,3,77,30,47,65,59,2,1,3,1
E33002396,359,254,79,175,3,41,18,23,59,53,0,6,0,2
E33002397,398,264,61,203,4,69,26,43,60,56,0,4,0,1
E33002398,5786,4160,1013,3147,42,706,285,421,858,784,24,36,14,20
E33002399,503,354,92,262,3,74,30,44,68,59,1,7,1,4
E33002400,934,698,153,545,3,52,18,34,174,166,1,7,0,7
E33002401,421,321,52,269,5,25,7,18,68,61,1,5,1,2
E33002402,1066,689,187,502,2,212,77,135,160,151,0,8,1,3
E33002403,343,244,50,194,1,39,11,28,54,51,0,3,0,5
E33002404,401,289,70,219,1,46,11,35,64,54,0,10,0,1
E33002405,756,495,121,374,3,91,44,47,163,150,1,9,3,4
E33002406,364,275,70,205,1,42,17,25,45,42,1,2,0,1
E33002407,515,295,71,224,3,93,44,49,119,113,0,5,1,5
E33002408,307,177,51,126,1,65,25,40,62,59,0,3,0,2
E33002409,521,334,57,277,4,91,38,53,91,86,0,5,0,1
E33002410,298,218,51,167,2,35,10,25,41,38,0,3,0,2
E33002411,852,619,156,463,7,118,49,69,106,96,0,10,0,2
E33002412,389,277,104,173,3,67,33,34,41,39,1,1,0,1
E33002413,208,109,34,75,1,45,15,30,51,49,0,1,1,2
E33002414,512,421,100,321,1,39,6,33,50,47,0,2,1,1
E33002415,467,287,89,198,2,88,37,51,90,82,2,6,0,0
E33002416,764,521,112,409,5,84,30,54,150,140,0,8,2,4
E33002417,477,323,90,233,3,53,22,31,96,95,0,0,1,2
E33002418,235,133,29,104,1,37,11,26,60,59,0,0,1,4
E33002419,251,142,31,111,0,39,12,27,69,65,0,3,1,1
E33002420,670,444,131,313,5,105,37,68,115,107,0,5,3,1
E33002421,276,143,44,99,0,33,13,20,94,89,0,5,0,6
E33002422,3371,2564,627,1937,24,302,172,130,460,424,4,26,6,21
E33002423,557,304,100,204,3,121,61,60,124,120,0,4,0,5
E33002424,639,399,96,303,6,52,13,39,174,165,1,7,1,8
E33002425,238,106,34,72,1,16,6,10,112,106,0,3,3,3
E33002426,209,140,35,105,2,10,3,7,55,53,0,1,1,2
E33002427,557,400,113,287,3,37,16,21,112,108,0,3,1,5
E33002428,344,260,75,185,1,35,7,28,47,46,0,1,0,1
E33002429,556,343,68,275,2,24,9,15,186,175,0,10,1,1
E33002430,306,240,55,185,0,17,9,8,45,42,0,2,1,4
E33002431,461,350,70,280,3,26,3,23,79,74,1,4,0,3
E33002432,644,418,85,333,7,33,10,23,185,179,1,5,0,1
E33002433,814,455,144,311,4,86,41,45,264,251,0,10,3,5
E33002434,446,322,79,243,1,30,14,16,90,86,0,4,0,3
E33002435,373,188,63,125,2,103,34,69,78,74,0,3,1,2
E33002436,672,437,110,327,9,132,76,56,90,85,1,4,0,4
E33002437,1196,929,246,683,5,86,39,47,170,163,0,3,4,6
E33002438,358,266,52,214,2,29,21,8,60,56,0,3,1,1
E33002439,413,312,71,241,0,56,26,30,44,39,0,4,1,1
E33002440,472,307,90,217,1,85,30,55,77,71,0,5,1,2
E33002441,289,170,52,118,0,42,10,32,71,64,0,7,0,6
E33002442,358,169,51,118,5,122,42,80,59,56,0,3,0,3
E33002443,306,196,36,160,1,36,15,21,73,73,0,0,0,0
E33002444,256,163,38,125,3,39,15,24,51,46,0,3,2,0
E33002445,242,168,50,118,2,33,18,15,37,35,0,2,0,2
E33002446,392,235,58,177,1,75,45,30,74,65,0,9,0,7
E33002447,346,243,54,189,2,50,28,22,51,46,0,3,2,0
E33002448,205,142,49,93,2,43,24,19,16,14,0,2,0,2
E33002449,293,193,59,134,0,60,37,23,38,38,0,0,0,2
E33002450,549,413,107,306,3,80,38,42,50,43,0,7,0,3
E33002451,176,134,27,107,0,25,8,17,16,14,0,2,0,1
E33002452,629,459,112,347,3,73,45,28,93,81,4,8,0,1
E33002453,356,228,55,173,2,43,18,25,69,61,2,4,2,14
E33002454,420,216,59,157,0,70,29,41,131,123,0,7,1,3
E33002455,643,453,101,352,7,103,43,60,79,72,0,7,0,1
E33002456,291,202,45,157,1,44,16,28,40,34,0,4,2,4
E33002457,554,447,122,325,0,38,13,25,64,60,0,4,0,5
E33002458,2653,1847,456,1391,12,244,108,136,531,506,0,21,4,19
E33002459,227,125,45,80,1,28,11,17,69,64,2,2,1,4
E33002460,233,144,40,104,1,26,10,16,60,58,0,2,0,2
E33002461,380,274,89,185,0,22,11,11,79,74,1,3,1,5
E33002462,983,722,132,590,6,74,27,47,179,169,0,9,1,2
E33002463,574,456,111,345,5,27,10,17,85,83,0,1,1,1
E33002464,950,712,162,550,5,48,15,33,182,173,1,8,0,3
E33002465,296,245,60,185,3,20,8,12,26,25,0,1,0,2
E33002466,2905,2340,470,1870,30,78,35,43,445,419,0,26,0,12
E33002467,6433,4752,1178,3574,38,777,338,439,835,778,5,48,4,31
E33002468,375,178,46,132,3,62,30,32,131,126,1,4,0,1
E33002469,1366,955,228,727,12,148,74,74,247,228,2,14,3,4
E33002470,452,270,57,213,2,68,37,31,109,103,1,5,0,3
E33002471,309,247,38,209,1,24,11,13,37,32,0,5,0,0
E33002472,1001,732,185,547,6,110,55,55,146,133,0,12,1,7
E33002473,410,316,74,242,2,41,20,21,51,47,0,4,0,0
E33002474,240,167,42,125,2,28,8,20,37,34,0,3,0,6
E33002475,571,433,86,347,3,58,27,31,75,66,0,8,1,2
E33002476,450,224,50,174,2,82,38,44,140,137,0,3,0,2
E33002477,810,633,138,495,8,55,21,34,111,97,3,11,0,3
E33002478,244,188,38,150,0,21,13,8,34,29,0,4,1,1
E33002479,381,305,77,228,1,32,18,14,43,37,1,2,3,0
E33002480,490,375,122,253,2,55,30,25,55,52,0,2,1,3
E33002481,235,191,46,145,1,26,15,11,16,14,0,2,0,1
E33002482,250,201,60,141,1,17,10,7,30,26,0,4,0,1
E33002483,406,328,94,234,2,37,24,13,38,37,0,1,0,1
E33002484,700,530,136,394,3,77,51,26,85,77,0,8,0,5
E33002485,233,146,27,119,0,22,14,8,63,58,1,4,0,2
E33002486,955,745,204,541,6,86,60,26,114,106,0,8,0,4
E33002487,214,156,47,109,1,23,12,11,32,25,0,6,1,2
E33002488,733,572,148,424,4,72,36,36,82,75,0,6,1,3
E33002489,425,303,76,227,1,38,18,20,81,75,1,5,0,2
E33002490,465,336,97,239,2,80,48,32,45,39,0,5,1,2
E33002491,1176,883,199,684,7,90,51,39,188,170,0,17,1,8
E33002492,122,83,19,64,2,16,13,3,21,18,0,3,0,0
E33002493,512,376,90,286,1,62,34,28,72,63,2,3,4,1
E33002494,751,597,115,482,2,64,30,34,86,77,0,9,0,2
E33002495,336,219,48,171,2,70,41,29,45,39,2,3,1,0
E33002496,371,234,79,155,1,90,50,40,44,38,0,4,2,2
E33002497,869,649,189,460,4,100,53,47,114,101,0,12,1,2
E33002498,350,300,94,206,0,33,12,21,17,15,0,2,0,0
E33002499,515,390,88,302,3,64,30,34,56,49,1,6,0,2
E33002500,1748,1416,372,1044,8,116,54,62,197,177,1,18,1,11
E33002501,396,306,103,203,0,54,29,25,36,34,0,2,0,0
E33002502,3087,2391,601,1790,12,304,164,140,366,328,4,32,2,14
E33002503,559,486,130,356,2,22,11,11,43,40,0,3,0,6
E33002504,251,185,49,136,0,35,19,16,31,28,0,1,2,0
E33002505,220,155,47,108,1,30,13,17,30,28,0,2,0,4
E33002506,279,221,61,160,2,26,15,11,26,24,0,1,1,4
E33002507,385,311,70,241,2,30,12,18,41,36,0,4,1,1
E33002508,327,241,72,169,1,35,23,12,48,44,1,1,2,2
E33002509,453,319,78,241,4,69,30,39,61,52,1,7,1,0
E33002510,697,535,141,394,3,64,27,37,92,76,1,14,1,3
E33002511,291,216,47,169,1,40,19,21,30,28,0,2,0,4
E33002512,233,181,58,123,2,17,7,10,32,32,0,0,0,1
E33002513,315,226,71,155,1,41,29,12,44,40,0,4,0,3
E33002514,920,653,148,505,3,129,68,61,131,117,1,13,0,4
E33002515,608,480,119,361,2,64,33,31,62,58,0,3,1,0
E33002516,433,327,92,235,4,26,10,16,74,71,0,3,0,2
E33002517,380,264,68,196,0,47,25,22,68,58,0,9,1,1
E33002518,790,588,180,408,3,100,53,47,95,85,0,9,1,4
E33002519,439,302,93,209,2,67,37,30,67,59,0,5,3,1
E33002520,279,202,55,147,1,27,17,10,47,39,0,8,0,2
E33002521,341,232,66,166,1,44,26,18,60,55,1,4,0,4
E33002522,231,179,48,131,3,23,12,11,25,25,0,0,0,1
E33002523,242,180,47,133,1,28,15,13,31,29,0,2,0,2
E33002524,301,237,71,166,1,30,16,14,32,28,0,4,0,1
E33002525,211,183,50,133,1,11,4,7,15,14,0,1,0,1
E33002526,239,193,64,129,1,28,9,19,13,12,0,1,0,4
E33002527,465,325,98,227,3,65,36,29,70,64,1,4,1,2
E33002528,497,340,81,259,1,60,37,23,91,86,0,5,0,5
E33002529,151,113,36,77,0,8,5,3,30,30,0,0,0,0
E33002530,293,204,49,155,2,40,26,14,44,40,0,4,0,3
E33002531,212,142,46,96,0,28,14,14,37,31,0,3,3,5
E33002532,830,656,175,481,3,70,34,36,99,88,1,10,0,2
E33002533,462,353,66,287,3,44,18,26,60,57,0,2,1,2
E33002534,567,467,87,380,4,26,11,15,68,65,0,3,0,2
E33002535,251,207,54,153,1,22,13,9,21,17,0,2,2,0
E33002536,588,431,125,306,1,79,32,47,73,69,0,4,0,4
E33002537,673,462,119,343,3,109,61,48,93,88,1,4,0,6
E33002538,656,535,171,364,4,62,36,26,52,48,1,3,0,3
E33002539,165,121,33,88,1,14,6,8,26,23,0,3,0,3
E33002540,532,414,95,319,1,52,19,33,61,55,1,5,0,4
E33002541,247,162,49,113,1,34,18,16,44,42,0,2,0,6
E33002542,383,294,64,230,0,43,18,25,44,39,0,5,0,2
E33002543,468,299,109,190,0,82,35,47,84,80,0,4,0,3
E33002544,662,475,143,332,4,78,50,28,101,91,1,8,1,4
E33002545,996,631,188,443,3,202,107,95,157,145,0,11,1,3
E33002546,943,679,158,521,6,92,67,25,157,143,2,9,3,9
E33002547,423,296,75,221,0,52,32,20,72,60,0,10,2,3
E33002548,948,698,168,530,6,126,94,32,117,111,0,5,1,1
E33002549,295,224,71,153,0,33,18,15,35,34,0,1,0,3
E33002550,685,562,164,398,1,65,46,19,53,47,0,6,0,4
E33002551,347,274,60,214,2,34,24,10,37,35,0,2,0,0
E33002552,209,149,51,98,0,26,20,6,34,30,0,4,0,0
E33002553,232,135,38,97,1,48,37,11,44,42,0,2,0,4
E33002554,226,186,71,115,2,24,19,5,12,11,0,1,0,2
E33002555,299,233,80,153,2,29,23,6,34,29,0,4,1,1
E33002556,289,222,50,172,0,20,16,4,42,37,0,5,0,5
E33002557,229,168,37,131,1,36,25,11,24,21,0,3,0,0
E33002558,266,185,51,134,0,36,26,10,43,35,0,7,1,2
E33002559,254,209,73,136,0,22,17,5,21,19,0,2,0,2
E33002560,253,192,59,133,2,27,23,4,31,26,0,5,0,1
E33002561,242,159,40,119,1,52,43,9,29,26,0,3,0,1
E33002562,238,167,45,122,3,29,17,12,38,36,0,2,0,1
E33002563,462,294,94,200,1,79,57,22,83,71,1,10,1,5
E33002564,428,350,89,261,0,30,21,9,46,41,0,5,0,2
E33002565,227,165,45,120,0,26,20,6,34,25,1,7,1,2
E33002566,299,217,55,162,2,32,21,11,47,44,0,3,0,1
E33002567,502,351,68,283,1,42,27,15,101,86,0,15,0,7
E33002568,565,385,133,252,2,90,63,27,83,74,1,8,0,5
E33002569,815,600,194,406,1,104,68,36,101,95,0,3,3,9
E33002570,429,336,99,237,0,31,23,8,60,56,0,4,0,2
E33002571,523,425,120,305,1,38,29,9,56,50,0,6,0,3
E33002572,253,187,50,137,0,23,11,12,40,34,2,4,0,3
E33002573,730,583,149,434,4,68,45,23,70,63,0,6,1,5
E33002574,374,278,63,215,1,50,34,16,45,40,0,5,0,0
E33002575,366,325,82,243,1,14,7,7,25,20,0,5,0,1
E33002576,418,303,89,214,2,46,17,29,65,59,0,6,0,2
E33002577,398,291,91,200,1,55,22,33,49,45,0,3,1,2
E33002578,436,338,80,258,3,41,28,13,53,46,0,7,0,1
E33002579,260,196,51,145,1,29,16,13,33,26,0,7,0,1
E33002580,467,393,108,285,1,18,11,7,52,47,1,4,0,3
E33002581,767,567,138,429,2,96,67,29,100,91,0,8,1,2
E33002582,1091,799,191,608,1,135,80,55,149,135,0,13,1,7
E33002583,271,217,43,174,3,17,8,9,32,31,1,0,0,2
E33002584,764,566,138,428,4,85,60,25,106,96,2,8,0,3
E33002585,407,287,57,230,1,55,29,26,63,57,0,5,1,1
E33002586,1476,991,241,750,4,213,122,91,263,239,1,23,0,5
E33002587,106,91,29,62,1,8,4,4,5,4,0,1,0,1
E33002588,307,225,49,176,0,27,16,11,53,43,0,6,4,2
E33002589,1125,786,144,642,3,98,60,38,229,204,0,8,17,9
E33002590,349,226,63,163,1,54,23,31,63,59,0,3,1,5
E33002591,254,193,45,148,0,32,18,14,29,27,0,2,0,0
E33002592,1332,935,219,716,1,175,105,70,216,197,3,14,2,5
E33002593,259,208,54,154,1,32,17,15,17,16,0,1,0,1
E33002594,404,312,96,216,0,52,33,19,35,30,0,5,0,5
E33002595,268,196,50,146,0,38,28,10,33,27,1,5,0,1
E33002596,201,146,45,101,0,25,14,11,30,25,0,5,0,0
E33002597,306,217,46,171,3,39,26,13,45,42,0,2,1,2
E33002598,826,548,124,424,3,158,96,62,112,98,0,9,5,5
E33002599,316,221,52,169,0,51,34,17,43,33,0,7,3,1
E33002600,224,182,46,136,1,19,14,5,22,21,0,1,0,0
E33002601,427,362,123,239,1,19,12,7,44,42,0,2,0,1
E33002602,416,336,98,238,2,33,22,11,41,38,0,2,1,4
E33002603,392,293,78,215,2,50,37,13,47,47,0,0,0,0
E33002604,704,556,179,377,3,59,35,24,83,76,1,5,1,3
E33002605,339,248,73,175,1,47,28,19,41,37,1,2,1,2
E33002606,306,228,64,164,0,33,26,7,39,34,0,5,0,6
E33002607,404,321,81,240,0,41,33,8,42,34,2,6,0,0
E33002608,545,341,86,255,6,118,83,35,76,74,0,2,0,4
E33002609,312,217,41,176,1,51,38,13,41,39,0,2,0,2
E33002610,1952,1456,405,1051,10,134,79,55,340,322,0,13,5,12
E33002611,213,159,52,107,1,29,21,8,24,21,1,2,0,0
E33002612,298,194,50,144,1,54,30,24,48,40,1,7,0,1
E33002613,383,231,93,138,2,63,34,29,86,73,1,5,7,1
E33002614,198,152,37,115,1,17,10,7,28,22,0,6,0,0
E33002615,586,457,97,360,1,64,38,26,62,57,0,4,1,2
E33002616,219,160,32,128,2,22,15,7,32,27,1,4,0,3
E33002617,723,571,140,431,3,66,38,28,79,71,2,6,0,4
E33002618,534,391,82,309,3,68,34,34,69,62,0,6,1,3
E33002619,616,439,108,331,3,99,49,50,75,71,0,2,2,0
E33002620,293,192,48,144,0,50,23,27,48,41,0,3,4,3
E33002621,442,339,74,265,2,52,25,27,45,42,0,3,0,4
E33002622,720,578,159,419,6,66,41,25,67,60,0,7,0,3
E33002623,395,254,72,182,4,74,46,28,61,56,0,5,0,2
E33002624,259,186,48,138,1,31,13,18,40,38,0,2,0,1
E33002625,238,162,34,128,2,48,38,10,25,22,1,2,0,1
E33002626,429,201,55,146,0,132,95,37,94,88,2,2,2,2
E33002627,298,223,62,161,3,36,25,11,33,31,0,0,2,3
E33002628,344,209,53,156,2,61,43,18,69,61,0,7,1,3
E33002629,426,341,74,267,1,28,15,13,53,50,0,3,0,3
E33002630,208,138,40,98,0,41,24,17,29,29,0,0,0,0
E33002631,400,273,90,183,1,70,50,20,53,49,0,3,1,3
E33002632,207,156,53,103,1,32,21,11,18,17,0,1,0,0
E33002633,565,407,74,333,2,49,37,12,105,102,1,1,1,2
E33002634,614,462,131,331,6,56,30,26,86,84,0,2,0,4
E33002635,1332,968,246,722,4,147,83,64,206,194,0,9,3,7
E33002636,463,245,65,180,5,142,89,53,71,63,0,7,1,0
E33002637,334,157,34,123,5,101,56,45,70,68,0,2,0,1
E33002638,265,181,40,141,2,46,34,12,34,33,0,1,0,2
E33002639,288,169,48,121,0,69,42,27,48,48,0,0,0,2
E33002640,241,132,34,98,1,43,22,21,64,62,0,2,0,1
E33002641,775,599,158,441,4,84,56,28,81,76,0,5,0,7
E33002642,464,341,81,260,0,45,26,19,72,66,0,5,1,6
E33002643,1000,747,148,599,4,128,94,34,121,107,1,13,0,0
E33002644,443,359,63,296,1,17,13,4,65,54,4,7,0,1
E33002645,502,388,110,278,7,61,36,25,42,39,0,3,0,4
E33002646,1694,1327,304,1023,8,151,92,59,204,187,0,16,1,4
E33002647,247,196,61,135,1,22,16,6,26,26,0,0,0,2
E33002648,327,267,78,189,2,24,18,6,32,29,0,2,1,2
E33002649,678,512,102,410,1,84,51,33,80,69,0,11,0,1
E33002650,912,627,144,483,10,78,41,37,190,178,0,11,1,7
E33002651,604,457,94,363,1,75,39,36,68,64,1,3,0,3
E33002652,709,510,124,386,1,94,56,38,102,93,0,8,1,2
E33002653,245,187,40,147,0,28,18,10,30,26,0,3,1,0
E33002654,351,277,74,203,2,26,17,9,43,39,0,3,1,3
E33002655,572,421,96,325,4,50,20,30,94,80,0,14,0,3
E33002656,609,489,136,353,3,56,31,25,58,48,0,8,2,3
E33002657,225,181,43,138,1,20,11,9,22,20,0,2,0,1
E33002658,289,220,58,162,1,35,18,17,30,26,2,2,0,3
E33002659,540,374,120,254,3,74,42,32,87,81,0,4,2,2
E33002660,516,313,78,235,5,53,27,26,139,125,0,12,2,6
E33002661,241,178,52,126,1,37,23,14,25,24,0,0,1,0
E33002662,368,257,70,187,3,36,14,22,70,64,3,3,0,2
E33002663,336,235,62,173,2,37,18,19,60,51,1,8,0,2
E33002664,368,252,58,194,6,37,18,19,72,63,0,9,0,1
E33002665,432,322,79,243,5,35,13,22,68,62,0,6,0,2
E33002666,815,566,184,382,5,122,75,47,117,109,3,5,0,5
E33002667,402,283,88,195,1,54,27,27,63,58,0,5,0,1
E33002668,684,608,142,466,5,26,9,17,41,38,0,3,0,4
E33002669,592,387,121,266,9,89,47,42,104,95,1,6,2,3
E33002670,236,174,43,131,2,15,7,8,44,41,0,3,0,1
E33002671,198,159,44,115,0,13,8,5,24,20,1,3,0,2
E33002672,336,266,86,180,7,21,7,14,40,38,1,1,0,2
E33002673,265,179,52,127,1,33,15,18,49,46,0,3,0,3
E33002674,204,140,42,98,5,11,5,6,46,44,0,1,1,2
E33002675,3233,2584,703,1881,28,259,140,119,346,329,0,17,0,16
E33002676,348,241,51,190,2,47,31,16,58,52,0,5,1,0
E33002677,451,350,105,245,5,41,22,19,55,52,0,3,0,0
E33002678,488,387,121,266,4,38,18,20,57,50,0,3,4,2
E33002679,672,522,123,399,2,51,22,29,94,81,0,13,0,3
E33002680,205,148,44,104,0,24,13,11,33,30,0,3,0,0
E33002681,354,257,87,170,1,44,27,17,51,45,1,4,1,1
E33002682,1213,927,271,656,3,93,51,42,184,170,0,13,1,6
E33002683,309,235,72,163,1,21,11,10,51,47,0,4,0,1
E33002684,378,270,69,201,1,46,21,25,58,53,1,4,0,3
E33002685,270,201,59,142,2,23,10,13,41,40,0,0,1,3
E33002686,1363,1015,204,811,9,111,60,51,218,212,1,5,0,10
E33002687,730,542,133,409,4,65,27,38,118,108,0,8,2,1
E33002688,545,436,149,287,3,31,19,12,73,66,1,5,1,2
E33002689,1427,1187,378,809,18,87,39,48,130,112,3,14,1,5
E33002690,440,367,76,291,1,21,14,7,50,44,0,2,4,1
E33002691,772,587,152,435,8,93,51,42,82,77,0,5,0,2
E33002692,277,197,52,145,3,32,14,18,44,43,0,1,0,1
E33002693,229,176,42,134,2,21,9,12,28,25,0,3,0,2
E33002694,784,635,124,511,7,59,25,34,81,73,0,7,1,2
E33002695,297,229,59,170,0,16,8,8,51,45,0,2,4,1
E33002696,392,312,74,238,4,19,10,9,57,49,1,6,1,0
E33002697,245,194,43,151,3,19,6,13,28,25,0,3,0,1
E33002698,4088,3198,781,2417,26,279,153,126,566,527,2,31,6,19
E33002699,1382,1088,273,815,9,57,28,29,225,211,1,12,1,3
E33002700,367,236,56,180,6,41,24,17,82,77,0,4,1,2
E33002701,588,460,144,316,10,53,21,32,65,61,1,3,0,0
E33002702,368,277,68,209,2,44,23,21,44,39,0,4,1,1
E33002703,388,285,65,220,5,40,21,19,53,53,0,0,0,5
E33002704,707,499,118,381,6,93,63,30,107,99,1,6,1,2
E33002705,310,233,55,178,1,34,20,14,40,36,0,3,1,2
E33002706,975,680,182,498,6,152,89,63,135,126,0,6,3,2
E33002707,491,350,108,242,4,60,40,20,74,65,2,7,0,3
E33002708,220,154,42,112,3,30,20,10,32,27,0,3,2,1
E33002709,260,209,74,135,3,12,2,10,35,34,0,1,0,1
E33002710,217,167,42,125,2,10,3,7,38,30,0,6,2,0
E33002711,769,572,155,417,4,64,41,23,121,119,0,2,0,8
E33002712,494,336,90,246,7,54,17,37,92,83,0,7,2,5
E33002713,538,431,76,355,3,27,6,21,70,65,0,4,1,7
E33002714,528,421,101,320,6,23,8,15,77,74,0,3,0,1
E33002715,570,446,108,338,1,18,9,9,104,97,1,5,1,1
E33002716,256,180,55,125,2,17,13,4,55,49,2,4,0,2
E33002717,442,364,75,289,5,22,6,16,49,47,0,1,1,2
E33002718,361,266,80,186,2,34,18,16,57,49,2,6,0,2
E33002719,727,523,110,413,3,32,12,20,166,156,1,8,1,3
E33002720,707,530,147,383,2,60,35,25,110,102,0,7,1,5
E33002721,264,175,42,133,1,38,23,15,49,42,0,6,1,1
E33002722,464,355,95,260,4,56,38,18,48,44,1,3,0,1
E33002723,218,161,40,121,1,22,8,14,34,33,0,1,0,0
E33002724,1321,954,213,741,15,73,42,31,269,250,1,16,2,10
E33002725,557,394,101,293,1,73,32,41,87,79,0,8,0,2
E33002726,1066,752,168,584,6,132,64,68,172,160,0,10,2,4
E33002727,327,229,74,155,0,25,13,12,68,66,0,2,0,5
E33002728,791,569,130,439,5,66,43,23,140,126,0,13,1,11
E33002729,546,415,80,335,8,41,16,25,80,69,2,6,3,2
E33002730,434,333,102,231,4,33,19,14,63,59,0,4,0,1
E33002731,287,228,81,147,3,16,10,6,39,36,0,3,0,1
E33002732,433,363,106,257,3,29,17,12,36,34,0,2,0,2
E33002733,278,201,45,156,2,19,6,13,52,50,0,2,0,4
E33002734,341,224,64,160,3,47,20,27,65,59,0,5,1,2
E33002735,930,773,191,582,6,39,24,15,107,99,0,6,2,5
E33002736,539,374,87,287,4,50,25,25,108,97,0,10,1,3
E33002737,252,156,39,117,1,44,26,18,49,47,0,2,0,2
E33002738,266,207,51,156,2,23,8,15,32,30,0,2,0,2
E33002739,424,340,86,254,3,36,20,16,42,38,0,4,0,3
E33002740,250,202,50,152,0,29,13,16,17,15,1,1,0,2
E33002741,221,177,38,139,1,16,11,5,27,27,0,0,0,0
E33002742,235,193,48,145,1,11,5,6,29,26,0,3,0,1
E33002743,285,219,55,164,4,14,6,8,48,45,0,3,0,0
E33002744,222,162,46,116,3,10,7,3,44,41,0,1,2,3
E33002745,376,301,82,219,1,23,7,16,48,46,0,2,0,3
E33002746,754,596,166,430,1,66,25,41,89,81,0,8,0,2
E33002747,805,578,147,431,3,100,27,73,120,111,0,8,1,4
E33002748,705,447,104,343,2,131,34,97,123,114,2,6,1,2
E33002749,620,424,126,298,1,107,28,79,83,75,0,7,1,5
E33002750,1746,1319,287,1032,8,188,63,125,221,201,0,20,0,10
E33002751,226,172,43,129,0,15,7,8,38,33,0,3,2,1
E33002752,338,270,78,192,1,27,10,17,37,32,0,4,1,3
E33002753,202,163,41,122,0,13,4,9,26,24,0,2,0,0
E33002754,419,262,57,205,2,87,36,51,63,58,3,2,0,5
E33002755,306,201,55,146,0,61,22,39,44,40,0,3,1,0
E33002756,279,169,30,139,2,42,15,27,66,62,2,2,0,0
E33002757,387,288,78,210,0,48,16,32,45,38,1,5,1,6
E33002758,162,138,39,99,0,5,0,5,19,19,0,0,0,0
E33002759,218,150,38,112,1,38,14,24,29,26,1,2,0,0
E33002760,303,200,57,143,1,49,13,36,48,40,1,4,3,5
E33002761,354,278,70,208,1,23,11,12,50,47,0,3,0,2
E33002762,295,213,83,130,0,39,12,27,43,39,0,3,1,0
E33002763,407,269,68,201,0,68,25,43,69,62,0,7,0,1
E33002764,630,477,104,373,3,75,11,64,69,60,3,6,0,6
E33002765,215,157,59,98,1,23,5,18,32,28,0,4,0,2
E33002766,803,668,187,481,1,56,23,33,78,70,2,5,1,0
E33002767,306,228,87,141,1,41,10,31,35,29,1,5,0,1
E33002768,809,628,156,472,5,84,28,56,86,77,1,7,1,6
E33002769,751,532,123,409,5,104,36,68,108,104,0,3,1,2
E33002770,419,282,74,208,3,58,18,40,73,67,0,4,2,3
E33002771,172,125,34,91,0,18,6,12,29,25,0,3,1,0
E33002772,212,153,36,117,1,34,12,22,23,20,0,3,0,1
E33002773,421,270,79,191,0,83,21,62,61,51,2,7,1,7
E33002774,1043,839,217,622,1,88,26,62,111,103,0,7,1,4
E33002775,319,250,70,180,2,29,11,18,35,30,3,2,0,3
E33002776,214,154,35,119,3,27,11,16,29,27,2,0,0,1
E33002777,299,216,48,168,1,44,13,31,37,34,0,3,0,1
E33002778,321,250,54,196,0,27,7,20,42,39,0,3,0,2
E33002779,495,376,97,279,1,42,14,28,71,70,0,1,0,5
E33002780,214,179,49,130,0,14,3,11,20,20,0,0,0,1
E33002781,484,388,90,298,1,57,20,37,38,30,0,8,0,0
E33002782,276,210,57,153,1,34,11,23,31,27,0,4,0,0
E33002783,211,157,37,120,0,24,9,15,30,30,0,0,0,0
E33002784,428,345,94,251,2,37,13,24,44,38,0,6,0,0
E33002785,836,611,164,447,1,111,30,81,108,95,0,12,1,5
E33002786,614,334,81,253,6,127,42,85,144,129,1,12,2,3
E33002787,620,465,129,336,0,79,32,47,74,65,0,9,0,2
E33002788,215,156,38,118,0,25,11,14,32,27,0,5,0,2
E33002789,268,210,74,136,1,37,14,23,20,16,0,4,0,0
E33002790,280,248,80,168,1,19,5,14,10,6,0,3,1,2
E33002791,375,253,53,200,1,75,21,54,46,45,0,1,0,0
E33002792,428,331,87,244,1,36,14,22,58,54,0,3,1,2
E33002793,254,183,53,130,2,35,15,20,34,32,0,2,0,0
E33002794,216,128,33,95,1,40,14,26,43,40,0,2,1,4
E33002795,784,540,144,396,5,137,51,86,101,88,2,11,0,1
E33002796,242,185,55,130,0,23,8,15,31,30,0,0,1,3
E33002797,251,158,30,128,1,32,11,21,58,55,1,2,0,2
E33002798,202,161,54,107,1,15,7,8,24,22,0,2,0,1
E33002799,366,247,79,168,3,56,11,45,59,54,0,3,2,1
E33002800,315,250,59,191,1,26,6,20,33,33,0,0,0,5
E33002801,220,154,36,118,1,15,5,10,49,49,0,0,0,1
E33002802,259,174,55,119,2,28,9,19,53,49,0,4,0,2
E33002803,250,166,33,133,3,12,5,7,69,66,0,3,0,0
E33002804,263,197,60,137,2,27,12,15,37,37,0,0,0,0
E33002805,275,159,43,116,1,44,17,27,68,63,0,4,1,3
E33002806,272,197,48,149,2,18,6,12,54,49,0,2,3,1
E33002807,413,279,73,206,3,57,25,32,69,66,0,3,0,5
E33002808,839,563,144,419,7,90,44,46,175,161,0,12,2,4
E33002809,271,211,72,139,2,10,3,7,42,36,0,5,1,6
E33002810,403,326,81,245,1,15,5,10,61,58,0,2,1,0
E33002811,201,144,32,112,1,6,3,3,50,47,0,2,1,0
E33002812,426,284,70,214,5,24,9,15,108,99,0,5,4,5
E33002813,333,219,66,153,4,58,19,39,46,43,0,2,1,6
E33002814,687,561,115,446,3,39,12,27,83,78,0,5,0,1
E33002815,820,653,145,508,3,37,12,25,123,116,1,6,0,4
E33002816,215,154,36,118,2,10,3,7,49,44,1,2,2,0
E33002817,835,673,159,514,4,43,19,24,109,99,2,8,0,6
E33002818,270,190,57,133,0,16,2,14,62,59,0,3,0,2
E33002819,437,304,76,228,2,36,11,25,92,80,1,11,0,3
E33002820,203,159,31,128,3,13,5,8,28,25,0,3,0,0
E33002821,398,298,76,222,3,23,7,16,71,66,2,3,0,3
E33002822,503,330,96,234,5,65,21,44,98,91,3,4,0,5
E33002823,999,626,155,471,5,139,60,79,225,213,0,12,0,4
E33002824,246,173,55,118,1,32,13,19,37,33,1,3,0,3
E33002825,250,194,32,162,3,23,3,20,29,27,0,1,1,1
E33002826,272,220,57,163,2,24,10,14,25,19,0,5,1,1
E33002827,660,410,120,290,6,130,48,82,113,104,0,9,0,1
E33002828,836,665,163,502,6,47,15,32,116,109,0,7,0,2
E33002829,206,140,37,103,0,28,14,14,37,33,0,3,1,1
E33002830,371,252,74,178,2,30,9,21,78,72,0,4,2,9
E33002831,612,446,94,352,5,44,16,28,115,103,2,10,0,2
E33002832,341,289,83,206,5,25,6,19,21,19,0,0,2,1
E33002833,727,492,105,387,3,70,32,38,159,151,2,5,1,3
E33002834,429,330,87,243,1,44,23,21,54,47,0,7,0,0
E33002835,390,285,56,229,2,37,15,22,65,58,0,6,1,1
E33002836,9317,5889,1423,4466,39,1141,558,583,2189,2044,7,124,14,59
E33002837,903,684,124,560,5,53,22,31,156,142,0,14,0,5
E33002838,997,667,178,489,6,145,82,63,176,170,1,3,2,3
E33002839,886,625,149,476,6,92,55,37,158,148,0,8,2,5
E33002840,645,422,107,315,2,56,30,26,162,153,1,7,1,3
E33002841,257,179,41,138,3,39,26,13,33,32,0,1,0,3
E33002842,262,191,46,145,0,32,14,18,38,37,0,1,0,1
E33002843,524,397,116,281,5,41,16,25,80,74,0,6,0,1
E33002844,415,326,81,245,2,50,33,17,34,32,0,2,0,3
E33002845,514,355,83,272,2,82,47,35,74,67,1,6,0,1
E33002846,1666,1185,260,925,6,214,99,115,251,235,1,14,1,10
E33002847,308,214,44,170,1,36,17,19,56,56,0,0,0,1
E33002848,383,265,64,201,2,47,26,21,66,65,0,1,0,3
E33002849,464,347,86,261,4,47,26,21,64,58,1,5,0,2
E33002850,679,453,115,338,1,93,47,46,129,120,0,9,0,3
E33002851,619,496,130,366,3,52,26,26,68,65,0,3,0,0
E33002852,458,370,82,288,1,27,14,13,60,56,0,4,0,0
E33002853,1851,1387,329,1058,10,185,101,84,255,237,0,16,2,14
E33002854,2071,1607,490,1117,10,185,82,103,263,244,0,15,4,6
E33002855,297,233,70,163,1,22,4,18,40,34,0,6,0,1
E33002856,359,276,95,181,1,32,9,23,45,41,0,3,1,5
E33002857,1822,1336,287,1049,8,121,51,70,348,322,0,26,0,9
E33002858,463,343,78,265,2,38,11,27,76,71,0,5,0,4
E33002859,992,610,105,505,8,110,51,59,261,246,0,13,2,3
E33002860,259,182,52,130,1,38,17,21,36,33,0,3,0,2
E33002861,286,182,34,148,2,46,18,28,56,54,0,2,0,0
E33002862,229,183,36,147,4,6,5,1,36,35,0,1,0,0
E33002863,416,316,91,225,3,19,7,12,74,71,0,3,0,4
E33002864,265,189,39,150,3,26,4,22,45,42,0,3,0,2
E33002865,729,506,136,370,3,60,33,27,154,147,0,6,1,6
E33002866,335,254,72,182,3,43,28,15,35,34,0,0,1,0
E33002867,377,259,57,202,1,59,27,32,58,52,0,6,0,0
E33002868,200,135,35,100,1,21,10,11,43,39,0,4,0,0
E33002869,438,293,66,227,0,50,20,30,90,85,0,4,1,5
E33002870,356,253,68,185,2,33,14,19,65,62,0,3,0,3
E33002871,346,275,92,183,1,21,8,13,48,45,0,3,0,1
E33002872,603,432,114,318,3,50,23,27,115,108,1,4,2,3
E33002873,314,227,47,180,2,31,19,12,54,52,1,1,0,0
E33002874,551,394,103,291,0,70,33,37,86,78,0,8,0,1
E33002875,332,261,49,212,2,10,3,7,58,55,0,3,0,1
E33002876,570,426,114,312,0,58,28,30,85,78,1,5,1,1
E33002877,466,366,80,286,2,35,19,16,61,52,0,7,2,2
E33002878,476,295,65,230,1,69,40,29,105,102,0,2,1,6
E33002879,555,385,80,305,2,52,33,19,114,101,0,12,1,2
E33002880,290,212,57,155,0,37,14,23,41,38,1,2,0,0
E33002881,880,633,139,494,3,105,44,61,135,128,0,7,0,4
E33002882,293,178,50,128,2,53,25,28,59,52,0,7,0,1
E33002883,1194,651,209,442,10,248,116,132,275,260,0,13,2,10
E33002884,738,622,144,478,6,54,33,21,54,53,0,1,0,2
E33002885,271,171,34,137,2,30,14,16,66,64,0,2,0,2
E33002886,267,190,38,152,1,24,10,14,49,44,0,5,0,3
E33002887,373,230,47,183,2,63,37,26,77,75,0,1,1,1
E33002888,244,175,42,133,2,29,12,17,34,34,0,0,0,4
E33002889,250,158,49,109,4,41,12,29,46,43,0,2,1,1
E33002890,209,128,38,90,0,28,9,19,50,43,0,7,0,3
E33002891,589,380,116,264,4,92,39,53,108,102,1,5,0,5
E33002892,558,436,71,365,3,23,9,14,92,82,2,7,1,4
E33002893,459,341,117,224,1,63,29,34,51,49,0,2,0,3
E33002894,213,139,38,101,3,31,10,21,40,38,0,2,0,0
E33002895,727,564,158,406,2,58,14,44,99,91,1,7,0,4
E33002896,292,188,51,137,3,36,9,27,63,56,0,6,1,2
E33002897,519,425,84,341,4,22,9,13,65,60,0,5,0,3
E33002898,291,211,47,164,1,29,17,12,47,47,0,0,0,3
E33002899,1102,655,207,448,5,210,84,126,220,207,1,11,1,12
E33002900,385,249,61,188,2,52,23,29,77,69,5,2,1,5
E33002901,515,343,78,265,3,41,15,26,126,113,0,13,0,2
E33002902,1516,750,216,534,11,169,69,100,578,548,2,22,6,8
E33002903,312,209,39,170,1,33,15,18,65,60,0,5,0,4
E33002904,354,232,72,160,3,61,29,32,58,53,0,4,1,0
E33002905,764,539,123,416,3,102,40,62,119,112,0,7,0,1
E33002906,3976,3452,542,2910,11,139,62,77,358,326,2,25,5,16
E33002907,836,573,164,409,5,73,31,42,177,169,0,8,0,8
E33002908,1757,1353,336,1017,16,187,82,105,190,175,1,9,5,11
E33002909,1337,964,244,720,10,100,30,70,259,245,0,13,1,4
E33002910,657,472,128,344,2,78,27,51,100,92,1,7,0,5
E33002911,595,435,110,325,2,65,24,41,83,81,0,2,0,10
E33002912,289,252,91,161,0,15,4,11,22,21,0,1,0,0
E33002913,654,495,144,351,1,82,55,27,71,60,0,11,0,5
E33002914,370,321,86,235,0,17,16,1,29,26,0,3,0,3
E33002915,858,687,203,484,2,77,56,21,89,82,0,7,0,3
E33002916,937,680,155,525,3,125,94,31,122,112,0,8,2,7
E33002917,238,169,55,114,2,30,19,11,35,34,0,1,0,2
E33002918,1369,1178,294,884,4,85,64,21,102,91,0,9,2,0
E33002919,1101,813,222,591,2,156,113,43,125,117,0,7,1,5
E33002920,396,292,78,214,0,47,39,8,53,49,0,3,1,4
E33002921,460,352,108,244,2,38,34,4,61,55,0,6,0,7
E33002922,462,355,96,259,1,57,52,5,46,42,0,4,0,3
E33002923,1048,726,196,530,8,155,134,21,150,145,0,5,0,9
E33002924,542,414,119,295,2,47,38,9,75,66,0,9,0,4
E33002925,314,218,53,165,2,42,28,14,49,45,0,4,0,3
E33002926,1155,858,245,613,2,142,121,21,145,130,1,13,1,8
E33002927,735,613,172,441,1,72,66,6,45,40,0,4,1,4
E33002928,1283,659,178,481,1,304,231,73,305,290,0,14,1,14
E33002929,231,153,36,117,0,40,27,13,38,37,0,1,0,0
E33002930,412,300,82,218,2,53,46,7,53,51,0,2,0,4
E33002931,344,243,68,175,4,41,38,3,54,48,1,5,0,2
E33002932,389,251,71,180,2,63,40,23,73,64,0,8,1,0
E33002933,684,453,128,325,9,112,102,10,105,95,0,10,0,5
E33002934,474,364,86,278,3,50,39,11,56,53,0,3,0,1
E33002935,415,358,74,284,2,19,15,4,35,34,0,1,0,1
E33002936,251,165,39,126,5,42,36,6,34,28,0,6,0,5
E33002937,263,216,48,168,1,15,12,3,29,27,0,2,0,2
E33002938,1096,897,271,626,3,84,69,15,105,92,0,13,0,7
E33002939,1062,835,206,629,5,90,55,35,130,125,1,4,0,2
E33002940,572,430,123,307,1,76,64,12,62,55,0,7,0,3
E33002941,1188,901,280,621,2,179,154,25,100,91,0,8,1,6
E33002942,235,174,34,140,0,27,22,5,30,28,0,2,0,4
E33002943,973,769,141,628,5,93,76,17,101,95,0,6,0,5
E33002944,377,270,66,204,1,53,47,6,51,47,0,4,0,2
E33002945,416,318,81,237,0,53,51,2,43,41,0,2,0,2
E33002946,223,162,33,129,2,30,23,7,26,21,0,3,2,3
E33002947,538,416,76,340,1,57,43,14,64,62,0,2,0,0
E33002948,207,154,42,112,1,18,16,2,33,32,0,1,0,1
E33002949,484,398,96,302,1,45,36,9,39,37,1,1,0,1
E33002950,481,412,92,320,3,21,16,5,41,38,2,1,0,4
E33002951,224,188,61,127,0,11,9,2,23,21,0,2,0,2
E33002952,660,443,127,316,0,120,101,19,95,87,0,7,1,2
E33002953,2213,1788,518,1270,8,211,183,28,194,176,3,14,1,12
E33002954,197,151,44,107,0,23,20,3,20,18,0,2,0,3
E33002955,521,418,141,277,1,57,42,15,45,43,0,2,0,0
E33002956,375,248,56,192,0,51,42,9,74,69,0,5,0,2
E33002957,356,295,81,214,0,31,26,5,27,27,0,0,0,3
E33002958,229,174,38,136,0,22,13,9,31,30,0,1,0,2
E33002959,308,196,63,133,0,56,47,9,53,48,0,4,1,3
E33002960,1272,961,246,715,5,146,122,24,154,144,0,10,0,6
E33002961,462,339,84,255,0,42,33,9,75,67,0,8,0,6
E33002962,288,198,52,146,1,41,35,6,46,40,0,3,3,2
E33002963,330,231,61,170,1,49,39,10,46,45,0,1,0,3
E33002964,388,341,63,278,1,16,14,2,28,25,0,3,0,2
E33002965,849,731,226,505,6,49,40,9,60,54,2,4,0,3
E33002966,547,415,112,303,1,73,60,13,57,53,2,2,0,1
E33002967,521,378,72,306,2,76,62,14,61,54,0,6,1,4
E33002968,1707,1321,406,915,2,195,151,44,184,165,2,16,1,5
E33002969,2521,2086,621,1465,5,247,213,34,176,167,0,5,4,7
E33002970,711,507,119,388,2,88,63,25,111,99,0,12,0,3
E33002971,524,410,103,307,1,53,45,8,55,47,3,3,2,5
E33002972,536,396,92,304,2,84,36,48,49,44,0,5,0,5
E33002973,614,512,133,379,5,49,23,26,44,38,0,4,2,4
E33002974,1032,814,214,600,4,111,36,75,99,85,2,11,1,4
E33002975,2042,1589,352,1237,8,244,57,187,192,176,0,15,1,9
E33002976,454,352,75,277,0,51,20,31,47,44,0,2,1,4
E33002977,545,450,78,372,0,56,26,30,38,32,0,4,2,1
E33002978,456,345,67,278,2,58,21,37,49,43,0,5,1,2
E33002979,381,275,58,217,2,62,15,47,39,35,0,3,1,3
E33002980,413,257,52,205,1,103,53,50,50,44,0,4,2,2
E33002981,829,626,167,459,1,94,32,62,103,96,0,5,2,5
E33002982,375,291,66,225,2,50,29,21,31,28,0,3,0,1
E33002983,402,328,93,235,0,39,13,26,35,30,0,5,0,0
E33002984,197,120,36,84,0,25,7,18,33,28,4,1,0,19
E33002985,680,481,111,370,2,97,27,70,97,88,0,9,0,3
E33002986,669,501,141,360,5,97,45,52,62,59,0,3,0,4
E33002987,271,224,52,172,0,26,11,15,20,16,0,3,1,1
E33002988,360,268,51,217,5,36,13,23,50,49,0,1,0,1
E33002989,305,248,58,190,1,31,10,21,24,22,0,2,0,1
E33002990,519,411,103,308,0,52,21,31,52,43,0,8,1,4
E33002991,1165,912,235,677,3,146,50,96,102,99,0,3,0,2
E33002992,398,293,78,215,1,67,30,37,36,31,0,5,0,1
E33002993,253,191,47,144,1,25,11,14,36,33,1,2,0,0
E33002994,366,260,64,196,2,41,19,22,63,58,0,5,0,0
E33002995,1283,1001,207,794,3,122,36,86,153,131,0,21,1,4
E33002996,986,705,178,527,7,159,74,85,113,106,0,6,1,2
E33002997,246,177,48,129,0,50,21,29,17,14,1,2,0,2
E33002998,292,200,52,148,0,53,19,34,39,36,0,3,0,0
E33002999,1249,1077,219,858,5,73,28,45,88,80,0,7,1,6
E33003000,855,640,169,471,2,129,43,86,80,76,0,3,1,4
E33003001,733,561,146,415,0,102,26,76,69,60,0,9,0,1
E33003002,374,293,56,237,1,37,14,23,42,40,0,1,1,1
E33003003,433,302,81,221,1,76,33,43,53,52,0,1,0,1
E33003004,285,206,38,168,0,51,16,35,26,26,0,0,0,2
E33003005,372,276,66,210,1,59,23,36,36,32,0,4,0,0
E33003006,582,430,105,325,1,98,25,73,52,49,0,3,0,1
E33003007,918,698,186,512,3,103,41,62,111,103,0,6,2,3
E33003008,1495,1138,269,869,4,202,92,110,144,133,0,8,3,7
E33003009,318,213,62,151,3,32,7,25,66,64,0,1,1,4
E33003010,550,290,66,224,6,116,34,82,136,130,1,4,1,2
E33003011,314,204,57,147,5,39,7,32,64,60,0,4,0,2
E33003012,970,799,216,583,4,52,9,43,114,107,0,5,2,1
E33003013,1226,896,214,682,1,110,20,90,210,195,3,9,3,9
E33003014,624,447,96,351,4,88,27,61,84,77,0,6,1,1
E33003015,1482,929,268,661,13,322,111,211,207,198,0,9,0,11
E33003016,289,208,53,155,1,36,3,33,43,41,0,2,0,1
E33003017,372,255,88,167,0,55,11,44,61,57,0,4,0,1
E33003018,1372,1064,229,835,5,101,29,72,199,180,0,16,3,3
E33003019,3695,2911,596,2315,25,264,60,204,482,444,4,27,7,13
E33003020,235,148,37,111,1,54,14,40,31,30,0,1,0,1
E33003021,630,466,134,332,1,77,21,56,83,77,0,6,0,3
E33003022,4798,3606,867,2739,21,495,126,369,660,592,20,37,11,16
E33003023,607,454,110,344,6,44,9,35,99,93,0,3,3,4
E33003024,952,722,161,561,3,81,18,63,143,131,1,8,3,3
E33003025,226,126,44,82,3,37,1,36,55,54,0,1,0,5
E33003026,214,160,33,127,1,19,5,14,34,32,0,1,1,0
E33003027,457,340,95,245,3,54,18,36,59,56,0,2,1,1
E33003028,1084,803,204,599,4,109,32,77,160,147,0,12,1,8
E33003029,384,231,63,168,0,93,12,81,59,58,0,1,0,1
E33003030,330,271,58,213,2,25,9,16,32,32,0,0,0,0
E33003031,669,463,144,319,3,96,20,76,102,96,0,4,2,5
E33003032,214,162,53,109,0,27,6,21,24,23,0,1,0,1
E33003033,628,462,168,294,1,109,17,92,54,53,0,1,0,2
E33003034,376,282,65,217,1,43,7,36,48,43,0,5,0,2
E33003035,224,173,43,130,0,18,3,15,30,28,0,2,0,3
E33003036,319,216,66,150,0,42,4,38,60,57,0,3,0,1
E33003037,1197,745,176,569,5,98,14,84,346,329,0,15,2,3
E33003038,253,173,46,127,0,26,2,24,53,48,0,5,0,1
E33003039,1330,1036,235,801,3,110,25,85,178,168,0,9,1,3
E33003040,228,156,41,115,0,32,6,26,39,37,0,1,1,1
E33003041,557,383,114,269,4,91,17,74,79,73,0,6,0,0
E33003042,611,400,105,295,4,40,2,38,165,155,0,9,1,2
E33003043,264,219,59,160,2,22,4,18,19,18,0,1,0,2
E33003044,1120,739,164,575,6,226,44,182,142,133,0,7,2,7
E33003045,997,691,170,521,6,138,32,106,160,156,0,4,0,2
E33003046,216,143,43,100,0,42,11,31,30,26,1,2,1,1
E33003047,273,209,56,153,0,35,9,26,29,28,0,1,0,0
E33003048,242,181,47,134,1,32,11,21,26,24,0,2,0,2
E33003049,270,204,29,175,2,31,11,20,31,29,0,1,1,2
E33003050,216,178,44,134,0,11,2,9,27,27,0,0,0,0
E33003051,309,235,77,158,1,32,8,24,41,39,0,1,1,0
E33003052,195,140,47,93,3,27,9,18,24,22,0,2,0,1
E33003053,244,177,41,136,2,25,8,17,37,36,0,1,0,3
E33003054,282,209,57,152,1,34,6,28,37,32,0,1,4,1
E33003055,378,287,91,196,3,35,9,26,52,50,0,2,0,1
E33003056,337,241,67,174,2,51,19,32,42,36,0,4,2,1
E33003057,245,182,47,135,1,35,12,23,26,23,0,3,0,1
E33003058,672,553,140,413,4,65,11,54,48,44,1,2,1,2
E33003059,599,370,118,252,3,133,43,90,92,82,1,8,1,1
E33003060,348,266,74,192,1,39,14,25,42,39,0,2,1,0
E33003061,282,232,71,161,0,26,13,13,21,18,0,2,1,3
E33003062,435,337,110,227,0,45,15,30,52,45,0,7,0,1
E33003063,984,779,130,649,2,66,27,39,135,118,0,17,0,2
E33003064,230,166,42,124,1,38,19,19,24,20,0,4,0,1
E33003065,292,228,55,173,0,31,15,16,32,30,0,2,0,1
E33003066,312,232,52,180,3,25,14,11,49,45,0,4,0,3
E33003067,414,320,101,219,2,38,19,19,48,39,0,6,3,6
E33003068,251,155,36,119,0,27,14,13,67,59,1,6,1,2
E33003069,1044,798,214,584,6,111,68,43,125,111,1,9,4,4
E33003070,210,170,37,133,0,25,14,11,15,14,0,1,0,0
E33003071,579,429,111,318,4,78,38,40,63,58,0,5,0,5
E33003072,193,140,40,100,0,31,17,14,22,20,0,2,0,0
E33003073,553,398,127,271,2,73,40,33,79,76,0,3,0,1
E33003074,517,381,92,289,2,71,33,38,60,53,0,5,2,3
E33003075,1093,764,191,573,3,172,86,86,153,143,0,9,1,1
E33003076,263,169,46,123,2,41,24,17,51,48,2,1,0,0
E33003077,446,311,88,223,0,89,25,64,43,39,0,4,0,3
E33003078,331,251,66,185,2,48,17,31,29,29,0,0,0,1
E33003079,512,410,127,283,2,52,19,33,47,40,1,6,0,1
E33003080,345,301,84,217,0,20,7,13,22,19,1,2,0,2
E33003081,679,507,102,405,2,44,9,35,123,117,1,5,0,3
E33003082,234,203,62,141,1,16,8,8,13,13,0,0,0,1
E33003083,740,587,164,423,4,85,40,45,64,60,0,4,0,0
E33003084,299,232,64,168,2,28,10,18,35,34,0,1,0,2
E33003085,246,148,48,100,0,45,12,33,50,47,0,3,0,3
E33003086,263,197,50,147,2,31,8,23,29,27,0,2,0,4
E33003087,414,329,88,241,2,45,12,33,38,35,0,3,0,0
E33003088,238,191,43,148,0,16,4,12,30,26,0,4,0,1
E33003089,1010,767,207,560,3,125,42,83,109,97,0,11,1,6
E33003090,198,143,46,97,1,29,8,21,24,22,0,2,0,1
E33003091,645,469,159,310,2,96,32,64,76,66,1,8,1,2
E33003092,315,259,75,184,0,22,8,14,32,26,2,3,1,2
E33003093,206,173,42,131,2,13,5,8,18,13,1,4,0,0
E33003094,308,226,47,179,1,46,12,34,32,28,0,4,0,3
E33003095,196,153,46,107,1,24,5,19,16,15,0,1,0,2
E33003096,526,348,96,252,3,110,39,71,57,54,0,3,0,8
E33003097,282,176,50,126,1,53,15,38,48,45,0,3,0,4
E33003098,760,660,143,517,6,38,15,23,54,50,0,3,1,2
E33003099,215,177,48,129,0,19,6,13,18,18,0,0,0,1
E33003100,190,142,49,93,1,26,8,18,19,18,1,0,0,2
E33003101,608,512,156,356,2,52,14,38,41,35,0,5,1,1
E33003102,381,298,91,207,1,30,11,19,47,40,2,4,1,5
E33003103,340,286,77,209,1,28,13,15,23,21,0,2,0,2
E33003104,683,557,159,398,6,70,18,52,49,45,0,2,2,1
E33003105,489,360,102,258,1,60,24,36,61,57,1,3,0,7
E33003106,544,375,91,284,2,87,31,56,80,73,0,7,0,0
E33003107,332,264,70,194,0,32,12,20,36,32,0,4,0,0
E33003108,278,210,41,169,1,36,17,19,31,30,0,1,0,0
E33003109,356,289,88,201,2,20,7,13,43,38,0,5,0,2
E33003110,1607,1058,275,783,7,251,99,152,281,269,2,10,0,10
E33003111,733,584,157,427,4,57,14,43,85,78,0,6,1,3
E33003112,320,252,68,184,2,29,5,24,36,33,0,3,0,1
E33003113,452,397,115,282,0,22,5,17,31,27,0,3,1,2
E33003114,199,131,30,101,0,32,9,23,35,30,0,3,2,1
E33003115,586,433,97,336,3,75,13,62,73,70,0,3,0,2
E33003116,1075,877,198,679,4,78,16,62,112,100,0,11,1,4
E33003117,202,129,40,89,3,11,3,8,58,52,3,3,0,1
E33003118,454,326,105,221,1,25,6,19,100,96,0,4,0,2
E33003119,589,394,136,258,1,53,16,37,138,129,0,9,0,3
E33003120,194,126,34,92,0,22,5,17,46,41,1,4,0,0
E33003121,285,211,65,146,1,10,0,10,60,59,0,1,0,3
E33003122,337,216,58,158,2,7,2,5,111,102,0,7,2,1
E33003123,231,188,64,124,0,12,3,9,30,29,0,1,0,1
E33003124,792,592,178,414,3,43,15,28,145,138,0,7,0,9
E33003125,328,286,82,204,1,10,5,5,30,27,1,2,0,1
E33003126,267,177,41,136,2,16,5,11,69,65,0,4,0,3
E33003127,234,188,39,149,0,5,3,2,38,35,0,2,1,3
E33003128,202,162,52,110,1,5,1,4,34,33,0,1,0,0
E33003129,498,413,125,288,0,17,9,8,65,55,0,10,0,3
E33003130,332,252,86,166,5,21,5,16,53,47,0,5,1,1
E33003131,202,138,39,99,0,18,5,13,46,40,0,6,0,0
E33003132,317,255,66,189,2,11,1,10,48,45,1,2,0,1
E33003133,451,308,94,214,2,25,5,20,112,105,1,6,0,4
E33003134,582,419,124,295,2,44,15,29,115,108,1,6,0,2
E33003135,790,638,189,449,1,35,8,27,111,100,1,9,1,5
E33003136,394,313,90,223,0,12,3,9,69,64,0,5,0,0
E33003137,380,282,88,194,1,21,9,12,70,65,4,1,0,6
E33003138,763,569,156,413,12,48,13,35,131,114,1,16,0,3
E33003139,515,390,116,274,0,34,8,26,86,80,1,5,0,5
E33003140,2235,1832,502,1330,10,81,30,51,300,277,0,22,1,12
E33003141,654,383,86,297,6,163,42,121,101,91,0,10,0,1
E33003142,504,347,81,266,0,87,21,66,68,62,0,6,0,2
E33003143,161,113,21,92,1,27,6,21,19,19,0,0,0,1
E33003144,264,196,57,139,4,31,7,24,31,29,0,2,0,2
E33003145,213,109,29,80,0,62,14,48,41,37,1,2,1,1
E33003146,265,216,67,149,0,32,8,24,15,14,0,1,0,2
E33003147,313,233,54,179,1,29,11,18,49,45,1,2,1,1
E33003148,207,148,44,104,2,30,8,22,27,25,0,1,1,0
E33003149,428,309,82,227,1,55,14,41,59,52,1,5,1,4
E33003150,585,457,131,326,3,67,19,48,56,52,0,3,1,2
E33003151,1025,751,212,539,6,115,28,87,148,139,0,8,1,5
E33003152,465,346,94,252,2,56,14,42,60,55,1,4,0,1
E33003153,778,564,132,432,6,94,23,71,111,105,0,6,0,3
E33003154,1025,816,176,640,0,66,12,54,137,125,0,12,0,6
E33003155,906,648,163,485,8,95,33,62,151,139,1,9,2,4
E33003156,839,647,165,482,6,83,17,66,101,91,0,9,1,2
E33003157,534,382,110,272,1,34,15,19,115,106,0,8,1,2
E33003158,412,311,97,214,2,19,6,13,78,67,2,9,0,2
E33003159,749,623,174,449,1,57,24,33,66,55,1,10,0,2
E33003160,799,649,222,427,3,37,15,22,104,93,1,8,2,6
E33003161,325,269,91,178,1,16,6,10,39,32,2,4,1,0
E33003162,534,451,133,318,2,20,6,14,59,56,0,3,0,2
E33003163,581,460,87,373,2,65,22,43,52,45,0,6,1,2
E33003164,1340,1113,239,874,7,75,18,57,139,130,0,9,0,6
E33003165,838,649,162,487,5,79,25,54,103,92,0,10,1,2
E33003166,350,291,107,184,2,18,7,11,38,34,0,4,0,1
E33003167,643,473,131,342,2,76,35,41,91,88,0,3,0,1
E33003168,564,403,114,289,2,67,27,40,89,80,0,9,0,3
E33003169,276,183,55,128,0,61,28,33,31,30,0,1,0,1
E33003170,336,243,52,191,0,29,8,21,61,52,0,8,1,3
E33003171,387,298,86,212,1,36,10,26,50,43,2,5,0,2
E33003172,1928,1535,380,1155,15,128,32,96,239,226,1,12,0,11
E33003173,433,342,105,237,3,34,11,23,53,51,0,2,0,1
E33003174,641,500,145,355,3,44,11,33,93,84,1,8,0,1
E33003175,617,489,138,351,5,48,12,36,73,69,0,4,0,2
E33003176,479,368,87,281,4,36,10,26,70,62,1,5,2,1
E33003177,374,245,56,189,1,35,7,28,90,87,0,3,0,3
E33003178,217,176,41,135,2,16,10,6,23,21,0,2,0,0
E33003179,256,172,52,120,1,28,9,19,52,48,0,4,0,3
E33003180,123,97,26,71,0,9,2,7,17,15,0,2,0,0
E33003181,306,197,50,147,5,35,12,23,67,66,0,1,0,2
E33003182,938,678,150,528,4,92,30,62,157,148,1,6,2,7
E33003183,647,406,120,286,3,94,40,54,139,129,0,10,0,5
E33003184,207,138,37,101,1,27,7,20,41,36,1,4,0,0
E33003185,243,165,53,112,4,30,6,24,43,37,0,2,4,1
E33003186,320,196,39,157,1,48,17,31,74,63,0,11,0,1
E33003187,1118,887,206,681,6,69,25,44,153,142,0,9,2,3
E33003188,952,669,177,492,5,101,37,64,172,168,0,3,1,5
E33003189,609,448,100,348,1,71,31,40,87,75,0,12,0,2
E33003190,1179,893,186,707,5,116,50,66,162,151,0,9,2,3
E33003191,551,429,94,335,0,42,21,21,75,68,0,6,1,5
E33003192,396,321,67,254,1,23,11,12,51,48,1,2,0,0
E33003193,375,291,83,208,1,23,10,13,58,57,0,1,0,2
E33003194,472,390,92,298,0,34,17,17,48,45,0,3,0,0
E33003195,312,254,52,202,1,19,8,11,37,35,0,2,0,1
E33003196,523,396,93,303,5,47,14,33,73,70,0,3,0,2
E33003197,900,667,164,503,5,71,20,51,147,137,0,10,0,10
E33003198,604,471,148,323,1,56,26,30,75,64,1,10,0,1
E33003199,334,272,65,207,3,13,6,7,46,39,1,5,1,0
E33003200,2583,2084,566,1518,11,174,87,87,299,279,1,18,1,15
E33003201,245,170,41,129,1,19,4,15,52,50,1,1,0,3
E33003202,427,342,115,227,1,37,18,19,45,42,0,3,0,2
E33003203,333,243,70,173,3,15,10,5,66,64,0,2,0,6
E33003204,251,216,65,151,2,7,4,3,25,20,0,4,1,1
E33003205,238,198,51,147,0,4,2,2,36,31,1,3,1,0
E33003206,249,200,61,139,2,14,7,7,32,29,0,2,1,1
E33003207,217,154,36,118,0,11,3,8,52,47,0,5,0,0
E33003208,532,350,77,273,4,56,21,35,119,113,0,5,1,3
E33003209,634,438,109,329,2,76,30,46,112,102,0,10,0,6
E33003210,4724,3699,892,2807,13,332,160,172,658,608,2,37,11,22
E33003211,666,487,106,381,6,62,15,47,106,95,0,10,1,5
E33003212,232,159,50,109,0,28,4,24,45,41,0,4,0,0
E33003213,630,551,154,397,3,26,7,19,49,46,1,2,0,1
E33003214,437,320,91,229,2,50,25,25,63,58,1,4,0,2
E33003215,1161,779,229,550,2,167,56,111,210,195,0,12,3,3
E33003216,534,421,112,309,3,37,13,24,73,65,0,8,0,0
E33003217,306,249,63,186,1,19,9,10,37,33,0,3,1,0
E33003218,623,459,125,334,3,70,34,36,91,81,1,9,0,0
E33003219,248,187,47,140,2,19,6,13,40,35,0,5,0,0
E33003220,602,447,110,337,1,84,23,61,68,61,1,6,0,2
E33003221,524,367,83,284,3,80,23,57,73,67,0,5,1,1
E33003222,224,165,35,130,1,36,14,22,20,19,0,1,0,2
E33003223,255,214,50,164,2,14,2,12,21,20,0,1,0,4
E33003224,319,268,63,205,2,22,6,16,24,22,0,2,0,3
E33003225,229,180,38,142,3,24,6,18,21,20,0,1,0,1
E33003226,406,317,74,243,2,52,9,43,34,33,0,1,0,1
E33003227,373,300,74,226,0,32,12,20,40,37,0,2,1,1
E33003228,600,481,96,385,4,41,8,33,68,59,0,9,0,6
E33003229,322,233,61,172,4,32,4,28,50,49,1,0,0,3
E33003230,266,200,47,153,3,13,3,10,49,45,0,4,0,1
E33003231,370,291,62,229,4,26,12,14,43,42,0,1,0,6
E33003232,331,257,66,191,4,22,4,18,46,45,0,0,1,2
E33003233,406,323,74,249,2,43,10,33,37,29,0,8,0,1
E33003234,400,286,64,222,7,58,11,47,47,44,0,3,0,2
E33003235,275,225,68,157,1,23,5,18,26,23,0,3,0,0
E33003236,414,322,97,225,2,54,15,39,35,34,0,1,0,1
E33003237,613,463,94,369,9,73,13,60,68,63,1,4,0,0
E33003238,1473,1136,182,954,17,134,24,110,180,168,2,9,1,6
E33003239,664,500,112,388,10,93,18,75,59,54,0,4,1,2
E33003240,245,193,39,154,4,18,4,14,29,28,0,1,0,1
E33003241,405,325,92,233,3,33,6,27,43,42,0,1,0,1
E33003242,245,195,62,133,2,29,7,22,19,19,0,0,0,0
E33003243,237,146,41,105,1,75,10,65,13,13,0,0,0,2
E33003244,966,589,165,424,3,280,38,242,92,79,0,11,2,2
E33003245,513,326,67,259,8,134,15,119,43,37,0,4,2,2
E33003246,356,275,89,186,3,45,8,37,31,26,0,4,1,2
E33003247,489,398,113,285,7,57,3,54,26,26,0,0,0,1
E33003248,382,268,88,180,3,56,18,38,53,51,0,2,0,2
E33003249,274,222,44,178,2,23,5,18,27,24,0,3,0,0
E33003250,338,273,77,196,4,33,12,21,28,24,0,4,0,0
E33003251,425,340,87,253,1,48,14,34,34,32,0,2,0,2
E33003252,252,208,59,149,0,25,2,23,19,13,0,6,0,0
E33003253,738,627,167,460,4,34,5,29,66,61,0,5,0,7
E33003254,412,298,99,199,0,83,21,62,27,24,0,3,0,4
E33003255,1300,1071,289,782,5,142,32,110,79,71,0,6,2,3
E33003256,280,220,57,163,2,31,11,20,25,21,0,4,0,2
E33003257,231,174,53,121,2,28,1,27,27,26,0,0,1,0
E33003258,458,300,76,224,7,89,20,69,60,53,1,5,1,2
E33003259,240,179,37,142,2,29,10,19,27,24,0,1,2,3
E33003260,911,532,98,434,7,151,52,99,218,205,3,8,2,3
E33003261,212,169,42,127,0,20,2,18,23,22,0,1,0,0
E33003262,277,203,54,149,1,41,14,27,32,27,2,3,0,0
E33003263,270,197,59,138,2,43,9,34,28,28,0,0,0,0
E33003264,310,215,38,177,0,50,19,31,43,42,0,0,1,2
E33003265,438,305,74,231,2,63,17,46,67,64,0,2,1,1
E33003266,291,209,53,156,0,37,15,22,40,35,1,4,0,5
E33003267,736,579,153,426,11,68,27,41,78,68,0,10,0,0
E33003268,368,287,75,212,1,36,18,18,43,42,0,1,0,1
E33003269,671,541,157,384,2,63,27,36,64,54,2,7,1,1
E33003270,898,667,129,538,5,90,41,49,133,122,2,6,3,3
E33003271,467,380,108,272,4,43,14,29,39,34,0,5,0,1
E33003272,370,323,68,255,2,18,6,12,27,24,1,2,0,0
E33003273,510,405,103,302,4,48,14,34,51,44,0,7,0,2
E33003274,123,86,24,62,0,23,12,11,10,9,0,1,0,4
E33003275,273,197,47,150,0,24,14,10,51,45,0,6,0,1
E33003276,202,143,54,89,1,27,10,17,30,27,0,3,0,1
E33003277,199,149,49,100,3,17,6,11,28,21,1,4,2,2
E33003278,308,249,71,178,2,21,10,11,36,31,0,5,0,0
E33003279,227,165,40,125,0,22,9,13,40,34,0,4,2,0
E33003280,437,295,55,240,5,69,45,24,65,59,0,6,0,3
E33003281,955,680,174,506,10,165,70,95,99,93,0,5,1,1
E33003282,305,244,76,168,2,26,15,11,32,28,0,4,0,1
E33003283,524,368,99,269,2,72,37,35,81,75,0,6,0,1
E33003284,235,185,46,139,0,24,7,17,25,23,0,2,0,1
E33003285,552,445,99,346,6,37,16,21,61,56,0,5,0,3
E33003286,258,190,57,133,1,37,16,21,30,28,0,2,0,0
E33003287,822,684,158,526,6,53,26,27,79,78,1,0,0,0
E33003288,578,412,106,306,1,68,20,48,96,93,0,3,0,1
E33003289,358,301,73,228,1,16,7,9,39,37,0,2,0,1
E33003290,556,407,88,319,3,57,23,34,85,78,0,6,1,4
E33003291,1645,1331,323,1008,6,53,14,39,250,227,1,20,2,5
E33003292,1203,988,223,765,9,41,15,26,160,153,0,5,2,5
E33003293,1438,1009,224,785,14,136,42,94,269,240,0,27,2,10
E33003294,520,407,89,318,2,62,21,41,48,44,0,4,0,1
E33003295,928,735,162,573,6,71,31,40,112,101,0,10,1,4
E33003296,603,423,86,337,2,66,32,34,111,100,0,10,1,1
E33003297,773,575,188,387,6,87,39,48,98,86,2,8,2,7
E33003298,360,273,73,200,3,52,25,27,31,30,0,1,0,1
E33003299,911,702,150,552,9,79,31,48,119,108,0,9,2,2
E33003300,756,619,176,443,5,47,20,27,83,73,0,10,0,2
E33003301,536,373,89,284,1,90,48,42,71,69,0,2,0,1
E33003302,294,174,42,132,2,48,23,25,66,58,1,6,1,4
E33003303,310,235,52,183,3,37,13,24,34,31,0,3,0,1
E33003304,578,463,114,349,2,64,30,34,47,39,1,5,2,2
E33003305,651,497,124,373,7,69,30,39,76,65,0,5,6,2
E33003306,847,683,126,557,5,39,13,26,117,110,0,6,1,3
E33003307,321,231,59,172,1,39,22,17,49,46,1,2,0,1
E33003308,660,458,116,342,4,107,40,67,86,80,0,6,0,5
E33003309,1218,952,267,685,9,122,61,61,135,127,0,7,1,0
E33003310,629,480,142,338,4,79,37,42,66,60,0,5,1,0
E33003311,261,222,74,148,0,19,10,9,20,19,0,1,0,0
E33003312,403,164,44,120,3,34,10,24,201,200,0,1,0,1
E33003313,2443,1687,406,1281,16,261,119,142,467,447,2,17,1,12
E33003314,248,175,43,132,1,35,15,20,32,29,1,2,0,5
E33003315,647,504,148,356,2,37,13,24,94,87,1,6,0,10
E33003316,725,566,154,412,5,89,30,59,65,58,0,6,1,0
E33003317,470,353,90,263,5,49,28,21,61,57,0,4,0,2
E33003318,271,230,59,171,3,9,3,6,29,29,0,0,0,0
E33003319,988,755,161,594,6,80,32,48,144,137,0,7,0,3
E33003320,1287,1051,283,768,9,102,45,57,121,112,0,9,0,4
E33003321,470,397,88,309,3,24,11,13,42,38,1,3,0,4
E33003322,853,646,127,519,4,63,25,38,138,126,0,12,0,2
E33003323,209,172,92,80,1,15,5,10,18,17,1,0,0,3
E33003324,789,630,175,455,1,55,19,36,93,84,1,6,2,10
E33003325,268,196,75,121,3,22,3,19,42,37,0,5,0,5
E33003326,457,355,123,232,1,57,8,49,39,35,0,3,1,5
E33003327,548,402,145,257,4,60,19,41,79,72,1,5,1,3
E33003328,801,625,180,445,4,55,14,41,114,98,1,15,0,3
E33003329,269,212,80,132,0,17,8,9,32,31,0,1,0,8
E33003330,646,497,117,380,8,40,12,28,99,92,0,7,0,2
E33003331,580,437,138,299,0,47,13,34,93,84,0,9,0,3
E33003332,733,580,155,425,2,49,14,35,98,85,0,13,0,4
E33003333,752,606,191,415,2,47,19,28,93,82,0,11,0,4
E33003334,227,181,62,119,1,22,7,15,21,18,2,1,0,2
E33003335,737,597,149,448,2,37,11,26,94,90,0,4,0,7
E33003336,409,328,107,221,2,23,5,18,52,44,2,6,0,4
E33003337,500,364,131,233,3,60,21,39,68,63,1,4,0,5
E33003338,522,435,128,307,2,25,6,19,57,54,1,2,0,3
E33003339,550,393,121,272,2,64,23,41,89,82,1,6,0,2
E33003340,3960,3153,811,2342,13,187,76,111,589,523,33,28,5,18
E33003341,861,614,213,401,9,93,32,61,142,120,1,16,5,3
E33003342,248,194,69,125,0,27,7,20,27,23,0,4,0,0
E33003343,452,337,92,245,5,42,18,24,65,63,0,2,0,3
E33003344,686,437,123,314,2,99,47,52,144,136,0,6,2,4
E33003345,339,247,56,191,0,39,9,30,53,47,0,3,3,0
E33003346,226,184,60,124,0,23,13,10,15,14,0,1,0,4
E33003347,454,343,133,210,0,42,15,27,66,60,0,6,0,3
E33003348,337,273,87,186,0,19,10,9,44,39,0,5,0,1
E33003349,428,321,76,245,2,36,16,20,66,62,2,2,0,3
E33003350,711,559,174,385,5,63,23,40,73,65,0,8,0,11
E33003351,269,197,51,146,2,22,7,15,43,40,1,2,0,5
E33003352,202,175,40,135,0,6,1,5,21,17,0,4,0,0
E33003353,288,234,67,167,4,16,1,15,30,27,2,1,0,4
E33003354,213,190,74,116,2,2,2,0,18,16,0,2,0,1
E33003355,494,410,142,268,2,29,10,19,49,41,1,7,0,4
E33003356,417,288,93,195,3,54,20,34,72,68,0,3,1,0
E33003357,370,289,91,198,1,21,7,14,58,54,1,3,0,1
E33003358,546,382,117,265,2,47,19,28,112,103,0,9,0,3
E33003359,269,229,81,148,1,11,0,11,24,19,3,2,0,4
E33003360,311,250,93,157,2,13,6,7,42,37,0,4,1,4
E33003361,349,242,90,152,2,43,11,32,59,53,0,6,0,3
E33003362,385,313,88,225,2,24,6,18,46,45,0,1,0,0
E33003363,1898,1571,475,1096,9,117,42,75,191,163,1,24,3,10
E33003364,259,178,59,119,4,22,8,14,46,37,0,6,3,9
E33003365,515,405,89,316,3,25,7,18,80,66,2,11,1,2
E33003366,224,163,48,115,0,18,7,11,41,37,0,4,0,2
E33003367,516,400,133,267,1,28,11,17,86,77,1,8,0,1
E33003368,305,236,78,158,0,23,6,17,42,41,0,1,0,4
E33003369,1045,880,267,613,3,48,11,37,105,97,1,6,1,9
E33003370,690,575,138,437,4,27,11,16,81,73,0,7,1,3
E33003371,237,171,56,115,1,17,7,10,44,42,0,2,0,4
E33003372,521,400,144,256,2,48,9,39,65,52,0,12,1,6
E33003373,278,210,76,134,0,31,10,21,35,31,2,1,1,2
E33003374,278,202,61,141,0,18,6,12,55,50,1,2,2,3
E33003375,215,164,51,113,0,15,6,9,34,29,0,2,3,2
E33003376,411,335,99,236,0,38,5,33,37,30,0,2,5,1
E33003377,263,207,83,124,1,18,5,13,35,30,1,4,0,2
E33003378,234,177,49,128,0,22,9,13,34,29,2,3,0,1
E33003379,369,211,67,144,1,27,17,10,122,117,0,5,0,8
E33003380,890,695,171,524,3,24,10,14,160,147,2,9,2,8
E33003381,634,464,126,338,1,39,22,17,125,121,0,4,0,5
E33003382,171,114,27,87,0,11,6,5,43,43,0,0,0,3
E33003383,187,94,16,78,0,18,13,5,68,63,2,3,0,7
E33003384,250,181,48,133,0,10,5,5,56,52,1,3,0,3
E33003385,261,178,44,134,0,8,4,4,75,72,0,3,0,0
E33003386,177,108,31,77,0,10,4,6,58,54,0,2,2,1
E33003387,1244,881,241,640,3,83,49,34,272,248,1,22,1,5
E33003388,403,297,83,214,0,32,15,17,73,67,1,4,1,1
E33003389,435,336,81,255,1,34,16,18,60,57,1,2,0,4
E33003390,661,468,102,366,2,32,18,14,158,142,5,9,2,1
E33003391,2923,2528,662,1866,11,93,41,52,277,254,0,23,0,14
E33003392,334,215,46,169,2,16,10,6,95,81,2,11,1,6
E33003393,657,555,121,434,5,13,3,10,83,71,3,8,1,1
E33003394,464,375,105,270,1,18,10,8,67,58,0,9,0,3
E33003395,939,756,241,515,8,41,19,22,132,117,0,13,2,2
E33003396,209,169,58,111,0,8,5,3,29,27,1,1,0,3
E33003397,1201,924,194,730,6,59,22,37,210,185,2,22,1,2
E33003398,904,615,145,470,5,52,21,31,229,211,3,13,2,3
E33003399,276,185,49,136,0,22,10,12,66,58,1,7,0,3
E33003400,255,144,37,107,1,20,12,8,88,86,0,1,1,2
E33003401,350,266,60,206,2,22,11,11,57,52,0,4,1,3
E33003402,413,307,106,201,1,26,17,9,78,69,1,8,0,1
E33003403,288,205,43,162,1,10,4,6,72,64,0,7,1,0
E33003404,146,100,34,66,1,9,7,2,35,32,0,3,0,1
E33003405,682,587,101,486,3,15,2,13,76,67,2,6,1,1
E33003406,288,164,46,118,1,23,10,13,97,89,0,8,0,3
E33003407,255,141,32,109,0,18,11,7,94,88,2,4,0,2
E33003408,87,46,17,29,0,6,4,2,33,31,0,1,1,2
E33003409,286,209,55,154,1,11,3,8,65,63,0,2,0,0
E33003410,294,207,40,167,0,23,17,6,61,59,0,2,0,3
E33003411,324,246,47,199,0,12,6,6,63,59,0,4,0,3
E33003412,231,158,34,124,1,12,7,5,60,57,0,3,0,0
E33003413,927,672,152,520,2,53,31,22,193,166,4,21,2,7
E33003414,747,570,161,409,5,36,21,15,133,119,0,14,0,3
E33003415,201,138,38,100,3,10,4,6,46,41,2,3,0,4
E33003416,296,236,66,170,1,16,8,8,43,40,0,3,0,0
E33003417,278,204,55,149,3,11,5,6,55,51,0,2,2,5
E33003418,224,176,45,131,0,7,4,3,41,35,0,6,0,0
E33003419,303,237,55,182,0,20,8,12,45,40,0,4,1,1
E33003420,365,234,49,185,3,24,11,13,103,91,0,11,1,1
E33003421,239,170,32,138,0,11,5,6,58,56,0,2,0,0
E33003422,520,424,122,302,1,13,7,6,81,75,1,5,0,1
E33003423,544,354,86,268,1,31,16,15,154,149,1,2,2,4
E33003424,219,166,51,115,3,10,2,8,40,38,0,2,0,0
E33003425,1093,837,203,634,4,114,58,56,130,115,5,10,0,8
E33003426,281,221,55,166,1,12,7,5,43,41,0,1,1,4
E33003427,264,195,41,154,2,20,8,12,44,43,0,1,0,3
E33003428,360,234,87,147,0,35,14,21,88,83,0,4,1,3
E33003429,393,252,76,176,3,50,24,26,82,80,0,2,0,6
E33003430,310,233,78,155,3,16,7,9,58,57,0,1,0,0
E33003431,211,146,49,97,0,13,5,8,50,48,1,1,0,2
E33003432,836,625,143,482,4,59,29,30,141,128,0,12,1,7
E33003433,331,225,63,162,2,15,12,3,86,82,0,4,0,3
E33003434,1021,655,166,489,11,132,57,75,219,204,4,11,0,4
E33003435,392,223,65,158,2,44,21,23,118,107,3,8,0,5
E33003436,545,363,98,265,3,74,29,45,100,92,2,5,1,5
E33003437,269,221,68,153,1,10,5,5,35,32,0,2,1,2
E33003438,572,342,78,264,3,80,31,49,145,131,0,10,4,2
E33003439,246,207,55,152,1,10,4,6,27,24,2,1,0,1
E33003440,478,372,100,272,5,39,15,24,57,52,0,4,1,5
E33003441,848,595,202,393,7,80,36,44,162,140,7,11,4,4
E33003442,256,165,59,106,1,28,13,15,52,49,0,2,1,10
E33003443,287,205,57,148,5,31,11,20,43,40,2,1,0,3
E33003444,669,423,123,300,3,50,18,32,187,169,3,14,1,6
E33003445,324,242,70,172,3,23,12,11,51,47,2,2,0,5
E33003446,773,486,139,347,12,55,25,30,211,199,1,8,3,9
E33003447,627,330,92,238,8,57,19,38,229,213,1,7,8,3
E33003448,286,188,49,139,2,34,11,23,58,52,1,3,2,4
E33003449,1073,890,239,651,9,67,31,36,100,92,1,7,0,7
E33003450,195,131,42,89,3,13,8,5,46,44,0,2,0,2
E33003451,248,201,59,142,2,23,15,8,22,20,0,1,1,0
E33003452,396,313,69,244,1,17,6,11,64,61,0,2,1,1
E33003453,434,306,102,204,2,44,21,23,82,75,0,5,2,0
E33003454,254,167,52,115,1,17,8,9,67,64,0,1,2,2
E33003455,405,295,74,221,4,34,14,20,71,63,0,8,0,1
E33003456,405,312,74,238,3,17,7,10,70,67,0,2,1,3
E33003457,357,301,69,232,4,14,9,5,36,31,1,4,0,2
E33003458,678,480,137,343,10,70,31,39,114,99,1,14,0,4
E33003459,337,224,73,151,0,54,24,30,54,51,0,2,1,5
E33003460,359,284,76,208,3,26,13,13,44,40,1,2,1,2
E33003461,800,608,158,450,11,84,31,53,94,86,1,7,0,3
E33003462,298,234,58,176,0,17,8,9,46,44,0,2,0,1
E33003463,595,378,68,310,6,77,25,52,131,123,1,6,1,3
E33003464,312,212,48,164,3,31,22,9,63,63,0,0,0,3
E33003465,678,434,131,303,2,100,37,63,140,129,1,9,1,2
E33003466,289,228,63,165,1,31,16,15,25,23,0,2,0,4
E33003467,604,465,136,329,5,69,28,41,63,59,0,4,0,2
E33003468,370,289,78,211,5,14,8,6,58,55,0,3,0,4
E33003469,472,369,96,273,2,15,8,7,81,69,2,9,1,5
E33003470,312,211,59,152,2,36,17,19,41,32,7,2,0,22
E33003471,1013,798,117,681,8,47,19,28,155,146,0,9,0,5
E33003472,1224,1020,138,882,10,30,13,17,159,142,0,15,2,5
E33003473,360,246,55,191,3,41,15,26,66,63,0,2,1,4
E33003474,451,316,77,239,5,28,14,14,97,91,0,5,1,5
E33003475,253,200,37,163,1,7,2,5,44,44,0,0,0,1
E33003476,286,230,56,174,2,13,6,7,41,38,0,3,0,0
E33003477,644,499,145,354,6,40,21,19,97,81,1,14,1,2
E33003478,393,276,95,181,3,20,9,11,89,82,0,5,2,5
E33003479,351,265,71,194,2,22,19,3,56,53,0,3,0,6
E33003480,1068,924,283,641,5,39,19,20,97,93,0,4,0,3
E33003481,501,250,52,198,3,51,19,32,196,73,79,4,40,1
E33003482,473,370,89,281,3,19,4,15,73,68,2,3,0,8
E33003483,346,266,75,191,2,17,9,8,54,51,2,1,0,7
E33003484,5033,4025,1043,2982,31,318,160,158,637,575,8,38,16,22
E33003485,317,270,82,188,0,19,10,9,27,22,1,4,0,1
E33003486,520,399,106,293,2,38,13,25,75,68,0,7,0,6
E33003487,505,414,105,309,1,46,12,34,41,37,0,3,1,3
E33003488,282,219,79,140,0,18,7,11,42,33,0,8,1,3
E33003489,826,668,197,471,1,48,18,30,103,100,0,3,0,6
E33003490,484,378,132,246,1,50,15,35,50,47,2,1,0,5
E33003491,248,193,69,124,1,11,1,10,41,34,4,3,0,2
E33003492,626,517,161,356,0,48,15,33,57,51,0,5,1,4
E33003493,238,200,69,131,0,10,1,9,27,22,0,4,1,1
E33003494,142,116,36,80,1,8,1,7,14,14,0,0,0,3
E33003495,474,407,133,274,0,17,7,10,48,45,1,2,0,2
E33003496,514,421,109,312,1,22,8,14,68,63,0,5,0,2
E33003497,237,182,47,135,2,22,11,11,29,24,1,3,1,2
E33003498,226,187,61,126,0,23,10,13,14,13,0,1,0,2
E33003499,903,768,179,589,2,44,19,25,86,81,0,2,3,3
E33003500,432,366,102,264,3,25,8,17,37,32,0,5,0,1
E33003501,277,211,52,159,0,15,1,14,51,48,1,2,0,0
E33003502,235,197,48,149,0,15,4,11,22,18,1,3,0,1
E33003503,478,376,109,267,1,32,9,23,63,54,0,6,3,6
E33003504,988,804,225,579,2,50,14,36,127,116,2,9,0,5
E33003505,558,448,134,314,2,25,4,21,78,72,0,3,3,5
E33003506,218,177,44,133,2,11,6,5,25,24,0,1,0,3
E33003507,397,314,85,229,2,28,11,17,52,49,0,2,1,1
E33003508,220,172,50,122,2,19,12,7,26,26,0,0,0,1
E33003509,352,246,72,174,4,29,10,19,70,60,0,6,4,3
E33003510,609,477,129,348,2,44,15,29,82,78,0,3,1,4
E33003511,437,354,107,247,2,27,6,21,50,43,0,6,1,4
E33003512,227,195,65,130,0,8,6,2,24,22,0,2,0,0
E33003513,713,521,182,339,6,82,29,53,102,96,0,5,1,2
E33003514,213,125,35,90,1,12,6,6,73,70,1,1,1,2
E33003515,704,506,146,360,1,65,26,39,127,115,2,9,1,5
E33003516,685,462,113,349,3,75,30,45,142,132,0,8,2,3
E33003517,369,239,56,183,3,49,28,21,77,70,0,6,1,1
E33003518,540,435,125,310,1,26,12,14,75,67,2,5,1,3
E33003519,246,183,44,139,1,26,10,16,35,33,1,1,0,1
E33003520,302,182,44,138,1,32,12,20,83,79,2,2,0,4
E33003521,344,303,74,229,3,8,2,6,28,28,0,0,0,2
E33003522,482,427,129,298,0,13,3,10,41,38,0,3,0,1
E33003523,288,224,49,175,2,21,10,11,40,36,0,3,1,1
E33003524,201,150,47,103,1,20,7,13,30,26,1,3,0,0
E33003525,1114,886,277,609,2,89,43,46,134,118,0,7,9,3
E33003526,207,157,39,118,1,5,3,2,42,36,0,0,6,2
E33003527,292,226,42,184,0,12,3,9,54,52,0,2,0,0
E33003528,431,289,66,223,1,33,9,24,107,99,0,8,0,1
E33003529,4459,3709,762,2947,13,202,70,132,529,485,4,39,1,6
E33003530,262,213,60,153,2,12,6,6,33,31,0,1,1,2
E33003531,285,216,61,155,0,26,8,18,42,39,0,2,1,1
E33003532,737,531,118,413,2,53,19,34,150,135,0,14,1,1
E33003533,752,548,127,421,1,77,34,43,124,117,1,6,0,2
E33003534,207,161,50,111,1,17,3,14,27,18,0,7,2,1
E33003535,286,221,54,167,0,20,8,12,43,34,0,9,0,2
E33003536,315,246,61,185,1,25,9,16,42,38,0,4,0,1
E33003537,243,208,54,154,0,9,2,7,25,23,0,2,0,1
E33003538,291,210,50,160,0,31,14,17,47,45,0,2,0,3
E33003539,529,395,88,307,2,43,11,32,82,75,1,4,2,7
E33003540,253,192,44,148,1,3,1,2,53,49,0,4,0,4
E33003541,352,239,82,157,4,46,19,27,61,56,0,5,0,2
E33003542,307,244,79,165,2,14,1,13,45,40,0,3,2,2
E33003543,220,173,52,121,1,11,3,8,35,32,1,2,0,0
E33003544,364,282,54,228,4,32,11,21,39,35,2,2,0,7
E33003545,423,290,57,233,2,69,57,12,61,53,1,7,0,1
E33003546,397,310,81,229,0,47,38,9,39,39,0,0,0,1
E33003547,533,462,131,331,6,24,14,10,38,33,0,5,0,3
E33003548,212,158,36,122,2,19,15,4,31,29,0,1,1,2
E33003549,490,353,89,264,1,82,68,14,51,43,0,8,0,3
E33003550,308,226,57,169,4,38,25,13,38,35,0,3,0,2
E33003551,281,228,57,171,0,24,14,10,26,22,0,0,4,3
E33003552,199,163,29,134,3,20,15,5,13,12,0,1,0,0
E33003553,266,214,52,162,0,19,11,8,32,27,0,5,0,1
E33003554,289,215,58,157,2,26,14,12,45,45,0,0,0,1
E33003555,1582,1150,279,871,7,192,148,44,220,196,2,20,2,13
E33003556,1793,1494,303,1191,4,142,66,76,149,132,1,16,0,4
E33003557,563,426,114,312,2,22,8,14,108,92,3,12,1,5
E33003558,248,182,44,138,3,11,1,10,50,45,0,5,0,2
E33003559,703,536,131,405,3,32,11,21,129,124,3,2,0,3
E33003560,4379,3769,810,2959,14,65,19,46,512,493,5,14,0,19
E33003561,219,172,44,128,1,15,2,13,29,24,2,3,0,2
E33003562,354,287,82,205,5,15,5,10,47,43,0,2,2,0
E33003563,804,585,135,450,7,86,35,51,125,118,0,7,0,1
E33003564,1282,1007,327,680,8,131,44,87,132,120,1,11,0,4
E33003565,954,748,188,560,3,55,21,34,142,132,0,9,1,6
E33003566,324,243,107,136,4,25,15,10,44,36,0,6,2,8
E33003567,218,162,46,116,5,15,2,13,34,31,0,3,0,2
E33003568,438,329,129,200,2,41,10,31,63,59,1,2,1,3
E33003569,311,231,55,176,4,22,6,16,53,48,1,4,0,1
E33003570,536,389,119,270,4,24,7,17,114,103,4,7,0,5
E33003571,202,156,30,126,1,13,5,8,31,28,1,2,0,1
E33003572,426,276,54,222,2,18,1,17,128,120,0,8,0,2
E33003573,222,164,47,117,0,20,5,15,38,27,5,4,2,0
E33003574,248,179,46,133,4,6,4,2,59,56,0,2,1,0
E33003575,287,202,45,157,2,21,5,16,61,54,0,7,0,1
E33003576,276,187,51,136,2,31,6,25,55,50,0,5,0,1
E33003577,327,252,73,179,1,32,14,18,39,38,0,1,0,3
E33003578,457,342,69,273,1,14,5,9,98,94,0,4,0,2
E33003579,506,393,98,295,2,16,3,13,92,84,0,8,0,3
E33003580,1050,855,223,632,10,40,5,35,139,120,0,19,0,6
E33003581,304,254,69,185,1,13,2,11,34,33,0,0,1,2
E33003582,227,156,40,116,0,26,4,22,44,40,2,2,0,1
E33003583,317,217,68,149,2,26,12,14,70,62,2,5,1,2
E33003584,227,167,48,119,2,22,6,16,32,30,0,2,0,4
E33003585,215,176,51,125,0,11,3,8,26,26,0,0,0,2
E33003586,563,416,112,304,4,34,7,27,104,94,1,6,3,5
E33003587,821,579,184,395,5,65,17,48,166,155,3,8,0,6
E33003588,954,802,209,593,2,14,5,9,132,125,1,6,0,4
E33003589,913,715,190,525,8,93,31,62,93,84,0,8,1,4
E33003590,272,201,46,155,1,23,5,18,47,45,0,2,0,0
E33003591,2437,1910,493,1417,11,144,47,97,357,329,2,24,2,15
E33003592,493,350,94,256,2,46,26,20,94,85,1,6,2,1
E33003593,474,349,106,243,2,38,12,26,77,68,2,3,4,8
E33003594,457,340,96,244,3,33,8,25,76,59,0,17,0,5
E33003595,596,409,115,294,6,56,15,41,119,103,0,15,1,6
E33003596,431,330,81,249,4,23,11,12,73,62,2,9,0,1
E33003597,751,561,131,430,0,68,19,49,119,106,0,12,1,3
E33003598,2153,1771,377,1394,12,76,27,49,290,273,0,14,3,4
E33003599,414,301,80,221,6,34,15,19,73,67,0,6,0,0
E33003600,304,211,61,150,2,14,2,12,71,64,5,2,0,6
E33003601,280,198,86,112,2,29,20,9,49,42,6,1,0,2
E33003602,883,645,172,473,16,89,26,63,125,116,1,7,1,8
E33003603,3022,2579,502,2077,14,59,26,33,354,337,2,11,4,16
E33003604,658,556,172,384,2,28,10,18,68,62,2,4,0,4
E33003605,226,156,57,99,3,11,6,5,51,48,0,1,2,5
E33003606,1030,774,205,569,6,76,33,43,172,157,2,13,0,2
E33003607,373,308,86,222,2,15,8,7,47,41,0,6,0,1
E33003608,232,190,57,133,1,21,13,8,19,16,0,2,1,1
E33003609,244,194,66,128,0,9,2,7,37,32,0,5,0,4
E33003610,273,206,62,144,3,27,12,15,34,28,0,2,4,3
E33003611,223,187,69,118,2,11,2,9,22,21,1,0,0,1
E33003612,248,196,53,143,1,24,7,17,25,23,0,1,1,2
E33003613,202,156,61,95,0,18,5,13,26,22,0,4,0,2
E33003614,591,510,148,362,3,26,15,11,47,45,1,1,0,5
E33003615,480,389,107,282,3,35,11,24,50,43,1,5,1,3
E33003616,256,205,47,158,0,10,7,3,41,38,0,2,1,0
E33003617,468,377,109,268,3,39,25,14,46,39,0,7,0,3
E33003618,887,731,198,533,3,56,22,34,94,85,1,8,0,3
E33003619,281,204,41,163,2,28,15,13,45,42,0,2,1,2
E33003620,747,581,179,402,11,73,37,36,79,73,0,6,0,3
E33003621,221,177,45,132,1,17,8,9,24,21,0,3,0,2
E33003622,232,191,42,149,4,10,2,8,26,23,0,3,0,1
E33003623,271,184,58,126,4,41,17,24,38,36,0,2,0,4
E33003624,207,178,40,138,1,9,3,6,19,18,0,1,0,0
E33003625,213,160,40,120,1,17,9,8,34,26,2,6,0,1
E33003626,325,239,71,168,3,39,21,18,42,39,2,1,0,2
E33003627,274,174,54,120,1,52,26,26,46,45,0,1,0,1
E33003628,671,506,137,369,6,56,25,31,102,92,1,9,0,1
E33003629,270,188,34,154,6,29,17,12,47,45,0,2,0,0
E33003630,992,753,184,569,9,103,59,44,123,113,0,10,0,4
E33003631,635,449,116,333,11,41,20,21,134,124,0,9,1,0
E33003632,530,423,115,308,3,22,5,17,81,75,0,6,0,1
E33003633,1344,1112,202,910,20,72,33,39,134,119,3,12,0,6
E33003634,1506,936,242,694,13,203,99,104,343,325,4,14,0,11
E33003635,1101,892,258,634,7,91,30,61,107,98,0,7,2,4
E33003636,444,321,76,245,0,58,28,30,64,60,1,3,0,1
E33003637,221,176,52,124,2,17,7,10,26,25,0,0,1,0
E33003638,994,726,182,544,2,121,54,67,142,128,1,13,0,3
E33003639,2043,1805,330,1475,11,51,20,31,170,151,3,16,0,6
E33003640,312,244,69,175,2,34,20,14,30,24,0,6,0,2
E33003641,242,183,50,133,4,25,9,16,28,20,6,2,0,2
E33003642,392,265,106,159,6,50,3,47,62,52,3,5,2,9
E33003643,487,403,134,269,3,39,9,30,37,35,0,2,0,5
E33003644,415,328,120,208,6,29,2,27,50,42,0,6,2,2
E33003645,503,369,116,253,3,53,4,49,75,66,4,3,2,3
E33003646,213,174,53,121,1,15,6,9,21,19,0,2,0,2
E33003647,468,360,117,243,1,60,15,45,44,41,0,3,0,3
E33003648,216,156,46,110,2,36,12,24,19,18,0,0,1,3
E33003649,662,529,189,340,2,58,8,50,66,60,1,5,0,7
E33003650,846,618,195,423,6,125,33,92,95,89,2,4,0,2
E33003651,228,143,59,84,2,31,4,27,48,46,1,0,1,4
E33003652,315,185,75,110,5,54,6,48,62,54,2,5,1,9
E33003653,192,80,33,47,3,52,9,43,51,36,9,2,4,6
E33003654,192,119,43,76,2,34,6,28,35,30,1,4,0,2
E33003655,210,137,52,85,3,32,7,25,34,25,1,5,3,4
E33003656,310,210,67,143,0,77,16,61,20,17,0,3,0,3
E33003657,263,190,68,122,0,49,7,42,22,20,0,2,0,2
E33003658,576,383,116,267,1,115,22,93,70,61,2,7,0,7
E33003659,312,224,87,137,0,52,5,47,33,26,1,6,0,3
E33003660,781,548,169,379,3,121,25,96,101,84,3,11,3,8
E33003661,313,281,57,224,0,16,2,14,14,13,0,0,1,2
E33003662,608,449,123,326,2,100,18,82,55,49,0,6,0,2
E33003663,618,463,149,314,3,94,9,85,56,47,1,7,1,2
E33003664,237,180,65,115,0,42,6,36,14,10,0,4,0,1
E33003665,792,655,225,430,2,60,5,55,72,58,1,13,0,3
E33003666,735,528,171,357,1,140,22,118,62,54,2,6,0,4
E33003667,555,466,137,329,1,48,8,40,39,32,3,3,1,1
E33003668,317,256,75,181,0,37,5,32,22,22,0,0,0,2
E33003669,738,511,146,365,0,158,20,138,62,53,0,8,1,7
E33003670,488,367,111,256,3,66,15,51,48,41,1,4,2,4
E33003671,956,781,249,532,5,106,27,79,60,54,1,5,0,4
E33003672,325,255,101,154,0,26,4,22,40,35,1,4,0,4
E33003673,938,775,267,508,2,62,12,50,96,84,0,12,0,3
E33003674,421,333,83,250,1,19,9,10,65,55,0,9,1,3
E33003675,6309,5473,1390,4083,8,187,132,55,615,550,4,53,8,26
E33003676,207,182,47,135,0,9,8,1,15,12,1,2,0,1
E33003677,298,227,73,154,1,22,14,8,45,41,0,4,0,3
E33003678,250,201,50,151,0,18,10,8,30,23,0,6,1,1
E33003679,425,384,83,301,0,11,10,1,28,25,0,3,0,2
E33003680,778,590,143,447,3,68,51,17,110,94,3,11,2,7
E33003681,306,239,76,163,1,26,20,6,37,31,0,6,0,3
E33003682,373,295,81,214,0,17,14,3,57,49,0,8,0,4
E33003683,398,317,76,241,0,18,16,2,61,54,1,6,0,2
E33003684,230,172,44,128,0,9,9,0,46,42,0,4,0,3
E33003685,549,399,96,303,1,52,38,14,87,81,0,6,0,10
E33003686,475,407,121,286,0,19,16,3,46,38,0,8,0,3
E33003687,429,307,61,246,0,43,34,9,77,72,1,3,1,2
E33003688,265,232,44,188,1,8,5,3,21,18,0,3,0,3
E33003689,430,345,81,264,1,28,16,12,53,45,0,7,1,3
E33003690,526,413,100,313,1,27,21,6,83,72,1,10,0,2
E33003691,487,402,135,267,3,17,14,3,60,55,1,3,1,5
E33003692,249,192,60,132,0,13,7,6,41,37,2,1,1,3
E33003693,917,716,222,494,0,74,55,19,117,102,3,10,2,10
E33003694,311,256,67,189,1,19,16,3,32,23,0,8,1,3
E33003695,311,233,64,169,0,15,5,10,60,58,0,2,0,3
E33003696,205,175,54,121,0,5,2,3,25,25,0,0,0,0
E33003697,311,234,69,165,2,20,1,19,54,51,0,3,0,1
E33003698,929,758,241,517,5,54,8,46,107,93,1,13,0,5
E33003699,876,662,187,475,6,79,19,60,122,102,6,14,0,7
E33003700,468,373,116,257,4,23,7,16,65,55,5,5,0,3
E33003701,750,605,166,439,4,62,10,52,73,60,2,11,0,6
E33003702,524,398,98,300,0,52,8,44,71,60,2,9,0,3
E33003703,248,205,57,148,0,14,2,12,26,23,1,2,0,3
E33003704,574,484,165,319,1,23,7,16,60,52,0,8,0,6
E33003705,340,288,78,210,3,16,1,15,32,28,0,4,0,1
E33003706,210,162,47,115,1,16,0,16,29,28,0,1,0,2
E33003707,425,381,112,269,2,6,1,5,34,33,0,1,0,2
E33003708,261,170,43,127,2,21,3,18,63,62,0,0,1,5
E33003709,326,262,88,174,1,13,3,10,48,44,0,3,1,2
E33003710,344,257,75,182,1,18,2,16,66,62,0,4,0,2
E33003711,255,195,57,138,2,18,4,14,40,36,0,3,1,0
E33003712,666,498,171,327,5,50,10,40,111,97,2,11,1,2
E33003713,226,173,49,124,2,22,3,19,27,24,0,3,0,2
E33003714,280,227,75,152,1,30,5,25,17,13,0,3,1,5
E33003715,483,373,110,263,1,24,4,20,82,77,0,5,0,3
E33003716,254,190,64,126,0,25,1,24,38,35,0,3,0,1
E33003717,204,157,47,110,0,10,1,9,36,33,0,3,0,1
E33003718,162,122,40,82,1,14,1,13,24,23,0,1,0,1
E33003719,609,422,124,298,3,41,4,37,137,126,1,8,2,6
E33003720,477,398,129,269,0,31,5,26,46,33,9,4,0,2
E33003721,219,178,62,116,2,13,1,12,23,22,0,1,0,3
E33003722,2738,2231,642,1589,6,135,25,110,348,298,19,22,9,18
E33003723,219,151,48,103,1,20,3,17,43,41,0,2,0,4
E33003724,217,173,74,99,1,8,2,6,31,29,0,1,1,4
E33003725,570,444,113,331,6,30,5,25,86,77,1,8,0,4
E33003726,231,173,77,96,1,15,3,12,35,35,0,0,0,7
E33003727,392,247,77,170,0,39,6,33,101,97,0,4,0,5
E33003728,395,322,102,220,5,23,2,21,43,35,1,6,1,2
E33003729,286,189,48,141,1,27,6,21,69,64,1,2,2,0
E33003730,237,145,41,104,0,19,3,16,72,67,0,5,0,1
E33003731,214,172,76,96,0,16,3,13,24,22,0,2,0,2
E33003732,303,261,87,174,2,12,3,9,28,26,0,2,0,0
E33003733,1079,891,261,630,5,63,8,55,114,98,2,11,3,6
E33003734,285,199,59,140,0,45,7,38,39,35,0,4,0,2
E33003735,323,259,80,179,1,17,3,14,43,42,0,1,0,3
E33003736,641,506,149,357,5,47,8,39,82,71,4,6,1,1
E33003737,388,295,101,194,3,22,3,19,67,64,0,3,0,1
E33003738,231,172,39,133,0,18,4,14,39,34,0,5,0,2
E33003739,612,499,168,331,2,37,10,27,68,63,1,3,1,6
E33003740,335,278,84,194,1,15,4,11,39,34,0,5,0,2
E33003741,268,195,56,139,0,27,9,18,45,41,0,4,0,1
E33003742,352,282,85,197,0,19,2,17,50,48,0,2,0,1
E33003743,514,347,97,250,2,52,10,42,111,103,2,6,0,2
E33003744,244,194,64,130,0,13,2,11,36,30,0,5,1,1
E33003745,532,388,129,259,3,52,7,45,86,70,3,12,1,3
E33003746,904,735,239,496,3,68,15,53,97,86,0,8,3,1
E33003747,635,503,132,371,2,45,5,40,83,76,1,6,0,2
E33003748,1483,1019,261,758,6,188,34,154,263,246,1,16,0,7
E33003749,331,259,110,149,3,15,5,10,40,33,4,2,1,14
E33003750,665,534,132,402,5,43,17,26,77,68,1,8,0,6
E33003751,11982,10606,2676,7930,13,564,187,377,764,705,6,48,5,35
E33003752,317,275,83,192,0,8,2,6,31,28,0,2,1,3
E33003753,654,549,142,407,1,31,11,20,72,69,1,2,0,1
E33003754,336,274,92,182,1,35,9,26,22,19,0,3,0,4
E33003755,843,714,238,476,0,59,24,35,62,48,1,10,3,8
E33003756,442,337,98,239,1,62,21,41,40,33,2,5,0,2
E33003757,332,237,73,164,0,71,30,41,23,21,0,1,1,1
E33003758,243,200,50,150,0,27,15,12,15,14,0,1,0,1
E33003759,401,312,105,207,2,38,19,19,45,39,2,3,1,4
E33003760,198,141,45,96,1,34,16,18,17,16,0,0,1,5
E33003761,367,276,72,204,2,43,18,25,46,38,2,5,1,0
E33003762,612,503,169,334,0,50,16,34,54,47,2,5,0,5
E33003763,258,150,51,99,0,25,2,23,73,55,4,10,4,10
E33003764,220,168,65,103,0,16,2,14,33,28,3,2,0,3
E33003765,1062,575,194,381,10,166,42,124,282,244,9,29,0,29
E33003766,231,181,66,115,4,13,4,9,32,24,2,5,1,1
E33003767,228,180,69,111,2,10,2,8,34,30,1,3,0,2
E33003768,222,158,62,96,2,24,2,22,36,35,0,1,0,2
E33003769,215,146,51,95,3,16,5,11,37,32,2,3,0,13
E33003770,1254,1055,276,779,17,48,6,42,120,103,3,13,1,14
E33003771,197,140,60,80,0,8,2,6,48,41,3,4,0,1
E33003772,267,187,62,125,3,31,3,28,42,38,0,4,0,4
E33003773,250,178,68,110,5,13,3,10,53,45,3,4,1,1
E33003774,838,610,206,404,10,54,7,47,151,138,2,9,2,13
E33003775,210,155,46,109,4,8,2,6,39,32,3,4,0,4
E33003776,263,183,80,103,2,24,4,20,49,44,0,5,0,5
E33003777,222,146,59,87,3,22,2,20,46,33,10,2,1,5
E33003778,275,200,84,116,3,30,2,28,29,20,3,4,2,13
E33003779,203,136,47,89,3,19,4,15,42,40,0,2,0,3
E33003780,453,348,121,227,2,32,5,27,66,61,1,4,0,5
E33003781,413,331,119,212,3,24,4,20,47,40,0,6,1,8
E33003782,326,253,72,181,3,28,5,23,41,38,1,2,0,1
E33003783,209,159,77,82,0,11,1,10,31,27,0,4,0,8
E33003784,254,176,84,92,0,22,11,11,53,46,2,1,4,3
E33003785,229,175,90,85,0,17,13,4,33,30,1,2,0,4
E33003786,274,188,70,118,1,22,18,4,60,54,1,4,1,3
E33003787,310,220,86,134,2,23,11,12,62,58,1,3,0,3
E33003788,381,288,86,202,4,18,9,9,64,61,0,2,1,7
E33003789,323,246,100,146,1,28,17,11,43,41,1,0,1,5
E33003790,204,162,82,80,1,8,6,2,32,30,1,1,0,1
E33003791,719,487,167,320,7,76,57,19,140,130,0,10,0,9
E33003792,250,168,67,101,0,23,16,7,57,51,0,6,0,2
E33003793,476,371,127,244,3,38,28,10,63,58,0,5,0,1
E33003794,576,395,147,248,2,66,49,17,107,102,0,5,0,6
E33003795,893,668,245,423,8,66,47,19,142,132,1,8,1,9
E33003796,407,330,115,215,1,21,13,8,52,46,1,5,0,3
E33003797,338,229,86,143,1,35,25,10,69,67,0,2,0,4
E33003798,169,130,51,79,1,15,9,6,22,22,0,0,0,1
E33003799,312,224,83,141,1,19,11,8,66,62,1,3,0,2
E33003800,477,347,125,222,6,43,31,12,77,73,0,4,0,4
E33003801,289,225,68,157,1,14,11,3,47,43,0,4,0,2
E33003802,350,248,72,176,2,30,24,6,67,58,1,6,2,3
E33003803,403,321,108,213,0,22,13,9,59,57,0,1,1,1
E33003804,360,294,91,203,3,13,8,5,47,44,0,2,1,3
E33003805,402,287,78,209,7,26,20,6,76,64,2,10,0,6
E33003806,247,120,47,73,1,30,11,19,93,78,10,5,0,3
E33003807,438,224,85,139,1,66,39,27,140,125,1,14,0,7
E33003808,256,199,85,114,0,9,2,7,46,42,1,2,1,2
E33003809,206,139,72,67,2,12,10,2,48,38,4,6,0,5
E33003810,730,629,186,443,1,28,22,6,69,65,0,4,0,3
E33003811,226,181,76,105,2,14,11,3,27,24,0,3,0,2
E33003812,284,199,69,130,0,25,17,8,53,42,5,5,1,7
E33003813,258,205,69,136,2,10,8,2,40,37,1,2,0,1
E33003814,734,474,162,312,8,66,43,23,173,158,6,9,0,13
E33003815,346,218,85,133,3,28,16,12,95,83,2,9,1,2
E33003816,199,106,37,69,2,26,16,10,59,57,1,0,1,6
E33003817,181,92,38,54,1,15,8,7,66,61,1,4,0,7
E33003818,255,149,48,101,3,29,19,10,70,65,3,2,0,4
E33003819,1555,1176,289,887,2,94,29,65,272,250,0,18,4,11
E33003820,276,212,61,151,1,20,10,10,42,35,0,6,1,1
E33003821,268,205,58,147,1,15,2,13,45,40,2,3,0,2
E33003822,424,339,82,257,2,23,9,14,59,49,0,10,0,1
E33003823,482,392,119,273,2,21,6,15,61,59,0,1,1,6
E33003824,382,297,76,221,2,27,11,16,51,48,0,3,0,5
E33003825,204,169,63,106,1,6,1,5,27,24,0,3,0,1
E33003826,312,269,81,188,1,5,2,3,36,35,0,1,0,1
E33003827,550,404,141,263,2,42,20,22,100,95,0,5,0,2
E33003828,597,405,106,299,1,52,20,32,134,116,3,12,3,5
E33003829,295,243,69,174,1,9,4,5,39,34,0,5,0,3
E33003830,374,318,89,229,0,19,6,13,36,32,0,4,0,1
E33003831,462,353,91,262,4,19,6,13,83,67,2,13,1,3
E33003832,791,691,175,516,0,13,2,11,81,69,0,10,2,6
E33003833,657,533,140,393,0,35,11,24,84,80,0,4,0,5
E33003834,402,338,113,225,4,19,5,14,39,34,0,5,0,2
E33003835,268,188,44,144,1,25,8,17,50,46,0,4,0,4
E33003836,244,186,52,134,3,16,4,12,38,36,0,2,0,1
E33003837,306,232,62,170,1,24,10,14,49,43,1,5,0,0
E33003838,265,207,56,151,0,13,3,10,44,43,0,1,0,1
E33003839,685,588,181,407,2,19,6,13,69,62,0,7,0,7
E33003840,1024,788,213,575,1,64,23,41,167,148,3,14,2,4
E33003841,845,700,199,501,2,37,14,23,98,87,0,9,2,8
E33003842,866,702,183,519,3,37,14,23,119,110,1,7,1,5
E33003843,665,488,157,331,3,52,15,37,117,109,0,7,1,5
E33003844,237,194,65,129,1,12,2,10,29,26,0,3,0,1
E33003845,451,357,111,246,2,27,14,13,62,55,0,5,2,3
E33003846,417,325,93,232,1,29,7,22,56,51,0,5,0,6
E33003847,643,511,155,356,0,59,29,30,71,65,0,6,0,2
E33003848,686,501,112,389,0,40,13,27,142,130,0,12,0,3
E33003849,636,432,129,303,4,55,22,33,141,130,0,11,0,4
E33003850,1080,863,212,651,8,80,31,49,123,115,0,6,2,6
E33003851,645,536,182,354,1,49,15,34,57,51,1,2,3,2
E33003852,295,253,77,176,2,10,4,6,27,25,0,2,0,3
E33003853,267,236,78,158,0,12,2,10,19,16,0,3,0,0
E33003854,403,355,94,261,3,7,3,4,37,32,0,4,1,1
E33003855,231,166,36,130,1,28,9,19,33,32,0,1,0,3
E33003856,425,389,86,303,1,9,3,6,25,22,2,1,0,1
E33003857,266,217,68,149,0,17,5,12,32,29,0,3,0,0
E33003858,376,320,96,224,1,19,2,17,34,30,0,4,0,2
E33003859,1927,1604,432,1172,7,115,26,89,189,160,5,21,3,12
E33003860,478,417,108,309,4,29,13,16,27,25,0,2,0,1
E33003861,328,265,70,195,2,24,5,19,36,32,0,4,0,1
E33003862,313,227,69,158,0,39,14,25,46,41,0,4,1,1
E33003863,249,201,46,155,2,12,3,9,32,27,0,5,0,2
E33003864,197,175,62,113,1,6,2,4,15,13,0,2,0,0
E33003865,574,414,114,300,0,73,22,51,84,73,0,10,1,3
E33003866,360,270,67,203,2,30,8,22,56,48,1,6,1,2
E33003867,218,149,39,110,0,26,3,23,42,36,0,6,0,1
E33003868,398,308,97,211,0,25,6,19,60,54,0,6,0,5
E33003869,737,568,130,438,7,73,34,39,87,82,0,5,0,2
E33003870,615,444,96,348,2,36,12,24,119,113,0,5,1,14
E33003871,258,176,38,138,0,10,2,8,71,65,2,4,0,1
E33003872,275,227,58,169,1,7,3,4,40,36,0,3,1,0
E33003873,439,317,90,227,1,17,4,13,101,96,1,4,0,3
E33003874,1464,1200,286,914,0,24,6,18,235,205,1,28,1,5
E33003875,555,435,133,302,2,16,4,12,98,89,1,7,1,4
E33003876,745,469,91,378,4,28,8,20,242,222,1,8,11,2
E33003877,1474,1311,365,946,2,38,13,25,114,92,0,14,8,9
E33003878,414,315,79,236,4,27,7,20,66,55,5,6,0,2
E33003879,380,281,85,196,0,12,1,11,83,76,3,4,0,4
E33003880,1206,886,215,671,3,44,21,23,267,242,3,22,0,6
E33003881,8370,7349,1744,5605,21,147,45,102,830,744,11,66,9,23
E33003882,382,305,73,232,4,10,2,8,60,52,0,8,0,3
E33003883,205,157,48,109,0,8,3,5,38,36,0,2,0,2
E33003884,592,464,99,365,3,22,9,13,96,82,1,13,0,7
E33003885,1233,1025,240,785,3,35,15,20,164,153,2,8,1,6
E33003886,478,366,68,298,2,18,6,12,90,86,0,4,0,2
E33003887,304,258,65,193,1,10,2,8,34,30,1,1,2,1
E33003888,782,607,145,462,1,49,10,39,122,111,1,9,1,3
E33003889,1344,1052,290,762,4,88,30,58,188,176,0,11,1,12
E33003890,199,150,40,110,0,9,4,5,38,34,0,3,1,2
E33003891,503,354,91,263,1,38,17,21,103,98,0,5,0,7
E33003892,249,179,56,123,0,18,3,15,49,45,0,3,1,3
E33003893,298,250,74,176,0,15,4,11,31,31,0,0,0,2
E33003894,221,175,41,134,0,8,4,4,38,37,0,1,0,0
E33003895,306,224,68,156,0,22,7,15,58,55,0,3,0,2
E33003896,286,225,58,167,1,15,8,7,45,40,0,4,1,0
E33003897,202,164,60,104,0,7,1,6,29,23,1,5,0,2
E33003898,445,323,103,220,3,41,12,29,74,65,0,6,3,4
E33003899,294,243,82,161,0,21,5,16,29,27,0,2,0,1
E33003900,249,173,53,120,2,20,9,11,53,49,0,4,0,1
E33003901,317,235,76,159,0,32,10,22,48,41,0,7,0,2
E33003902,541,416,158,258,2,29,4,25,89,75,2,11,1,5
E33003903,879,709,210,499,6,42,8,34,116,104,0,12,0,6
E33003904,635,473,171,302,2,32,11,21,121,114,0,7,0,7
E33003905,704,540,152,388,1,58,19,39,104,92,1,9,2,1
E33003906,650,509,148,361,2,36,7,29,102,95,0,4,3,1
E33003907,972,756,179,577,3,47,15,32,157,141,1,12,3,9
E33003908,267,217,74,143,0,12,2,10,38,33,0,5,0,0
E33003909,531,363,103,260,3,32,16,16,123,111,0,11,1,10
E33003910,600,465,149,316,2,33,23,10,98,87,0,11,0,2
E33003911,183,126,24,102,2,12,8,4,39,38,0,1,0,4
E33003912,639,393,126,267,3,54,33,21,181,168,0,11,2,8
E33003913,929,674,163,511,6,55,31,24,190,178,1,9,2,4
E33003914,490,369,100,269,2,26,23,3,88,81,2,5,0,5
E33003915,120,94,35,59,0,5,5,0,21,20,0,1,0,0
E33003916,618,505,156,349,1,26,18,8,83,71,0,12,0,3
E33003917,584,472,136,336,1,21,14,7,86,78,1,5,2,4
E33003918,461,350,98,252,3,10,2,8,92,82,0,9,1,6
E33003919,265,201,60,141,0,17,8,9,45,40,2,3,0,2
E33003920,275,186,54,132,3,15,10,5,67,58,1,8,0,4
E33003921,299,186,46,140,3,14,8,6,94,89,0,5,0,2
E33003922,258,188,54,134,2,13,7,6,53,49,0,3,1,2
E33003923,238,158,40,118,2,17,9,8,59,50,0,7,2,2
E33003924,871,544,161,383,7,67,39,28,244,229,0,10,5,9
E33003925,255,185,63,122,4,18,11,7,47,42,1,4,0,1
E33003926,201,131,52,79,1,13,6,7,53,47,4,2,0,3
E33003927,220,157,49,108,1,14,8,6,47,42,0,5,0,1
E33003928,318,193,56,137,2,17,10,7,105,99,0,6,0,1
E33003929,245,176,60,116,4,9,4,5,52,49,0,3,0,4
E33003930,442,348,96,252,6,14,5,9,68,62,0,6,0,6
E33003931,607,480,126,354,4,19,9,10,100,93,1,6,0,4
E33003932,253,210,69,141,1,7,7,0,32,26,2,4,0,3
E33003933,257,213,51,162,0,10,9,1,33,31,0,2,0,1
E33003934,618,443,138,305,5,43,30,13,127,109,4,14,0,0
E33003935,1517,1324,342,982,5,35,17,18,145,134,0,10,1,8
E33003936,454,315,90,225,3,32,14,18,100,90,0,9,1,4
E33003937,199,138,46,92,2,4,2,2,52,46,1,5,0,3
E33003938,203,153,42,111,0,6,3,3,40,32,0,8,0,4
E33003939,355,292,74,218,2,12,3,9,46,40,0,5,1,3
E33003940,486,312,101,211,6,34,7,27,130,123,1,6,0,4
E33003941,233,163,48,115,1,12,7,5,54,45,0,9,0,3
E33003942,637,514,167,347,7,22,17,5,91,82,2,7,0,3
E33003943,1059,776,206,570,10,52,31,21,215,204,1,9,1,6
E33003944,664,508,156,352,5,36,25,11,110,105,0,5,0,5
E33003945,527,369,119,250,5,26,16,10,123,106,2,14,1,4
E33003946,1247,932,268,664,6,76,38,38,226,202,1,22,1,7
E33003947,469,381,120,261,1,19,10,9,68,61,2,5,0,0
E33003948,493,376,138,238,2,36,13,23,75,70,1,3,1,4
E33003949,401,320,93,227,1,20,7,13,50,40,0,9,1,10
E33003950,749,600,191,409,1,40,23,17,103,91,1,7,4,5
E33003951,2539,1957,526,1431,10,143,59,84,412,360,3,49,0,17
E33003952,233,195,57,138,1,9,0,9,28,24,1,2,1,0
E33003953,655,441,167,274,6,49,25,24,157,150,2,5,0,2
E33003954,255,194,53,141,0,25,15,10,34,31,0,3,0,2
E33003955,861,615,205,410,0,84,44,40,157,141,0,15,1,5
E33003956,378,310,97,213,0,20,11,9,46,44,1,1,0,2
E33003957,578,417,134,283,0,44,16,28,110,103,0,7,0,7
E33003958,419,316,90,226,2,23,10,13,73,64,1,8,0,5
E33003959,909,637,191,446,1,63,31,32,202,188,3,9,2,6
E33003960,242,207,71,136,0,9,6,3,24,20,1,3,0,2
E33003961,316,257,75,182,0,14,5,9,44,43,0,1,0,1
E33003962,360,317,110,207,0,10,3,7,30,29,0,1,0,3
E33003963,330,258,83,175,2,12,2,10,58,53,0,5,0,0
E33003964,326,259,96,163,2,15,6,9,46,38,1,5,2,4
E33003965,1028,863,249,614,11,47,11,36,101,92,1,8,0,6
E33003966,715,589,168,421,4,36,11,25,85,76,0,9,0,1
E33003967,892,708,182,526,4,71,21,50,107,97,1,9,0,2
E33003968,418,329,79,250,4,29,7,22,52,48,0,4,0,4
E33003969,302,215,49,166,3,28,8,20,56,49,1,6,0,0
E33003970,515,408,84,324,2,51,17,34,50,43,0,7,0,4
E33003971,502,369,86,283,3,53,20,33,75,69,0,6,0,2
E33003972,869,632,142,490,5,93,21,72,136,128,0,7,1,3
E33003973,364,265,59,206,2,44,10,34,51,46,1,4,0,2
E33003974,315,259,73,186,0,18,3,15,38,36,0,2,0,0
E33003975,998,874,241,633,3,32,8,24,83,76,2,5,0,6
E33003976,312,261,63,198,1,13,4,9,37,36,0,1,0,0
E33003977,278,226,65,161,2,20,1,19,28,27,0,1,0,2
E33003978,362,237,62,175,3,28,7,21,91,83,1,6,1,3
E33003979,120,104,26,78,0,4,1,3,9,8,0,1,0,3
E33003980,321,235,52,183,3,24,5,19,59,51,0,8,0,0
E33003981,768,557,139,418,9,72,17,55,129,117,3,8,1,1
E33003982,530,390,105,285,4,45,8,37,87,82,0,3,2,4
E33003983,214,129,45,84,2,33,6,27,42,38,0,4,0,8
E33003984,861,714,192,522,4,48,17,31,95,88,0,6,1,0
E33003985,1074,887,277,610,5,76,9,67,97,87,2,8,0,9
E33003986,338,283,85,198,6,14,3,11,33,31,0,2,0,2
E33003987,4132,3352,699,2653,23,160,45,115,582,532,3,45,2,15
E33003988,1096,796,196,600,5,108,22,86,182,168,0,14,0,5
E33003989,5152,4159,1054,3105,26,258,58,200,693,619,13,53,8,16
E33003990,282,178,51,127,0,31,5,26,69,64,0,4,1,4
E33003991,416,331,78,253,2,18,6,12,64,58,0,6,0,1
E33003992,440,300,77,223,4,31,6,25,104,96,0,6,2,1
E33003993,309,222,61,161,0,17,5,12,68,60,2,5,1,2
E33003994,269,176,48,128,0,22,4,18,70,64,1,4,1,1
E33003995,481,412,123,289,2,18,1,17,48,43,0,5,0,1
E33003996,465,351,76,275,0,33,5,28,77,68,3,5,1,4
E33003997,1052,738,200,538,1,98,22,76,205,194,0,10,1,10
E33003998,886,673,190,483,3,69,14,55,135,126,0,9,0,6
E33003999,238,198,54,144,1,8,1,7,29,26,1,1,1,2
E33004000,296,231,72,159,0,6,4,2,58,41,16,0,1,1
E33004001,732,632,150,482,2,36,6,30,58,50,0,7,1,4
E33004002,931,667,187,480,5,78,7,71,175,161,0,13,1,6
E33004003,243,160,65,95,1,42,7,35,39,35,0,4,0,1
E33004004,432,348,88,260,2,26,6,20,53,47,0,5,1,3
E33004005,1605,1333,364,969,14,90,8,82,158,147,3,7,1,10
E33004006,285,240,84,156,1,16,1,15,28,24,0,4,0,0
E33004007,480,302,74,228,2,54,10,44,117,111,0,4,2,5
E33004008,130,95,20,75,0,7,0,7,28,26,0,1,1,0
E33004009,580,454,117,337,4,32,4,28,87,80,1,6,0,3
E33004010,5151,4600,1056,3544,17,119,41,78,393,359,0,31,3,22
E33004011,472,364,127,237,1,25,5,20,79,67,2,9,1,3
E33004012,200,153,65,88,2,14,2,12,29,26,2,1,0,2
E33004013,419,320,110,210,2,26,6,20,70,68,0,2,0,1
E33004014,1087,884,265,619,0,62,11,51,135,120,0,15,0,6
E33004015,625,509,180,329,3,35,11,24,75,64,1,9,1,3
E33004016,722,517,142,375,4,46,12,34,153,145,1,7,0,2
E33004017,226,140,51,89,0,5,1,4,78,72,0,6,0,3
E33004018,654,442,140,302,0,89,38,51,121,111,0,9,1,2
E33004019,420,310,104,206,1,29,13,16,71,63,0,8,0,9
E33004020,714,570,187,383,1,36,17,19,101,90,0,9,2,6
E33004021,299,239,65,174,1,20,12,8,36,29,0,7,0,3
E33004022,314,268,80,188,1,11,4,7,34,28,0,6,0,0
E33004023,232,190,59,131,1,4,1,3,35,35,0,0,0,2
E33004024,629,471,145,326,3,63,23,40,86,85,0,1,0,6
E33004025,627,485,133,352,4,43,21,22,91,73,4,11,3,4
E33004026,258,217,73,144,0,9,4,5,32,27,0,5,0,0
E33004027,798,609,183,426,3,77,32,45,104,97,0,7,0,5
E33004028,904,693,172,521,6,77,17,60,123,110,1,9,3,5
E33004029,385,308,86,222,0,29,3,26,48,43,1,4,0,0
E33004030,436,354,107,247,1,23,7,16,58,51,0,7,0,0
E33004031,1352,1112,287,825,4,73,27,46,158,147,1,10,0,5
E33004032,760,375,86,289,3,140,41,99,237,229,1,6,1,5
E33004033,632,452,122,330,1,83,21,62,93,83,0,9,1,3
E33004034,506,417,111,306,1,29,8,21,58,50,0,5,3,1
E33004035,1668,1292,364,928,5,159,31,128,203,182,1,17,3,9
E33004036,605,490,129,361,3,44,8,36,66,58,0,8,0,2
E33004037,918,733,225,508,3,77,18,59,100,92,0,8,0,5
E33004038,528,435,153,282,3,43,10,33,46,39,1,5,1,1
E33004039,923,592,127,465,10,91,12,79,228,223,1,4,0,2
E33004040,773,607,153,454,5,58,8,50,98,89,1,7,1,5
E33004041,1171,862,176,686,5,86,27,59,212,195,0,15,2,6
E33004042,1203,1034,305,729,6,61,18,43,99,94,1,4,0,3
E33004043,336,280,100,180,1,28,4,24,27,27,0,0,0,0
E33004044,437,274,76,198,2,49,12,37,110,105,1,4,0,2
E33004045,570,500,120,380,5,19,4,15,44,37,0,7,0,2
E33004046,219,205,60,145,0,3,0,3,11,11,0,0,0,0
E33004047,339,240,70,170,2,37,3,34,57,46,0,10,1,3
E33004048,264,224,66,158,1,16,3,13,23,18,2,3,0,0
E33004049,610,500,130,370,3,44,5,39,61,55,0,6,0,2
E33004050,347,246,72,174,4,41,11,30,54,50,1,3,0,2
E33004051,470,344,92,252,1,46,14,32,73,64,2,5,2,6
E33004052,309,252,82,170,0,21,7,14,34,31,1,2,0,2
E33004053,782,670,156,514,4,32,5,27,73,65,0,6,2,3
E33004054,348,261,63,198,4,41,14,27,41,39,0,2,0,1
E33004055,756,513,98,415,2,155,137,18,82,79,0,3,0,4
E33004056,508,432,120,312,1,38,25,13,36,30,1,5,0,1
E33004057,330,286,91,195,1,14,7,7,25,24,0,1,0,4
E33004058,479,402,110,292,1,30,23,7,43,40,0,2,1,3
E33004059,1232,1049,280,769,5,71,47,24,101,97,1,3,0,6
E33004060,368,265,82,183,5,31,21,10,63,59,0,4,0,4
E33004061,317,240,64,176,0,19,10,9,55,51,0,3,1,3
E33004062,251,193,49,144,1,23,19,4,33,29,2,2,0,1
E33004063,633,540,165,375,1,24,16,8,64,56,0,7,1,4
E33004064,352,224,97,127,9,9,3,6,106,93,7,5,1,4
E33004065,221,181,72,109,4,8,3,5,25,24,0,1,0,3
E33004066,722,582,155,427,4,48,29,19,81,71,0,9,1,7
E33004067,219,160,41,119,2,15,12,3,42,39,0,3,0,0
E33004068,249,174,46,128,1,14,8,6,60,59,0,1,0,0
E33004069,237,167,54,113,0,10,6,4,59,58,0,1,0,1
E33004070,376,305,79,226,2,28,20,8,39,35,0,4,0,2
E33004071,1461,1058,254,804,6,159,128,31,235,216,1,17,1,3
E33004072,538,433,109,324,1,53,44,9,51,50,0,1,0,0
E33004073,384,302,64,238,0,43,39,4,36,33,0,3,0,3
E33004074,711,533,156,377,4,62,44,18,110,98,2,10,0,2
E33004075,276,236,61,175,1,15,9,6,22,22,0,0,0,2
E33004076,329,225,81,144,3,55,38,17,46,46,0,0,0,0
E33004077,854,721,150,571,1,55,43,12,76,71,0,4,1,1
E33004078,264,198,72,126,1,4,4,0,60,49,1,6,4,1
E33004079,410,306,60,246,1,48,34,14,53,49,0,4,0,2
E33004080,1103,614,115,499,20,153,118,35,314,303,2,7,2,2
E33004081,459,367,89,278,0,43,29,14,48,45,0,3,0,1
E33004082,434,356,59,297,3,36,26,10,39,32,0,7,0,0
E33004083,285,250,107,143,5,8,5,3,22,20,0,2,0,0
E33004084,762,647,199,448,2,46,34,12,66,62,0,4,0,1
E33004085,870,764,214,550,3,23,7,16,80,73,0,7,0,0
E33004086,418,340,76,264,1,16,2,14,60,55,0,5,0,1
E33004087,462,390,144,246,4,21,9,12,43,40,0,3,0,4
E33004088,365,312,114,198,4,6,1,5,41,39,0,2,0,2
E33004089,222,180,57,123,0,9,0,9,32,28,2,2,0,1
E33004090,403,324,121,203,1,21,4,17,57,51,1,5,0,0
E33004091,328,260,114,146,1,11,3,8,56,47,0,7,2,0
E33004092,362,281,80,201,1,13,5,8,64,56,2,4,2,3
E33004093,303,234,63,171,0,7,2,5,62,55,2,5,0,0
E33004094,237,159,44,115,1,17,6,11,48,41,5,2,0,12
E33004095,514,429,126,303,1,30,4,26,53,50,0,3,0,1
E33004096,559,409,116,293,4,45,16,29,97,93,0,3,1,4
E33004097,980,675,196,479,3,79,27,52,216,202,0,10,4,7
E33004098,173,118,36,82,1,16,7,9,37,34,2,1,0,1
E33004099,559,363,75,288,4,58,11,47,131,118,1,12,0,3
E33004100,393,277,70,207,2,35,7,28,75,71,0,4,0,4
E33004101,744,630,173,457,3,25,5,20,80,67,2,10,1,6
E33004102,291,218,82,136,2,18,4,14,48,47,0,1,0,5
E33004103,218,183,59,124,2,4,1,3,29,26,0,3,0,0
E33004104,230,198,52,146,2,12,5,7,17,16,0,1,0,1
E33004105,1745,1576,368,1208,6,25,12,13,132,117,0,14,1,6
E33004106,243,156,35,121,0,30,7,23,56,54,1,1,0,1
E33004107,767,587,168,419,4,57,29,28,119,104,3,11,1,0
E33004108,296,213,47,166,1,34,13,21,46,44,0,2,0,2
E33004109,472,351,103,248,3,52,8,44,65,61,1,3,0,1
E33004110,209,158,42,116,3,21,3,18,27,23,0,4,0,0
E33004111,229,180,46,134,1,20,8,12,28,25,0,3,0,0
E33004112,304,231,56,175,1,37,11,26,33,33,0,0,0,2
E33004113,232,163,46,117,1,26,9,17,40,32,0,6,2,2
E33004114,292,208,67,141,0,25,7,18,58,57,0,1,0,1
E33004115,354,225,57,168,1,56,18,38,68,62,0,6,0,4
E33004116,288,185,38,147,5,48,21,27,47,42,0,5,0,3
E33004117,344,250,63,187,1,55,21,34,38,36,0,2,0,0
E33004118,1355,1002,282,720,7,177,42,135,164,152,1,10,1,5
E33004119,387,296,85,211,2,45,23,22,44,39,0,5,0,0
E33004120,237,158,33,125,0,38,17,21,40,36,0,4,0,1
E33004121,348,293,86,207,1,22,13,9,31,25,0,5,1,1
E33004122,617,487,133,354,6,49,13,36,74,63,0,10,1,1
E33004123,356,288,47,241,1,19,7,12,47,42,1,4,0,1
E33004124,387,241,66,175,0,41,12,29,105,94,3,8,0,0
E33004125,478,392,104,288,2,36,12,24,46,44,0,2,0,2
E33004126,245,180,53,127,0,14,5,9,50,47,0,3,0,1
E33004127,243,159,44,115,1,36,13,23,47,40,0,7,0,0
E33004128,916,787,163,624,3,43,6,37,80,71,3,6,0,3
E33004129,329,265,82,183,2,16,6,10,41,36,0,5,0,5
E33004130,329,261,69,192,2,20,6,14,42,40,0,1,1,4
E33004131,238,165,45,120,0,26,13,13,47,41,0,5,1,0
E33004132,407,312,105,207,2,38,13,25,54,52,0,2,0,1
E33004133,632,527,112,415,4,27,24,3,73,66,0,7,0,1
E33004134,247,185,46,139,0,36,33,3,24,21,0,3,0,2
E33004135,223,170,45,125,0,21,19,2,30,27,0,3,0,2
E33004136,244,172,53,119,0,32,26,6,40,39,0,0,1,0
E33004137,265,190,56,134,2,37,32,5,34,32,0,2,0,2
E33004138,203,171,44,127,0,14,11,3,16,13,0,3,0,2
E33004139,718,562,170,392,4,60,43,17,89,83,1,5,0,3
E33004140,260,198,67,131,1,26,18,8,35,32,0,1,2,0
E33004141,482,387,119,268,1,47,32,15,46,40,1,4,1,1
E33004142,788,604,200,404,6,52,40,12,124,112,1,9,2,2
E33004143,431,299,88,211,2,37,22,15,87,81,2,3,1,6
E33004144,508,409,121,288,2,21,17,4,75,69,0,6,0,1
E33004145,709,488,81,407,3,53,24,29,157,139,0,17,1,8
E33004146,235,163,42,121,2,28,17,11,41,40,0,1,0,1
E33004147,2081,1720,517,1203,15,145,50,95,190,172,1,16,1,11
E33004148,440,325,79,246,2,21,7,14,91,88,0,1,2,1
E33004149,348,227,73,154,4,59,16,43,56,55,0,1,0,2
E33004150,672,452,139,313,4,127,69,58,87,78,1,8,0,2
E33004151,443,319,90,229,2,52,27,25,67,58,0,7,2,3
E33004152,438,332,73,259,1,43,17,26,60,56,0,4,0,2
E33004153,236,157,56,101,1,37,6,31,40,35,1,3,1,1
E33004154,498,364,105,259,3,75,22,53,55,51,1,3,0,1
E33004155,267,203,47,156,1,33,9,24,29,25,1,3,0,1
E33004156,1457,1111,284,827,9,105,34,71,227,210,1,14,2,5
E33004157,1761,1447,434,1013,6,74,36,38,230,214,0,11,5,4
E33004158,376,296,55,241,2,33,15,18,44,41,0,3,0,1
E33004159,233,180,45,135,1,25,9,16,25,21,0,3,1,2
E33004160,208,164,42,122,1,12,3,9,27,23,0,4,0,4
E33004161,364,292,91,201,1,39,13,26,30,28,1,1,0,2
E33004162,287,202,56,146,5,50,18,32,30,25,0,5,0,0
E33004163,199,145,34,111,1,24,19,5,27,27,0,0,0,2
E33004164,400,290,85,205,6,41,30,11,59,54,0,5,0,4
E33004165,493,379,105,274,1,66,50,16,45,41,1,3,0,2
E33004166,322,259,100,159,2,17,12,5,44,38,0,6,0,0
E33004167,962,709,183,526,12,50,32,18,185,171,3,8,3,6
E33004168,562,421,79,342,5,18,13,5,112,106,0,5,1,6
E33004169,2559,2073,556,1517,14,110,64,46,343,316,4,22,1,19
E33004170,1581,1152,392,760,6,46,27,19,367,343,0,24,0,10
E33004171,302,174,75,99,5,9,3,6,107,60,43,4,0,7
E33004172,275,184,62,122,0,11,6,5,80,76,0,4,0,0
E33004173,268,166,51,115,0,3,1,2,99,85,9,5,0,0
E33004174,227,163,53,110,1,2,1,1,61,55,0,5,1,0
E33004175,295,198,67,131,2,12,8,4,82,79,1,2,0,1
E33004176,377,305,93,212,0,2,1,1,67,63,0,4,0,3
E33004177,603,458,116,342,2,19,12,7,118,110,1,6,1,6
E33004178,181,135,51,84,1,1,0,1,42,39,0,3,0,2
E33004179,271,214,65,149,0,9,2,7,47,46,0,1,0,1
E33004180,216,180,42,138,1,8,2,6,27,23,0,3,1,0
E33004181,1079,884,197,687,4,45,10,35,140,124,5,11,0,6
E33004182,239,161,42,119,6,32,7,25,39,37,0,2,0,1
E33004183,383,316,82,234,0,36,8,28,28,25,0,3,0,3
E33004184,279,204,52,152,3,27,5,22,41,39,0,2,0,4
E33004185,345,282,55,227,1,28,7,21,34,31,0,2,1,0
E33004186,755,633,169,464,3,62,15,47,53,45,0,8,0,4
E33004187,1241,1080,264,816,4,47,13,34,105,83,4,16,2,5
E33004188,925,841,225,616,3,25,7,18,54,53,0,1,0,2
E33004189,338,259,85,174,1,31,8,23,45,43,0,2,0,2
E33004190,311,256,68,188,4,26,8,18,25,23,0,2,0,0
E33004191,215,174,54,120,0,20,1,19,21,19,0,2,0,0
E33004192,219,168,52,116,3,34,6,28,14,10,0,3,1,0
E33004193,333,245,61,184,7,36,10,26,44,40,0,4,0,1
E33004194,348,238,46,192,6,56,13,43,48,47,0,1,0,0
E33004195,326,224,66,158,2,55,9,46,43,38,0,5,0,2
E33004196,488,375,100,275,7,57,13,44,49,44,0,5,0,0
E33004197,545,406,99,307,5,83,12,71,51,44,1,5,1,0
E33004198,512,358,99,259,5,89,19,70,58,53,1,4,0,2
E33004199,296,214,56,158,4,21,9,12,56,53,0,3,0,1
E33004200,427,312,102,210,1,55,35,20,56,52,0,4,0,3
E33004201,492,359,137,222,6,76,56,20,48,45,0,3,0,3
E33004202,349,269,77,192,1,28,17,11,49,45,0,4,0,2
E33004203,283,228,63,165,0,18,12,6,35,33,0,2,0,2
E33004204,497,395,125,270,1,47,31,16,50,43,0,7,0,4
E33004205,585,496,164,332,2,46,27,19,38,37,0,1,0,3
E33004206,762,600,179,421,3,87,67,20,69,63,0,6,0,3
E33004207,571,426,108,318,4,52,32,20,87,77,1,7,2,2
E33004208,520,386,98,288,1,47,28,19,84,79,0,5,0,2
E33004209,874,666,131,535,2,77,55,22,126,110,4,11,1,3
E33004210,112,80,37,43,0,17,8,9,14,11,2,1,0,1
E33004211,590,390,108,282,1,103,74,29,87,79,0,8,0,9
E33004212,619,445,144,301,1,84,60,24,84,73,0,11,0,5
E33004213,367,277,81,196,1,33,22,11,54,51,1,2,0,2
E33004214,380,251,71,180,1,79,60,19,47,46,0,1,0,2
E33004215,447,380,103,277,0,37,22,15,27,26,0,1,0,3
E33004216,844,620,130,490,4,51,30,21,163,148,0,14,1,6
E33004217,698,476,139,337,3,91,49,42,125,116,0,7,2,3
E33004218,898,690,187,503,5,47,14,33,153,139,0,13,1,3
E33004219,306,237,64,173,0,12,3,9,56,49,3,2,2,1
E33004220,490,382,109,273,1,26,11,15,80,74,0,5,1,1
E33004221,606,476,123,353,0,40,17,23,89,76,1,11,1,1
E33004222,568,469,136,333,3,29,13,16,60,54,0,6,0,7
E33004223,361,315,71,244,0,11,5,6,29,27,0,2,0,6
E33004224,810,668,166,502,2,37,19,18,100,89,0,9,2,3
E33004225,321,239,50,189,0,28,12,16,53,44,0,5,4,1
E33004226,565,431,115,316,5,35,8,27,93,87,1,4,1,1
E33004227,288,176,55,121,2,31,18,13,74,69,1,2,2,5
E33004228,431,281,53,228,1,50,18,32,95,93,0,2,0,4
E33004229,415,263,71,192,2,41,21,20,107,102,0,4,1,2
E33004230,277,209,45,164,0,18,2,16,44,41,0,2,1,6
E33004231,689,556,175,381,1,26,1,25,101,90,0,11,0,5
E33004232,495,391,118,273,6,24,4,20,73,61,0,11,1,1
E33004233,364,273,73,200,2,33,5,28,56,51,1,3,1,0
E33004234,374,259,78,181,1,29,5,24,81,69,1,11,0,4
E33004235,481,279,81,198,2,61,10,51,131,128,0,3,0,8
E33004236,697,482,146,336,5,39,6,33,165,158,1,4,2,6
E33004237,194,117,34,83,0,19,8,11,58,52,0,4,2,0
E33004238,596,433,111,322,4,42,13,29,110,99,0,11,0,7
E33004239,779,615,169,446,8,72,23,49,79,73,1,5,0,5
E33004240,462,329,113,216,5,61,22,39,62,53,6,3,0,5
E33004241,110,50,17,33,2,22,5,17,34,34,0,0,0,2
E33004242,375,275,74,201,3,25,4,21,71,64,0,7,0,1
E33004243,360,211,56,155,4,51,13,38,87,85,0,2,0,7
E33004244,1867,1518,386,1132,6,128,32,96,204,190,3,11,0,11
E33004245,439,335,115,220,6,27,1,26,64,62,0,2,0,7
E33004246,718,572,168,404,1,35,5,30,104,95,1,8,0,6
E33004247,563,440,146,294,7,42,7,35,68,63,1,4,0,6
E33004248,2737,2184,625,1559,7,91,15,76,445,416,4,24,1,10
E33004249,383,268,107,161,1,61,13,48,49,46,0,3,0,4
E33004250,297,205,52,153,1,34,5,29,56,52,0,4,0,1
E33004251,663,462,142,320,4,102,22,80,93,82,0,10,1,2
E33004252,1098,916,226,690,8,49,13,36,114,103,0,11,0,11
E33004253,203,129,47,82,1,27,5,22,44,43,0,1,0,2
E33004254,207,132,45,87,0,35,3,32,39,39,0,0,0,1
E33004255,233,180,40,140,0,26,10,16,26,21,2,3,0,1
E33004256,226,156,40,116,1,31,15,16,37,32,0,4,1,1
E33004257,263,195,42,153,1,35,19,16,31,28,0,3,0,1
E33004258,485,331,93,238,1,32,15,17,119,115,0,1,3,2
E33004259,760,450,98,352,5,77,36,41,219,206,1,11,1,9
E33004260,514,321,61,260,5,45,24,21,139,134,1,3,1,4
E33004261,360,225,52,173,2,18,6,12,112,104,0,6,2,3
E33004262,841,562,117,445,3,56,29,27,215,201,0,12,2,5
E33004263,450,324,87,237,1,37,19,18,86,83,0,3,0,2
E33004264,586,470,91,379,2,40,22,18,72,65,0,6,1,2
E33004265,240,169,32,137,2,41,31,10,28,24,0,3,1,0
E33004266,768,334,105,229,7,248,152,96,168,166,0,1,1,11
E33004267,715,512,114,398,4,66,32,34,132,120,1,8,3,1
E33004268,946,643,153,490,7,74,35,39,218,207,0,10,1,4
E33004269,804,629,163,466,4,53,25,28,115,106,0,9,0,3
E33004270,818,582,150,432,3,113,81,32,115,101,1,9,4,5
E33004271,664,515,83,432,3,45,26,19,100,84,1,14,1,1
E33004272,1450,884,180,704,8,244,125,119,299,275,5,13,6,15
E33004273,508,380,86,294,4,56,28,28,66,63,0,3,0,2
E33004274,332,227,43,184,2,43,23,20,60,54,0,5,1,0
E33004275,370,279,52,227,1,17,9,8,69,66,1,0,2,4
E33004276,3561,3050,646,2404,14,133,42,91,355,330,1,24,0,9
E33004277,1007,751,185,566,9,97,45,52,146,136,0,10,0,4
E33004278,271,193,64,129,3,38,18,20,35,29,0,4,2,2
E33004279,178,139,37,102,1,18,10,8,20,17,0,3,0,0
E33004280,717,480,119,361,6,122,58,64,102,99,0,3,0,7
E33004281,203,147,37,110,1,27,17,10,27,24,1,2,0,1
E33004282,308,238,70,168,2,28,11,17,35,31,1,3,0,5
E33004283,315,197,35,162,2,33,16,17,79,71,0,8,0,4
E33004284,201,158,33,125,0,20,8,12,23,19,0,4,0,0
E33004285,279,189,48,141,2,42,22,20,43,39,0,4,0,3
E33004286,375,266,41,225,1,30,14,16,76,71,0,5,0,2
E33004287,447,291,68,223,7,87,49,38,56,55,0,1,0,6
E33004288,244,191,54,137,1,25,8,17,26,25,0,1,0,1
E33004289,204,128,40,88,1,36,20,16,39,37,0,2,0,0
E33004290,231,166,36,130,3,23,9,14,36,33,0,3,0,3
E33004291,841,659,140,519,11,38,19,19,131,122,1,8,0,2
E33004292,317,223,52,171,1,37,13,24,54,50,0,4,0,2
E33004293,336,219,78,141,5,57,36,21,53,50,0,2,1,2
E33004294,1445,997,241,756,7,202,83,119,233,214,0,18,1,6
E33004295,263,188,44,144,1,30,11,19,38,30,0,7,1,6
E33004296,1547,1144,235,909,8,131,63,68,260,244,1,15,0,4
E33004297,971,777,222,555,10,76,27,49,106,95,1,9,1,2
E33004298,263,189,66,123,1,39,16,23,32,31,0,1,0,2
E33004299,1016,861,198,663,7,54,16,38,91,81,0,9,1,3
E33004300,449,324,80,244,7,50,22,28,65,60,1,4,0,3
E33004301,259,177,29,148,2,22,7,15,56,52,1,3,0,2
E33004302,555,369,75,294,1,79,22,57,104,97,0,7,0,2
E33004303,930,657,165,492,8,136,41,95,126,118,1,7,0,3
E33004304,752,558,144,414,6,101,26,75,86,79,0,6,1,1
E33004305,305,255,68,187,1,16,5,11,31,28,0,3,0,2
E33004306,425,332,65,267,1,15,5,10,77,70,0,5,2,0
E33004307,440,335,91,244,1,46,28,18,56,50,0,5,1,2
E33004308,845,681,150,531,3,65,26,39,94,85,0,8,1,2
E33004309,424,354,75,279,0,12,1,11,56,49,1,5,1,2
E33004310,271,212,45,167,2,9,0,9,45,40,0,5,0,3
E33004311,249,204,48,156,0,15,3,12,29,22,1,5,1,1
E33004312,340,238,63,175,1,44,13,31,54,52,0,2,0,3
E33004313,307,224,61,163,1,35,14,21,46,44,0,2,0,1
E33004314,796,599,144,455,5,49,15,34,137,125,1,6,5,6
E33004315,362,282,79,203,1,28,4,24,48,44,1,2,1,3
E33004316,738,591,160,431,4,63,12,51,79,71,1,6,1,1
E33004317,306,233,62,171,3,16,4,12,50,45,0,5,0,4
E33004318,222,170,43,127,1,12,4,8,38,36,0,2,0,1
E33004319,639,479,130,349,3,82,25,57,71,62,1,7,1,4
E33004320,274,216,66,150,0,17,4,13,41,31,0,8,2,0
E33004321,566,404,102,302,2,50,17,33,96,91,1,4,0,14
E33004322,1101,856,188,668,4,76,22,54,161,146,1,13,1,4
E33004323,836,692,156,536,6,42,12,30,90,86,0,1,3,6
E33004324,248,209,54,155,1,8,4,4,30,24,0,6,0,0
E33004325,521,384,82,302,1,35,15,20,100,96,0,3,1,1
E33004326,493,420,106,314,3,13,5,8,54,52,1,1,0,3
E33004327,414,306,60,246,3,37,11,26,64,55,0,9,0,4
E33004328,465,334,125,209,3,43,15,28,81,76,0,5,0,4
E33004329,943,607,135,472,6,86,36,50,242,228,0,14,0,2
E33004330,573,448,133,315,2,36,5,31,84,76,2,5,1,3
E33004331,316,245,52,193,2,15,3,12,50,47,0,3,0,4
E33004332,403,322,73,249,4,23,5,18,53,50,1,2,0,1
E33004333,779,649,175,474,1,23,4,19,102,94,0,6,2,4
E33004334,886,606,122,484,1,43,16,27,227,210,0,16,1,9
E33004335,8654,5903,1257,4646,54,890,359,531,1753,1657,12,73,11,54
E33004336,214,109,36,73,3,24,11,13,75,70,0,4,1,3
E33004337,272,150,33,117,3,22,8,14,96,92,0,4,0,1
E33004338,311,166,36,130,1,25,15,10,118,109,0,9,0,1
E33004339,1172,628,170,458,6,190,75,115,338,317,1,19,1,10
E33004340,328,168,41,127,3,39,14,25,116,112,0,3,1,2
E33004341,209,156,27,129,1,17,12,5,33,32,0,1,0,2
E33004342,257,158,28,130,0,22,9,13,72,70,0,2,0,5
E33004343,1584,1026,275,751,8,75,30,45,465,447,0,14,4,10
E33004344,6456,4213,1216,2997,22,374,147,227,1812,1734,3,63,12,35
E33004345,1876,1338,439,899,10,120,41,79,396,376,0,20,0,12
E33004346,314,124,33,91,4,42,9,33,141,126,1,10,4,3
E33004347,519,330,80,250,3,27,8,19,158,146,1,9,2,1
E33004348,681,377,103,274,7,73,29,44,223,211,0,11,1,1
E33004349,1236,770,234,536,8,106,41,65,344,315,0,26,3,8
E33004350,2928,2053,423,1630,21,84,41,43,752,715,4,31,2,18
E33004351,447,318,69,249,4,22,9,13,101,98,0,2,1,2
E33004352,574,404,80,324,1,34,20,14,132,124,1,7,0,3
E33004353,334,206,41,165,1,24,14,10,102,94,0,7,1,1
E33004354,585,282,77,205,5,54,33,21,238,228,0,9,1,6
E33004355,333,181,38,143,6,44,23,21,98,91,3,4,0,4
E33004356,189,111,26,85,0,20,10,10,58,57,1,0,0,0
E33004357,208,117,29,88,1,15,5,10,73,68,0,3,2,2
E33004358,884,610,128,482,5,27,11,16,237,226,1,10,0,5
E33004359,713,496,114,382,3,46,19,27,167,159,0,8,0,1
E33004360,1276,1005,198,807,4,44,20,24,215,207,1,7,0,8
E33004361,338,190,36,154,2,23,12,11,122,119,0,3,0,1
E33004362,263,160,39,121,1,23,12,11,79,76,0,3,0,0
E33004363,358,221,57,164,1,21,6,15,106,99,0,7,0,9
E33004364,510,312,70,242,3,32,21,11,159,153,1,5,0,4
E33004365,1107,654,193,461,8,110,51,59,330,310,3,13,4,5
E33004366,1092,721,171,550,10,99,50,49,252,238,0,12,2,10
E33004367,492,341,79,262,1,27,14,13,121,115,0,4,2,2
E33004368,220,108,30,78,1,11,5,6,99,96,0,2,1,1
E33004369,462,290,67,223,2,37,18,19,130,123,0,6,1,3
E33004370,244,146,37,109,1,26,14,12,69,62,0,6,1,2
E33004371,728,553,115,438,1,48,19,29,126,116,0,8,2,0
E33004372,235,161,40,121,2,14,7,7,53,53,0,0,0,5
E33004373,576,401,92,309,9,62,19,43,102,100,0,2,0,2
E33004374,766,596,118,478,3,33,12,21,131,124,0,5,2,3
E33004375,256,123,28,95,1,23,15,8,105,100,0,5,0,4
E33004376,226,141,39,102,4,7,2,5,72,67,1,4,0,2
E33004377,360,199,41,158,3,50,24,26,108,100,1,7,0,0
E33004378,396,227,51,176,0,39,18,21,127,120,1,6,0,3
E33004379,483,331,77,254,1,26,12,14,123,119,0,4,0,2
E33004380,863,520,97,423,5,57,33,24,277,263,2,10,2,4
E33004381,1181,741,137,604,15,60,24,36,362,337,0,25,0,3
E33004382,296,176,38,138,3,25,10,15,90,87,0,2,1,2
E33004383,113,87,18,69,0,9,5,4,17,17,0,0,0,0
E33004384,1922,1165,318,847,11,205,101,104,529,499,1,24,5,12
E33004385,733,463,127,336,1,56,28,28,211,202,0,9,0,2
E33004386,445,284,58,226,3,32,12,20,124,115,0,9,0,2
E33004387,628,319,93,226,3,74,42,32,230,222,1,6,1,2
E33004388,231,144,31,113,0,30,13,17,56,51,0,4,1,1
E33004389,392,219,43,176,3,20,8,12,147,141,0,5,1,3
E33004390,239,86,23,63,4,29,16,13,113,106,1,5,1,7
E33004391,212,124,33,91,0,11,4,7,76,74,0,1,1,1
E33004392,325,128,29,99,4,54,19,35,134,128,0,4,2,5
E33004393,275,202,57,145,3,42,17,25,27,27,0,0,0,1
E33004394,255,171,54,117,2,32,19,13,46,44,0,2,0,4
E33004395,1952,1353,401,952,13,332,200,132,244,220,2,17,5,10
E33004396,230,89,24,65,3,41,21,20,96,90,0,5,1,1
E33004397,399,263,53,210,1,17,7,10,117,115,0,2,0,1
E33004398,260,102,27,75,2,30,13,17,124,118,0,4,2,2
E33004399,1007,639,140,499,7,67,31,36,284,268,0,15,1,10
E33004400,305,171,40,131,3,16,5,11,111,103,0,8,0,4
E33004401,395,231,55,176,2,18,7,11,143,131,0,11,1,1
E33004402,903,667,140,527,6,54,26,28,173,161,0,12,0,3
E33004403,301,217,19,198,1,17,6,11,65,63,0,2,0,1
E33004404,784,519,115,404,2,44,14,30,219,204,0,14,1,0
E33004405,938,627,127,500,4,52,23,29,249,234,1,13,1,6
E33004406,4296,2253,569,1684,27,547,281,266,1443,1360,1,72,10,26
E33004407,968,409,93,316,3,218,108,110,336,320,1,12,3,2
E33004408,777,580,98,482,5,41,18,23,148,143,0,3,2,3
E33004409,474,377,56,321,4,14,8,6,76,71,0,5,0,3
E33004410,451,222,46,176,5,75,31,44,142,136,1,5,0,7
E33004411,573,417,74,343,2,26,11,15,122,121,0,1,0,6
E33004412,1084,859,189,670,7,48,24,24,165,151,0,13,1,5
E33004413,659,414,71,343,5,48,17,31,188,179,1,8,0,4
E33004414,787,610,125,485,5,28,10,18,141,134,2,4,1,3
E33004415,235,129,26,103,4,17,5,12,81,74,2,3,2,4
E33004416,437,285,61,224,1,26,8,18,121,119,0,2,0,4
E33004417,784,268,73,195,6,84,41,43,424,410,2,10,2,2
E33004418,1077,846,160,686,3,66,28,38,157,147,0,8,2,5
E33004419,246,121,37,84,2,43,20,23,80,74,0,2,4,0
E33004420,444,230,56,174,2,57,27,30,153,146,0,7,0,2
E33004421,322,170,38,132,4,50,18,32,93,90,0,2,1,5
E33004422,258,123,29,94,2,36,16,20,94,87,0,6,1,3
E33004423,275,153,40,113,3,18,5,13,100,95,1,3,1,1
E33004424,239,144,33,111,4,25,9,16,66,64,0,2,0,0
E33004425,220,93,20,73,0,21,7,14,105,97,1,7,0,1
E33004426,340,212,34,178,2,19,10,9,107,101,0,5,1,0
E33004427,869,592,140,452,4,84,41,43,187,174,2,11,0,2
E33004428,669,451,109,342,6,43,18,25,167,162,0,5,0,2
E33004429,245,133,30,103,0,28,12,16,82,72,0,10,0,2
E33004430,349,201,37,164,1,31,17,14,114,105,0,8,1,2
E33004431,289,167,43,124,1,29,15,14,90,86,0,3,1,2
E33004432,392,155,36,119,6,66,33,33,160,156,0,3,1,5
E33004433,218,106,30,76,2,27,11,16,82,80,0,2,0,1
E33004434,398,241,51,190,1,107,40,67,45,42,0,3,0,4
E33004435,505,330,73,257,5,35,10,25,134,127,0,5,2,1
E33004436,323,166,39,127,3,102,51,51,51,46,0,4,1,1
E33004437,399,184,37,147,2,157,65,92,55,46,0,8,1,1
E33004438,218,127,22,105,1,65,20,45,25,25,0,0,0,0
E33004439,452,343,65,278,0,37,13,24,72,66,0,6,0,0
E33004440,743,361,72,289,2,201,71,130,171,160,3,6,2,8
E33004441,231,131,38,93,1,38,15,23,61,58,0,2,1,0
E33004442,211,107,20,87,0,21,10,11,81,78,0,2,1,2
E33004443,203,141,39,102,0,21,7,14,40,35,0,5,0,1
E33004444,233,161,48,113,0,22,12,10,47,44,1,2,0,3
E33004445,216,148,58,90,0,20,7,13,46,42,0,4,0,2
E33004446,363,254,81,173,4,38,13,25,64,61,0,3,0,3
E33004447,345,229,66,163,0,28,12,16,82,76,0,6,0,6
E33004448,446,325,67,258,2,46,19,27,70,64,0,4,2,3
E33004449,243,147,42,105,1,38,22,16,55,47,1,5,2,2
E33004450,225,147,53,94,0,30,10,20,46,43,0,1,2,2
E33004451,530,373,126,247,3,62,27,35,86,80,0,5,1,6
E33004452,239,155,54,101,1,32,11,21,49,48,0,1,0,2
E33004453,630,485,136,349,6,40,16,24,96,87,0,8,1,3
E33004454,197,90,22,68,1,42,13,29,61,53,1,5,2,3
E33004455,433,268,73,195,3,34,13,21,124,120,0,3,1,4
E33004456,238,158,37,121,2,17,2,15,47,35,10,2,0,14
E33004457,280,161,50,111,4,36,12,24,76,69,1,3,3,3
E33004458,236,121,34,87,2,27,8,19,82,75,2,4,1,4
E33004459,1260,863,182,681,14,73,38,35,309,293,3,12,1,1
E33004460,934,671,142,529,5,66,27,39,188,171,1,15,1,4
E33004461,342,250,48,202,1,10,6,4,79,76,0,3,0,2
E33004462,201,104,28,76,0,36,19,17,59,56,0,2,1,2
E33004463,339,185,50,135,2,49,22,27,99,98,0,1,0,4
E33004464,466,215,55,160,4,77,30,47,168,159,0,9,0,2
E33004465,1056,672,144,528,4,67,27,40,309,304,1,4,0,4
E33004466,983,672,127,545,5,78,31,47,222,211,3,8,0,6
E33004467,1443,927,210,717,14,74,34,40,419,390,0,27,2,9
E33004468,271,143,36,107,1,34,21,13,92,88,0,3,1,1
E33004469,386,285,53,232,1,7,3,4,91,86,0,5,0,2
E33004470,1175,827,243,584,5,130,76,54,203,188,2,12,1,10
E33004471,335,256,54,202,2,14,6,8,62,60,0,2,0,1
E33004472,212,132,38,94,1,10,5,5,67,63,0,4,0,2
E33004473,723,479,105,374,5,44,15,29,192,177,0,14,1,3
E33004474,526,406,75,331,1,26,18,8,90,87,0,3,0,3
E33004475,798,562,144,418,4,103,54,49,125,114,0,9,2,4
E33004476,824,587,127,460,6,58,24,34,168,155,0,11,2,5
E33004477,488,315,88,227,0,52,22,30,119,108,0,9,2,2
E33004478,690,462,96,366,2,55,22,33,168,156,0,12,0,3
E33004479,727,349,74,275,5,62,26,36,306,288,1,15,2,5
E33004480,442,315,74,241,3,20,9,11,103,100,1,2,0,1
E33004481,775,527,119,408,5,45,23,22,196,192,1,3,0,2
E33004482,410,207,51,156,4,69,28,41,122,116,0,5,1,8
E33004483,235,111,27,84,4,24,7,17,94,91,0,2,1,2
E33004484,777,555,132,423,0,85,28,57,133,122,1,10,0,4
E33004485,450,324,73,251,2,44,17,27,76,72,1,1,2,4
E33004486,419,261,61,200,3,81,30,51,74,68,1,5,0,0
E33004487,425,264,72,192,2,70,28,42,83,75,3,5,0,6
E33004488,339,235,56,179,3,45,17,28,56,51,1,4,0,0
E33004489,662,439,124,315,2,124,54,70,93,92,0,1,0,4
E33004490,338,210,50,160,3,45,19,26,80,76,0,4,0,0
E33004491,457,340,84,256,2,24,8,16,91,83,2,6,0,0
E33004492,239,192,48,144,3,6,3,3,36,34,0,2,0,2
E33004493,197,159,51,108,0,5,1,4,32,30,0,2,0,1
E33004494,199,159,46,113,1,4,0,4,33,31,1,1,0,2
E33004495,370,259,41,218,5,14,8,6,90,85,0,4,1,2
E33004496,615,416,97,319,2,37,8,29,154,141,1,12,0,6
E33004497,353,167,48,119,1,35,12,23,148,139,1,8,0,2
E33004498,564,400,87,313,7,32,12,20,118,108,1,7,2,7
E33004499,531,333,71,262,1,28,11,17,165,158,1,5,1,4
E33004500,250,161,45,116,1,25,9,16,62,61,0,1,0,1
E33004501,332,205,61,144,1,39,10,29,86,82,0,2,2,1
E33004502,1368,1024,226,798,1,77,33,44,262,249,0,12,1,4
E33004503,3424,2370,546,1824,12,205,85,120,816,762,2,46,6,21
E33004504,414,272,57,215,3,21,10,11,111,108,1,2,0,7
E33004505,509,162,35,127,5,44,16,28,295,285,1,9,0,3
E33004506,353,204,34,170,1,20,8,12,126,125,0,1,0,2
E33004507,202,143,46,97,1,26,14,12,32,30,1,1,0,0
E33004508,605,405,100,305,4,30,17,13,163,153,0,9,1,3
E33004509,590,444,103,341,2,22,8,14,119,110,1,8,0,3
E33004510,1362,968,287,681,8,99,34,65,284,268,0,13,3,3
E33004511,355,210,35,175,5,22,14,8,115,108,2,5,0,3
E33004512,573,256,58,198,5,76,36,40,231,223,0,6,2,5
E33004513,1115,868,208,660,3,61,28,33,177,165,0,10,2,6
E33004514,240,133,33,100,1,28,12,16,77,65,2,8,2,1
E33004515,193,124,41,83,2,26,16,10,39,36,2,1,0,2
E33004516,559,323,84,239,8,78,32,46,149,145,0,4,0,1
E33004517,1553,1153,229,924,10,103,49,54,279,262,1,13,3,8
E33004518,936,583,127,456,7,124,53,71,217,198,1,15,3,5
E33004519,227,150,29,121,0,33,15,18,44,40,0,4,0,0
E33004520,237,144,44,100,3,40,18,22,48,45,0,2,1,2
E33004521,848,633,134,499,7,71,36,35,135,131,0,4,0,2
E33004522,473,308,68,240,6,56,9,47,99,89,1,8,1,4
E33004523,831,642,174,468,3,57,11,46,127,123,1,3,0,2
E33004524,464,314,100,214,5,28,9,19,117,113,0,4,0,0
E33004525,276,164,36,128,2,38,6,32,72,70,1,1,0,0
E33004526,552,355,100,255,0,65,14,51,129,125,1,2,1,3
E33004527,293,214,61,153,1,37,8,29,41,36,0,5,0,0
E33004528,229,182,41,141,1,11,2,9,35,33,0,2,0,0
E33004529,209,125,33,92,4,15,3,12,64,57,0,4,3,1
E33004530,753,574,147,427,4,55,13,42,116,109,0,6,1,4
E33004531,970,754,180,574,5,38,3,35,158,147,0,9,2,15
E33004532,1260,1033,281,752,2,63,14,49,158,140,2,14,2,4
E33004533,2445,1399,368,1031,18,308,66,242,703,670,2,25,6,17
E33004534,765,416,107,309,9,97,24,73,241,225,0,14,2,2
E33004535,357,134,33,101,5,41,8,33,174,168,0,4,2,3
E33004536,460,281,63,218,4,59,19,40,114,106,0,8,0,2
E33004537,259,157,23,134,1,32,7,25,68,64,0,3,1,1
E33004538,252,158,40,118,1,38,5,33,52,47,0,5,0,3
E33004539,443,279,52,227,2,45,4,41,115,109,0,6,0,2
E33004540,1199,708,176,532,5,237,59,178,243,231,0,11,1,6
E33004541,278,138,37,101,4,47,7,40,85,80,0,4,1,4
E33004542,326,198,47,151,1,44,6,38,80,72,0,7,1,3
E33004543,233,124,43,81,0,41,8,33,64,58,0,5,1,4
E33004544,506,253,57,196,5,59,8,51,184,178,0,5,1,5
E33004545,348,209,52,157,0,48,9,39,89,83,0,6,0,2
E33004546,697,450,114,336,4,102,26,76,139,130,0,7,2,2
E33004547,340,246,65,181,2,37,2,35,55,52,0,2,1,0
E33004548,271,155,47,108,4,33,9,24,74,74,0,0,0,5
E33004549,5725,4057,980,3077,33,596,108,488,1024,955,2,60,7,15
E33004550,296,222,70,152,2,23,8,15,48,46,0,2,0,1
E33004551,449,329,77,252,2,43,10,33,73,69,2,2,0,2
E33004552,197,141,37,104,0,22,5,17,34,34,0,0,0,0
E33004553,609,455,99,356,4,49,14,35,97,90,0,6,1,4
E33004554,227,144,33,111,1,29,8,21,51,48,0,3,0,2
E33004555,739,543,129,414,7,58,16,42,126,120,3,2,1,5
E33004556,1711,1398,312,1086,6,62,12,50,240,219,2,13,6,5
E33004557,735,607,140,467,3,46,9,37,75,70,0,5,0,4
E33004558,323,249,72,177,2,29,10,19,41,36,0,4,1,2
E33004559,280,229,52,177,1,15,1,14,33,31,0,2,0,2
E33004560,617,473,144,329,2,38,11,27,102,93,0,7,2,2
E33004561,198,118,38,80,2,19,4,15,56,54,0,2,0,3
E33004562,331,258,69,189,1,27,5,22,45,42,0,2,1,0
E33004563,1115,884,207,677,6,59,13,46,161,146,0,14,1,5
E33004564,113,93,30,63,2,2,0,2,16,16,0,0,0,0
E33004565,333,240,52,188,1,15,1,14,76,70,0,6,0,1
E33004566,157,89,29,60,1,10,4,6,56,54,0,1,1,1
E33004567,308,184,45,139,3,43,1,42,75,69,0,5,1,3
E33004568,256,179,35,144,1,25,9,16,51,48,1,2,0,0
E33004569,691,527,129,398,2,44,10,34,115,107,0,8,0,3
E33004570,208,128,30,98,0,25,10,15,53,50,1,2,0,2
E33004571,964,679,174,505,7,110,28,82,162,154,1,6,1,6
E33004572,310,231,51,180,3,24,4,20,52,44,1,7,0,0
E33004573,467,280,60,220,2,42,12,30,140,127,2,9,2,3
E33004574,524,379,83,296,5,38,8,30,99,88,0,11,0,3
E33004575,277,209,65,144,3,26,3,23,39,35,0,4,0,0
E33004576,256,217,63,154,0,11,4,7,28,25,0,3,0,0
E33004577,233,141,26,115,0,29,7,22,60,58,0,2,0,3
E33004578,322,212,54,158,0,42,15,27,67,65,0,2,0,1
E33004579,523,241,54,187,3,96,17,79,183,174,0,9,0,0
E33004580,547,389,131,258,1,68,17,51,83,75,2,5,1,6
E33004581,969,671,152,519,10,123,22,101,161,157,0,4,0,4
E33004582,697,452,130,322,3,110,24,86,128,124,0,2,2,4
E33004583,354,227,65,162,4,51,9,42,72,67,0,3,2,0
E33004584,585,334,72,262,9,79,15,64,156,149,0,3,4,7
E33004585,308,208,64,144,7,53,9,44,39,38,0,1,0,1
E33004586,591,379,100,279,4,91,25,66,114,110,0,3,1,3
E33004587,204,113,29,84,0,43,14,29,46,42,0,4,0,2
E33004588,285,152,36,116,2,33,2,31,97,95,0,2,0,1
E33004589,991,702,162,540,4,90,19,71,194,175,0,16,3,1
E33004590,238,130,46,84,3,49,4,45,56,54,0,2,0,0
E33004591,195,111,29,82,0,26,6,20,57,54,0,1,2,1
E33004592,441,368,106,262,3,30,2,28,40,37,0,3,0,0
E33004593,387,229,58,171,2,62,21,41,93,80,1,5,7,1
E33004594,498,362,79,283,4,26,5,21,102,95,0,6,1,4
E33004595,312,239,61,178,1,27,7,20,44,43,0,1,0,1
E33004596,474,311,90,221,5,38,6,32,118,110,0,7,1,2
E33004597,414,268,58,210,0,45,7,38,98,94,0,3,1,3
E33004598,253,114,28,86,4,23,5,18,112,107,0,2,3,0
E33004599,1146,834,181,653,7,121,23,98,180,168,0,10,2,4
E33004600,421,282,69,213,2,55,11,44,80,75,0,3,2,2
E33004601,638,485,107,378,1,38,8,30,111,103,0,8,0,3
E33004602,963,680,146,534,6,89,21,68,183,177,0,5,1,5
E33004603,395,248,71,177,3,97,14,83,46,43,0,1,2,1
E33004604,423,312,76,236,1,23,7,16,82,72,1,9,0,5
E33004605,612,466,122,344,2,35,4,31,109,98,0,9,2,0
E33004606,1120,777,169,608,7,115,26,89,218,198,13,7,0,3
E33004607,2226,1732,431,1301,10,179,28,151,295,274,0,21,0,10
E33004608,1021,716,189,527,7,102,24,78,190,185,0,2,3,6
E33004609,702,502,122,380,1,57,12,45,139,133,1,5,0,3
E33004610,485,359,106,253,3,62,12,50,58,54,0,3,1,3
E33004611,1110,805,201,604,7,121,24,97,175,163,0,9,3,2
E33004612,1563,1206,302,904,8,169,25,144,170,161,0,7,2,10
E33004613,761,593,138,455,5,57,7,50,104,94,0,10,0,2
E33004614,1499,1212,298,914,12,119,21,98,155,146,0,8,1,1
E33004615,376,258,73,185,1,48,5,43,68,65,0,1,2,1
E33004616,337,208,71,137,2,51,6,45,76,66,1,7,2,0
E33004617,442,291,92,199,2,46,11,35,99,96,0,3,0,4
E33004618,309,182,48,134,3,28,4,24,92,79,1,10,2,4
E33004619,363,161,52,109,2,27,1,26,171,160,4,4,3,2
E33004620,505,237,55,182,3,101,16,85,164,162,0,2,0,0
E33004621,519,272,80,192,0,63,10,53,179,167,3,8,1,5
E33004622,279,193,73,120,2,32,6,26,51,51,0,0,0,1
E33004623,226,121,42,79,0,34,4,30,70,67,0,3,0,1
E33004624,119,95,24,71,0,18,7,11,6,5,0,1,0,0
E33004625,1635,1274,274,1000,9,144,42,102,207,186,6,12,3,1
E33004626,398,303,86,217,3,43,8,35,49,47,1,1,0,0
E33004627,263,207,62,145,0,20,4,16,35,32,0,3,0,1
E33004628,598,339,73,266,5,69,12,57,180,172,0,8,0,5
E33004629,376,255,55,200,3,49,12,37,68,62,0,4,2,1
E33004630,2043,1499,339,1160,6,143,23,120,380,363,3,14,0,15
E33004631,1717,1310,286,1024,8,93,19,74,298,279,1,17,1,8
E33004632,425,356,121,235,1,13,10,3,53,46,0,4,3,2
E33004633,292,245,67,178,0,14,8,6,30,26,0,1,3,3
E33004634,325,293,79,214,1,4,3,1,25,21,0,4,0,2
E33004635,313,265,92,173,2,6,4,2,38,35,0,3,0,2
E33004636,479,377,83,294,2,29,18,11,66,62,0,4,0,5
E33004637,307,251,85,166,2,16,13,3,38,34,0,3,1,0
E33004638,388,321,78,243,1,19,13,6,47,44,0,3,0,0
E33004639,551,402,114,288,2,92,74,18,51,48,1,2,0,4
E33004640,233,181,50,131,0,13,8,5,37,34,0,3,0,2
E33004641,256,232,81,151,0,5,4,1,19,16,1,2,0,0
E33004642,513,437,130,307,2,18,14,4,54,52,0,2,0,2
E33004643,335,262,91,171,2,19,18,1,50,46,0,4,0,2
E33004644,335,296,80,216,3,10,7,3,25,19,0,6,0,1
E33004645,351,303,76,227,2,8,7,1,35,28,0,7,0,3
E33004646,412,311,90,221,0,19,17,2,73,64,0,8,1,9
E33004647,246,192,45,147,2,19,15,4,33,31,0,2,0,0
E33004648,275,199,68,131,1,31,25,6,37,33,0,2,2,7
E33004649,297,206,48,158,2,46,35,11,41,38,0,2,1,2
E33004650,391,293,70,223,3,38,25,13,51,45,0,4,2,6
E33004651,332,281,73,208,2,23,19,4,25,22,0,3,0,1
E33004652,447,323,94,229,1,65,60,5,54,52,0,1,1,4
E33004653,416,319,115,204,0,37,23,14,59,55,0,4,0,1
E33004654,743,543,162,381,3,81,58,23,107,93,0,10,4,9
E33004655,245,188,51,137,1,20,13,7,34,32,0,2,0,2
E33004656,438,298,83,215,1,47,41,6,89,81,0,5,3,3
E33004657,285,222,60,162,1,27,21,6,35,29,0,2,4,0
E33004658,435,368,114,254,3,22,18,4,39,38,0,1,0,3
E33004659,368,308,97,211,1,10,3,7,45,41,0,3,1,4
E33004660,444,384,112,272,1,35,21,14,19,17,0,0,2,5
E33004661,264,231,72,159,1,8,5,3,24,22,0,2,0,0
E33004662,2209,1601,433,1168,10,238,174,64,343,318,0,22,3,17
E33004663,1577,1245,353,892,8,143,98,45,178,160,2,16,0,3
E33004664,1139,898,219,679,8,85,57,28,142,127,1,12,2,6
E33004665,239,193,57,136,1,16,9,7,27,23,0,2,2,2
E33004666,626,500,119,381,2,37,23,14,83,78,0,4,1,4
E33004667,367,289,88,201,0,25,17,8,46,43,0,3,0,7
E33004668,386,324,85,239,0,29,16,13,32,29,0,3,0,1
E33004669,505,418,125,293,2,30,20,10,51,43,0,6,2,4
E33004670,319,253,77,176,1,24,15,9,38,37,0,1,0,3
E33004671,293,238,64,174,2,19,10,9,32,27,0,5,0,2
E33004672,326,269,93,176,1,21,19,2,34,33,0,1,0,1
E33004673,681,511,150,361,3,65,47,18,100,92,2,5,1,2
E33004674,259,194,58,136,0,28,24,4,37,29,0,8,0,0
E33004675,331,274,81,193,0,23,17,6,33,28,0,5,0,1
E33004676,430,330,87,243,1,62,52,10,34,32,0,2,0,3
E33004677,363,241,74,167,4,53,39,14,59,57,0,1,1,6
E33004678,560,408,117,291,3,79,61,18,69,62,0,7,0,1
E33004679,385,308,84,224,4,34,20,14,36,34,0,2,0,3
E33004680,394,296,72,224,2,57,51,6,37,31,0,5,1,2
E33004681,465,307,137,170,2,72,43,29,77,64,0,10,3,7
E33004682,242,172,53,119,0,23,17,6,45,40,0,5,0,2
E33004683,311,209,64,145,1,63,45,18,35,32,0,3,0,3
E33004684,502,395,121,274,3,43,28,15,58,52,1,3,2,3
E33004685,301,220,60,160,2,33,23,10,41,37,2,2,0,5
E33004686,344,211,63,148,0,86,78,8,44,39,0,3,2,3
E33004687,241,199,63,136,3,18,15,3,17,15,2,0,0,4
E33004688,608,479,140,339,3,44,37,7,77,68,1,4,4,5
E33004689,258,157,40,117,0,73,65,8,24,23,0,1,0,4
E33004690,482,329,92,237,2,108,88,20,41,36,0,5,0,2
E33004691,619,409,110,299,1,123,105,18,83,76,1,5,1,3
E33004692,1027,741,222,519,1,126,96,30,159,145,5,9,0,0
E33004693,256,192,45,147,2,27,17,10,29,26,0,3,0,6
E33004694,1027,800,200,600,2,49,31,18,175,160,0,14,1,1
E33004695,254,205,68,137,2,18,9,9,27,23,1,3,0,2
E33004696,894,669,199,470,5,103,71,32,112,108,0,4,0,5
E33004697,652,474,153,321,6,75,53,22,93,83,0,7,3,4
E33004698,349,238,63,175,1,42,29,13,65,59,1,5,0,3
E33004699,346,246,82,164,2,33,21,12,64,60,0,2,2,1
E33004700,324,224,56,168,2,24,13,11,72,67,0,4,1,2
E33004701,279,205,50,155,0,25,16,9,47,40,0,7,0,2
E33004702,517,401,147,254,2,52,37,15,62,62,0,0,0,0
E33004703,788,609,148,461,4,59,39,20,111,94,1,15,1,5
E33004704,271,200,52,148,1,36,22,14,33,27,0,6,0,1
E33004705,718,565,148,417,4,65,43,22,81,74,0,6,1,3
E33004706,335,245,67,178,1,46,33,13,41,38,0,3,0,2
E33004707,382,252,92,160,2,60,38,22,64,58,0,4,2,4
E33004708,217,178,76,102,1,24,18,6,12,9,0,3,0,2
E33004709,209,122,36,86,2,50,36,14,35,35,0,0,0,0
E33004710,250,201,78,123,2,24,11,13,22,22,0,0,0,1
E33004711,226,149,50,99,2,49,36,13,24,21,0,3,0,2
E33004712,373,221,77,144,2,59,24,35,86,83,0,2,1,5
E33004713,412,294,102,192,2,55,42,13,56,51,0,4,1,5
E33004714,577,396,96,300,7,82,58,24,88,83,0,5,0,4
E33004715,294,220,56,164,0,38,24,14,36,31,0,5,0,0
E33004716,246,173,50,123,4,33,21,12,34,31,0,2,1,2
E33004717,312,227,82,145,0,38,22,16,42,35,0,6,1,5
E33004718,329,247,82,165,5,32,24,8,44,40,0,4,0,1
E33004719,295,199,65,134,1,46,34,12,47,45,1,1,0,2
E33004720,382,280,91,189,1,31,28,3,66,62,0,4,0,4
E33004721,313,256,62,194,0,13,9,4,43,40,0,2,1,1
E33004722,433,311,110,201,2,45,30,15,67,61,2,3,1,8
E33004723,374,259,61,198,2,63,39,24,48,41,0,6,1,2
E33004724,298,257,70,187,0,15,12,3,20,18,0,2,0,6
E33004725,614,459,98,361,5,72,56,16,78,67,0,11,0,0
E33004726,283,219,60,159,0,34,28,6,26,25,0,1,0,4
E33004727,396,314,91,223,5,35,25,10,39,30,0,8,1,3
E33004728,305,276,109,167,0,6,4,2,23,22,0,1,0,0
E33004729,486,398,108,290,2,34,24,10,43,41,0,2,0,9
E33004730,577,471,116,355,3,29,16,13,69,63,0,6,0,5
E33004731,350,313,130,183,1,11,6,5,25,23,0,1,1,0
E33004732,415,262,89,173,0,77,53,24,69,63,0,6,0,7
E33004733,297,204,115,89,0,47,30,17,40,33,1,6,0,6
E33004734,783,567,163,404,3,132,93,39,79,69,0,8,2,2
E33004735,481,306,90,216,1,84,68,16,79,71,0,7,1,11
E33004736,454,325,140,185,1,66,46,20,52,45,1,4,2,10
E33004737,642,523,96,427,0,30,20,10,80,71,0,8,1,9
E33004738,615,436,141,295,3,111,83,28,62,60,0,2,0,3
E33004739,247,199,46,153,2,15,11,4,29,28,0,1,0,2
E33004740,293,195,68,127,2,43,35,8,51,45,0,5,1,2
E33004741,431,307,87,220,0,46,34,12,78,76,0,2,0,0
E33004742,530,350,95,255,4,77,55,22,94,88,1,5,0,5
E33004743,270,180,51,129,1,58,35,23,29,25,0,4,0,2
E33004744,279,214,45,169,0,31,24,7,33,27,1,5,0,1
E33004745,272,197,60,137,3,37,26,11,34,32,0,2,0,1
E33004746,345,268,71,197,0,21,13,8,52,46,0,5,1,4
E33004747,248,200,80,120,1,20,11,9,21,17,0,3,1,6
E33004748,664,536,157,379,0,55,35,20,72,54,7,10,1,1
E33004749,352,250,89,161,2,35,22,13,63,55,3,3,2,2
E33004750,278,193,102,91,1,38,22,16,43,37,0,4,2,3
E33004751,341,265,88,177,0,28,21,7,41,36,2,2,1,7
E33004752,260,163,69,94,0,56,38,18,40,38,0,0,2,1
E33004753,286,246,71,175,0,15,9,6,24,22,0,2,0,1
E33004754,331,252,85,167,3,42,30,12,28,23,2,3,0,6
E33004755,283,228,87,141,2,22,19,3,28,24,0,4,0,3
E33004756,299,234,69,165,1,24,17,7,40,35,0,5,0,0
E33004757,261,194,56,138,3,24,21,3,36,32,0,4,0,4
E33004758,357,295,82,213,0,29,24,5,32,29,0,3,0,1
E33004759,461,287,107,180,7,99,79,20,55,52,0,3,0,13
E33004760,572,379,133,246,1,91,64,27,95,87,0,4,4,6
E33004761,314,234,71,163,2,13,7,6,61,57,0,2,2,4
E33004762,454,335,135,200,2,52,36,16,55,52,0,2,1,10
E33004763,274,198,60,138,0,34,14,20,41,34,0,4,3,1
E33004764,244,176,40,136,1,39,25,14,26,25,0,1,0,2
E33004765,389,279,68,211,1,48,36,12,58,55,0,2,1,3
E33004766,565,389,121,268,3,89,64,25,78,72,0,5,1,6
E33004767,379,286,82,204,2,44,27,17,43,34,0,9,0,4
E33004768,511,372,105,267,4,71,51,20,62,52,1,8,1,2
E33004769,330,278,84,194,2,22,17,5,25,22,0,3,0,3
E33004770,504,413,124,289,1,28,23,5,57,51,0,6,0,5
E33004771,544,417,96,321,3,35,21,14,89,75,0,13,1,0
E33004772,242,194,48,146,1,10,6,4,37,31,0,6,0,0
E33004773,311,272,88,184,1,12,7,5,26,23,0,2,1,0
E33004774,371,281,59,222,1,53,44,9,33,27,0,5,1,3
E33004775,503,408,111,297,1,39,28,11,46,37,0,9,0,9
E33004776,416,343,121,222,2,29,26,3,40,36,0,2,2,2
E33004777,733,536,146,390,2,97,72,25,96,83,0,13,0,2
E33004778,298,216,83,133,0,47,39,8,31,28,0,3,0,4
E33004779,513,403,99,304,1,45,33,12,59,56,0,3,0,5
E33004780,555,423,104,319,2,62,44,18,64,59,0,4,1,4
E33004781,344,250,83,167,0,57,36,21,37,35,0,2,0,0
E33004782,493,396,106,290,3,36,24,12,58,52,0,6,0,0
E33004783,297,197,61,136,0,41,31,10,55,48,1,6,0,4
E33004784,463,333,103,230,6,67,51,16,45,40,0,5,0,12
E33004785,273,230,67,163,0,19,14,5,23,22,0,0,1,1
E33004786,290,187,47,140,2,43,38,5,55,46,1,7,1,3
E33004787,311,224,65,159,1,52,36,16,32,25,0,6,1,2
E33004788,415,310,102,208,2,59,42,17,42,37,0,5,0,2
E33004789,383,265,68,197,1,50,37,13,63,55,0,6,2,4
E33004790,703,481,146,335,6,132,101,31,77,71,1,5,0,7
E33004791,322,232,48,184,2,45,35,10,42,38,0,4,0,1
E33004792,318,227,72,155,3,34,24,10,52,47,0,3,2,2
E33004793,664,466,147,319,2,103,73,30,90,75,0,14,1,3
E33004794,328,270,60,210,1,25,18,7,29,25,1,3,0,3
E33004795,307,218,53,165,0,21,14,7,67,58,1,7,1,1
E33004796,519,392,93,299,1,62,44,18,60,52,0,7,1,4
E33004797,288,209,70,139,0,46,30,16,31,26,0,3,2,2
E33004798,298,252,48,204,0,20,15,5,25,21,1,3,0,1
E33004799,300,261,71,190,0,14,9,5,24,21,0,3,0,1
E33004800,274,219,65,154,1,26,11,15,27,19,1,7,0,1
E33004801,298,276,55,221,1,6,3,3,15,15,0,0,0,0
E33004802,310,263,65,198,0,13,12,1,30,27,0,3,0,4
E33004803,493,397,119,278,3,25,16,9,66,55,0,9,2,2
E33004804,293,255,64,191,1,7,5,2,30,24,0,6,0,0
E33004805,248,193,57,136,0,20,9,11,32,27,0,5,0,3
E33004806,531,419,130,289,0,35,23,12,71,60,2,5,4,6
E33004807,558,459,144,315,1,27,17,10,63,57,1,4,1,8
E33004808,389,314,89,225,2,29,23,6,39,33,2,4,0,5
E33004809,385,345,108,237,0,15,12,3,22,20,0,2,0,3
E33004810,349,294,90,204,0,21,17,4,33,30,2,0,1,1
E33004811,407,360,103,257,0,13,8,5,31,28,0,3,0,3
E33004812,435,361,96,265,1,16,11,5,53,45,1,7,0,4
E33004813,324,277,88,189,3,15,10,5,23,21,0,2,0,6
E33004814,242,199,76,123,1,7,5,2,30,24,0,4,2,5
E33004815,459,385,115,270,1,26,19,7,42,36,0,6,0,5
E33004816,245,202,60,142,1,18,13,5,24,24,0,0,0,0
E33004817,322,288,66,222,0,6,1,5,24,21,0,3,0,4
E33004818,336,273,69,204,0,13,8,5,47,45,0,2,0,3
E33004819,398,289,84,205,4,54,44,10,48,43,0,3,2,3
E33004820,578,452,146,306,3,47,38,9,68,62,0,6,0,8
E33004821,300,222,61,161,1,28,23,5,47,41,0,5,1,2
E33004822,508,379,119,260,0,58,48,10,60,53,0,7,0,11
E33004823,278,227,73,154,1,22,19,3,25,23,0,2,0,3
E33004824,410,351,103,248,1,18,13,5,36,33,0,3,0,4
E33004825,294,204,46,158,0,42,36,6,45,42,0,3,0,3
E33004826,408,327,83,244,1,28,20,8,52,48,0,4,0,0
E33004827,302,274,74,200,1,4,4,0,23,19,0,4,0,0
E33004828,464,371,112,259,0,26,15,11,63,53,2,8,0,4
E33004829,396,338,68,270,1,8,7,1,45,40,0,3,2,4
E33004830,2500,2006,530,1476,10,155,82,73,314,284,4,24,2,15
E33004831,773,587,166,421,0,88,56,32,95,85,0,10,0,3
E33004832,375,255,39,216,0,68,52,16,51,42,1,8,0,1
E33004833,685,510,155,355,2,82,59,23,90,82,0,7,1,1
E33004834,411,321,79,242,1,35,26,9,52,44,0,8,0,2
E33004835,257,169,38,131,1,53,44,9,30,28,0,2,0,4
E33004836,562,420,103,317,1,69,37,32,69,62,0,6,1,3
E33004837,616,463,131,332,5,51,23,28,88,79,1,8,0,9
E33004838,315,225,58,167,0,38,24,14,51,43,3,5,0,1
E33004839,322,238,83,155,0,34,16,18,46,41,0,4,1,4
E33004840,418,294,87,207,6,49,34,15,64,49,0,13,2,5
E33004841,291,218,78,140,1,23,15,8,47,45,0,2,0,2
E33004842,321,239,55,184,1,25,17,8,56,47,0,8,1,0
E33004843,557,356,63,293,2,69,45,24,129,122,1,6,0,1
E33004844,259,198,66,132,0,15,10,5,43,38,0,5,0,3
E33004845,306,232,64,168,1,26,19,7,42,40,0,2,0,5
E33004846,232,156,44,112,2,29,21,8,44,42,0,2,0,1
E33004847,281,203,65,138,4,14,12,2,58,48,0,6,4,2
E33004848,513,428,147,281,0,27,17,10,54,45,0,9,0,4
E33004849,294,263,94,169,1,8,6,2,19,17,0,2,0,3
E33004850,335,300,84,216,1,12,7,5,20,16,1,3,0,2
E33004851,319,237,68,169,1,26,16,10,52,44,2,5,1,3
E33004852,282,215,55,160,0,23,12,11,43,38,0,5,0,1
E33004853,290,200,60,140,3,46,15,31,39,36,0,3,0,2
E33004854,337,243,57,186,0,44,27,17,49,45,0,4,0,1
E33004855,323,269,83,186,2,14,11,3,32,30,0,2,0,6
E33004856,336,268,75,193,2,38,29,9,24,23,0,1,0,4
E33004857,931,738,208,530,1,93,61,32,95,79,0,14,2,4
E33004858,280,202,56,146,0,31,10,21,47,45,0,2,0,0
E33004859,308,234,52,182,0,24,20,4,50,43,0,7,0,0
E33004860,623,453,104,349,4,72,39,33,93,88,0,5,0,1
E33004861,670,544,122,422,1,33,20,13,91,83,0,6,2,1
E33004862,304,243,51,192,2,19,14,5,40,38,0,2,0,0
E33004863,337,269,77,192,0,27,19,8,40,34,1,5,0,1
E33004864,450,377,100,277,2,22,15,7,46,36,1,9,0,3
E33004865,606,482,127,355,2,41,23,18,81,79,0,2,0,0
E33004866,546,375,99,276,2,89,65,24,79,71,3,4,1,1
E33004867,239,169,49,120,1,30,12,18,39,31,0,4,4,0
E33004868,197,149,42,107,1,17,12,5,30,26,0,4,0,0
E33004869,290,210,62,148,0,20,7,13,57,55,0,0,2,3
E33004870,352,245,41,204,1,48,41,7,56,47,0,8,1,2
E33004871,385,255,80,175,0,69,37,32,58,50,0,6,2,3
E33004872,591,442,114,328,4,65,31,34,80,77,0,3,0,0
E33004873,473,359,87,272,1,55,41,14,58,55,0,3,0,0
E33004874,583,451,124,327,3,61,37,24,58,52,1,5,0,10
E33004875,362,278,64,214,0,46,19,27,36,30,1,4,1,2
E33004876,334,254,74,180,1,28,13,15,48,43,0,5,0,3
E33004877,326,280,86,194,0,13,8,5,32,31,0,1,0,1
E33004878,311,246,67,179,1,22,11,11,39,36,0,3,0,3
E33004879,416,353,119,234,0,13,7,6,48,44,1,3,0,2
E33004880,595,407,137,270,3,88,61,27,93,82,2,7,2,4
E33004881,327,249,65,184,1,28,18,10,46,40,2,4,0,3
E33004882,377,294,80,214,1,29,21,8,50,45,0,4,1,3
E33004883,353,262,70,192,2,45,36,9,38,35,0,2,1,6
E33004884,253,188,66,122,0,24,13,11,39,32,0,5,2,2
E33004885,297,236,69,167,1,16,9,7,38,31,0,7,0,6
E33004886,492,431,153,278,0,16,8,8,42,39,1,2,0,3
E33004887,293,217,51,166,1,22,12,10,50,49,0,1,0,3
E33004888,272,190,54,136,1,32,15,17,49,46,0,2,1,0
E33004889,329,246,66,180,2,25,13,12,53,48,0,5,0,3
E33004890,455,370,83,287,0,23,13,10,60,57,0,2,1,2
E33004891,248,190,54,136,0,35,22,13,22,19,0,3,0,1
E33004892,535,381,99,282,0,63,27,36,89,82,0,5,2,2
E33004893,726,513,104,409,1,114,65,49,96,88,1,7,0,2
E33004894,385,255,67,188,0,86,14,72,41,37,0,4,0,3
E33004895,415,275,93,182,4,24,17,7,109,102,1,4,2,3
E33004896,332,245,74,171,1,32,25,7,49,46,0,2,1,5
E33004897,508,438,120,318,0,22,15,7,46,44,0,2,0,2
E33004898,294,224,54,170,2,29,25,4,36,34,0,2,0,3
E33004899,394,272,70,202,3,37,22,15,80,72,1,6,1,2
E33004900,550,429,99,330,1,46,23,23,66,62,0,1,3,8
E33004901,358,274,72,202,0,38,26,12,42,34,0,8,0,4
E33004902,347,227,74,153,1,43,21,22,74,64,0,7,3,2
E33004903,246,183,50,133,0,34,10,24,29,25,0,4,0,0
E33004904,284,234,62,172,0,15,9,6,35,33,0,1,1,0
E33004905,226,166,61,105,0,21,9,12,36,35,0,1,0,3
E33004906,567,388,99,289,0,46,27,19,133,127,1,5,0,0
E33004907,373,288,113,175,1,30,18,12,52,47,0,5,0,2
E33004908,336,244,84,160,2,44,26,18,45,45,0,0,0,1
E33004909,668,465,131,334,4,95,51,44,101,95,0,6,0,3
E33004910,419,268,75,193,0,26,14,12,120,111,0,8,1,5
E33004911,300,236,65,171,0,15,10,5,45,43,0,2,0,4
E33004912,322,251,66,185,1,9,8,1,61,57,1,3,0,0
E33004913,365,298,69,229,2,16,9,7,48,43,0,5,0,1
E33004914,271,204,58,146,1,28,21,7,35,32,0,3,0,3
E33004915,356,282,106,176,0,19,15,4,54,50,0,4,0,1
E33004916,409,276,71,205,3,80,38,42,49,45,0,3,1,1
E33004917,640,448,92,356,7,122,104,18,61,53,0,8,0,2
E33004918,321,223,55,168,2,53,43,10,39,34,0,3,2,4
E33004919,361,238,64,174,4,51,34,17,65,61,2,2,0,3
E33004920,487,310,75,235,12,79,57,22,86,81,0,5,0,0
E33004921,310,227,50,177,1,46,30,16,33,33,0,0,0,3
E33004922,338,215,58,157,2,57,35,22,63,57,2,4,0,1
E33004923,434,316,85,231,2,44,26,18,70,59,0,7,4,2
E33004924,279,152,47,105,4,84,63,21,37,32,0,5,0,2
E33004925,298,177,41,136,4,74,56,18,41,37,0,4,0,2
E33004926,266,199,36,163,0,44,29,15,20,16,0,4,0,3
E33004927,345,246,61,185,2,54,39,15,39,34,2,3,0,4
E33004928,478,319,90,229,3,96,75,21,58,50,0,7,1,2
E33004929,307,212,53,159,2,53,38,15,40,38,0,1,1,0
E33004930,324,244,70,174,0,29,14,15,50,46,0,4,0,1
E33004931,363,209,57,152,2,79,43,36,72,64,1,7,0,1
E33004932,466,326,119,207,4,36,13,23,89,84,1,4,0,11
E33004933,315,256,59,197,1,24,12,12,31,28,0,2,1,3
E33004934,271,184,57,127,3,36,26,10,46,40,0,5,1,2
E33004935,440,327,78,249,2,78,57,21,26,25,0,1,0,7
E33004936,385,272,62,210,2,53,38,15,55,51,0,4,0,3
E33004937,406,267,86,181,3,64,33,31,65,60,1,2,2,7
E33004938,486,296,83,213,2,82,58,24,100,93,1,6,0,6
E33004939,391,209,49,160,2,58,45,13,118,112,0,4,2,4
E33004940,596,332,94,238,4,147,99,48,108,101,1,5,1,5
E33004941,470,279,71,208,3,63,32,31,123,112,0,6,5,2
E33004942,363,231,77,154,3,66,47,19,58,58,0,0,0,5
E33004943,301,206,67,139,0,32,23,9,58,58,0,0,0,5
E33004944,404,306,88,218,1,29,18,11,64,58,0,6,0,4
E33004945,463,272,97,175,1,56,27,29,127,113,0,13,1,7
E33004946,286,200,52,148,0,28,14,14,55,50,0,5,0,3
E33004947,847,496,146,350,5,118,64,54,225,218,0,5,2,3
E33004948,705,489,145,344,4,93,54,39,111,99,0,10,2,8
E33004949,830,566,150,416,5,95,37,58,159,146,0,11,2,5
E33004950,302,161,42,119,1,49,20,29,86,80,1,2,3,5
E33004951,429,224,46,178,1,117,80,37,82,67,1,14,0,5
E33004952,489,251,67,184,4,109,63,46,118,113,0,5,0,7
E33004953,398,195,55,140,9,105,64,41,86,77,3,4,2,3
E33004954,260,159,35,124,1,62,37,25,34,32,0,1,1,4
E33004955,353,222,72,150,0,69,41,28,60,55,0,4,1,2
E33004956,360,245,71,174,4,52,27,25,57,50,3,2,2,2
E33004957,427,279,68,211,3,83,44,39,54,51,1,2,0,8
E33004958,315,222,49,173,1,50,31,19,42,42,0,0,0,0
E33004959,428,208,60,148,2,124,42,82,90,86,0,4,0,4
E33004960,448,257,62,195,4,138,79,59,43,39,0,4,0,6
E33004961,368,249,78,171,0,53,24,29,62,57,0,4,1,4
E33004962,405,239,47,192,2,55,31,24,107,103,0,4,0,2
E33004963,297,116,15,101,2,12,6,6,167,157,0,10,0,0
E33004964,283,156,36,120,1,86,60,26,37,33,1,3,0,3
E33004965,490,299,75,224,2,84,29,55,99,94,0,5,0,6
E33004966,388,232,57,175,1,81,39,42,70,64,0,5,1,4
E33004967,239,129,26,103,2,50,19,31,54,52,0,2,0,4
E33004968,625,489,87,402,3,57,20,37,73,66,0,7,0,3
E33004969,321,197,43,154,2,52,21,31,69,64,0,2,3,1
E33004970,267,147,42,105,5,69,22,47,46,42,0,2,2,0
E33004971,484,279,70,209,3,106,37,69,92,88,0,1,3,4
E33004972,397,209,48,161,1,54,19,35,130,122,0,8,0,3
E33004973,243,171,36,135,0,42,13,29,30,29,0,1,0,0
E33004974,572,394,94,300,5,92,34,58,76,69,2,3,2,5
E33004975,417,238,73,165,1,81,27,54,86,78,0,7,1,11
E33004976,353,254,55,199,2,53,17,36,41,35,0,4,2,3
E33004977,278,155,48,107,0,63,25,38,54,50,0,2,2,6
E33004978,657,392,103,289,0,136,56,80,125,116,0,6,3,4
E33004979,179,73,15,58,0,61,6,55,44,42,0,1,1,1
E33004980,613,389,95,294,4,106,24,82,109,106,0,3,0,5
E33004981,270,115,39,76,1,113,91,22,36,34,0,2,0,5
E33004982,598,308,53,255,3,123,34,89,156,146,0,6,4,8
E33004983,689,447,116,331,5,117,53,64,116,104,1,11,0,4
E33004984,431,268,72,196,0,98,46,52,63,56,2,4,1,2
E33004985,326,178,51,127,0,59,33,26,87,81,0,5,1,2
E33004986,399,246,41,205,1,72,21,51,75,71,0,3,1,5
E33004987,316,184,60,124,1,49,8,41,78,75,0,2,1,4
E33004988,429,207,53,154,0,114,26,88,105,97,0,6,2,3
E33004989,359,199,42,157,1,34,7,27,122,114,1,5,2,3
E33004990,395,183,39,144,3,62,16,46,142,134,0,7,1,5
E33004991,764,572,130,442,5,80,27,53,103,95,0,6,2,4
E33004992,651,420,101,319,9,78,32,46,140,129,0,9,2,4
E33004993,415,205,56,149,0,124,44,80,84,74,0,10,0,2
E33004994,541,333,85,248,2,132,63,69,68,60,0,6,2,6
E33004995,387,238,63,175,1,83,36,47,64,59,0,2,3,1
E33004996,598,386,90,296,6,99,36,63,104,95,1,5,3,3
E33004997,726,462,127,335,5,144,49,95,113,105,1,7,0,2
E33004998,668,431,92,339,6,114,56,58,111,102,0,8,1,6
E33004999,568,369,98,271,1,66,16,50,128,117,2,9,0,4
E33005000,275,172,39,133,3,32,14,18,68,62,0,3,3,0
E33005001,514,317,62,255,2,80,44,36,113,108,0,5,0,2
E33005002,634,452,59,393,7,48,12,36,116,109,0,6,1,11
E33005003,211,109,22,87,1,27,8,19,73,68,0,5,0,1
E33005004,452,295,97,198,1,59,28,31,89,83,1,3,2,8
E33005005,271,131,52,79,0,45,7,38,94,86,2,4,2,1
E33005006,275,169,36,133,1,34,10,24,71,67,1,3,0,0
E33005007,280,129,36,93,2,43,7,36,104,99,0,5,0,2
E33005008,342,153,56,97,5,62,26,36,119,113,1,5,0,3
E33005009,251,143,43,100,1,41,19,22,60,57,0,2,1,6
E33005010,564,321,64,257,9,124,50,74,109,99,0,9,1,1
E33005011,468,229,64,165,3,110,49,61,119,113,0,5,1,7
E33005012,406,184,55,129,1,120,47,73,100,92,1,7,0,1
E33005013,439,240,53,187,1,109,36,73,81,77,0,3,1,8
E33005014,288,111,34,77,1,111,37,74,63,51,0,3,9,2
E33005015,276,123,33,90,3,85,22,63,62,59,0,2,1,3
E33005016,551,335,89,246,1,132,51,81,78,69,0,8,1,5
E33005017,335,151,46,105,5,79,19,60,93,80,1,12,0,7
E33005018,412,141,51,90,1,109,21,88,159,151,1,6,1,2
E33005019,520,246,88,158,2,121,26,95,141,133,0,6,2,10
E33005020,353,160,42,118,0,65,20,45,125,110,4,11,0,3
E33005021,249,148,46,102,1,32,12,20,65,65,0,0,0,3
E33005022,287,184,55,129,4,30,14,16,65,58,0,7,0,4
E33005023,329,163,37,126,1,80,37,43,82,75,0,3,4,3
E33005024,313,210,55,155,0,51,24,27,43,36,0,7,0,9
E33005025,304,150,40,110,3,52,19,33,94,83,1,9,1,5
E33005026,259,122,45,77,8,50,28,22,79,76,0,2,1,0
E33005027,440,268,78,190,2,57,20,37,112,107,0,4,1,1
E33005028,285,195,71,124,1,38,22,16,47,47,0,0,0,4
E33005029,336,174,62,112,3,49,9,40,99,91,0,5,3,11
E33005030,463,274,66,208,5,85,27,58,96,89,0,6,1,3
E33005031,456,236,76,160,3,44,18,26,170,151,0,16,3,3
E33005032,744,379,117,262,8,120,18,102,223,210,1,8,4,14
E33005033,560,339,92,247,2,85,25,60,125,116,1,6,2,9
E33005034,344,158,46,112,0,59,18,41,124,117,0,6,1,3
E33005035,527,303,89,214,8,55,11,44,150,140,4,6,0,11
E33005036,461,232,62,170,1,65,7,58,160,152,0,6,2,3
E33005037,334,232,67,165,2,22,7,15,76,69,0,7,0,2
E33005038,307,152,46,106,1,37,11,26,116,108,5,3,0,1
E33005039,301,192,62,130,0,24,11,13,83,75,0,8,0,2
E33005040,633,438,117,321,3,51,24,27,139,130,4,5,0,2
E33005041,267,205,59,146,0,17,4,13,42,38,1,2,1,3
E33005042,314,178,54,124,2,46,16,30,84,81,0,3,0,4
E33005043,799,509,159,350,4,89,28,61,190,178,0,11,1,7
E33005044,306,164,34,130,0,71,41,30,69,56,4,9,0,2
E33005045,378,204,39,165,1,97,52,45,73,60,0,13,0,3
E33005046,605,436,117,319,0,65,31,34,104,95,0,9,0,0
E33005047,269,164,53,111,1,30,7,23,72,68,2,2,0,2
E33005048,603,365,96,269,2,76,29,47,151,146,0,5,0,9
E33005049,364,165,42,123,3,69,21,48,123,115,1,7,0,4
E33005050,357,215,56,159,9,59,17,42,70,63,0,7,0,4
E33005051,383,254,75,179,3,39,11,28,84,74,1,7,2,3
E33005052,288,195,46,149,2,32,5,27,57,52,0,4,1,2
E33005053,223,64,18,46,2,28,13,15,127,126,0,1,0,2
E33005054,299,171,62,109,0,34,9,25,93,89,0,4,0,1
E33005055,232,101,29,72,4,28,9,19,94,88,0,6,0,5
E33005056,311,189,69,120,2,19,8,11,99,98,0,1,0,2
E33005057,425,166,52,114,2,80,21,59,175,168,1,5,1,2
E33005058,463,170,47,123,2,47,12,35,236,222,0,7,7,8
E33005059,598,357,125,232,4,43,11,32,193,185,0,5,3,1
E33005060,472,302,83,219,2,67,21,46,99,94,0,4,1,2
E33005061,577,361,141,220,1,61,26,35,147,141,0,4,2,7
E33005062,296,176,36,140,2,65,23,42,50,47,0,2,1,3
E33005063,336,207,65,142,3,33,14,19,91,85,1,5,0,2
E33005064,357,256,81,175,1,42,13,29,56,54,0,1,1,2
E33005065,434,293,94,199,2,46,18,28,88,79,1,8,0,5
E33005066,454,337,87,250,3,28,11,17,83,78,0,5,0,3
E33005067,327,173,54,119,3,75,25,50,74,73,0,1,0,2
E33005068,412,217,67,150,1,43,13,30,149,141,0,7,1,2
E33005069,429,269,67,202,6,80,30,50,70,70,0,0,0,4
E33005070,494,278,78,200,2,57,20,37,154,151,0,1,2,3
E33005071,1372,634,163,471,4,207,78,129,509,485,1,18,5,18
E33005072,414,249,92,157,2,36,9,27,124,115,0,9,0,3
E33005073,315,206,57,149,2,15,5,10,92,78,7,1,6,0
E33005074,363,233,58,175,1,72,37,35,55,51,0,4,0,2
E33005075,297,235,64,171,3,14,0,14,44,41,2,0,1,1
E33005076,415,242,76,166,1,67,26,41,100,95,0,4,1,5
E33005077,393,195,65,130,2,30,7,23,163,151,0,11,1,3
E33005078,440,222,68,154,1,70,35,35,140,128,2,9,1,7
E33005079,505,317,116,201,3,50,14,36,134,131,0,3,0,1
E33005080,751,375,89,286,4,80,29,51,288,266,2,19,1,4
E33005081,817,544,119,425,4,65,18,47,198,188,1,9,0,6
E33005082,401,248,53,195,9,63,31,32,71,66,0,1,4,10
E33005083,592,360,115,245,1,87,28,59,139,129,3,6,1,5
E33005084,254,122,26,96,0,26,12,14,98,93,0,4,1,8
E33005085,409,254,72,182,2,48,23,25,100,92,2,5,1,5
E33005086,406,258,81,177,1,46,21,25,98,98,0,0,0,3
E33005087,482,280,78,202,3,90,34,56,109,100,1,8,0,0
E33005088,340,174,49,125,4,34,14,20,126,115,1,10,0,2
E33005089,409,258,83,175,1,95,42,53,51,47,2,1,1,4
E33005090,350,196,57,139,2,100,45,55,43,37,1,2,3,9
E33005091,1111,745,192,553,7,176,75,101,173,155,1,14,3,10
E33005092,777,491,103,388,4,114,41,73,157,145,1,9,2,11
E33005093,513,249,72,177,2,86,32,54,174,168,0,5,1,2
E33005094,305,197,51,146,3,77,29,48,26,21,2,3,0,2
E33005095,236,151,45,106,1,22,8,14,59,57,0,2,0,3
E33005096,358,188,36,152,2,91,55,36,75,72,0,3,0,2
E33005097,372,266,78,188,0,26,12,14,70,68,0,2,0,10
E33005098,315,222,57,165,0,12,4,8,80,74,2,1,3,1
E33005099,284,207,76,131,0,24,5,19,50,45,0,5,0,3
E33005100,288,183,54,129,2,15,6,9,79,74,0,4,1,9
E33005101,273,165,35,130,1,26,7,19,79,71,1,7,0,2
E33005102,315,223,77,146,1,21,8,13,67,57,3,6,1,3
E33005103,769,562,119,443,5,113,43,70,83,72,1,6,4,6
E33005104,389,248,49,199,0,97,47,50,41,37,0,3,1,3
E33005105,355,202,36,166,1,102,48,54,48,38,1,6,3,2
E33005106,575,418,129,289,4,49,19,30,97,89,0,8,0,7
E33005107,321,223,55,168,4,20,8,12,74,70,1,3,0,0
E33005108,324,269,72,197,4,10,5,5,36,35,0,1,0,5
E33005109,593,414,103,311,5,22,7,15,146,135,1,10,0,6
E33005110,420,265,60,205,3,59,14,45,90,85,0,5,0,3
E33005111,294,191,37,154,6,60,25,35,30,29,1,0,0,7
E33005112,547,406,103,303,3,57,18,39,72,71,0,1,0,9
E33005113,451,307,84,223,6,94,45,49,40,38,0,2,0,4
E33005114,438,287,59,228,4,71,27,44,74,68,1,4,1,2
E33005115,220,157,39,118,0,34,13,21,29,27,0,2,0,0
E33005116,560,440,94,346,4,52,21,31,63,60,0,3,0,1
E33005117,274,183,35,148,0,56,25,31,33,31,0,2,0,2
E33005118,220,145,29,116,1,38,12,26,36,34,0,2,0,0
E33005119,588,415,81,334,5,65,21,44,102,99,0,3,0,1
E33005120,317,212,60,152,4,52,25,27,46,43,0,3,0,3
E33005121,307,191,44,147,2,59,33,26,52,45,1,6,0,3
E33005122,289,188,32,156,0,69,37,32,30,28,0,2,0,2
E33005123,307,196,40,156,1,77,37,40,31,28,0,3,0,2
E33005124,866,565,94,471,7,173,78,95,114,110,0,4,0,7
E33005125,305,202,42,160,3,53,22,31,47,44,1,2,0,0
E33005126,827,542,114,428,2,153,59,94,127,118,1,6,2,3
E33005127,399,175,39,136,2,154,41,113,60,53,1,6,0,8
E33005128,341,190,39,151,2,93,30,63,54,48,0,6,0,2
E33005129,330,191,37,154,1,78,26,52,55,49,2,3,1,5
E33005130,331,158,30,128,1,123,38,85,36,35,0,1,0,13
E33005131,373,224,36,188,0,88,26,62,56,53,1,2,0,5
E33005132,282,174,41,133,2,78,18,60,28,28,0,0,0,0
E33005133,307,154,35,119,4,108,51,57,40,37,0,3,0,1
E33005134,305,167,34,133,2,86,38,48,45,41,3,1,0,5
E33005135,655,415,97,318,8,149,65,84,81,77,0,4,0,2
E33005136,344,249,54,195,1,48,24,24,45,44,0,1,0,1
E33005137,485,357,70,287,1,67,24,43,58,53,0,4,1,2
E33005138,372,209,52,157,2,107,36,71,51,50,0,1,0,3
E33005139,934,606,105,501,5,115,52,63,202,187,2,13,0,6
E33005140,1378,993,223,770,12,114,36,78,249,234,1,13,1,10
E33005141,503,364,79,285,3,48,17,31,86,84,0,2,0,2
E33005142,610,344,90,254,8,181,76,105,77,67,1,7,2,0
E33005143,351,198,55,143,2,108,42,66,41,34,0,5,2,2
E33005144,388,335,108,227,2,20,12,8,28,25,0,2,1,3
E33005145,399,340,116,224,4,25,18,7,30,26,0,4,0,0
E33005146,391,305,93,212,1,38,23,15,45,39,0,6,0,2
E33005147,1743,1189,389,800,6,302,173,129,230,215,0,11,4,16
E33005148,337,275,77,198,0,31,21,10,27,25,0,1,1,4
E33005149,256,201,71,130,4,14,5,9,36,29,0,5,2,1
E33005150,369,271,82,189,1,59,21,38,36,29,0,7,0,2
E33005151,327,235,58,177,0,45,27,18,46,41,0,5,0,1
E33005152,353,296,98,198,0,22,10,12,34,31,1,2,0,1
E33005153,423,321,104,217,5,39,24,15,51,47,0,4,0,7
E33005154,268,236,66,170,0,11,8,3,17,11,0,4,2,4
E33005155,471,392,121,271,3,38,23,15,32,30,0,2,0,6
E33005156,323,249,71,178,2,27,17,10,39,33,1,5,0,6
E33005157,296,246,66,180,2,10,5,5,37,32,0,5,0,1
E33005158,440,354,85,269,4,28,18,10,51,42,1,7,1,3
E33005159,322,270,70,200,0,22,15,7,27,22,0,5,0,3
E33005160,273,211,85,126,0,39,24,15,21,19,0,2,0,2
E33005161,362,304,99,205,1,15,9,6,40,35,1,2,2,2
E33005162,434,350,108,242,2,28,14,14,49,40,2,4,3,5
E33005163,595,477,178,299,2,33,13,20,78,65,0,8,5,5
E33005164,425,311,56,255,1,71,46,25,40,32,0,7,1,2
E33005165,270,192,30,162,2,40,28,12,34,28,0,6,0,2
E33005166,462,412,110,302,2,10,6,4,36,32,0,3,1,2
E33005167,937,703,171,532,5,88,45,43,131,122,0,9,0,10
E33005168,570,437,133,304,2,58,35,23,73,66,0,7,0,0
E33005169,568,429,130,299,3,46,25,21,80,69,0,9,2,10
E33005170,412,311,93,218,4,45,22,23,47,37,0,8,2,5
E33005171,546,424,115,309,0,57,22,35,61,53,0,8,0,4
E33005172,307,240,55,185,1,29,11,18,36,34,0,2,0,1
E33005173,822,633,165,468,0,98,54,44,90,79,0,10,1,1
E33005174,192,151,40,111,0,16,12,4,24,19,0,5,0,1
E33005175,514,385,103,282,2,49,37,12,66,54,2,8,2,12
E33005176,561,457,156,301,1,38,23,15,61,49,1,9,2,4
E33005177,978,798,213,585,8,82,41,41,89,72,1,13,3,1
E33005178,403,300,82,218,0,55,27,28,46,43,0,2,1,2
E33005179,470,319,85,234,3,96,65,31,47,41,0,6,0,5
E33005180,400,327,56,271,1,35,20,15,35,32,0,0,3,2
E33005181,650,517,174,343,5,61,32,29,61,53,0,6,2,6
E33005182,535,362,87,275,1,96,57,39,62,56,0,2,4,14
E33005183,282,248,63,185,0,4,2,2,30,27,0,0,3,0
E33005184,305,232,82,150,0,18,13,5,48,45,2,1,0,7
E33005185,501,392,139,253,3,33,12,21,69,58,2,8,1,4
E33005186,252,215,80,135,0,5,2,3,27,21,0,4,2,5
E33005187,327,260,82,178,2,27,14,13,35,32,1,2,0,3
E33005188,401,253,73,180,0,91,51,40,53,53,0,0,0,4
E33005189,246,169,43,126,2,41,30,11,32,29,1,2,0,2
E33005190,439,325,93,232,1,53,32,21,54,45,0,9,0,6
E33005191,333,230,59,171,1,48,19,29,51,45,0,6,0,3
E33005192,325,263,74,189,1,23,14,9,37,34,2,1,0,1
E33005193,378,337,97,240,1,10,6,4,29,23,0,6,0,1
E33005194,398,352,98,254,1,23,10,13,20,15,0,5,0,2
E33005195,422,295,86,209,4,67,29,38,48,42,1,5,0,8
E33005196,340,237,55,182,1,40,17,23,58,52,0,6,0,4
E33005197,281,181,61,120,1,50,11,39,44,35,0,9,0,5
E33005198,251,197,63,134,1,26,16,10,25,23,0,2,0,2
E33005199,498,339,110,229,3,102,57,45,52,43,2,6,1,2
E33005200,273,223,67,156,3,12,5,7,27,21,2,3,1,8
E33005201,353,281,73,208,1,29,22,7,38,35,0,3,0,4
E33005202,259,182,59,123,0,31,14,17,44,40,2,0,2,2
E33005203,486,364,87,277,1,42,24,18,77,72,1,4,0,2
E33005204,398,304,75,229,2,38,22,16,49,46,0,3,0,5
E33005205,454,363,112,251,2,41,26,15,47,39,4,4,0,1
E33005206,415,304,99,205,2,44,19,25,63,51,1,9,2,2
E33005207,305,203,47,156,1,68,37,31,31,26,0,5,0,2
E33005208,421,339,85,254,0,41,15,26,40,36,0,4,0,1
E33005209,330,270,87,183,3,20,11,9,35,27,0,6,2,2
E33005210,331,263,99,164,2,24,9,15,36,24,0,8,4,6
E33005211,357,272,90,182,1,38,25,13,42,41,0,1,0,4
E33005212,288,226,52,174,4,27,15,12,28,26,0,1,1,3
E33005213,750,601,165,436,1,52,28,24,88,77,1,8,2,8
E33005214,285,241,90,151,1,10,4,6,32,27,2,3,0,1
E33005215,423,353,133,220,2,19,10,9,49,40,2,6,1,0
E33005216,324,254,70,184,4,32,13,19,33,28,0,5,0,1
E33005217,287,244,69,175,0,9,3,6,32,26,0,6,0,2
E33005218,246,212,66,146,1,7,1,6,23,20,0,2,1,3
E33005219,341,296,88,208,1,14,7,7,30,29,0,1,0,0
E33005220,271,197,55,142,0,18,12,6,52,43,2,7,0,4
E33005221,332,247,95,152,1,36,17,19,37,33,0,4,0,11
E33005222,285,172,57,115,2,61,29,32,45,41,0,3,1,5
E33005223,404,277,104,173,1,69,29,40,48,44,0,4,0,9
E33005224,373,272,86,186,2,36,8,28,53,45,0,6,2,10
E33005225,500,415,161,254,1,40,11,29,37,34,0,2,1,7
E33005226,278,211,74,137,3,19,9,10,41,37,0,4,0,4
E33005227,482,315,77,238,2,76,27,49,85,76,0,9,0,4
E33005228,896,632,232,400,2,127,40,87,124,110,0,10,4,11
E33005229,561,408,102,306,1,65,28,37,81,76,1,4,0,6
E33005230,444,334,110,224,0,50,17,33,58,49,0,9,0,2
E33005231,302,222,59,163,1,48,26,22,30,24,0,5,1,1
E33005232,344,238,58,180,3,67,40,27,34,28,0,5,1,2
E33005233,434,293,88,205,3,74,42,32,55,52,0,3,0,9
E33005234,250,191,56,135,0,26,15,11,33,26,0,5,2,0
E33005235,379,290,66,224,1,48,29,19,38,35,0,2,1,2
E33005236,268,188,48,140,3,33,14,19,43,37,2,4,0,1
E33005237,433,349,93,256,0,41,22,19,40,35,0,4,1,3
E33005238,353,279,74,205,1,33,17,16,39,37,1,1,0,1
E33005239,336,250,74,176,2,39,23,16,42,40,0,1,1,3
E33005240,1408,992,306,686,6,238,132,106,163,148,0,15,0,9
E33005241,520,386,105,281,4,72,19,53,50,43,1,6,0,8
E33005242,295,176,39,137,2,57,19,38,52,42,2,8,0,8
E33005243,499,352,87,265,2,78,35,43,63,54,0,7,2,4
E33005244,666,470,168,302,2,116,45,71,73,63,0,9,1,5
E33005245,261,152,37,115,1,82,12,70,25,23,0,1,1,1
E33005246,254,199,44,155,0,44,6,38,10,6,1,1,2,1
E33005247,235,178,56,122,0,27,4,23,29,27,0,2,0,1
E33005248,365,235,73,162,2,72,25,47,50,44,0,4,2,6
E33005249,500,387,105,282,0,48,26,22,61,55,0,3,3,4
E33005250,671,510,122,388,2,66,37,29,86,77,1,8,0,7
E33005251,688,542,176,366,2,71,36,35,70,63,0,6,1,3
E33005252,314,276,92,184,0,9,1,8,28,21,0,7,0,1
E33005253,444,290,70,220,2,78,44,34,73,63,0,10,0,1
E33005254,666,394,117,277,1,151,92,59,117,107,1,7,2,3
E33005255,248,197,46,151,1,18,3,15,31,27,0,4,0,1
E33005256,376,303,67,236,0,32,19,13,37,36,0,1,0,4
E33005257,247,208,63,145,0,12,3,9,24,19,0,1,4,3
E33005258,418,268,75,193,2,73,41,32,73,60,2,9,2,2
E33005259,529,435,116,319,2,37,19,18,51,43,0,5,3,4
E33005260,304,238,63,175,1,25,15,10,38,35,0,2,1,2
E33005261,470,381,108,273,1,38,17,21,48,39,0,6,3,2
E33005262,285,237,64,173,0,17,12,5,31,30,0,1,0,0
E33005263,671,493,124,369,0,72,62,10,103,94,3,5,1,3
E33005264,652,515,129,386,3,48,32,16,81,73,3,5,0,5
E33005265,404,306,82,224,1,27,21,6,66,59,1,3,3,4
E33005266,315,231,65,166,0,31,24,7,49,42,3,3,1,4
E33005267,419,305,58,247,0,36,28,8,76,71,0,5,0,2
E33005268,436,340,95,245,1,51,37,14,40,37,0,3,0,4
E33005269,563,463,131,332,1,21,18,3,71,61,5,5,0,7
E33005270,215,153,58,95,0,11,8,3,42,39,0,3,0,9
E33005271,385,323,107,216,1,8,7,1,51,45,0,3,3,2
E33005272,307,224,57,167,1,32,25,7,48,39,0,8,1,2
E33005273,532,423,89,334,1,45,35,10,57,49,1,7,0,6
E33005274,309,229,69,160,2,36,32,4,37,32,0,4,1,5
E33005275,412,274,71,203,0,79,63,16,59,55,0,4,0,0
E33005276,815,605,142,463,4,92,54,38,108,96,0,12,0,6
E33005277,313,204,41,163,3,47,43,4,56,50,0,5,1,3
E33005278,292,234,60,174,2,18,11,7,32,26,0,5,1,6
E33005279,437,356,99,257,2,33,23,10,44,42,0,1,1,2
E33005280,445,297,84,213,4,67,40,27,71,66,0,4,1,6
E33005281,1028,792,184,608,2,107,74,33,121,114,0,7,0,6
E33005282,294,226,73,153,2,31,27,4,33,30,0,1,2,2
E33005283,363,318,98,220,1,13,11,2,29,24,0,4,1,2
E33005284,356,286,99,187,0,10,3,7,47,45,0,1,1,13
E33005285,360,298,104,194,1,16,12,4,43,35,1,6,1,2
E33005286,430,391,124,267,1,6,4,2,30,26,0,3,1,2
E33005287,355,326,103,223,0,12,8,4,17,17,0,0,0,0
E33005288,410,338,93,245,1,29,24,5,37,33,2,2,0,5
E33005289,256,189,53,136,1,23,17,6,42,34,0,6,2,1
E33005290,305,235,80,155,1,25,22,3,43,41,0,2,0,1
E33005291,264,197,64,133,0,35,28,7,31,30,0,1,0,1
E33005292,348,270,102,168,4,39,20,19,33,31,0,2,0,2
E33005293,335,247,62,185,1,35,22,13,49,45,0,4,0,3
E33005294,242,163,44,119,0,37,24,13,42,33,0,7,2,0
E33005295,393,293,83,210,0,40,21,19,56,50,0,3,3,4
E33005296,355,279,93,186,0,33,23,10,40,35,2,3,0,3
E33005297,274,212,62,150,3,18,10,8,39,37,0,2,0,2
E33005298,605,460,140,320,3,63,28,35,70,64,0,6,0,9
E33005299,265,198,67,131,1,33,32,1,32,29,0,3,0,1
E33005300,251,191,65,126,0,24,12,12,34,31,0,3,0,2
E33005301,265,198,48,150,1,29,23,6,36,33,0,1,2,1
E33005302,406,290,76,214,0,49,39,10,62,56,0,6,0,5
E33005303,236,177,56,121,0,22,16,6,33,31,0,2,0,4
E33005304,429,299,85,214,4,40,27,13,85,77,1,6,1,1
E33005305,363,277,72,205,0,47,39,8,38,27,0,10,1,1
E33005306,1315,1038,297,741,11,113,79,34,147,135,0,12,0,6
E33005307,492,385,120,265,0,37,25,12,65,59,1,5,0,5
E33005308,283,187,65,122,0,55,48,7,34,26,3,2,3,7
E33005309,591,448,145,303,1,54,38,16,82,77,0,5,0,6
E33005310,369,244,95,149,4,72,62,10,43,36,0,6,1,6
E33005311,307,219,89,130,0,52,39,13,33,31,1,1,0,3
E33005312,220,170,49,121,1,17,8,9,30,26,1,3,0,2
E33005313,285,195,70,125,2,43,37,6,43,41,0,2,0,2
E33005314,327,267,82,185,1,12,9,3,46,40,0,6,0,1
E33005315,297,259,84,175,0,7,3,4,28,26,1,1,0,3
E33005316,367,257,57,200,2,45,32,13,60,52,0,8,0,3
E33005317,291,177,51,126,1,71,52,19,35,34,0,1,0,7
E33005318,489,321,95,226,0,82,60,22,78,68,0,9,1,8
E33005319,597,463,118,345,3,70,59,11,55,45,2,8,0,6
E33005320,399,263,79,184,0,59,32,27,69,64,0,5,0,8
E33005321,265,193,45,148,0,33,26,7,38,35,0,3,0,1
E33005322,350,266,59,207,2,29,24,5,53,44,1,7,1,0
E33005323,296,216,47,169,1,25,16,9,49,48,0,1,0,5
E33005324,281,226,59,167,1,22,17,5,31,27,0,3,1,1
E33005325,283,191,52,139,0,42,35,7,49,43,0,6,0,1
E33005326,317,259,57,202,1,18,13,5,38,32,2,4,0,1
E33005327,526,412,114,298,1,43,34,9,66,64,0,2,0,4
E33005328,335,251,95,156,2,25,14,11,52,48,1,2,1,5
E33005329,427,327,110,217,0,31,18,13,62,53,0,6,3,7
E33005330,355,299,86,213,2,16,11,5,30,25,0,3,2,8
E33005331,332,227,96,131,2,46,25,21,51,47,0,3,1,6
E33005332,275,169,71,98,2,52,42,10,44,42,0,2,0,8
E33005333,398,279,121,158,1,52,33,19,54,46,0,7,1,12
E33005334,583,429,92,337,1,64,38,26,85,76,0,9,0,4
E33005335,333,244,61,183,1,31,11,20,55,43,0,9,3,2
E33005336,359,207,45,162,1,112,97,15,36,32,0,4,0,3
E33005337,409,338,97,241,2,25,17,8,37,37,0,0,0,7
E33005338,371,292,76,216,1,42,36,6,34,29,0,5,0,2
E33005339,304,205,52,153,1,66,58,8,30,25,0,5,0,2
E33005340,256,195,67,128,2,16,13,3,41,38,1,2,0,2
E33005341,558,453,144,309,1,49,37,12,52,48,0,4,0,3
E33005342,303,237,69,168,0,30,21,9,36,33,0,1,2,0
E33005343,377,270,78,192,0,46,28,18,59,50,2,5,2,2
E33005344,404,309,83,226,0,48,33,15,44,40,0,4,0,3
E33005345,257,194,49,145,0,30,17,13,28,26,0,2,0,5
E33005346,526,374,95,279,2,46,35,11,103,95,0,8,0,1
E33005347,457,353,111,242,5,39,27,12,56,52,0,4,0,4
E33005348,614,451,131,320,3,72,43,29,83,76,2,4,1,5
E33005349,244,186,48,138,0,28,20,8,28,24,0,3,1,2
E33005350,625,486,134,352,7,54,28,26,74,69,0,5,0,4
E33005351,580,390,114,276,2,110,65,45,70,61,1,8,0,8
E33005352,428,301,75,226,0,64,39,25,58,53,0,4,1,5
E33005353,352,265,60,205,1,47,31,16,39,35,0,4,0,0
E33005354,274,187,39,148,0,55,42,13,30,24,1,4,1,2
E33005355,333,245,59,186,2,51,27,24,33,31,1,1,0,2
E33005356,322,277,75,202,1,16,9,7,28,24,0,4,0,0
E33005357,390,286,87,199,1,74,15,59,26,23,0,2,1,3
E33005358,373,261,57,204,1,47,25,22,62,59,0,3,0,2
E33005359,407,312,99,213,2,41,24,17,44,39,0,5,0,8
E33005360,443,312,84,228,3,74,54,20,53,46,0,7,0,1
E33005361,339,235,74,161,0,41,19,22,61,49,0,12,0,2
E33005362,394,334,88,246,0,18,15,3,41,37,0,4,0,1
E33005363,278,221,56,165,0,23,12,11,29,27,0,1,1,5
E33005364,333,276,74,202,0,29,15,14,26,23,0,3,0,2
E33005365,354,246,63,183,2,64,42,22,39,30,2,6,1,3
E33005366,625,486,144,342,1,62,45,17,71,63,2,4,2,5
E33005367,306,225,70,155,0,49,35,14,30,27,0,3,0,2
E33005368,333,235,64,171,1,60,18,42,34,32,0,2,0,3
E33005369,445,303,71,232,3,90,35,55,47,43,0,2,2,2
E33005370,251,161,55,106,3,62,18,44,21,20,0,1,0,4
E33005371,488,366,85,281,1,57,45,12,61,52,0,9,0,3
E33005372,380,290,63,227,0,37,27,10,51,48,0,3,0,2
E33005373,830,625,151,474,1,100,65,35,102,91,1,9,1,2
E33005374,363,271,62,209,1,37,21,16,53,49,0,4,0,1
E33005375,293,221,48,173,1,25,11,14,44,35,1,5,3,2
E33005376,339,256,62,194,0,29,16,13,50,48,0,2,0,4
E33005377,269,205,54,151,1,28,21,7,33,29,2,1,1,2
E33005378,1171,898,208,690,6,128,90,38,130,116,1,12,1,9
E33005379,370,267,75,192,3,53,33,20,46,45,0,1,0,1
E33005380,317,226,72,154,3,43,27,16,45,43,0,2,0,0
E33005381,380,321,79,242,0,19,12,7,39,31,0,8,0,1
E33005382,362,276,65,211,0,44,19,25,42,39,0,1,2,0
E33005383,293,198,55,143,0,39,25,14,53,44,0,9,0,3
E33005384,422,309,91,218,2,52,30,22,57,51,0,4,2,2
E33005385,401,335,110,225,1,37,20,17,23,20,0,3,0,5
E33005386,580,529,155,374,0,19,13,6,29,27,0,2,0,3
E33005387,362,275,90,185,4,53,39,14,29,26,0,2,1,1
E33005388,633,430,105,325,0,119,93,26,78,71,2,5,0,6
E33005389,553,405,109,296,0,93,67,26,52,47,2,3,0,3
E33005390,352,188,40,148,0,122,72,50,39,32,0,6,1,3
E33005391,458,278,67,211,3,119,92,27,57,50,1,6,0,1
E33005392,307,235,71,164,0,38,30,8,32,30,0,2,0,2
E33005393,342,229,69,160,1,79,53,26,32,29,0,3,0,1
E33005394,651,445,126,319,2,116,84,32,81,74,0,7,0,7
E33005395,246,186,39,147,1,30,20,10,26,25,0,1,0,3
E33005396,319,204,55,149,2,58,39,19,54,53,0,1,0,1
E33005397,341,237,64,173,3,45,24,21,56,50,0,4,2,0
E33005398,464,361,90,271,0,61,47,14,42,40,0,2,0,0
E33005399,1561,1151,281,870,10,182,127,55,207,183,0,23,1,11
E33005400,430,323,78,245,3,36,17,19,68,64,1,3,0,0
E33005401,258,173,36,137,1,39,30,9,39,34,3,0,2,6
E33005402,532,360,100,260,1,78,50,28,86,79,0,4,3,7
E33005403,457,381,93,288,0,34,24,10,40,39,0,1,0,2
E33005404,251,177,54,123,0,38,25,13,32,30,0,2,0,4
E33005405,516,403,90,313,1,48,32,16,62,54,2,6,0,2
E33005406,389,244,69,175,1,61,43,18,80,75,0,4,1,3
E33005407,611,474,146,328,2,57,36,21,77,70,0,6,1,1
E33005408,293,235,54,181,2,17,12,5,33,28,1,4,0,6
E33005409,664,528,133,395,3,58,43,15,74,69,0,5,0,1
E33005410,462,361,80,281,3,33,26,7,65,52,1,11,1,0
E33005411,353,294,93,201,1,16,12,4,35,33,1,0,1,7
E33005412,517,337,74,263,2,114,80,34,59,57,0,2,0,5
E33005413,333,239,57,182,1,32,16,16,59,57,1,1,0,2
E33005414,342,265,55,210,1,33,15,18,40,36,0,4,0,3
E33005415,276,200,56,144,1,32,20,12,42,38,0,4,0,1
E33005416,281,208,53,155,0,25,18,7,48,44,1,3,0,0
E33005417,315,248,64,184,0,28,20,8,37,35,0,2,0,2
E33005418,408,310,90,220,1,56,35,21,41,37,0,3,1,0
E33005419,227,149,33,116,0,24,11,13,54,52,0,2,0,0
E33005420,337,174,46,128,2,55,23,32,104,95,0,8,1,2
E33005421,407,240,63,177,1,21,5,16,136,123,0,11,2,9
E33005422,232,143,55,88,1,30,12,18,57,52,0,4,1,1
E33005423,290,161,49,112,1,37,17,20,89,82,0,7,0,2
E33005424,402,288,84,204,0,36,16,20,75,72,0,2,1,3
E33005425,677,468,144,324,3,58,24,34,139,134,2,2,1,9
E33005426,340,202,60,142,0,67,58,9,62,56,2,4,0,9
E33005427,304,213,61,152,1,54,38,16,34,25,2,6,1,2
E33005428,276,191,50,141,0,42,29,13,40,37,0,3,0,3
E33005429,322,235,70,165,3,37,29,8,46,43,0,3,0,1
E33005430,538,408,93,315,3,63,40,23,61,52,3,6,0,3
E33005431,306,199,46,153,1,60,35,25,44,42,0,2,0,2
E33005432,396,303,87,216,3,38,28,10,50,46,0,2,2,2
E33005433,351,251,66,185,1,12,9,3,85,80,3,2,0,2
E33005434,563,456,153,303,2,35,27,8,66,64,0,2,0,4
E33005435,388,343,76,267,0,16,9,7,29,27,0,2,0,0
E33005436,338,287,67,220,2,10,8,2,33,31,0,1,1,6
E33005437,308,261,81,180,1,14,8,6,30,30,0,0,0,2
E33005438,231,178,55,123,1,19,14,5,31,22,7,2,0,2
E33005439,409,336,100,236,1,19,12,7,50,47,0,3,0,3
E33005440,308,267,72,195,0,14,10,4,24,21,0,2,1,3
E33005441,325,265,73,192,1,21,16,5,38,35,1,2,0,0
E33005442,295,251,62,189,0,8,4,4,35,30,1,4,0,1
E33005443,227,178,42,136,0,15,9,6,33,32,0,1,0,1
E33005444,303,243,79,164,0,28,16,12,29,27,0,2,0,3
E33005445,358,253,63,190,2,33,22,11,65,57,1,6,1,5
E33005446,327,280,75,205,0,15,7,8,32,29,2,1,0,0
E33005447,940,813,159,654,2,40,29,11,82,72,1,9,0,3
E33005448,254,202,59,143,1,16,13,3,33,30,0,3,0,2
E33005449,296,170,41,129,1,70,30,40,53,42,3,7,1,2
E33005450,218,71,18,53,4,39,22,17,100,95,0,4,1,4
E33005451,294,133,47,86,1,80,43,37,75,73,0,1,1,5
E33005452,289,143,39,104,0,92,40,52,49,48,0,0,1,5
E33005453,360,155,51,104,1,55,18,37,145,131,0,13,1,4
E33005454,622,336,107,229,1,139,64,75,143,134,4,4,1,3
E33005455,261,126,37,89,5,70,29,41,55,54,0,1,0,5
E33005456,316,178,55,123,1,34,12,22,101,95,0,6,0,2
E33005457,324,194,46,148,1,70,51,19,57,53,0,3,1,2
E33005458,645,433,108,325,4,89,37,52,114,102,0,11,1,5
E33005459,253,137,39,98,2,52,34,18,60,55,0,4,1,2
E33005460,823,538,143,395,4,130,71,59,136,126,1,7,2,15
E33005461,242,173,48,125,0,33,14,19,31,29,0,1,1,5
E33005462,537,416,113,303,1,39,19,20,78,74,0,3,1,3
E33005463,329,216,58,158,1,50,29,21,58,56,0,1,1,4
E33005464,378,289,80,209,2,47,32,15,40,37,1,2,0,0
E33005465,286,192,42,150,2,63,41,22,28,24,4,0,0,1
E33005466,592,436,109,327,1,59,35,24,90,79,0,4,7,6
E33005467,447,274,85,189,1,61,42,19,108,103,0,5,0,3
E33005468,403,255,67,188,2,90,64,26,45,41,0,4,0,11
E33005469,775,502,139,363,3,124,72,52,141,135,1,5,0,5
E33005470,428,312,84,228,1,57,43,14,58,48,0,10,0,0
E33005471,522,388,90,298,2,45,25,20,87,78,0,9,0,0
E33005472,732,563,135,428,3,49,30,19,115,107,0,8,0,2
E33005473,531,380,95,285,5,62,40,22,82,79,1,2,0,2
E33005474,243,146,30,116,3,64,38,26,27,23,1,3,0,3
E33005475,320,243,67,176,1,34,22,12,37,37,0,0,0,5
E33005476,316,256,62,194,0,23,15,8,33,30,0,2,1,4
E33005477,280,193,46,147,1,31,19,12,54,50,0,4,0,1
E33005478,286,220,55,165,5,27,17,10,34,31,0,2,1,0
E33005479,408,294,91,203,5,52,32,20,55,48,1,4,2,2
E33005480,1238,879,245,634,7,202,141,61,143,134,0,7,2,7
E33005481,287,220,60,160,2,33,24,9,30,26,0,4,0,2
E33005482,276,186,54,132,0,47,22,25,43,39,0,4,0,0
E33005483,5932,4342,978,3364,25,643,377,266,894,848,3,39,4,28
E33005484,301,163,52,111,1,39,23,16,89,85,0,4,0,9
E33005485,1395,817,174,643,12,150,99,51,409,389,1,18,1,7
E33005486,318,240,82,158,0,32,25,7,44,42,0,2,0,2
E33005487,431,256,74,182,4,91,60,31,78,74,1,2,1,2
E33005488,310,202,50,152,1,9,6,3,94,91,0,3,0,4
E33005489,1209,884,248,636,5,168,105,63,142,131,1,9,1,10
E33005490,557,277,69,208,6,62,31,31,202,197,0,5,0,10
E33005491,256,145,38,107,4,46,26,20,60,57,0,3,0,1
E33005492,322,171,57,114,5,93,59,34,50,40,4,5,1,3
E33005493,328,204,40,164,3,58,35,23,63,57,1,4,1,0
E33005494,695,485,130,355,6,71,36,35,129,121,0,7,1,4
E33005495,356,202,57,145,1,55,29,26,94,87,0,4,3,4
E33005496,447,237,69,168,3,35,24,11,170,163,0,6,1,2
E33005497,406,227,76,151,0,81,48,33,88,87,0,0,1,10
E33005498,339,235,58,177,3,46,26,20,50,48,0,0,2,5
E33005499,363,203,58,145,12,59,26,33,86,82,0,3,1,3
E33005500,264,179,56,123,1,29,12,17,55,47,4,3,1,0
E33005501,370,270,48,222,3,33,25,8,63,58,0,5,0,1
E33005502,284,125,35,90,0,103,75,28,55,54,0,1,0,1
E33005503,553,361,104,257,4,113,76,37,70,63,1,5,1,5
E33005504,284,177,58,119,3,57,34,23,42,41,0,1,0,5
E33005505,409,304,83,221,1,43,19,24,58,54,0,4,0,3
E33005506,260,199,46,153,1,29,23,6,30,29,0,1,0,1
E33005507,428,306,74,232,0,64,46,18,56,51,0,4,1,2
E33005508,232,190,44,146,2,23,12,11,15,14,0,1,0,2
E33005509,434,287,63,224,2,83,53,30,60,50,0,7,3,2
E33005510,366,246,47,199,3,71,48,23,43,43,0,0,0,3
E33005511,284,187,44,143,3,55,34,21,37,35,0,1,1,2
E33005512,329,247,68,179,2,49,30,19,31,27,0,4,0,0
E33005513,257,177,49,128,0,24,9,15,51,45,0,5,1,5
E33005514,374,263,58,205,5,45,26,19,58,53,0,4,1,3
E33005515,713,493,125,368,5,81,39,42,121,113,1,4,3,13
E33005516,391,251,50,201,1,69,36,33,67,61,1,5,0,3
E33005517,407,254,52,202,7,38,19,19,106,102,1,3,0,2
E33005518,951,512,107,405,9,128,70,58,291,282,0,9,0,11
E33005519,870,603,115,488,7,124,80,44,131,122,1,8,0,5
E33005520,237,141,38,103,1,52,35,17,41,39,0,2,0,2
E33005521,255,151,50,101,1,27,14,13,76,68,1,5,2,0
E33005522,453,284,98,186,3,92,57,35,72,68,0,4,0,2
E33005523,652,403,83,320,2,83,49,34,157,150,1,5,1,7
E33005524,355,194,49,145,3,90,49,41,66,61,2,3,0,2
E33005525,348,228,37,191,3,30,14,16,86,84,0,1,1,1
E33005526,1466,1019,200,819,4,126,68,58,305,281,3,16,5,12
E33005527,251,156,44,112,1,29,22,7,57,54,0,3,0,8
E33005528,1864,1279,265,1014,19,132,64,68,423,400,2,16,5,11
E33005529,830,615,143,472,3,103,60,43,106,96,4,6,0,3
E33005530,872,606,126,480,3,94,50,44,166,155,2,8,1,3
E33005531,735,545,108,437,3,70,34,36,113,103,1,9,0,4
E33005532,404,242,61,181,0,105,65,40,54,52,1,1,0,3
E33005533,392,325,75,250,0,23,18,5,39,32,0,7,0,5
E33005534,374,297,71,226,0,36,24,12,38,37,0,1,0,3
E33005535,806,591,129,462,4,109,61,48,102,91,2,5,4,0
E33005536,314,226,58,168,2,56,38,18,25,22,1,0,2,5
E33005537,336,243,66,177,2,46,27,19,42,35,3,4,0,3
E33005538,390,313,81,232,0,39,30,9,36,30,2,3,1,2
E33005539,384,274,53,221,3,38,19,19,68,64,0,3,1,1
E33005540,775,571,121,450,4,55,27,28,142,134,0,5,3,3
E33005541,312,240,52,188,0,27,18,9,36,32,1,2,1,9
E33005542,429,364,105,259,4,20,14,6,38,36,0,2,0,3
E33005543,527,401,88,313,2,47,26,21,70,64,0,6,0,7
E33005544,559,388,108,280,12,78,36,42,76,66,0,10,0,5
E33005545,501,379,105,274,2,42,18,24,75,68,0,5,2,3
E33005546,496,375,93,282,1,41,23,18,75,66,0,8,1,4
E33005547,342,258,58,200,2,38,30,8,41,37,0,4,0,3
E33005548,563,392,105,287,1,67,44,23,101,92,0,6,3,2
E33005549,625,481,151,330,3,57,42,15,82,71,1,9,1,2
E33005550,555,477,130,347,3,24,14,10,49,46,0,3,0,2
E33005551,299,223,59,164,4,21,11,10,50,43,0,5,2,1
E33005552,334,260,62,198,1,32,27,5,38,35,2,1,0,3
E33005553,517,401,110,291,4,37,15,22,73,65,1,7,0,2
E33005554,273,153,42,111,2,94,88,6,19,17,0,2,0,5
E33005555,253,163,34,129,2,73,63,10,15,13,1,0,1,0
E33005556,309,198,54,144,7,63,57,6,32,25,0,7,0,9
E33005557,288,267,92,175,3,4,4,0,13,13,0,0,0,1
E33005558,461,364,106,258,3,57,35,22,35,28,2,3,2,2
E33005559,291,240,76,164,3,20,12,8,27,21,0,6,0,1
E33005560,387,289,82,207,1,21,11,10,72,63,1,8,0,4
E33005561,235,191,71,120,0,9,4,5,33,31,0,1,1,2
E33005562,277,226,51,175,0,12,5,7,35,34,0,1,0,4
E33005563,266,212,66,146,0,12,4,8,42,34,1,7,0,0
E33005564,420,282,92,190,1,54,27,27,76,67,2,7,0,7
E33005565,363,270,71,199,6,49,27,22,36,32,0,4,0,2
E33005566,318,252,70,182,3,25,19,6,37,36,0,1,0,1
E33005567,368,282,67,215,0,28,18,10,56,51,0,5,0,2
E33005568,226,155,54,101,2,32,18,14,36,35,0,1,0,1
E33005569,283,227,62,165,1,24,21,3,30,27,0,3,0,1
E33005570,447,333,91,242,4,54,35,19,53,49,0,4,0,3
E33005571,315,236,80,156,3,23,14,9,51,48,1,2,0,2
E33005572,360,244,85,159,1,54,37,17,59,55,0,4,0,2
E33005573,403,331,114,217,0,16,8,8,56,51,0,5,0,0
E33005574,333,208,56,152,1,50,24,26,72,65,2,5,0,2
E33005575,336,246,85,161,0,34,22,12,50,48,0,2,0,6
E33005576,409,333,103,230,2,20,10,10,53,46,1,6,0,1
E33005577,351,263,65,198,2,30,18,12,53,46,1,5,1,3
E33005578,316,241,67,174,1,21,14,7,51,46,1,3,1,2
E33005579,562,427,136,291,4,55,29,26,74,68,0,6,0,2
E33005580,284,221,59,162,2,22,10,12,39,34,2,2,1,0
E33005581,963,661,135,526,6,137,63,74,156,147,1,8,0,3
E33005582,1036,747,181,566,6,142,86,56,137,129,1,7,0,4
E33005583,329,247,63,184,4,20,13,7,54,50,0,4,0,4
E33005584,354,302,81,221,4,15,11,4,32,28,0,1,3,1
E33005585,358,277,82,195,1,43,29,14,37,32,0,5,0,0
E33005586,528,419,130,289,4,40,18,22,56,50,2,4,0,9
E33005587,310,264,103,161,0,12,6,6,32,27,0,2,3,2
E33005588,387,256,76,180,1,62,49,13,67,62,0,5,0,1
E33005589,347,286,87,199,1,15,13,2,42,39,0,3,0,3
E33005590,278,240,71,169,2,12,9,3,22,20,0,2,0,2
E33005591,347,271,91,180,2,37,23,14,35,30,0,5,0,2
E33005592,259,202,56,146,3,18,5,13,33,31,0,2,0,3
E33005593,362,282,69,213,2,51,18,33,26,26,0,0,0,1
E33005594,557,401,110,291,4,76,43,33,71,67,0,4,0,5
E33005595,325,250,75,175,3,31,16,15,40,37,0,3,0,1
E33005596,317,262,84,178,2,15,8,7,36,29,0,5,2,2
E33005597,297,254,93,161,1,9,4,5,32,31,0,1,0,1
E33005598,623,460,131,329,2,81,46,35,76,71,0,3,2,4
E33005599,544,363,123,240,0,78,26,52,97,84,1,11,1,6
E33005600,311,238,77,161,0,23,14,9,48,45,0,3,0,2
E33005601,634,406,123,283,9,89,52,37,126,117,0,9,0,4
E33005602,2283,1693,388,1305,17,202,100,102,357,325,0,28,4,14
E33005603,714,416,105,311,7,132,82,50,153,136,1,12,4,6
E33005604,364,256,66,190,3,54,28,26,51,50,1,0,0,0
E33005605,215,150,46,104,1,42,32,10,21,20,0,1,0,1
E33005606,238,193,53,140,3,22,12,10,20,19,0,0,1,0
E33005607,853,680,219,461,7,51,25,26,112,100,1,11,0,3
E33005608,376,303,82,221,1,34,24,10,35,33,1,1,0,3
E33005609,294,204,55,149,5,17,6,11,64,58,0,3,3,4
E33005610,448,381,107,274,0,20,9,11,42,38,0,3,1,5
E33005611,417,282,65,217,5,47,23,24,81,73,0,5,3,2
E33005612,313,188,62,126,5,54,38,16,62,58,3,1,0,4
E33005613,521,408,91,317,0,46,27,19,66,59,0,6,1,1
E33005614,317,289,97,192,0,10,6,4,16,14,0,2,0,2
E33005615,285,237,101,136,1,7,7,0,33,24,0,3,6,7
E33005616,484,425,155,270,0,16,11,5,39,33,0,3,3,4
E33005617,335,262,72,190,1,22,17,5,49,45,1,3,0,1
E33005618,938,701,124,577,8,56,31,25,171,154,0,14,3,2
E33005619,843,629,206,423,9,106,66,40,94,87,0,7,0,5
E33005620,271,172,41,131,1,51,38,13,42,40,0,2,0,5
E33005621,389,264,83,181,8,41,23,18,73,66,1,4,2,3
E33005622,610,441,119,322,4,80,61,19,82,71,1,9,1,3
E33005623,458,352,99,253,2,33,15,18,71,66,0,5,0,0
E33005624,308,247,70,177,4,24,14,10,32,28,0,4,0,1
E33005625,520,399,113,286,6,39,14,25,73,65,1,6,1,3
E33005626,400,323,74,249,3,26,17,9,48,46,0,2,0,0
E33005627,427,356,96,260,2,22,6,16,46,42,0,2,2,1
E33005628,341,288,80,208,1,20,14,6,30,26,2,2,0,2
E33005629,427,362,98,264,0,27,12,15,38,31,0,6,1,0
E33005630,302,202,58,144,3,26,13,13,71,65,0,5,1,0
E33005631,291,236,61,175,0,20,13,7,35,29,0,6,0,0
E33005632,542,430,136,294,6,40,20,20,61,50,0,9,2,5
E33005633,243,188,57,131,1,19,7,12,33,31,0,2,0,2
E33005634,242,195,49,146,0,19,11,8,25,25,0,0,0,3
E33005635,322,278,60,218,1,13,8,5,26,24,0,2,0,4
E33005636,317,271,80,191,1,15,10,5,27,22,1,4,0,3
E33005637,282,210,53,157,1,44,22,22,26,23,0,3,0,1
E33005638,437,342,102,240,4,39,23,16,45,42,0,3,0,7
E33005639,432,366,83,283,2,11,6,5,49,46,0,3,0,4
E33005640,276,196,64,132,0,27,12,15,49,40,7,2,0,4
E33005641,904,731,209,522,1,60,31,29,106,102,0,3,1,6
E33005642,439,346,120,226,5,29,21,8,55,48,0,7,0,4
E33005643,309,236,70,166,3,19,9,10,50,44,1,4,1,1
E33005644,326,239,57,182,1,24,15,9,61,57,0,4,0,1
E33005645,620,445,125,320,1,61,43,18,107,98,0,8,1,6
E33005646,238,185,49,136,1,18,16,2,29,27,0,2,0,5
E33005647,358,242,80,162,1,90,50,40,23,19,0,4,0,2
E33005648,406,354,98,256,0,17,14,3,32,27,0,5,0,3
E33005649,263,209,42,167,3,23,15,8,27,26,0,1,0,1
E33005650,273,234,54,180,0,11,4,7,23,23,0,0,0,5
E33005651,290,222,55,167,2,33,15,18,28,27,0,0,1,5
E33005652,299,262,92,170,4,8,4,4,24,22,1,1,0,1
E33005653,292,251,65,186,0,18,5,13,19,17,0,2,0,4
E33005654,367,214,45,169,3,101,91,10,45,39,0,6,0,4
E33005655,463,324,75,249,1,61,43,18,76,69,0,6,1,1
E33005656,733,537,137,400,5,98,60,38,91,85,0,6,0,2
E33005657,284,211,60,151,3,28,17,11,41,36,3,1,1,1
E33005658,292,213,60,153,2,23,16,7,53,52,0,1,0,1
E33005659,590,514,156,358,1,15,11,4,56,52,0,3,1,4
E33005660,359,273,88,185,2,23,13,10,60,59,1,0,0,1
E33005661,374,288,85,203,4,36,12,24,45,44,0,1,0,1
E33005662,450,363,113,250,2,30,19,11,55,49,0,6,0,0
E33005663,729,519,139,380,4,102,64,38,99,95,0,4,0,5
E33005664,287,244,74,170,0,21,14,7,18,16,0,2,0,4
E33005665,426,357,122,235,1,11,8,3,56,50,0,6,0,1
E33005666,356,300,89,211,1,11,4,7,35,34,0,1,0,9
E33005667,446,354,113,241,0,31,21,10,59,48,5,5,1,2
E33005668,262,199,69,130,1,20,13,7,39,34,0,1,4,3
E33005669,545,428,126,302,2,49,29,20,62,52,0,7,3,4
E33005670,292,216,63,153,1,29,21,8,43,40,1,0,2,3
E33005671,273,237,70,167,1,11,9,2,22,18,2,2,0,2
E33005672,756,593,159,434,2,72,35,37,82,75,0,7,0,7
E33005673,300,243,79,164,3,15,11,4,37,29,2,6,0,2
E33005674,319,245,67,178,2,14,8,6,56,51,0,4,1,2
E33005675,321,249,59,190,3,26,20,6,41,38,0,3,0,2
E33005676,551,415,115,300,2,51,29,22,74,65,0,8,1,9
E33005677,284,205,52,153,3,20,15,5,52,46,1,5,0,4
E33005678,235,208,57,151,2,11,8,3,14,12,0,2,0,0
E33005679,543,403,95,308,4,19,12,7,112,102,3,7,0,5
E33005680,275,218,59,159,4,18,13,5,34,32,0,2,0,1
E33005681,331,284,62,222,2,22,7,15,22,21,0,1,0,1
E33005682,337,293,98,195,2,12,4,8,28,26,0,2,0,2
E33005683,248,202,85,117,0,15,5,10,29,28,0,0,1,2
E33005684,238,213,65,148,0,9,5,4,15,12,0,3,0,1
E33005685,477,390,116,274,2,25,20,5,59,55,0,4,0,1
E33005686,307,264,88,176,5,15,6,9,23,20,1,2,0,0
E33005687,357,274,73,201,1,33,18,15,49,46,0,3,0,0
E33005688,318,260,75,185,3,20,8,12,32,28,0,2,2,3
E33005689,525,455,141,314,5,22,12,10,35,31,0,3,1,8
E33005690,302,260,78,182,1,9,7,2,32,26,1,5,0,0
E33005691,367,321,112,209,0,16,10,6,29,28,0,1,0,1
E33005692,426,358,94,264,4,21,8,13,42,39,1,2,0,1
E33005693,738,606,186,420,5,43,15,28,78,68,3,6,1,6
E33005694,307,275,74,201,0,5,3,2,23,22,0,1,0,4
E33005695,345,298,80,218,4,7,5,2,35,33,0,1,1,1
E33005696,514,414,143,271,4,35,18,17,57,52,0,5,0,4
E33005697,524,464,147,317,2,12,7,5,42,40,0,1,1,4
E33005698,347,275,87,188,3,13,6,7,55,52,1,2,0,1
E33005699,284,256,87,169,2,7,5,2,19,16,0,3,0,0
E33005700,367,298,114,184,5,17,10,7,43,39,0,2,2,4
E33005701,444,368,105,263,1,27,15,12,41,38,1,1,1,7
E33005702,252,216,70,146,0,12,9,3,22,19,1,2,0,2
E33005703,261,221,64,157,0,9,5,4,29,26,0,3,0,2
E33005704,801,678,194,484,0,35,25,10,79,71,1,7,0,9
E33005705,257,220,61,159,0,6,3,3,29,28,0,1,0,2
E33005706,297,233,61,172,6,25,10,15,28,24,0,4,0,5
E33005707,311,247,67,180,1,24,13,11,35,27,2,6,0,4
E33005708,265,211,42,169,3,10,2,8,39,35,0,4,0,2
E33005709,636,493,120,373,3,58,14,44,76,61,0,15,0,6
E33005710,295,221,53,168,3,25,16,9,46,43,0,3,0,0
E33005711,287,241,79,162,1,10,6,4,33,31,0,2,0,2
E33005712,255,234,68,166,0,3,3,0,16,15,0,1,0,2
E33005713,225,200,78,122,0,12,5,7,12,12,0,0,0,1
E33005714,259,229,72,157,0,6,6,0,22,21,0,1,0,2
E33005715,271,227,85,142,1,17,13,4,24,21,0,3,0,2
E33005716,344,293,95,198,2,13,5,8,36,31,1,3,1,0
E33005717,858,726,215,511,1,47,18,29,79,69,1,7,2,5
E33005718,378,325,99,226,2,10,6,4,41,39,1,1,0,0
E33005719,271,208,55,153,1,13,1,12,47,40,0,7,0,2
E33005720,417,332,93,239,2,26,5,21,55,43,0,9,3,2
E33005721,268,203,68,135,1,26,14,12,35,31,2,2,0,3
E33005722,416,326,107,219,2,28,8,20,53,46,0,7,0,7
E33005723,251,199,60,139,0,9,5,4,40,36,0,1,3,3
E33005724,349,290,85,205,0,20,8,12,36,33,1,2,0,3
E33005725,303,223,68,155,1,36,13,23,41,41,0,0,0,2
E33005726,303,238,73,165,0,32,8,24,30,26,0,4,0,3
E33005727,627,514,147,367,2,46,16,30,62,54,3,3,2,3
E33005728,346,273,68,205,2,38,14,24,33,33,0,0,0,0
E33005729,320,254,77,177,1,33,9,24,32,26,0,6,0,0
E33005730,351,271,67,204,1,47,9,38,28,26,0,1,1,4
E33005731,367,260,69,191,0,59,18,41,42,36,0,5,1,6
E33005732,727,487,114,373,3,107,33,74,122,115,1,5,1,8
E33005733,391,290,80,210,1,52,15,37,44,38,1,4,1,4
E33005734,446,334,89,245,1,59,24,35,48,45,0,2,1,4
E33005735,359,278,77,201,1,38,15,23,35,31,0,4,0,7
E33005736,374,250,69,181,0,73,20,53,49,44,0,4,1,2
E33005737,285,221,59,162,0,24,8,16,40,35,0,5,0,0
E33005738,253,174,46,128,0,37,11,26,42,40,0,1,1,0
E33005739,292,190,53,137,1,75,25,50,25,24,1,0,0,1
E33005740,266,198,40,158,0,28,7,21,40,38,0,1,1,0
E33005741,457,348,95,253,1,29,12,17,79,74,1,4,0,0
E33005742,245,188,58,130,1,25,6,19,27,25,0,1,1,4
E33005743,345,259,66,193,0,42,11,31,42,34,0,8,0,2
E33005744,3019,2402,617,1785,8,214,70,144,383,346,3,32,2,12
E33005745,444,319,83,236,0,78,35,43,44,40,2,1,1,3
E33005746,695,506,129,377,3,96,38,58,83,76,0,6,1,7
E33005747,437,324,87,237,0,63,27,36,49,47,0,1,1,1
E33005748,300,208,55,153,0,46,18,28,41,32,0,9,0,5
E33005749,370,287,72,215,2,35,13,22,42,35,0,4,3,4
E33005750,604,419,114,305,0,82,31,51,98,88,0,8,2,5
E33005751,264,186,53,133,2,25,8,17,51,47,1,1,2,0
E33005752,279,214,61,153,0,17,8,9,44,38,0,3,3,4
E33005753,411,292,72,220,2,45,16,29,66,60,0,5,1,6
E33005754,279,225,69,156,1,13,4,9,38,28,1,5,4,2
E33005755,271,216,57,159,0,19,6,13,32,29,0,3,0,4
E33005756,446,319,93,226,4,49,22,27,74,68,0,3,3,0
E33005757,342,302,90,212,0,21,7,14,19,17,0,2,0,0
E33005758,370,292,86,206,0,24,8,16,54,49,0,4,1,0
E33005759,416,308,69,239,1,39,10,29,61,57,0,4,0,7
E33005760,373,298,86,212,1,28,8,20,43,37,2,2,2,3
E33005761,305,240,66,174,0,32,9,23,31,24,0,7,0,2
E33005762,296,210,57,153,1,32,9,23,45,40,0,5,0,8
E33005763,284,203,45,158,3,26,4,22,46,44,0,2,0,6
E33005764,437,363,92,271,1,22,5,17,48,36,0,12,0,3
E33005765,773,550,144,406,1,91,30,61,128,120,1,7,0,3
E33005766,248,145,36,109,0,51,7,44,49,44,0,4,1,3
E33005767,419,337,96,241,0,30,10,20,51,45,1,5,0,1
E33005768,750,522,159,363,2,111,32,79,112,104,1,7,0,3
E33005769,497,317,106,211,1,94,33,61,83,76,0,3,4,2
E33005770,306,209,70,139,0,45,8,37,50,44,0,4,2,2
E33005771,378,221,53,168,1,50,17,33,103,98,0,4,1,3
E33005772,500,317,69,248,0,112,25,87,66,59,0,4,3,5
E33005773,3030,2422,612,1810,12,268,87,181,313,282,1,27,3,15
E33005774,586,456,98,358,4,42,14,28,80,74,0,6,0,4
E33005775,242,165,39,126,1,52,10,42,23,19,0,4,0,1
E33005776,255,218,64,154,1,13,3,10,23,18,0,5,0,0
E33005777,313,266,79,187,1,8,3,5,35,31,0,4,0,3
E33005778,663,487,159,328,2,86,29,57,86,76,3,5,2,2
E33005779,262,204,68,136,1,21,8,13,35,31,2,2,0,1
E33005780,279,255,73,182,1,9,3,6,14,12,0,2,0,0
E33005781,256,214,85,129,0,10,7,3,29,28,0,1,0,3
E33005782,455,319,90,229,3,82,28,54,49,40,2,6,1,2
E33005783,472,369,95,274,0,35,17,18,66,59,0,7,0,2
E33005784,514,402,89,313,5,57,18,39,44,38,1,4,1,6
E33005785,404,358,105,253,0,22,9,13,23,17,0,5,1,1
E33005786,775,588,179,409,2,99,33,66,81,67,3,10,1,5
E33005787,315,222,68,154,1,44,16,28,45,40,1,1,3,3
E33005788,263,215,61,154,2,25,5,20,19,17,0,2,0,2
E33005789,263,204,63,141,0,29,6,23,27,21,2,4,0,3
E33005790,601,467,116,351,2,70,21,49,59,49,0,10,0,3
E33005791,227,155,38,117,0,39,10,29,30,26,1,2,1,3
E33005792,278,213,38,175,0,28,8,20,35,33,1,1,0,2
E33005793,265,220,36,184,1,14,5,9,27,26,0,1,0,3
E33005794,268,170,49,121,0,62,26,36,33,28,1,4,0,3
E33005795,456,361,86,275,0,48,14,34,44,36,1,7,0,3
E33005796,576,425,104,321,2,63,25,38,83,71,0,12,0,3
E33005797,582,466,126,340,1,36,13,23,77,66,0,11,0,2
E33005798,820,584,161,423,3,104,30,74,114,103,3,8,0,15
E33005799,654,511,132,379,4,64,17,47,71,65,0,6,0,4
E33005800,339,235,55,180,2,36,11,25,66,61,0,5,0,0
E33005801,348,249,58,191,0,51,22,29,48,40,0,8,0,0
E33005802,247,194,46,148,0,15,2,13,38,34,0,2,2,0
E33005803,655,454,119,335,4,74,19,55,119,104,1,11,3,4
E33005804,242,160,30,130,0,40,8,32,42,36,0,6,0,0
E33005805,469,331,94,237,1,77,30,47,57,53,1,3,0,3
E33005806,332,248,59,189,1,37,9,28,40,36,1,2,1,6
E33005807,387,300,82,218,1,32,12,20,52,50,0,2,0,2
E33005808,300,212,42,170,0,49,10,39,36,30,1,5,0,3
E33005809,303,232,61,171,1,25,8,17,45,42,0,2,1,0
E33005810,344,284,44,240,0,24,7,17,35,30,1,4,0,1
E33005811,277,200,56,144,0,24,5,19,52,51,0,1,0,1
E33005812,298,257,63,194,0,13,6,7,25,23,0,2,0,3
E33005813,895,653,163,490,0,131,52,79,105,97,1,7,0,6
E33005814,268,196,50,146,0,40,17,23,31,29,0,2,0,1
E33005815,671,530,164,366,0,68,21,47,70,62,0,8,0,3
E33005816,333,244,88,156,0,40,20,20,46,42,0,0,4,3
E33005817,323,266,98,168,2,26,13,13,28,24,2,2,0,1
E33005818,378,301,89,212,2,29,8,21,44,43,0,1,0,2
E33005819,373,326,82,244,2,13,6,7,27,27,0,0,0,5
E33005820,379,312,87,225,0,23,8,15,40,35,0,5,0,4
E33005821,446,367,91,276,3,22,5,17,54,52,0,2,0,0
E33005822,289,216,54,162,1,24,6,18,47,43,0,4,0,1
E33005823,972,694,177,517,4,116,43,73,147,130,2,11,4,11
E33005824,631,480,138,342,2,71,24,47,69,59,2,7,1,9
E33005825,542,413,58,355,1,81,21,60,47,40,0,7,0,0
E33005826,578,435,101,334,1,95,29,66,43,34,0,8,1,4
E33005827,321,222,42,180,2,71,20,51,25,23,0,2,0,1
E33005828,584,479,138,341,3,45,9,36,54,49,0,4,1,3
E33005829,313,216,61,155,1,45,19,26,48,44,0,4,0,3
E33005830,263,192,51,141,0,33,7,26,36,33,0,1,2,2
E33005831,601,419,113,306,6,93,31,62,80,75,0,5,0,3
E33005832,325,251,75,176,3,26,11,15,43,36,0,7,0,2
E33005833,289,213,53,160,1,34,9,25,38,34,1,3,0,3
E33005834,319,229,65,164,0,38,11,27,50,46,0,4,0,2
E33005835,335,220,71,149,1,64,19,45,44,41,0,3,0,6
E33005836,394,294,65,229,1,56,10,46,40,27,2,7,4,3
E33005837,410,310,81,229,0,58,5,53,39,29,0,6,4,3
E33005838,419,277,84,193,3,79,16,63,49,49,0,0,0,11
E33005839,548,405,123,282,1,62,21,41,71,65,0,4,2,9
E33005840,365,310,83,227,2,13,5,8,37,33,0,4,0,3
E33005841,298,236,76,160,0,18,7,11,41,39,0,1,1,3
E33005842,250,208,65,143,0,11,4,7,28,22,0,5,1,3
E33005843,492,249,68,181,2,116,52,64,122,117,0,5,0,3
E33005844,493,365,85,280,4,53,25,28,66,63,0,3,0,5
E33005845,305,128,45,83,10,93,21,72,69,62,2,3,2,5
E33005846,327,195,66,129,2,58,13,45,66,62,0,2,2,6
E33005847,399,291,70,221,1,22,6,16,84,79,1,4,0,1
E33005848,334,200,62,138,0,54,19,35,75,73,0,2,0,5
E33005849,340,135,39,96,2,118,41,77,79,74,0,2,3,6
E33005850,300,245,60,185,1,23,13,10,29,27,0,2,0,2
E33005851,487,385,124,261,3,38,18,20,60,53,0,7,0,1
E33005852,328,263,58,205,2,17,9,8,46,44,0,2,0,0
E33005853,538,408,139,269,3,61,24,37,63,58,0,5,0,3
E33005854,863,578,128,450,9,65,19,46,205,190,0,14,1,6
E33005855,275,201,66,135,1,27,13,14,45,34,0,10,1,1
E33005856,470,333,70,263,2,52,21,31,83,76,1,5,1,0
E33005857,524,402,90,312,2,52,27,25,66,62,0,4,0,2
E33005858,1020,693,144,549,4,113,45,68,204,185,0,18,1,6
E33005859,318,241,61,180,1,35,11,24,40,39,0,1,0,1
E33005860,418,300,96,204,8,30,5,25,79,71,0,2,6,1
E33005861,382,293,75,218,3,31,17,14,51,45,0,5,1,4
E33005862,373,262,75,187,4,49,25,24,53,47,1,5,0,5
E33005863,240,183,42,141,2,22,7,15,30,28,0,1,1,3
E33005864,579,310,74,236,3,80,45,35,184,176,0,8,0,2
E33005865,335,272,85,187,0,21,9,12,39,36,0,3,0,3
E33005866,297,267,68,199,2,10,5,5,16,16,0,0,0,2
E33005867,483,389,92,297,3,29,9,20,60,56,0,4,0,2
E33005868,249,176,44,132,5,16,6,10,52,47,0,5,0,0
E33005869,332,251,68,183,2,31,17,14,46,45,0,1,0,2
E33005870,334,266,71,195,4,21,5,16,41,35,0,6,0,2
E33005871,303,222,66,156,0,38,20,18,35,31,1,3,0,8
E33005872,336,284,48,236,0,33,14,19,18,17,0,1,0,1
E33005873,256,216,52,164,1,14,7,7,25,23,0,2,0,0
E33005874,287,227,54,173,2,18,14,4,32,31,0,1,0,8
E33005875,586,475,135,340,2,35,15,20,68,65,0,2,1,6
E33005876,371,263,61,202,3,64,32,32,39,32,1,4,2,2
E33005877,489,346,87,259,1,78,28,50,59,54,0,5,0,5
E33005878,275,233,54,179,3,15,8,7,23,20,0,3,0,1
E33005879,272,217,68,149,1,26,13,13,28,28,0,0,0,0
E33005880,630,442,104,338,7,82,28,54,97,93,0,4,0,2
E33005881,352,258,85,173,0,55,17,38,37,33,2,2,0,2
E33005882,276,207,42,165,2,28,17,11,36,34,0,2,0,3
E33005883,472,347,118,229,3,45,19,26,68,62,1,5,0,9
E33005884,297,248,69,179,0,18,7,11,30,26,0,4,0,1
E33005885,285,187,55,132,1,40,15,25,52,45,3,3,1,5
E33005886,365,293,68,225,1,23,7,16,47,44,0,3,0,1
E33005887,286,242,77,165,0,15,8,7,27,25,0,2,0,2
E33005888,379,264,69,195,2,50,18,32,60,58,1,1,0,3
E33005889,251,202,66,136,0,15,4,11,33,31,0,2,0,1
E33005890,333,253,67,186,2,28,11,17,50,44,0,6,0,0
E33005891,445,298,93,205,3,74,34,40,65,59,0,5,1,5
E33005892,302,234,67,167,2,21,8,13,41,41,0,0,0,4
E33005893,270,199,45,154,1,21,10,11,48,41,0,6,1,1
E33005894,357,269,73,196,0,28,17,11,58,55,1,2,0,2
E33005895,254,218,66,152,0,15,7,8,19,18,0,1,0,2
E33005896,641,541,136,405,4,27,11,16,67,60,0,7,0,2
E33005897,318,256,68,188,2,26,4,22,33,30,0,3,0,1
E33005898,705,516,136,380,3,75,23,52,105,99,1,5,0,6
E33005899,315,245,80,165,2,38,11,27,28,21,2,4,1,2
E33005900,383,294,73,221,0,41,15,26,45,43,0,2,0,3
E33005901,384,277,58,219,2,60,16,44,44,37,3,4,0,1
E33005902,309,255,71,184,3,28,9,19,18,18,0,0,0,5
E33005903,273,240,60,180,0,13,5,8,19,19,0,0,0,1
E33005904,284,209,55,154,0,25,9,16,49,42,0,7,0,1
E33005905,279,204,61,143,0,29,15,14,42,39,0,3,0,4
E33005906,275,212,64,148,2,20,5,15,39,36,0,2,1,2
E33005907,422,297,74,223,1,57,22,35,64,56,1,6,1,3
E33005908,290,245,82,163,2,24,14,10,17,16,0,1,0,2
E33005909,295,180,35,145,1,14,3,11,97,85,0,10,2,3
E33005910,243,167,42,125,0,11,4,7,64,58,0,1,5,1
E33005911,369,303,75,228,0,16,8,8,49,46,0,3,0,1
E33005912,377,273,65,208,1,27,11,16,75,73,0,1,1,1
E33005913,953,649,132,517,8,81,32,49,211,194,6,11,0,4
E33005914,464,373,106,267,1,20,8,12,70,65,0,5,0,0
E33005915,377,292,74,218,0,20,6,14,63,60,0,1,2,2
E33005916,313,222,55,167,1,37,13,24,51,45,1,4,1,2
E33005917,859,671,177,494,3,55,20,35,128,119,0,8,1,2
E33005918,403,331,84,247,1,24,8,16,45,41,0,4,0,2
E33005919,288,241,70,171,4,9,2,7,30,28,0,2,0,4
E33005920,284,236,71,165,1,25,3,22,21,21,0,0,0,1
E33005921,601,446,172,274,3,84,26,58,66,56,0,10,0,2
E33005922,394,248,53,195,2,114,15,99,28,25,0,2,1,2
E33005923,518,362,110,252,1,79,24,55,73,66,0,7,0,3
E33005924,424,296,67,229,1,74,18,56,51,42,0,6,3,2
E33005925,447,344,93,251,2,36,19,17,63,56,4,2,1,2
E33005926,418,329,86,243,1,64,39,25,24,21,0,3,0,0
E33005927,444,341,74,267,5,19,5,14,78,72,0,6,0,1
E33005928,319,242,72,170,3,49,15,34,25,20,0,5,0,0
E33005929,396,221,45,176,7,124,18,106,40,38,0,0,2,4
E33005930,290,235,68,167,0,16,6,10,36,31,5,0,0,3
E33005931,300,264,63,201,0,8,3,5,27,20,0,7,0,1
E33005932,433,321,96,225,3,51,22,29,52,48,0,3,1,6
E33005933,266,199,52,147,0,17,8,9,48,43,0,4,1,2
E33005934,646,461,134,327,9,49,11,38,125,120,0,5,0,2
E33005935,473,422,131,291,2,18,6,12,29,25,0,3,1,2
E33005936,364,312,103,209,0,13,1,12,36,32,0,4,0,3
E33005937,434,373,126,247,0,22,7,15,37,35,0,2,0,2
E33005938,274,188,54,134,0,55,6,49,30,29,0,1,0,1
E33005939,554,427,115,312,0,72,27,45,48,44,1,2,1,7
E33005940,337,206,53,153,7,97,23,74,25,25,0,0,0,2
E33005941,294,252,70,182,1,12,4,8,27,24,0,3,0,2
E33005942,252,212,71,141,0,18,10,8,21,21,0,0,0,1
E33005943,235,187,69,118,0,18,9,9,30,26,2,2,0,0
E33005944,296,256,85,171,0,17,9,8,20,20,0,0,0,3
E33005945,267,216,82,134,3,16,3,13,29,21,0,8,0,3
E33005946,309,262,82,180,0,7,1,6,40,37,0,3,0,0
E33005947,715,531,119,412,5,69,38,31,108,103,0,5,0,2
E33005948,832,581,172,409,2,131,50,81,113,105,0,7,1,5
E33005949,385,248,54,194,4,19,6,13,112,110,0,2,0,2
E33005950,351,218,48,170,4,39,9,30,89,85,0,4,0,1
E33005951,612,439,121,318,5,53,23,30,114,107,0,6,1,1
E33005952,651,471,99,372,6,51,17,34,120,108,1,11,0,3
E33005953,372,286,92,194,3,27,6,21,50,49,0,1,0,6
E33005954,264,185,60,125,2,33,14,19,43,41,0,2,0,1
E33005955,417,303,82,221,4,29,10,19,80,76,0,4,0,1
E33005956,390,244,62,182,6,48,21,27,91,86,0,5,0,1
E33005957,479,359,95,264,7,53,20,33,57,54,1,2,0,3
E33005958,343,217,59,158,1,65,19,46,57,52,0,3,2,3
E33005959,293,213,86,127,0,26,6,20,45,36,6,1,2,9
E33005960,322,237,96,141,4,16,4,12,59,55,0,4,0,6
E33005961,727,484,118,366,1,73,30,43,165,154,0,8,3,4
E33005962,311,210,70,140,6,43,18,25,44,39,2,2,1,8
E33005963,341,282,84,198,0,12,3,9,43,41,0,2,0,4
E33005964,314,251,81,170,2,17,5,12,41,40,0,1,0,3
E33005965,290,238,79,159,1,11,1,10,35,32,0,3,0,5
E33005966,289,238,72,166,1,3,1,2,46,43,0,3,0,1
E33005967,579,466,144,322,3,15,2,13,91,81,2,7,1,4
E33005968,225,180,80,100,4,9,5,4,30,29,0,0,1,2
E33005969,469,324,86,238,2,36,11,25,104,96,0,5,3,3
E33005970,307,219,66,153,1,43,19,24,43,38,0,4,1,1
E33005971,279,228,64,164,0,10,4,6,38,36,0,2,0,3
E33005972,293,223,84,139,7,20,7,13,42,40,0,2,0,1
E33005973,406,310,104,206,1,16,6,10,73,70,0,3,0,6
E33005974,316,243,84,159,2,15,5,10,48,46,0,2,0,8
E33005975,282,219,60,159,0,24,4,20,37,32,1,4,0,2
E33005976,313,256,94,162,1,22,9,13,33,30,0,3,0,1
E33005977,251,201,74,127,2,21,7,14,26,21,2,3,0,1
E33005978,323,222,65,157,0,22,7,15,78,75,0,2,1,1
E33005979,248,206,68,138,3,4,0,4,34,33,0,1,0,1
E33005980,301,225,57,168,3,29,9,20,43,38,1,4,0,1
E33005981,319,265,92,173,1,18,10,8,28,26,2,0,0,7
E33005982,301,241,84,157,1,24,19,5,31,24,0,7,0,4
E33005983,357,281,80,201,0,27,23,4,43,37,0,6,0,6
E33005984,411,344,93,251,1,29,25,4,33,30,0,3,0,4
E33005985,535,435,137,298,0,39,36,3,59,54,0,4,1,2
E33005986,261,219,54,165,0,19,17,2,22,16,0,3,3,1
E33005987,495,402,116,286,1,38,26,12,49,46,0,2,1,5
E33005988,582,456,154,302,5,49,46,3,67,54,2,9,2,5
E33005989,239,207,68,139,0,10,8,2,22,21,0,1,0,0
E33005990,339,300,105,195,0,9,8,1,27,25,0,2,0,3
E33005991,266,211,59,152,0,22,19,3,31,28,0,3,0,2
E33005992,634,531,150,381,4,26,22,4,69,64,2,3,0,4
E33005993,285,235,80,155,0,30,28,2,19,16,0,3,0,1
E33005994,279,253,66,187,1,12,10,2,11,9,0,2,0,2
E33005995,282,214,65,149,1,35,32,3,29,26,1,2,0,3
E33005996,329,288,111,177,1,11,11,0,26,25,0,1,0,3
E33005997,257,190,58,132,1,26,23,3,38,36,0,2,0,2
E33005998,255,215,71,144,0,18,16,2,20,16,1,3,0,2
E33005999,298,217,49,168,2,51,49,2,26,21,0,3,2,2
E33006000,434,332,90,242,0,61,52,9,39,38,0,1,0,2
E33006001,664,509,127,382,1,76,65,11,71,57,1,9,4,7
E33006002,223,169,47,122,3,22,20,2,27,24,0,3,0,2
E33006003,285,201,64,137,1,37,32,5,43,41,1,1,0,3
E33006004,292,243,77,166,2,13,11,2,33,32,0,1,0,1
E33006005,517,389,103,286,0,55,45,10,70,62,0,6,2,3
E33006006,367,292,94,198,0,18,16,2,54,49,0,4,1,3
E33006007,2225,1834,499,1335,6,140,112,28,231,196,14,16,5,14
E33006008,280,227,94,133,0,20,18,2,28,26,0,0,2,5
E33006009,1011,820,211,609,5,109,87,22,76,67,0,8,1,1
E33006010,253,182,54,128,1,26,20,6,42,37,2,3,0,2
E33006011,464,387,109,278,2,42,37,5,31,28,0,3,0,2
E33006012,785,657,205,452,3,41,32,9,81,75,0,6,0,3
E33006013,266,204,72,132,1,13,12,1,47,44,0,3,0,1
E33006014,413,317,93,224,3,45,36,9,46,33,8,5,0,2
E33006015,324,268,77,191,0,22,19,3,31,27,1,3,0,3
E33006016,359,263,58,205,5,55,45,10,32,27,0,5,0,4
E33006017,253,197,71,126,1,30,27,3,24,21,0,3,0,1
E33006018,224,177,50,127,1,15,13,2,28,25,1,2,0,3
E33006019,304,219,79,140,0,58,53,5,27,22,0,3,2,0
E33006020,483,315,85,230,0,97,78,19,62,56,1,3,2,9
E33006021,1380,888,247,641,4,221,183,38,264,249,1,14,0,3
E33006022,805,611,170,441,2,87,73,14,101,94,0,5,2,4
E33006023,650,414,109,305,2,182,174,8,44,40,0,4,0,8
E33006024,288,224,56,168,0,30,27,3,33,28,0,5,0,1
E33006025,429,311,102,209,0,77,67,10,38,31,1,5,1,3
E33006026,305,239,76,163,0,23,19,4,40,36,0,3,1,3
E33006027,248,204,65,139,0,24,19,5,19,17,1,1,0,1
E33006028,248,187,58,129,0,41,31,10,20,18,0,2,0,0
E33006029,307,243,65,178,1,26,22,4,33,30,1,2,0,4
E33006030,541,348,100,248,6,105,86,19,77,72,0,5,0,5
E33006031,472,356,109,247,2,63,51,12,47,39,0,7,1,4
E33006032,464,319,96,223,2,99,93,6,42,40,0,2,0,2
E33006033,439,345,115,230,1,52,42,10,37,31,1,5,0,4
E33006034,296,213,60,153,1,40,37,3,40,36,0,4,0,2
E33006035,329,298,60,238,0,8,5,3,22,22,0,0,0,1
E33006036,554,421,118,303,0,67,52,15,58,53,0,3,2,8
E33006037,276,220,58,162,0,13,10,3,42,36,0,4,2,1
E33006038,325,273,95,178,3,22,18,4,25,22,0,1,2,2
E33006039,328,245,61,184,0,45,43,2,37,31,0,4,2,1
E33006040,477,354,105,249,1,59,42,17,61,53,0,6,2,2
E33006041,387,280,85,195,1,49,43,6,54,47,0,6,1,3
E33006042,717,556,142,414,1,73,59,14,85,73,0,10,2,2
E33006043,434,323,105,218,2,67,63,4,39,34,0,2,3,3
E33006044,444,357,113,244,2,34,24,10,51,44,1,3,3,0
E33006045,389,312,92,220,0,38,28,10,37,34,0,3,0,2
E33006046,442,318,88,230,1,62,53,9,56,54,0,2,0,5
E33006047,583,387,91,296,1,92,78,14,96,89,0,5,2,7
E33006048,316,226,58,168,0,61,53,8,28,28,0,0,0,1
E33006049,617,457,125,332,2,104,97,7,50,43,1,6,0,4
E33006050,345,305,79,226,0,26,24,2,13,12,0,1,0,1
E33006051,367,251,86,165,2,88,83,5,22,18,0,4,0,4
E33006052,390,218,44,174,1,95,87,8,74,72,0,2,0,2
E33006053,378,270,56,214,0,56,47,9,49,46,2,1,0,3
E33006054,605,442,111,331,2,88,69,19,70,59,1,9,1,3
E33006055,248,207,66,141,0,24,21,3,13,12,0,0,1,4
E33006056,321,257,83,174,0,35,35,0,25,25,0,0,0,4
E33006057,272,229,69,160,1,12,11,1,24,24,0,0,0,6
E33006058,320,255,86,169,1,27,25,2,35,28,0,7,0,2
E33006059,432,350,114,236,0,36,29,7,44,43,0,1,0,2
E33006060,766,664,200,464,1,40,34,6,59,53,0,6,0,2
E33006061,285,241,55,186,0,15,12,3,28,26,0,2,0,1
E33006062,372,304,82,222,1,34,27,7,30,27,0,3,0,3
E33006063,510,427,141,286,1,40,33,7,41,35,0,5,1,1
E33006064,744,535,168,367,1,115,102,13,88,82,0,4,2,5
E33006065,310,262,76,186,0,16,14,2,28,22,2,3,1,4
E33006066,470,397,108,289,1,31,25,6,37,32,0,5,0,4
E33006067,688,585,181,404,0,59,50,9,41,38,0,3,0,3
E33006068,338,320,102,218,1,8,7,1,9,9,0,0,0,0
E33006069,300,274,83,191,0,9,4,5,16,16,0,0,0,1
E33006070,501,444,145,299,0,22,19,3,32,28,1,3,0,3
E33006071,323,282,60,222,1,14,11,3,26,22,1,3,0,0
E33006072,449,373,98,275,0,32,31,1,43,36,0,7,0,1
E33006073,519,388,122,266,7,67,60,7,53,50,0,3,0,4
E33006074,394,279,74,205,0,51,43,8,59,55,0,3,1,5
E33006075,433,323,79,244,1,51,33,18,57,50,3,4,0,1
E33006076,402,335,104,231,0,27,23,4,35,27,0,8,0,5
E33006077,509,415,131,284,0,58,47,11,34,31,0,2,1,2
E33006078,476,317,75,242,0,70,57,13,78,69,0,7,2,11
E33006079,319,229,56,173,0,27,21,6,59,52,0,6,1,4
E33006080,294,219,62,157,0,39,34,5,30,28,0,2,0,6
E33006081,276,228,56,172,0,14,11,3,33,33,0,0,0,1
E33006082,454,357,105,252,1,47,41,6,45,36,0,9,0,4
E33006083,491,378,104,274,1,65,50,15,42,36,0,6,0,5
E33006084,318,246,55,191,1,33,24,9,36,30,0,5,1,2
E33006085,610,460,109,351,3,62,53,9,79,78,0,1,0,6
E33006086,447,316,67,249,2,62,48,14,64,60,0,3,1,3
E33006087,358,267,102,165,0,42,36,6,45,42,0,1,2,4
E33006088,328,279,65,214,1,18,15,3,28,25,0,1,2,2
E33006089,305,238,67,171,2,25,19,6,36,32,1,3,0,4
E33006090,439,322,86,236,3,57,42,15,55,50,0,4,1,2
E33006091,419,332,83,249,1,17,8,9,65,58,1,5,1,4
E33006092,400,306,96,210,2,70,63,7,20,19,0,1,0,2
E33006093,307,252,74,178,1,24,20,4,29,24,0,5,0,1
E33006094,827,685,150,535,4,43,32,11,92,79,0,13,0,3
E33006095,744,540,154,386,2,104,85,19,96,91,0,4,1,2
E33006096,336,255,66,189,2,31,28,3,45,41,0,4,0,3
E33006097,367,266,69,197,0,73,65,8,27,24,0,3,0,1
E33006098,520,381,79,302,4,77,72,5,52,41,3,8,0,6
E33006099,285,194,45,149,0,42,37,5,47,45,0,2,0,2
E33006100,341,308,74,234,1,8,7,1,23,22,0,1,0,1
E33006101,724,564,161,403,6,84,75,9,67,58,1,8,0,3
E33006102,433,365,93,272,6,22,18,4,35,33,0,1,1,5
E33006103,281,232,60,172,0,14,13,1,29,27,0,2,0,6
E33006104,461,357,97,260,1,52,39,13,50,43,1,5,1,1
E33006105,280,233,48,185,1,18,9,9,28,21,0,4,3,0
E33006106,289,214,50,164,0,46,41,5,23,21,0,2,0,6
E33006107,342,260,70,190,3,35,27,8,44,39,0,5,0,0
E33006108,512,400,115,285,2,39,27,12,68,63,0,5,0,3
E33006109,324,227,63,164,0,29,27,2,65,56,3,6,0,3
E33006110,343,231,62,169,1,56,52,4,53,51,0,2,0,2
E33006111,321,260,72,188,1,19,10,9,38,33,0,4,1,3
E33006112,350,252,84,168,0,38,30,8,55,48,0,5,2,5
E33006113,559,422,105,317,3,46,34,12,86,82,0,4,0,2
E33006114,696,502,154,348,0,90,74,16,99,90,0,8,1,5
E33006115,849,702,200,502,4,68,47,21,68,65,0,2,1,7
E33006116,610,402,115,287,3,139,131,8,61,54,0,6,1,5
E33006117,326,237,53,184,1,51,42,9,35,33,0,1,1,2
E33006118,463,372,106,266,0,55,52,3,31,26,0,5,0,5
E33006119,258,219,64,155,0,14,13,1,25,23,0,2,0,0
E33006120,386,325,84,241,1,17,12,5,42,40,0,1,1,1
E33006121,391,309,70,239,3,51,37,14,25,23,0,2,0,3
E33006122,360,251,59,192,0,43,33,10,62,58,1,2,1,4
E33006123,284,193,57,136,0,41,37,4,47,44,0,3,0,3
E33006124,429,331,101,230,4,31,23,8,59,51,0,6,2,4
E33006125,326,250,77,173,2,49,39,10,20,17,0,3,0,5
E33006126,324,256,62,194,1,23,15,8,44,37,3,4,0,0
E33006127,287,234,68,166,1,29,23,6,23,22,0,1,0,0
E33006128,464,372,107,265,0,46,42,4,44,36,0,8,0,2
E33006129,612,526,114,412,1,22,17,5,61,53,0,8,0,2
E33006130,516,419,129,290,1,46,36,10,45,41,0,2,2,5
E33006131,413,352,108,244,1,31,28,3,27,23,0,3,1,2
E33006132,374,328,103,225,0,12,8,4,33,28,0,5,0,1
E33006133,592,478,136,342,1,51,38,13,59,55,0,3,1,3
E33006134,289,208,67,141,0,30,23,7,43,39,0,3,1,8
E33006135,240,147,35,112,4,45,38,7,40,34,0,4,2,4
E33006136,494,397,111,286,3,31,26,5,62,53,0,8,1,1
E33006137,617,498,129,369,4,58,45,13,54,53,0,1,0,3
E33006138,335,279,92,187,0,16,13,3,38,34,0,3,1,2
E33006139,579,415,118,297,9,63,39,24,83,73,3,6,1,9
E33006140,695,527,161,366,0,91,62,29,74,69,0,3,2,3
E33006141,296,216,45,171,1,42,30,12,34,33,1,0,0,3
E33006142,642,486,118,368,7,49,29,20,97,92,1,4,0,3
E33006143,429,307,77,230,2,75,65,10,41,35,0,5,1,4
E33006144,287,216,66,150,1,39,32,7,29,28,0,1,0,2
E33006145,289,252,78,174,0,14,11,3,23,20,0,3,0,0
E33006146,382,295,102,193,1,34,26,8,49,45,0,4,0,3
E33006147,716,572,139,433,0,47,26,21,93,75,0,17,1,4
E33006148,554,465,144,321,0,39,32,7,45,37,0,8,0,5
E33006149,950,745,175,570,2,96,70,26,102,97,0,5,0,5
E33006150,594,485,131,354,3,38,30,8,66,55,1,10,0,2
E33006151,455,388,99,289,0,38,30,8,25,24,0,1,0,4
E33006152,366,300,87,213,0,28,22,6,38,33,0,5,0,0
E33006153,430,327,86,241,1,51,39,12,50,46,1,3,0,1
E33006154,391,294,60,234,0,56,23,33,40,36,0,3,1,1
E33006155,285,206,34,172,1,50,29,21,27,24,1,2,0,1
E33006156,335,235,59,176,0,72,40,32,25,22,0,3,0,3
E33006157,577,447,107,340,1,63,24,39,65,62,0,3,0,1
E33006158,439,344,71,273,0,51,18,33,41,38,0,3,0,3
E33006159,446,361,78,283,0,39,15,24,43,39,0,3,1,3
E33006160,448,407,56,351,1,9,5,4,29,27,0,1,1,2
E33006161,262,210,59,151,0,28,17,11,24,24,0,0,0,0
E33006162,255,164,38,126,0,60,31,29,31,29,0,2,0,0
E33006163,451,325,75,250,2,81,29,52,40,35,0,4,1,3
E33006164,267,172,48,124,0,68,24,44,24,20,0,2,2,3
E33006165,308,253,50,203,2,22,8,14,26,25,0,1,0,5
E33006166,405,304,53,251,0,42,18,24,55,52,0,3,0,4
E33006167,287,216,58,158,1,47,25,22,22,18,0,3,1,1
E33006168,266,198,32,166,2,33,18,15,30,28,0,2,0,3
E33006169,880,707,204,503,5,94,29,65,73,69,0,4,0,1
E33006170,976,647,161,486,7,189,57,132,125,116,0,7,2,8
E33006171,289,208,51,157,3,51,29,22,25,24,0,1,0,2
E33006172,1292,1038,231,807,3,113,33,80,132,115,1,13,3,6
E33006173,282,190,65,125,2,63,21,42,26,24,0,2,0,1
E33006174,296,232,65,167,1,31,11,20,30,25,0,3,2,2
E33006175,449,321,70,251,2,75,25,50,48,45,0,3,0,3
E33006176,200,156,45,111,0,17,2,15,22,22,0,0,0,5
E33006177,254,177,40,137,1,44,17,27,30,27,0,2,1,2
E33006178,278,184,29,155,3,64,20,44,27,23,0,4,0,0
E33006179,644,407,100,307,9,168,27,141,54,49,0,5,0,6
E33006180,747,497,104,393,1,169,86,83,75,72,0,1,2,5
E33006181,325,261,48,213,1,24,15,9,33,31,0,2,0,6
E33006182,313,222,50,172,0,34,12,22,52,46,1,4,1,5
E33006183,278,210,61,149,0,37,18,19,29,20,4,5,0,2
E33006184,295,223,57,166,2,35,12,23,33,33,0,0,0,2
E33006185,269,186,51,135,2,41,25,16,40,38,0,2,0,0
E33006186,256,162,47,115,0,69,35,34,21,20,0,1,0,4
E33006187,414,286,62,224,0,88,42,46,40,35,0,5,0,0
E33006188,283,208,41,167,2,47,16,31,23,21,0,2,0,3
E33006189,305,239,62,177,0,39,19,20,25,23,0,2,0,2
E33006190,335,283,75,208,1,22,7,15,27,24,0,2,1,2
E33006191,383,319,69,250,0,32,15,17,27,26,0,1,0,5
E33006192,4750,3730,876,2854,13,428,175,253,569,524,4,39,2,10
E33006193,620,466,85,381,2,83,40,43,60,53,0,6,1,9
E33006194,361,234,54,180,2,75,45,30,48,44,0,3,1,2
E33006195,245,194,37,157,3,31,12,19,16,15,0,1,0,1
E33006196,428,338,80,258,2,48,24,24,37,35,1,1,0,3
E33006197,284,180,44,136,1,63,24,39,35,31,0,4,0,5
E33006198,252,182,47,135,0,40,19,21,28,25,1,2,0,2
E33006199,413,340,61,279,0,40,15,25,32,30,0,2,0,1
E33006200,292,240,54,186,4,34,18,16,13,12,0,1,0,1
E33006201,259,205,56,149,2,32,19,13,20,18,0,2,0,0
E33006202,580,436,108,328,4,79,31,48,50,44,0,6,0,11
E33006203,620,536,159,377,0,30,10,20,51,49,0,2,0,3
E33006204,911,692,159,533,4,126,38,88,85,79,0,5,1,4
E33006205,433,329,75,254,2,49,18,31,48,40,1,7,0,5
E33006206,477,380,85,295,0,56,31,25,38,30,0,8,0,3
E33006207,536,363,107,256,5,86,37,49,77,68,2,6,1,5
E33006208,542,431,91,340,1,54,15,39,55,50,2,2,1,1
E33006209,391,347,105,242,0,16,2,14,24,22,0,2,0,4
E33006210,324,255,87,168,0,37,12,25,27,25,0,2,0,5
E33006211,424,380,119,261,1,12,7,5,29,21,3,4,1,2
E33006212,553,463,133,330,2,39,15,24,42,35,2,5,0,7
E33006213,249,224,82,142,0,11,5,6,9,8,1,0,0,5
E33006214,737,543,134,409,7,117,38,79,68,64,0,1,3,2
E33006215,508,435,110,325,3,26,12,14,43,38,0,5,0,1
E33006216,367,287,63,224,0,32,12,20,46,40,0,6,0,2
E33006217,336,250,47,203,2,46,26,20,36,32,0,4,0,2
E33006218,499,384,97,287,3,66,24,42,45,39,0,6,0,1
E33006219,1180,975,202,773,3,120,53,67,81,79,0,2,0,1
E33006220,322,258,51,207,0,27,9,18,36,31,5,0,0,1
E33006221,299,203,63,140,0,48,12,36,43,41,0,2,0,5
E33006222,781,613,167,446,3,82,21,61,80,69,0,9,2,3
E33006223,257,202,56,146,0,36,8,28,18,18,0,0,0,1
E33006224,261,187,43,144,0,35,10,25,35,34,0,1,0,4
E33006225,294,212,66,146,1,26,4,22,53,46,1,4,2,2
E33006226,279,224,58,166,2,20,6,14,29,26,1,1,1,4
E33006227,562,443,104,339,0,47,7,40,71,67,0,4,0,1
E33006228,819,622,133,489,5,70,15,55,117,106,0,9,2,5
E33006229,332,266,63,203,0,28,6,22,36,34,1,1,0,2
E33006230,306,235,57,178,0,21,5,16,46,43,0,2,1,4
E33006231,249,206,61,145,0,16,5,11,25,24,0,1,0,2
E33006232,268,195,54,141,2,27,9,18,41,36,1,4,0,3
E33006233,483,357,85,272,2,46,10,36,74,68,0,3,3,4
E33006234,297,225,49,176,1,33,9,24,38,33,0,5,0,0
E33006235,332,232,56,176,1,61,17,44,38,38,0,0,0,0
E33006236,1418,835,193,642,5,233,63,170,340,327,1,12,0,5
E33006237,476,273,66,207,0,134,46,88,66,58,1,6,1,3
E33006238,578,320,58,262,0,173,45,128,79,75,0,2,2,6
E33006239,508,364,91,273,1,71,19,52,67,65,1,1,0,5
E33006240,630,412,107,305,0,144,24,120,68,59,0,8,1,6
E33006241,297,169,44,125,0,66,17,49,58,52,1,5,0,4
E33006242,436,310,84,226,0,69,16,53,51,46,0,5,0,6
E33006243,981,762,174,588,6,79,11,68,128,120,0,5,3,6
E33006244,741,484,130,354,5,118,32,86,133,127,1,3,2,1
E33006245,416,341,62,279,3,19,7,12,50,43,3,2,2,3
E33006246,443,387,75,312,5,18,3,15,32,29,1,2,0,1
E33006247,1374,1003,344,659,6,234,70,164,124,115,0,8,1,7
E33006248,730,514,152,362,6,140,33,107,68,64,1,3,0,2
E33006249,782,523,144,379,3,159,42,117,93,87,0,5,1,4
E33006250,286,192,48,144,1,31,8,23,57,53,0,4,0,5
E33006251,299,187,49,138,1,48,6,42,59,55,0,4,0,4
E33006252,292,234,64,170,2,26,5,21,30,25,0,4,1,0
E33006253,252,179,46,133,1,32,12,20,39,39,0,0,0,1
E33006254,483,347,94,253,1,65,11,54,69,61,0,8,0,1
E33006255,361,239,64,175,0,88,18,70,33,29,0,3,1,1
E33006256,467,293,66,227,1,116,31,85,51,50,0,1,0,6
E33006257,266,158,43,115,2,81,19,62,24,23,0,1,0,1
E33006258,253,154,49,105,0,77,19,58,18,14,0,4,0,4
E33006259,357,251,71,180,1,60,15,45,42,41,0,0,1,3
E33006260,363,228,62,166,0,94,24,70,39,35,0,3,1,2
E33006261,690,455,112,343,5,104,16,88,121,114,0,6,1,5
E33006262,483,319,88,231,2,66,14,52,94,86,0,8,0,2
E33006263,295,176,44,132,2,52,5,47,64,55,2,6,1,1
E33006264,526,366,77,289,3,66,12,54,88,81,2,4,1,3
E33006265,341,265,83,182,3,35,12,23,33,28,0,5,0,5
E33006266,263,184,44,140,0,47,14,33,31,28,0,3,0,1
E33006267,273,194,56,138,2,52,11,41,25,24,0,0,1,0
E33006268,403,267,73,194,2,59,14,45,70,62,3,5,0,5
E33006269,241,181,46,135,1,45,13,32,13,8,0,5,0,1
E33006270,268,144,45,99,2,72,15,57,47,43,0,2,2,3
E33006271,864,586,146,440,3,159,24,135,111,105,0,6,0,5
E33006272,318,218,52,166,1,60,27,33,36,32,0,4,0,3
E33006273,570,434,121,313,5,59,13,46,69,66,1,1,1,3
E33006274,351,220,50,170,0,77,15,62,51,49,1,1,0,3
E33006275,387,231,68,163,3,96,24,72,53,47,1,5,0,4
E33006276,617,371,91,280,3,84,13,71,157,146,1,6,4,2
E33006277,305,169,52,117,1,71,7,64,64,64,0,0,0,0
E33006278,282,150,41,109,1,71,9,62,58,58,0,0,0,2
E33006279,319,198,68,130,1,41,7,34,71,67,0,4,0,8
E33006280,229,126,39,87,0,38,5,33,65,63,0,2,0,0
E33006281,310,207,64,143,1,44,4,40,53,49,0,3,1,5
E33006282,294,192,51,141,3,38,8,30,60,55,0,4,1,1
E33006283,349,202,48,154,0,48,6,42,98,92,0,5,1,1
E33006284,267,192,47,145,1,27,7,20,44,35,0,9,0,3
E33006285,294,194,62,132,0,38,10,28,60,49,1,10,0,2
E33006286,342,240,54,186,0,59,14,45,40,36,0,4,0,3
E33006287,420,254,66,188,2,61,5,56,101,86,4,10,1,2
E33006288,997,783,224,559,5,97,24,73,109,107,0,1,1,3
E33006289,596,426,94,332,4,67,12,55,91,87,0,4,0,8
E33006290,329,275,76,199,2,18,2,16,32,27,0,0,5,2
E33006291,429,332,89,243,1,40,7,33,50,48,0,1,1,6
E33006292,504,370,112,258,0,78,24,54,53,51,0,2,0,3
E33006293,547,435,120,315,3,41,12,29,65,59,0,6,0,3
E33006294,323,247,61,186,0,29,8,21,45,40,2,3,0,2
E33006295,276,165,51,114,2,61,12,49,44,42,0,1,1,4
E33006296,294,170,43,127,1,75,19,56,48,44,2,1,1,0
E33006297,238,163,40,123,6,44,9,35,23,21,0,2,0,2
E33006298,288,126,42,84,0,111,17,94,51,44,0,5,2,0
E33006299,282,202,45,157,0,61,17,44,17,16,1,0,0,2
E33006300,628,430,110,320,5,111,21,90,81,75,0,5,1,1
E33006301,375,222,74,148,1,69,14,55,79,73,0,5,1,4
E33006302,1681,1220,328,892,6,142,22,120,306,281,2,17,6,7
E33006303,374,225,53,172,2,75,17,58,67,66,0,1,0,5
E33006304,271,176,51,125,2,60,14,46,33,28,1,4,0,0
E33006305,360,213,47,166,6,59,8,51,77,73,0,4,0,5
E33006306,227,128,48,80,2,71,16,55,23,22,1,0,0,3
E33006307,695,391,116,275,2,186,24,162,111,99,1,7,4,5
E33006308,954,697,134,563,2,102,18,84,149,138,1,10,0,4
E33006309,414,240,77,163,1,109,16,93,62,56,1,2,3,2
E33006310,333,212,37,175,2,68,16,52,50,45,0,2,3,1
E33006311,290,170,36,134,1,70,24,46,44,40,0,3,1,5
E33006312,326,236,61,175,1,56,11,45,31,31,0,0,0,2
E33006313,238,182,46,136,1,33,10,23,22,18,1,1,2,0
E33006314,661,492,130,362,6,97,33,64,65,57,2,5,1,1
E33006315,401,310,90,220,0,36,13,23,53,50,0,3,0,2
E33006316,277,210,56,154,1,43,11,32,22,19,0,3,0,1
E33006317,460,330,80,250,1,66,15,51,61,56,0,5,0,2
E33006318,354,255,69,186,0,40,7,33,57,53,0,3,1,2
E33006319,325,250,59,191,1,32,6,26,40,39,0,1,0,2
E33006320,271,202,54,148,2,20,3,17,45,39,0,6,0,2
E33006321,406,289,71,218,2,55,10,45,55,49,0,4,2,5
E33006322,278,186,47,139,1,40,9,31,47,42,0,2,3,4
E33006323,387,254,90,164,0,58,12,46,70,68,0,2,0,5
E33006324,286,173,35,138,0,38,16,22,71,63,0,6,2,4
E33006325,349,165,48,117,2,67,7,60,112,108,0,4,0,3
E33006326,347,208,60,148,1,62,11,51,75,72,1,1,1,1
E33006327,257,141,44,97,2,40,4,36,69,65,0,4,0,5
E33006328,277,187,65,122,2,40,8,32,48,44,0,4,0,0
E33006329,325,238,58,180,3,46,13,33,37,33,0,3,1,1
E33006330,454,340,77,263,1,51,14,37,55,51,0,3,1,7
E33006331,314,217,71,146,2,47,12,35,41,36,0,5,0,7
E33006332,381,199,60,139,5,63,20,43,108,104,0,4,0,6
E33006333,293,162,46,116,5,49,6,43,73,70,0,3,0,4
E33006334,349,171,53,118,1,65,10,55,107,105,1,1,0,5
E33006335,287,193,46,147,0,40,8,32,53,51,0,2,0,1
E33006336,423,254,66,188,3,52,10,42,110,104,0,6,0,4
E33006337,656,415,121,294,2,121,10,111,116,107,0,8,1,2
E33006338,742,607,116,491,3,62,9,53,70,60,0,5,5,0
E33006339,2014,1487,373,1114,10,236,50,186,272,255,0,14,3,9
E33006340,353,200,42,158,3,56,7,49,91,86,3,2,0,3
E33006341,283,185,40,145,1,38,9,29,57,53,0,2,2,2
E33006342,242,163,46,117,3,46,8,38,28,25,0,3,0,2
E33006343,318,215,51,164,5,55,9,46,42,42,0,0,0,1
E33006344,705,340,89,251,7,202,34,168,154,150,0,2,2,2
E33006345,298,197,52,145,1,47,11,36,51,48,0,3,0,2
E33006346,399,269,77,192,1,48,8,40,78,73,0,4,1,3
E33006347,368,264,65,199,3,48,15,33,51,49,0,2,0,2
E33006348,289,202,52,150,2,43,9,34,40,36,0,4,0,2
E33006349,571,400,95,305,2,88,16,72,81,75,1,5,0,0
E33006350,369,309,101,208,1,22,6,16,36,30,0,4,2,1
E33006351,420,337,90,247,1,32,8,24,47,44,0,2,1,3
E33006352,315,223,70,153,1,48,16,32,42,38,0,3,1,1
E33006353,254,200,42,158,0,26,7,19,27,24,0,3,0,1
E33006354,781,607,155,452,2,45,7,38,125,117,0,7,1,2
E33006355,663,399,121,278,5,108,14,94,150,142,0,7,1,1
E33006356,443,244,72,172,0,69,9,60,128,123,1,3,1,2
E33006357,269,232,66,166,0,9,0,9,28,28,0,0,0,0
E33006358,298,255,76,179,0,18,7,11,22,19,0,3,0,3
E33006359,326,272,76,196,1,23,5,18,29,27,0,2,0,1
E33006360,611,332,86,246,6,74,12,62,195,177,4,10,4,4
E33006361,237,135,30,105,3,50,10,40,48,44,0,2,2,1
E33006362,465,255,92,163,1,65,6,59,125,110,3,10,2,19
E33006363,282,106,35,71,1,115,13,102,58,54,0,4,0,2
E33006364,242,128,34,94,0,66,9,57,47,46,1,0,0,1
E33006365,616,279,67,212,3,68,3,65,264,245,3,5,11,2
E33006366,333,173,56,117,8,70,16,54,73,66,0,6,1,9
E33006367,248,139,37,102,0,36,4,32,68,61,0,5,2,5
E33006368,301,155,48,107,2,38,4,34,104,93,4,7,0,2
E33006369,391,189,50,139,3,28,3,25,168,156,0,12,0,3
E33006370,692,333,105,228,4,109,15,94,244,237,0,7,0,2
E33006371,370,224,61,163,0,52,8,44,93,83,0,6,4,1
E33006372,564,271,67,204,4,164,35,129,120,106,3,11,0,5
E33006373,464,193,67,126,2,141,11,130,125,114,3,4,4,3
E33006374,428,242,80,162,6,116,20,96,59,58,0,1,0,5
E33006375,599,367,91,276,2,145,29,116,83,75,0,7,1,2
E33006376,510,336,93,243,1,106,27,79,63,58,0,5,0,4
E33006377,262,174,46,128,2,59,10,49,25,23,0,2,0,2
E33006378,570,422,112,310,3,90,16,74,53,48,0,5,0,2
E33006379,279,153,53,100,5,75,12,63,40,36,0,2,2,6
E33006380,268,214,80,134,1,27,9,18,23,21,2,0,0,3
E33006381,360,274,59,215,0,25,7,18,55,50,0,4,1,6
E33006382,281,230,50,180,0,9,2,7,41,38,1,2,0,1
E33006383,635,495,146,349,3,48,8,40,85,83,0,2,0,4
E33006384,392,267,59,208,3,25,4,21,96,92,0,2,2,1
E33006385,268,204,67,137,2,24,10,14,37,34,0,3,0,1
E33006386,541,348,87,261,2,62,14,48,127,121,0,6,0,2
E33006387,273,162,30,132,3,23,2,21,79,75,0,4,0,6
E33006388,288,184,51,133,0,16,6,10,85,78,0,7,0,3
E33006389,553,389,98,291,3,60,8,52,99,93,1,4,1,2
E33006390,375,242,67,175,0,27,0,27,104,93,0,6,5,2
E33006391,247,177,53,124,0,21,5,16,49,41,0,5,3,0
E33006392,435,222,72,150,2,102,11,91,104,93,3,8,0,5
E33006393,848,439,120,319,7,157,22,135,244,231,4,5,4,1
E33006394,319,156,51,105,1,53,7,46,103,97,1,3,2,6
E33006395,253,120,41,79,5,75,8,67,53,49,0,2,2,0
E33006396,288,195,50,145,0,68,20,48,24,18,0,3,3,1
E33006397,262,126,37,89,3,81,14,67,51,51,0,0,0,1
E33006398,300,167,56,111,2,67,4,63,59,54,0,3,2,5
E33006399,454,252,59,193,6,117,16,101,76,71,0,5,0,3
E33006400,600,422,83,339,5,83,15,68,85,73,0,11,1,5
E33006401,371,218,50,168,1,100,22,78,49,44,0,3,2,3
E33006402,364,250,62,188,2,73,12,61,37,32,4,0,1,2
E33006403,253,208,72,136,0,10,1,9,28,24,3,1,0,7
E33006404,517,419,112,307,2,38,8,30,55,43,1,11,0,3
E33006405,310,237,61,176,2,20,4,16,45,41,3,0,1,6
E33006406,292,260,89,171,0,7,2,5,24,24,0,0,0,1
E33006407,572,408,93,315,5,29,7,22,122,111,0,11,0,8
E33006408,661,496,130,366,3,61,13,48,98,88,2,6,2,3
E33006409,1693,1324,361,963,8,81,11,70,265,241,12,7,5,15
E33006410,385,248,68,180,4,40,2,38,90,87,0,3,0,3
E33006411,372,247,86,161,3,51,10,41,71,65,1,1,4,0
E33006412,300,207,74,133,2,38,4,34,50,44,0,6,0,3
E33006413,286,163,63,100,0,53,7,46,67,63,1,3,0,3
E33006414,597,262,89,173,2,127,13,114,200,189,2,8,1,6
E33006415,679,457,118,339,6,83,18,65,129,119,2,6,2,4
E33006416,737,538,154,384,1,70,7,63,125,120,0,5,0,3
E33006417,279,218,61,157,0,21,4,17,38,35,0,3,0,2
E33006418,495,369,107,262,2,40,9,31,84,76,1,6,1,0
E33006419,279,215,68,147,2,21,7,14,39,36,0,1,2,2
E33006420,717,479,150,329,3,100,22,78,131,119,0,10,2,4
E33006421,749,551,131,420,3,65,11,54,124,114,0,9,1,6
E33006422,328,216,67,149,1,48,9,39,62,58,0,1,3,1
E33006423,263,168,51,117,1,31,1,30,62,60,0,2,0,1
E33006424,334,224,65,159,3,43,7,36,62,60,0,2,0,2
E33006425,330,241,70,171,4,39,4,35,46,45,0,0,1,0
E33006426,645,488,158,330,0,52,9,43,94,85,1,7,1,11
E33006427,428,272,75,197,1,89,14,75,60,51,1,7,1,6
E33006428,349,224,57,167,1,52,9,43,69,62,1,4,2,3
E33006429,453,315,105,210,2,58,13,45,71,66,0,3,2,7
E33006430,345,187,48,139,5,62,5,57,88,84,1,3,0,3
E33006431,515,276,79,197,4,107,21,86,125,117,1,3,4,3
E33006432,263,204,54,150,1,22,4,18,32,26,3,3,0,4
E33006433,301,255,83,172,0,15,5,10,29,29,0,0,0,2
E33006434,450,353,113,240,1,31,1,30,62,57,0,5,0,3
E33006435,230,193,64,129,1,13,2,11,20,17,0,2,1,3
E33006436,276,214,62,152,0,40,16,24,20,18,0,2,0,2
E33006437,400,277,80,197,3,57,9,48,60,57,0,3,0,3
E33006438,413,332,67,265,0,22,5,17,54,48,0,6,0,5
E33006439,291,221,54,167,1,35,8,27,33,28,0,3,2,1
E33006440,286,211,64,147,0,36,12,24,37,34,1,1,1,2
E33006441,543,433,110,323,0,60,18,42,44,42,0,2,0,6
E33006442,500,360,92,268,0,64,12,52,76,67,3,6,0,0
E33006443,329,238,77,161,0,33,10,23,56,51,1,3,1,2
E33006444,259,212,65,147,0,21,7,14,22,21,0,1,0,4
E33006445,260,199,75,124,1,15,3,12,42,40,0,2,0,3
E33006446,245,130,30,100,1,63,11,52,45,44,0,1,0,6
E33006447,750,546,154,392,3,73,16,57,125,117,1,7,0,3
E33006448,385,314,86,228,1,24,2,22,45,42,0,2,1,1
E33006449,453,312,62,250,1,63,13,50,76,72,0,3,1,1
E33006450,484,340,81,259,4,85,18,67,54,49,0,4,1,1
E33006451,261,177,53,124,1,39,12,27,42,39,0,3,0,2
E33006452,289,189,53,136,0,33,6,27,61,57,0,3,1,6
E33006453,1239,811,179,632,6,132,42,90,285,265,1,18,1,5
E33006454,488,338,92,246,1,81,26,55,65,58,2,5,0,3
E33006455,908,660,151,509,1,108,31,77,138,130,0,6,2,1
E33006456,2016,1290,312,978,15,322,79,243,383,364,0,15,4,6
E33006457,2201,1681,426,1255,8,254,75,179,246,223,0,19,4,12
E33006458,2055,1253,270,983,9,269,69,200,514,487,4,15,8,10
E33006459,2116,1394,349,1045,8,315,72,243,390,364,2,24,0,9
E33006460,838,527,164,363,4,196,46,150,107,101,4,1,1,4
E33006461,323,212,40,172,0,39,15,24,70,67,2,1,0,2
E33006462,818,480,120,360,4,241,47,194,89,84,0,5,0,4
E33006463,783,630,207,423,3,69,26,43,73,65,4,2,2,8
E33006464,369,259,84,175,2,31,15,16,74,52,9,3,10,3
E33006465,355,290,127,163,0,22,8,14,39,34,1,3,1,4
E33006466,595,506,155,351,2,34,10,24,50,41,3,5,1,3
E33006467,226,197,77,120,1,10,3,7,16,12,1,0,3,2
E33006468,295,243,69,174,0,14,4,10,34,30,0,3,1,4
E33006469,470,395,139,256,0,29,16,13,43,39,0,2,2,3
E33006470,284,238,81,157,1,21,5,16,21,17,0,4,0,3
E33006471,260,209,60,149,0,29,15,14,19,18,0,1,0,3
E33006472,385,330,99,231,0,23,13,10,29,28,0,1,0,3
E33006473,472,420,132,288,0,21,17,4,30,23,1,5,1,1
E33006474,319,230,62,168,1,61,25,36,24,21,1,1,1,3
E33006475,623,521,142,379,0,53,19,34,48,43,0,3,2,1
E33006476,453,347,102,245,1,54,18,36,46,43,0,3,0,5
E33006477,405,307,87,220,3,56,20,36,38,37,0,1,0,1
E33006478,367,232,58,174,1,85,33,52,45,43,0,2,0,4
E33006479,452,381,113,268,1,34,13,21,34,29,0,4,1,2
E33006480,371,275,73,202,2,51,26,25,40,36,0,4,0,3
E33006481,346,253,61,192,1,47,19,28,41,35,0,5,1,4
E33006482,328,231,67,164,0,47,17,30,48,47,0,0,1,2
E33006483,240,199,74,125,2,12,3,9,25,23,0,1,1,2
E33006484,445,352,102,250,1,55,16,39,33,26,3,4,0,4
E33006485,296,240,78,162,2,25,7,18,29,25,0,4,0,0
E33006486,446,394,115,279,1,17,6,11,34,32,0,2,0,0
E33006487,343,305,99,206,1,15,6,9,20,18,0,2,0,2
E33006488,262,205,56,149,2,33,8,25,19,12,0,7,0,3
E33006489,482,356,117,239,0,71,22,49,51,46,0,5,0,4
E33006490,467,396,129,267,1,33,12,21,37,32,0,2,3,0
E33006491,270,234,83,151,1,15,7,8,19,15,0,3,1,1
E33006492,571,410,142,268,2,96,41,55,58,55,0,3,0,5
E33006493,321,276,79,197,0,27,8,19,18,18,0,0,0,0
E33006494,435,350,78,272,1,47,16,31,37,32,0,3,2,0
E33006495,357,259,47,212,5,49,15,34,39,38,0,1,0,5
E33006496,271,181,51,130,2,56,19,37,27,23,0,4,0,5
E33006497,285,207,49,158,3,43,14,29,31,28,0,1,2,1
E33006498,390,294,87,207,3,44,13,31,41,35,2,4,0,8
E33006499,337,288,79,209,0,24,5,19,23,22,0,1,0,2
E33006500,367,274,87,187,6,48,16,32,34,34,0,0,0,5
E33006501,304,225,63,162,5,37,11,26,35,33,0,2,0,2
E33006502,299,240,66,174,0,18,2,16,39,31,1,6,1,2
E33006503,237,152,50,102,4,48,7,41,32,27,1,3,1,1
E33006504,712,506,160,346,1,119,44,75,81,72,3,4,2,5
E33006505,442,319,82,237,0,63,22,41,60,59,0,1,0,0
E33006506,811,517,136,381,6,177,63,114,106,93,2,11,0,5
E33006507,308,239,66,173,1,24,10,14,40,37,0,3,0,4
E33006508,292,218,46,172,2,25,6,19,44,39,0,5,0,3
E33006509,1148,895,272,623,4,149,44,105,97,85,1,10,1,3
E33006510,893,753,220,533,2,63,18,45,72,68,0,4,0,3
E33006511,685,544,141,403,5,63,21,42,71,64,0,6,1,2
E33006512,409,335,90,245,1,39,21,18,33,30,0,3,0,1
E33006513,361,231,69,162,4,69,21,48,47,43,0,4,0,10
E33006514,419,329,119,210,0,48,15,33,39,38,0,1,0,3
E33006515,676,567,177,390,2,53,13,40,54,50,0,4,0,0
E33006516,385,288,93,195,3,52,28,24,38,35,1,2,0,4
E33006517,227,177,55,122,0,33,12,21,16,15,0,0,1,1
E33006518,350,264,82,182,2,51,15,36,31,29,0,2,0,2
E33006519,418,307,79,228,4,73,23,50,30,26,0,3,1,4
E33006520,274,211,55,156,1,20,5,15,39,38,0,1,0,3
E33006521,310,233,59,174,2,46,13,33,29,26,0,3,0,0
E33006522,266,188,40,148,1,52,12,40,23,22,0,1,0,2
E33006523,231,169,53,116,0,40,17,23,20,20,0,0,0,2
E33006524,286,219,61,158,1,27,9,18,39,32,0,7,0,0
E33006525,269,217,58,159,0,31,13,18,19,16,0,2,1,2
E33006526,553,426,125,301,3,57,20,37,62,55,0,7,0,5
E33006527,1102,924,246,678,4,83,14,69,88,80,0,7,1,3
E33006528,309,241,85,156,3,22,5,17,43,40,0,3,0,0
E33006529,318,216,60,156,4,47,15,32,45,39,1,2,3,6
E33006530,612,467,121,346,0,70,28,42,74,60,0,14,0,1
E33006531,458,285,72,213,0,113,37,76,57,51,0,5,1,3
E33006532,604,496,149,347,0,38,14,24,64,60,2,2,0,6
E33006533,647,510,138,372,3,76,26,50,52,49,0,3,0,6
E33006534,290,254,56,198,0,6,3,3,26,24,0,2,0,4
E33006535,348,229,56,173,0,65,22,43,47,41,0,2,4,7
E33006536,516,382,102,280,2,68,25,43,61,50,0,3,8,3
E33006537,551,444,104,340,2,70,22,48,35,32,0,3,0,0
E33006538,754,572,158,414,3,96,28,68,81,68,1,12,0,2
E33006539,435,345,76,269,1,32,11,21,55,51,1,3,0,2
E33006540,431,316,99,217,0,78,20,58,33,27,1,5,0,4
E33006541,402,314,106,208,0,42,13,29,42,38,0,2,2,4
E33006542,454,328,108,220,0,60,17,43,60,49,0,9,2,6
E33006543,371,261,88,173,1,50,12,38,57,51,0,6,0,2
E33006544,333,269,66,203,1,22,7,15,38,36,0,2,0,3
E33006545,294,240,80,160,1,28,12,16,25,24,0,1,0,0
E33006546,398,319,91,228,2,30,13,17,42,39,0,3,0,5
E33006547,565,435,109,326,2,65,25,40,61,55,0,4,2,2
E33006548,605,469,146,323,2,66,19,47,61,60,0,1,0,7
E33006549,298,220,55,165,1,41,10,31,35,29,0,6,0,1
E33006550,332,271,45,226,1,23,6,17,36,31,1,4,0,1
E33006551,442,319,94,225,3,85,25,60,32,26,3,3,0,3
E33006552,428,361,119,242,1,20,5,15,45,39,0,6,0,1
E33006553,470,405,119,286,2,29,8,21,30,26,0,4,0,4
E33006554,320,283,98,185,0,19,7,12,18,16,0,2,0,0
E33006555,300,230,59,171,2,32,12,20,33,30,0,3,0,3
E33006556,524,458,140,318,0,19,4,15,46,43,0,3,0,1
E33006557,281,238,98,140,1,8,2,6,34,31,0,3,0,0
E33006558,556,415,131,284,3,24,10,14,113,108,0,5,0,1
E33006559,366,320,109,211,1,5,1,4,39,37,0,2,0,1
E33006560,282,225,74,151,2,12,0,12,41,34,0,7,0,2
E33006561,376,316,98,218,1,19,3,16,39,32,0,7,0,1
E33006562,599,525,177,348,0,13,5,8,58,56,0,2,0,3
E33006563,362,285,86,199,0,14,5,9,55,49,2,3,1,8
E33006564,433,295,99,196,6,35,10,25,94,86,0,8,0,3
E33006565,234,180,49,131,1,11,2,9,39,38,0,1,0,3
E33006566,237,179,56,123,0,9,3,6,49,48,0,1,0,0
E33006567,315,259,95,164,0,14,1,13,37,33,0,4,0,5
E33006568,376,246,75,171,2,27,6,21,96,87,1,2,6,5
E33006569,330,238,65,173,2,23,6,17,64,61,1,1,1,3
E33006570,209,114,38,76,4,13,3,10,77,75,0,1,1,1
E33006571,267,220,68,152,1,6,1,5,39,33,0,6,0,1
E33006572,350,241,65,176,4,19,6,13,84,77,1,4,2,2
E33006573,521,393,104,289,6,25,4,21,91,85,0,4,2,6
E33006574,596,413,141,272,4,38,14,24,134,120,1,11,2,7
E33006575,598,360,100,260,3,35,7,28,196,181,0,14,1,4
E33006576,434,328,93,235,1,14,6,8,88,80,3,3,2,3
E33006577,311,215,71,144,0,19,5,14,74,73,0,1,0,3
E33006578,502,328,100,228,2,26,6,20,143,140,0,3,0,3
E33006579,337,278,97,181,0,4,1,3,53,49,0,2,2,2
E33006580,437,327,98,229,5,25,9,16,79,66,0,13,0,1
E33006581,508,395,102,293,1,37,5,32,72,62,1,9,0,3
E33006582,323,248,89,159,0,7,1,6,66,62,3,1,0,2
E33006583,290,218,66,152,1,17,5,12,49,43,1,5,0,5
E33006584,219,176,55,121,1,4,2,2,35,29,0,4,2,3
E33006585,328,248,71,177,0,19,6,13,59,52,0,7,0,2
E33006586,294,236,60,176,0,13,2,11,42,39,0,3,0,3
E33006587,265,193,59,134,3,19,4,15,48,46,1,1,0,2
E33006588,318,258,73,185,0,8,1,7,46,43,0,2,1,6
E33006589,365,288,95,193,1,12,1,11,59,55,0,3,1,5
E33006590,336,278,86,192,0,5,0,5,50,44,2,1,3,3
E33006591,359,257,95,162,2,30,5,25,67,61,0,6,0,3
E33006592,375,300,93,207,1,6,2,4,65,59,1,4,1,3
E33006593,237,180,56,124,0,7,2,5,46,42,0,4,0,4
E33006594,281,190,56,134,0,14,0,14,75,69,0,6,0,2
E33006595,293,235,80,155,0,10,5,5,45,41,0,4,0,3
E33006596,239,188,61,127,0,15,2,13,35,33,0,2,0,1
E33006597,533,433,143,290,2,31,4,27,66,58,0,7,1,1
E33006598,363,283,77,206,0,12,4,8,66,60,0,6,0,2
E33006599,720,545,155,390,7,34,12,22,126,116,0,10,0,8
E33006600,424,327,108,219,4,17,4,13,75,68,0,6,1,1
E33006601,362,293,78,215,0,20,8,12,49,43,0,6,0,0
E33006602,259,212,70,142,2,5,0,5,39,32,1,6,0,1
E33006603,426,311,115,196,1,10,3,7,103,88,1,11,3,1
E33006604,280,211,74,137,1,13,3,10,52,47,0,4,1,3
E33006605,904,773,265,508,1,26,6,20,101,96,0,5,0,3
E33006606,262,212,65,147,0,8,2,6,41,41,0,0,0,1
E33006607,501,381,133,248,3,17,4,13,96,87,3,6,0,4
E33006608,306,258,97,161,1,14,4,10,33,33,0,0,0,0
E33006609,341,288,62,226,1,19,9,10,32,30,1,1,0,1
E33006610,234,183,58,125,1,15,7,8,32,28,0,4,0,3
E33006611,283,246,97,149,1,10,5,5,23,19,0,3,1,3
E33006612,377,334,88,246,1,4,0,4,38,30,1,6,1,0
E33006613,395,332,89,243,1,5,0,5,56,53,1,2,0,1
E33006614,485,383,111,272,1,21,9,12,76,62,3,10,1,4
E33006615,277,235,57,178,0,11,4,7,26,23,0,2,1,5
E33006616,303,244,62,182,0,25,8,17,33,29,1,1,2,1
E33006617,352,303,90,213,0,21,6,15,28,24,0,4,0,0
E33006618,402,360,143,217,0,5,3,2,33,27,0,3,3,4
E33006619,612,480,146,334,1,62,16,46,65,50,10,2,3,4
E33006620,262,244,99,145,1,3,1,2,10,9,0,1,0,4
E33006621,283,237,92,145,4,12,7,5,28,25,1,2,0,2
E33006622,274,223,80,143,0,10,5,5,35,29,0,1,5,6
E33006623,401,341,112,229,0,13,5,8,43,39,0,4,0,4
E33006624,419,358,125,233,1,17,9,8,37,34,0,3,0,6
E33006625,298,241,77,164,1,14,3,11,35,33,0,2,0,7
E33006626,511,428,140,288,3,18,9,9,59,55,0,3,1,3
E33006627,275,219,73,146,1,9,2,7,39,36,0,3,0,7
E33006628,382,321,112,209,0,12,4,8,44,42,1,1,0,5
E33006629,310,262,89,173,0,12,4,8,33,31,0,2,0,3
E33006630,253,230,81,149,0,8,3,5,15,14,0,1,0,0
E33006631,585,526,172,354,3,12,4,8,39,33,0,6,0,5
E33006632,270,245,75,170,1,8,1,7,15,14,0,1,0,1
E33006633,325,270,82,188,0,12,5,7,36,27,0,5,4,7
E33006634,342,257,79,178,1,21,8,13,61,48,7,4,2,2
E33006635,330,299,82,217,0,9,2,7,21,18,1,1,1,1
E33006636,405,354,105,249,0,15,3,12,34,30,0,4,0,2
E33006637,336,289,89,200,0,21,7,14,23,20,0,2,1,3
E33006638,323,255,91,164,4,19,10,9,42,39,1,2,0,3
E33006639,344,323,109,214,1,8,4,4,12,10,0,2,0,0
E33006640,651,571,153,418,0,32,15,17,45,39,0,5,1,3
E33006641,358,304,80,224,0,16,2,14,36,31,0,5,0,2
E33006642,347,284,94,190,0,23,9,14,35,29,0,6,0,5
E33006643,415,362,105,257,2,18,10,8,31,27,0,4,0,2
E33006644,410,359,110,249,2,17,8,9,27,25,0,2,0,5
E33006645,372,320,73,247,0,21,7,14,28,26,2,0,0,3
E33006646,554,456,130,326,3,40,9,31,54,45,0,9,0,1
E33006647,560,463,130,333,1,40,16,24,56,49,0,7,0,0
E33006648,507,406,107,299,1,36,15,21,60,55,2,3,0,4
E33006649,511,389,112,277,2,51,22,29,65,59,1,5,0,4
E33006650,305,235,65,170,0,31,12,19,36,35,0,1,0,3
E33006651,572,454,115,339,4,54,22,32,58,47,0,9,2,2
E33006652,284,255,90,165,1,7,4,3,20,17,0,3,0,1
E33006653,315,224,64,160,1,30,13,17,58,57,0,1,0,2
E33006654,692,524,140,384,3,97,41,56,64,59,0,5,0,4
E33006655,261,203,63,140,1,21,6,15,36,34,0,2,0,0
E33006656,247,225,65,160,0,9,4,5,13,11,0,1,1,0
E33006657,334,257,69,188,2,21,6,15,52,50,0,2,0,2
E33006658,314,234,71,163,0,39,12,27,40,38,2,0,0,1
E33006659,251,221,78,143,1,7,2,5,21,18,0,3,0,1
E33006660,437,370,116,254,0,11,1,10,55,51,1,3,0,1
E33006661,231,184,57,127,1,15,3,12,30,27,0,3,0,1
E33006662,234,188,63,125,0,13,6,7,29,25,0,3,1,4
E33006663,323,262,63,199,3,31,15,16,25,21,0,4,0,2
E33006664,251,186,41,145,0,36,17,19,29,26,0,2,1,0
E33006665,337,219,59,160,3,80,33,47,34,31,0,3,0,1
E33006666,234,163,42,121,2,47,22,25,21,20,0,1,0,1
E33006667,632,435,100,335,1,142,57,85,49,44,1,3,1,5
E33006668,355,244,66,178,4,37,10,27,69,67,0,2,0,1
E33006669,358,279,83,196,1,40,22,18,37,33,0,2,2,1
E33006670,348,313,89,224,0,10,4,6,22,21,0,1,0,3
E33006671,467,413,127,286,0,20,6,14,32,29,0,3,0,2
E33006672,339,273,100,173,2,37,4,33,26,24,0,2,0,1
E33006673,555,449,109,340,1,44,15,29,59,49,1,6,3,2
E33006674,434,374,88,286,0,16,8,8,40,37,1,2,0,4
E33006675,441,371,105,266,2,35,17,18,32,28,1,3,0,1
E33006676,288,240,57,183,0,17,5,12,30,24,3,3,0,1
E33006677,329,295,98,197,1,14,2,12,18,14,1,3,0,1
E33006678,601,457,129,328,1,72,23,49,70,64,0,6,0,1
E33006679,327,258,50,208,2,25,4,21,39,34,2,3,0,3
E33006680,394,284,77,207,2,32,6,26,71,65,1,4,1,5
E33006681,253,226,66,160,0,5,2,3,20,16,1,3,0,2
E33006682,363,261,70,191,3,22,9,13,70,63,0,6,1,7
E33006683,240,193,47,146,0,27,7,20,20,20,0,0,0,0
E33006684,479,318,75,243,5,100,45,55,53,49,0,3,1,3
E33006685,823,577,133,444,6,148,68,80,87,79,0,8,0,5
E33006686,294,206,67,139,0,19,5,14,67,60,0,5,2,2
E33006687,426,305,96,209,0,46,14,32,70,68,0,1,1,5
E33006688,365,316,90,226,0,23,10,13,25,23,0,2,0,1
E33006689,345,269,61,208,3,20,6,14,49,45,0,4,0,4
E33006690,287,202,46,156,2,23,4,19,52,48,0,4,0,8
E33006691,362,299,73,226,0,23,13,10,38,36,0,2,0,2
E33006692,344,239,56,183,2,59,24,35,41,38,0,3,0,3
E33006693,607,459,106,353,2,73,26,47,72,65,0,7,0,1
E33006694,675,467,120,347,3,104,20,84,99,85,2,10,2,2
E33006695,405,288,87,201,0,69,29,40,47,40,1,6,0,1
E33006696,456,322,79,243,1,49,18,31,80,72,1,6,1,4
E33006697,951,699,179,520,4,131,33,98,112,106,0,6,0,5
E33006698,410,314,92,222,3,48,17,31,39,33,0,2,4,6
E33006699,446,316,82,234,4,59,17,42,64,59,0,4,1,3
E33006700,299,244,65,179,0,25,7,18,28,24,0,4,0,2
E33006701,2094,1738,409,1329,10,155,43,112,181,163,4,14,0,10
E33006702,409,259,70,189,4,78,13,65,65,60,0,5,0,3
E33006703,253,173,56,117,1,55,15,40,22,20,0,2,0,2
E33006704,292,202,62,140,2,52,14,38,32,30,0,2,0,4
E33006705,453,323,81,242,4,73,16,57,53,49,2,2,0,0
E33006706,231,165,41,124,1,30,4,26,35,30,0,4,1,0
E33006707,289,213,64,149,3,41,18,23,30,25,0,4,1,2
E33006708,323,246,66,180,1,45,20,25,29,24,0,5,0,2
E33006709,321,246,66,180,2,52,20,32,19,16,0,3,0,2
E33006710,724,502,137,365,0,153,53,100,65,60,0,5,0,4
E33006711,329,239,63,176,2,40,8,32,45,43,0,2,0,3
E33006712,246,158,49,109,0,39,9,30,47,46,0,1,0,2
E33006713,257,171,32,139,4,44,5,39,36,34,0,1,1,2
E33006714,235,147,39,108,2,52,14,38,33,31,0,2,0,1
E33006715,239,142,33,109,3,45,7,38,46,43,0,3,0,3
E33006716,647,421,94,327,2,124,24,100,97,92,2,3,0,3
E33006717,309,211,50,161,3,49,17,32,46,41,0,5,0,0
E33006718,790,599,197,402,0,102,24,78,85,77,0,6,2,4
E33006719,735,508,142,366,3,110,28,82,110,102,0,7,1,4
E33006720,309,220,64,156,0,58,24,34,30,25,1,3,1,1
E33006721,234,170,39,131,4,28,12,16,32,29,2,1,0,0
E33006722,462,340,93,247,2,61,13,48,58,51,1,6,0,1
E33006723,414,326,73,253,0,49,15,34,37,32,1,4,0,2
E33006724,1764,1449,417,1032,8,126,32,94,177,168,1,7,1,4
E33006725,733,534,141,393,2,97,30,67,96,89,0,7,0,4
E33006726,327,222,77,145,1,42,10,32,59,50,0,6,3,3
E33006727,515,376,92,284,3,68,22,46,56,48,0,7,1,12
E33006728,285,209,58,151,1,38,21,17,36,33,0,2,1,1
E33006729,381,260,74,186,1,23,8,15,96,89,4,3,0,1
E33006730,406,249,75,174,4,24,7,17,122,107,1,10,4,7
E33006731,539,432,113,319,0,13,0,13,93,82,0,9,2,1
E33006732,305,228,64,164,1,13,3,10,61,48,3,8,2,2
E33006733,336,254,79,175,0,10,6,4,69,64,0,5,0,3
E33006734,308,226,72,154,2,13,2,11,62,53,0,6,3,5
E33006735,534,390,93,297,1,41,15,26,98,90,1,7,0,4
E33006736,913,751,208,543,3,34,14,20,120,108,1,8,3,5
E33006737,375,298,91,207,0,12,8,4,61,49,4,5,3,4
E33006738,265,213,73,140,0,14,3,11,36,32,0,2,2,2
E33006739,396,300,88,212,1,18,5,13,74,65,0,9,0,3
E33006740,336,258,78,180,0,7,3,4,70,64,1,5,0,1
E33006741,279,231,60,171,0,9,3,6,34,28,1,5,0,5
E33006742,309,260,70,190,1,5,1,4,41,34,1,6,0,2
E33006743,553,401,127,274,1,47,18,29,102,95,1,6,0,2
E33006744,402,307,92,215,2,14,4,10,75,66,0,7,2,4
E33006745,343,226,71,155,0,24,8,16,86,76,1,9,0,7
E33006746,358,286,66,220,0,11,3,8,61,57,0,3,1,0
E33006747,418,288,69,219,0,39,11,28,90,82,0,8,0,1
E33006748,308,225,65,160,1,16,7,9,64,62,0,2,0,2
E33006749,337,257,68,189,1,19,6,13,52,44,0,8,0,8
E33006750,478,362,87,275,1,60,19,41,51,48,1,1,1,4
E33006751,390,341,110,231,2,11,7,4,33,28,1,3,1,3
E33006752,336,256,57,199,2,47,7,40,25,21,0,2,2,6
E33006753,382,299,93,206,1,19,6,13,61,58,0,3,0,2
E33006754,490,388,101,287,0,29,13,16,72,64,0,8,0,1
E33006755,351,303,91,212,1,12,5,7,33,32,0,1,0,2
E33006756,389,304,77,227,1,20,6,14,62,56,0,5,1,2
E33006757,269,210,67,143,1,15,10,5,43,38,0,5,0,0
E33006758,387,281,89,192,5,40,9,31,58,55,0,0,3,3
E33006759,382,287,70,217,1,21,9,12,70,68,1,1,0,3
E33006760,403,260,75,185,0,46,16,30,96,88,0,8,0,1
E33006761,426,276,76,200,0,65,18,47,84,74,0,8,2,1
E33006762,687,503,142,361,1,89,31,58,91,80,0,11,0,3
E33006763,1037,788,223,565,1,147,58,89,97,93,0,3,1,4
E33006764,250,201,51,150,1,25,11,14,20,15,1,3,1,3
E33006765,288,193,62,131,1,49,22,27,45,43,0,2,0,0
E33006766,745,517,171,346,7,112,50,62,106,100,0,6,0,3
E33006767,452,343,86,257,1,36,11,25,71,63,0,8,0,1
E33006768,436,320,83,237,1,44,18,26,70,65,0,5,0,1
E33006769,240,174,52,122,1,20,8,12,44,42,0,2,0,1
E33006770,289,196,62,134,3,43,17,26,46,43,0,3,0,1
E33006771,318,256,66,190,1,12,4,8,48,45,0,3,0,1
E33006772,345,212,49,163,1,100,51,49,31,29,1,0,1,1
E33006773,336,234,58,176,2,61,33,28,39,35,0,4,0,0
E33006774,254,117,37,80,2,81,45,36,50,48,0,1,1,4
E33006775,442,351,78,273,0,37,18,19,48,43,0,5,0,6
E33006776,336,272,90,182,1,22,10,12,36,31,0,5,0,5
E33006777,655,521,130,391,3,45,20,25,85,74,1,9,1,1
E33006778,248,185,62,123,0,21,10,11,41,32,2,7,0,1
E33006779,331,233,52,181,1,39,29,10,55,50,0,4,1,3
E33006780,359,301,104,197,0,12,9,3,46,40,0,6,0,0
E33006781,390,345,92,253,0,12,7,5,31,29,0,2,0,2
E33006782,542,443,117,326,1,30,10,20,63,51,0,10,2,5
E33006783,422,376,107,269,0,3,1,2,39,33,0,6,0,4
E33006784,647,475,133,342,2,49,15,34,118,103,1,14,0,3
E33006785,608,423,123,300,0,43,10,33,134,113,10,7,4,8
E33006786,262,210,69,141,0,6,2,4,39,36,0,2,1,7
E33006787,234,171,46,125,2,18,4,14,43,36,0,4,3,0
E33006788,214,151,45,106,0,9,4,5,49,40,5,4,0,5
E33006789,347,278,70,208,2,31,14,17,36,29,1,6,0,0
E33006790,658,518,167,351,1,41,15,26,92,86,0,5,1,6
E33006791,280,218,58,160,0,17,10,7,38,35,1,2,0,7
E33006792,442,327,101,226,3,47,25,22,59,53,0,5,1,6
E33006793,258,197,62,135,1,24,15,9,35,32,0,2,1,1
E33006794,259,214,57,157,0,15,7,8,28,25,0,2,1,2
E33006795,250,177,37,140,1,23,3,20,47,41,0,5,1,2
E33006796,439,311,75,236,2,60,24,36,64,57,0,7,0,2
E33006797,291,200,47,153,3,42,13,29,44,41,0,2,1,2
E33006798,340,228,65,163,1,50,13,37,60,57,0,3,0,1
E33006799,239,145,47,98,2,54,16,38,38,37,0,1,0,0
E33006800,317,220,63,157,2,41,17,24,53,51,0,1,1,1
E33006801,836,527,114,413,3,117,46,71,187,174,0,12,1,2
E33006802,428,331,97,234,3,25,9,16,65,56,0,7,2,4
E33006803,392,346,93,253,2,11,7,4,30,28,0,2,0,3
E33006804,355,298,77,221,1,20,8,12,35,31,0,3,1,1
E33006805,686,561,146,415,3,61,30,31,53,46,1,6,0,8
E33006806,343,251,78,173,2,32,14,18,56,52,2,2,0,2
E33006807,300,240,73,167,4,17,5,12,38,34,1,3,0,1
E33006808,662,444,96,348,2,115,51,64,92,85,0,7,0,9
E33006809,418,272,82,190,0,55,28,27,88,84,0,3,1,3
E33006810,659,507,178,329,4,48,15,33,91,80,2,7,2,9
E33006811,353,280,89,191,0,11,2,9,54,50,0,3,1,8
E33006812,317,178,38,140,3,25,4,21,108,95,3,10,0,3
E33006813,281,171,65,106,3,33,19,14,70,66,0,4,0,4
E33006814,248,186,68,118,3,16,3,13,42,39,0,3,0,1
E33006815,286,208,60,148,1,33,6,27,42,37,0,4,1,2
E33006816,363,241,66,175,5,30,7,23,85,79,0,3,3,2
E33006817,334,239,52,187,3,42,12,30,48,43,1,4,0,2
E33006818,730,561,167,394,5,61,14,47,98,93,0,5,0,5
E33006819,293,205,50,155,1,23,8,15,59,56,1,2,0,5
E33006820,328,238,49,189,1,29,5,24,54,49,0,5,0,6
E33006821,306,218,60,158,4,15,8,7,68,63,1,4,0,1
E33006822,249,202,59,143,0,10,1,9,33,30,0,3,0,4
E33006823,302,217,68,149,1,27,16,11,55,52,0,3,0,2
E33006824,277,190,54,136,0,42,7,35,45,43,0,2,0,0
E33006825,257,240,71,169,0,7,3,4,9,9,0,0,0,1
E33006826,356,288,102,186,1,6,0,6,57,51,1,5,0,4
E33006827,366,303,80,223,1,17,9,8,41,37,2,2,0,4
E33006828,460,389,117,272,1,24,9,15,38,35,0,3,0,8
E33006829,348,307,90,217,1,11,4,7,28,28,0,0,0,1
E33006830,247,190,58,132,0,14,6,8,39,36,0,3,0,4
E33006831,1166,936,218,718,9,73,36,37,142,129,1,12,0,6
E33006832,253,180,57,123,2,24,11,13,47,41,0,6,0,0
E33006833,409,353,75,278,0,14,11,3,40,37,0,2,1,2
E33006834,243,171,40,131,0,25,14,11,43,40,0,3,0,4
E33006835,342,238,68,170,5,53,30,23,42,39,0,1,2,4
E33006836,431,267,64,203,3,96,43,53,63,61,0,2,0,2
E33006837,503,391,108,283,3,47,25,22,58,52,2,4,0,4
E33006838,273,203,61,142,2,30,10,20,34,30,0,4,0,4
E33006839,268,198,67,131,0,10,4,6,58,46,0,10,2,2
E33006840,445,377,118,259,1,21,12,9,43,39,2,2,0,3
E33006841,245,189,58,131,0,9,2,7,45,35,1,9,0,2
E33006842,281,227,67,160,0,18,8,10,34,30,2,2,0,2
E33006843,637,445,130,315,4,56,26,30,127,117,1,6,3,5
E33006844,337,204,54,150,2,66,25,41,62,58,0,2,2,3
E33006845,286,161,28,133,1,50,26,24,70,65,0,5,0,4
E33006846,415,296,58,238,0,48,22,26,61,56,1,4,0,10
E33006847,538,355,102,253,4,76,25,51,103,96,0,6,1,0
E33006848,267,225,86,139,0,10,3,7,29,28,1,0,0,3
E33006849,280,248,92,156,0,9,9,0,23,19,0,4,0,0
E33006850,357,310,102,208,1,8,1,7,36,34,0,2,0,2
E33006851,636,557,164,393,2,11,3,8,60,50,1,9,0,6
E33006852,548,400,105,295,6,58,20,38,81,76,0,5,0,3
E33006853,402,315,86,229,0,31,9,22,54,49,0,4,1,2
E33006854,399,322,82,240,0,32,15,17,40,36,0,4,0,5
E33006855,294,224,61,163,0,17,9,8,49,47,1,1,0,4
E33006856,314,270,90,180,1,14,6,8,27,24,0,3,0,2
E33006857,407,340,96,244,1,31,15,16,34,27,0,7,0,1
E33006858,314,196,56,140,2,77,34,43,34,30,0,4,0,5
E33006859,326,252,75,177,3,31,12,19,40,37,3,0,0,0
E33006860,502,346,100,246,4,75,26,49,73,65,0,8,0,4
E33006861,227,149,39,110,3,25,4,21,49,43,2,4,0,1
E33006862,440,282,87,195,3,70,30,40,81,68,0,8,5,4
E33006863,270,236,83,153,0,9,4,5,22,21,0,1,0,3
E33006864,344,254,72,182,0,18,10,8,66,62,0,4,0,6
E33006865,292,210,48,162,1,39,23,16,36,32,1,3,0,6
E33006866,453,375,92,283,0,27,9,18,47,44,0,3,0,4
E33006867,549,431,137,294,2,37,16,21,74,64,0,6,4,5
E33006868,244,208,72,136,0,11,3,8,17,15,0,1,1,8
E33006869,379,343,103,240,0,8,2,6,25,23,0,1,1,3
E33006870,314,269,93,176,1,26,15,11,15,12,0,3,0,3
E33006871,596,513,160,353,5,18,10,8,58,53,0,3,2,2
E33006872,580,494,143,351,2,26,10,16,54,52,0,1,1,4
E33006873,310,219,52,167,0,45,16,29,43,42,0,1,0,3
E33006874,406,348,100,248,2,20,5,15,31,26,0,4,1,5
E33006875,488,397,121,276,1,24,7,17,59,54,1,4,0,7
E33006876,283,237,78,159,0,10,4,6,34,30,0,3,1,2
E33006877,383,280,90,190,1,33,5,28,64,57,0,5,2,5
E33006878,1058,882,210,672,3,58,27,31,110,97,1,11,1,5
E33006879,556,424,118,306,1,46,16,30,78,65,0,12,1,7
E33006880,575,456,147,309,3,46,20,26,61,57,0,4,0,9
E33006881,1215,967,261,706,2,53,25,28,184,178,2,4,0,9
E33006882,639,531,179,352,0,30,8,22,74,67,0,7,0,4
E33006883,652,518,151,367,3,23,13,10,106,85,3,15,3,2
E33006884,644,496,121,375,3,32,15,17,107,101,0,4,2,6
E33006885,469,366,106,260,0,28,11,17,73,71,0,2,0,2
E33006886,256,219,94,125,0,16,9,7,21,18,1,1,1,0
E33006887,413,348,118,230,0,21,12,9,43,42,0,1,0,1
E33006888,234,207,71,136,0,3,1,2,23,22,0,1,0,1
E33006889,291,252,80,172,0,7,1,6,32,29,0,3,0,0
E33006890,651,521,166,355,2,29,13,16,87,76,1,5,5,12
E33006891,561,420,126,294,3,35,23,12,93,85,5,3,0,10
E33006892,429,338,86,252,1,45,18,27,45,45,0,0,0,0
E33006893,371,304,95,209,0,22,10,12,42,41,1,0,0,3
E33006894,245,174,49,125,1,42,14,28,28,26,0,2,0,0
E33006895,279,228,58,170,0,25,7,18,25,22,1,2,0,1
E33006896,271,241,105,136,0,2,2,0,24,23,0,1,0,4
E33006897,447,393,142,251,1,11,4,7,41,35,1,5,0,1
E33006898,344,269,72,197,2,21,15,6,51,43,4,3,1,1
E33006899,565,498,199,299,1,11,7,4,48,47,0,1,0,7
E33006900,278,247,79,168,0,7,3,4,22,20,0,2,0,2
E33006901,503,430,136,294,1,17,12,5,55,53,0,2,0,0
E33006902,349,275,64,211,0,22,8,14,50,46,0,4,0,2
E33006903,385,308,66,242,0,32,22,10,43,38,0,5,0,2
E33006904,280,221,44,177,1,8,4,4,45,40,1,3,1,5
E33006905,703,592,180,412,3,45,18,27,63,59,0,3,1,0
E33006906,297,252,70,182,0,17,10,7,26,23,0,1,2,2
E33006907,376,295,91,204,1,29,12,17,47,43,2,2,0,4
E33006908,258,239,75,164,0,8,1,7,9,9,0,0,0,2
E33006909,373,314,87,227,2,20,5,15,35,31,0,2,2,2
E33006910,539,444,105,339,2,50,12,38,41,38,0,3,0,2
E33006911,620,555,115,440,0,20,4,16,41,36,1,4,0,4
E33006912,323,302,68,234,0,2,1,1,18,18,0,0,0,1
E33006913,297,259,70,189,0,18,6,12,19,18,0,1,0,1
E33006914,273,199,60,139,0,36,10,26,36,34,1,1,0,2
E33006915,226,179,59,120,1,16,4,12,30,24,0,4,2,0
E33006916,239,196,54,142,1,25,8,17,17,15,0,2,0,0
E33006917,254,182,51,131,1,41,14,27,28,25,0,3,0,2
E33006918,1041,729,207,522,4,213,64,149,89,79,0,9,1,6
E33006919,392,249,64,185,2,107,28,79,28,25,0,2,1,6
E33006920,392,290,73,217,0,61,30,31,40,35,0,4,1,1
E33006921,263,200,62,138,0,36,7,29,23,21,0,1,1,4
E33006922,543,470,124,346,0,26,9,17,43,38,0,5,0,4
E33006923,396,300,70,230,1,57,13,44,36,31,1,0,4,2
E33006924,257,209,64,145,1,13,4,9,33,29,0,4,0,1
E33006925,259,220,51,169,0,24,11,13,14,14,0,0,0,1
E33006926,506,385,93,292,1,74,24,50,45,41,1,3,0,1
E33006927,283,189,52,137,1,56,20,36,37,32,0,5,0,0
E33006928,568,359,85,274,2,122,29,93,82,75,0,5,2,3
E33006929,654,500,132,368,4,84,20,64,63,57,0,5,1,3
E33006930,232,187,65,122,1,15,6,9,25,19,0,6,0,4
E33006931,432,302,72,230,0,55,6,49,70,64,3,3,0,5
E33006932,783,581,161,420,4,108,32,76,85,70,3,11,1,5
E33006933,388,309,80,229,2,32,13,19,44,39,0,5,0,1
E33006934,248,192,58,134,1,23,6,17,31,26,0,5,0,1
E33006935,262,188,51,137,0,36,8,28,38,35,0,2,1,0
E33006936,422,315,83,232,3,65,24,41,38,36,0,2,0,1
E33006937,405,322,95,227,2,56,24,32,24,22,0,2,0,1
E33006938,739,572,174,398,3,105,28,77,58,54,0,3,1,1
E33006939,664,527,132,395,2,58,21,37,70,68,0,2,0,7
E33006940,944,705,200,505,3,148,40,108,82,75,0,7,0,6
E33006941,269,212,61,151,4,21,7,14,29,28,0,1,0,3
E33006942,794,625,158,467,5,85,30,55,72,68,1,1,2,7
E33006943,1158,839,192,647,9,148,31,117,157,148,0,6,3,5
E33006944,591,514,82,432,0,20,4,16,55,49,0,5,1,2
E33006945,609,480,94,386,4,62,9,53,61,54,0,7,0,2
E33006946,771,611,99,512,3,61,18,43,93,85,1,6,1,3
E33006947,388,267,54,213,3,64,10,54,52,51,0,1,0,2
E33006948,297,243,49,194,5,31,3,28,16,14,0,1,1,2
E33006949,418,321,77,244,3,49,14,35,44,41,0,1,2,1
E33006950,725,584,118,466,4,24,7,17,111,104,0,7,0,2
E33006951,1171,994,274,720,8,27,4,23,140,131,0,9,0,2
E33006952,270,155,46,109,2,95,12,83,16,12,0,2,2,2
E33006953,386,237,65,172,5,103,11,92,39,38,0,0,1,2
E33006954,272,189,52,137,2,61,9,52,19,18,0,1,0,1
E33006955,301,223,56,167,2,39,7,32,37,29,1,6,1,0
E33006956,610,458,116,342,4,95,20,75,52,45,1,4,2,1
E33006957,445,365,96,269,0,44,7,37,31,26,0,4,1,5
E33006958,373,293,90,203,2,47,7,40,29,25,0,4,0,2
E33006959,275,202,61,141,2,31,4,27,40,34,1,5,0,0
E33006960,391,301,81,220,1,44,8,36,44,39,0,1,4,1
E33006961,520,420,100,320,2,43,11,32,54,52,0,1,1,1
E33006962,433,291,67,224,3,67,9,58,70,66,1,2,1,2
E33006963,642,455,126,329,1,93,14,79,88,80,0,6,2,5
E33006964,328,262,61,201,1,28,5,23,35,34,0,1,0,2
E33006965,336,247,71,176,1,59,3,56,26,24,0,2,0,3
E33006966,534,361,80,281,3,116,15,101,47,43,1,3,0,7
E33006967,307,209,55,154,0,70,19,51,25,23,0,1,1,3
E33006968,460,331,95,236,5,83,7,76,38,35,0,1,2,3
E33006969,426,285,74,211,10,94,8,86,35,33,0,2,0,2
E33006970,290,209,57,152,0,62,7,55,19,16,0,3,0,0
E33006971,254,164,43,121,0,70,13,57,19,16,0,3,0,1
E33006972,1461,1089,328,761,10,205,27,178,152,142,0,9,1,5
E33006973,705,565,152,413,5,60,14,46,72,69,0,3,0,3
E33006974,407,331,89,242,5,44,8,36,26,21,0,5,0,1
E33006975,427,359,105,254,5,27,5,22,33,32,0,1,0,3
E33006976,276,218,49,169,0,25,2,23,31,28,0,3,0,2
E33006977,300,258,91,167,3,13,7,6,24,20,1,3,0,2
E33006978,411,365,101,264,0,16,11,5,30,27,1,2,0,0
E33006979,269,190,50,140,2,36,26,10,37,32,1,2,2,4
E33006980,455,351,132,219,0,42,36,6,61,55,0,6,0,1
E33006981,513,438,183,255,0,29,18,11,44,37,0,3,4,2
E33006982,304,239,81,158,3,23,12,11,36,34,0,2,0,3
E33006983,457,367,94,273,2,41,27,14,41,38,0,3,0,6
E33006984,241,205,60,145,2,15,9,6,18,17,0,0,1,1
E33006985,375,309,97,212,0,29,21,8,35,31,1,2,1,2
E33006986,555,457,127,330,2,48,29,19,43,35,0,3,5,5
E33006987,246,192,48,144,1,20,7,13,31,29,0,2,0,2
E33006988,355,270,56,214,1,38,15,23,45,41,0,4,0,1
E33006989,1264,1012,254,758,7,105,43,62,131,119,0,12,0,9
E33006990,484,362,96,266,0,63,31,32,55,52,0,3,0,4
E33006991,1319,1105,269,836,7,59,22,37,138,130,0,8,0,10
E33006992,1707,1381,336,1045,7,91,28,63,224,208,2,14,0,4
E33006993,1522,1185,280,905,5,99,27,72,223,195,0,28,0,10
E33006994,337,288,61,227,7,12,6,6,29,26,0,2,1,1
E33006995,314,210,49,161,3,70,11,59,26,22,0,4,0,5
E33006996,293,248,79,169,2,21,6,15,22,20,0,2,0,0
E33006997,758,521,122,399,4,157,108,49,67,54,1,11,1,9
E33006998,304,269,78,191,3,7,2,5,23,19,0,4,0,2
E33006999,424,340,96,244,1,45,16,29,36,28,0,7,1,2
E33007000,746,600,154,446,5,51,13,38,87,84,1,2,0,3
E33007001,351,203,48,155,1,115,45,70,31,28,0,2,1,1
E33007002,258,212,63,149,1,28,17,11,17,14,0,3,0,0
E33007003,330,236,63,173,8,68,36,32,18,15,0,3,0,0
E33007004,401,260,71,189,1,96,36,60,40,36,0,4,0,4
E33007005,306,277,50,227,1,8,1,7,20,20,0,0,0,0
E33007006,518,402,85,317,9,39,17,22,67,61,2,4,0,1
E33007007,581,467,67,400,4,34,19,15,76,74,0,2,0,0
E33007008,1636,1358,361,997,6,133,40,93,130,117,2,9,2,9
E33007009,349,306,42,264,4,19,5,14,20,20,0,0,0,0
E33007010,337,233,66,167,4,42,22,20,56,55,0,0,1,2
E33007011,363,325,65,260,2,12,2,10,23,21,0,1,1,1
E33007012,263,191,45,146,1,31,5,26,37,36,0,0,1,3
E33007013,322,284,69,215,0,13,3,10,22,21,1,0,0,3
E33007014,282,216,45,171,2,30,17,13,32,24,1,5,2,2
E33007015,344,244,63,181,2,44,16,28,51,49,0,2,0,3
E33007016,950,655,156,499,8,136,74,62,147,133,7,7,0,4
E33007017,276,191,51,140,1,32,16,16,47,40,0,7,0,5
E33007018,256,189,57,132,1,38,6,32,26,23,0,2,1,2
E33007019,862,691,161,530,3,88,53,35,76,64,2,9,1,4
E33007020,306,245,61,184,3,24,12,12,34,30,0,4,0,0
E33007021,222,182,48,134,0,15,7,8,25,20,0,5,0,0
E33007022,268,223,69,154,0,14,1,13,29,24,0,5,0,2
E33007023,300,241,67,174,1,23,7,16,33,30,0,3,0,2
E33007024,278,229,62,167,2,25,17,8,21,15,0,6,0,1
E33007025,806,449,103,346,4,146,67,79,206,197,0,7,2,1
E33007026,540,431,89,342,6,45,18,27,57,45,1,10,1,1
E33007027,246,187,43,144,2,32,20,12,24,22,0,2,0,1
E33007028,455,289,54,235,1,82,52,30,81,70,0,9,2,2
E33007029,3793,3054,724,2330,22,279,114,165,420,382,6,30,2,18
E33007030,538,444,102,342,1,39,17,22,53,50,0,1,2,1
E33007031,327,288,81,207,0,20,10,10,17,16,0,1,0,2
E33007032,456,371,124,247,1,40,14,26,42,39,0,3,0,2
E33007033,269,219,62,157,0,19,11,8,30,24,0,6,0,1
E33007034,259,192,52,140,1,22,9,13,32,28,0,1,3,12
E33007035,432,366,99,267,0,12,5,7,49,43,0,5,1,5
E33007036,343,283,87,196,0,26,9,17,30,28,1,0,1,4
E33007037,313,273,74,199,0,15,5,10,21,19,0,1,1,4
E33007038,331,284,59,225,4,11,3,8,30,28,0,2,0,2
E33007039,543,433,104,329,3,53,8,45,52,43,2,5,2,2
E33007040,472,379,97,282,2,36,13,23,54,42,0,8,4,1
E33007041,296,181,45,136,2,27,12,15,86,77,0,8,1,0
E33007042,325,230,69,161,2,43,19,24,48,42,1,5,0,2
E33007043,302,225,59,166,1,42,16,26,34,32,0,2,0,0
E33007044,265,199,62,137,0,17,8,9,49,41,0,8,0,0
E33007045,538,375,115,260,3,91,59,32,65,62,0,3,0,4
E33007046,305,223,56,167,2,35,20,15,43,39,0,4,0,2
E33007047,281,208,60,148,1,23,16,7,49,44,0,3,2,0
E33007048,599,405,87,318,8,89,49,40,93,88,0,5,0,4
E33007049,257,166,37,129,1,41,20,21,46,42,0,3,1,3
E33007050,378,296,79,217,3,28,15,13,48,45,0,1,2,3
E33007051,442,297,76,221,3,69,37,32,73,67,1,5,0,0
E33007052,318,240,78,162,1,38,21,17,38,33,0,3,2,1
E33007053,594,491,149,342,3,28,15,13,64,58,0,6,0,8
E33007054,252,183,44,139,3,30,17,13,32,29,0,3,0,4
E33007055,427,326,86,240,9,44,24,20,46,44,0,2,0,2
E33007056,295,257,74,183,2,11,3,8,22,20,0,0,2,3
E33007057,541,453,107,346,1,33,14,19,50,41,0,7,2,4
E33007058,382,329,97,232,1,19,11,8,31,31,0,0,0,2
E33007059,590,501,127,374,4,32,10,22,49,45,2,2,0,4
E33007060,899,729,208,521,4,72,26,46,92,90,0,1,1,2
E33007061,331,228,63,165,1,41,26,15,61,54,0,4,3,0
E33007062,345,265,60,205,0,47,21,26,32,31,0,0,1,1
E33007063,268,173,35,138,3,48,33,15,40,35,0,4,1,4
E33007064,257,205,46,159,0,24,8,16,27,24,0,3,0,1
E33007065,270,179,37,142,1,48,29,19,41,37,0,3,1,1
E33007066,534,357,93,264,2,74,43,31,96,93,1,2,0,5
E33007067,274,237,69,168,0,12,4,8,24,23,0,1,0,1
E33007068,229,167,41,126,2,21,12,9,33,29,2,2,0,6
E33007069,350,282,83,199,2,17,12,5,45,42,0,3,0,4
E33007070,414,319,109,210,1,39,21,18,54,52,0,1,1,1
E33007071,286,223,67,156,0,23,15,8,37,33,3,1,0,3
E33007072,678,569,169,400,3,46,23,23,59,56,1,2,0,1
E33007073,405,311,100,211,2,30,12,18,58,36,7,15,0,4
E33007074,564,443,126,317,5,27,13,14,87,74,0,8,5,2
E33007075,287,233,89,144,2,15,13,2,35,34,0,1,0,2
E33007076,351,301,67,234,2,22,16,6,23,21,0,1,1,3
E33007077,241,194,60,134,0,17,11,6,28,25,0,3,0,2
E33007078,332,268,76,192,7,25,6,19,24,20,0,4,0,8
E33007079,325,288,89,199,2,9,2,7,26,21,1,4,0,0
E33007080,252,193,55,138,1,24,8,16,33,30,0,3,0,1
E33007081,418,373,111,262,2,19,9,10,21,20,0,1,0,3
E33007082,349,302,84,218,5,10,4,6,28,26,0,2,0,4
E33007083,296,244,77,167,1,24,14,10,25,22,0,3,0,2
E33007084,342,295,99,196,0,21,14,7,24,19,0,5,0,2
E33007085,550,431,113,318,1,41,16,25,73,66,2,5,0,4
E33007086,408,316,85,231,3,39,18,21,49,37,7,1,4,1
E33007087,484,427,143,284,1,19,5,14,34,25,2,4,3,3
E33007088,438,363,102,261,1,20,11,9,47,42,0,4,1,7
E33007089,2394,1778,422,1356,22,231,104,127,353,329,0,21,3,10
E33007090,557,449,104,345,1,23,12,11,78,63,9,3,3,6
E33007091,749,629,172,457,1,32,14,18,79,71,5,3,0,8
E33007092,287,274,100,174,0,3,1,2,8,7,0,1,0,2
E33007093,352,301,106,195,0,21,9,12,29,28,1,0,0,1
E33007094,338,307,106,201,0,7,4,3,21,16,1,4,0,3
E33007095,354,247,77,170,3,38,16,22,61,51,2,8,0,5
E33007096,379,296,85,211,0,31,13,18,50,47,0,3,0,2
E33007097,275,222,85,137,0,18,5,13,32,29,0,3,0,3
E33007098,641,545,188,357,5,30,10,20,53,48,2,1,2,8
E33007099,437,339,97,242,1,35,14,21,59,53,1,4,1,3
E33007100,380,302,91,211,2,15,1,14,58,52,0,5,1,3
E33007101,283,233,79,154,1,6,1,5,40,32,1,7,0,3
E33007102,357,321,131,190,0,7,1,6,22,22,0,0,0,7
E33007103,325,267,109,158,0,15,3,12,39,33,0,4,2,4
E33007104,281,218,92,126,1,23,2,21,38,21,0,2,15,1
E33007105,254,189,74,115,1,37,10,27,25,24,0,1,0,2
E33007106,286,224,111,113,1,18,3,15,41,40,0,1,0,2
E33007107,497,384,198,186,0,40,10,30,68,57,1,8,2,5
E33007108,295,249,122,127,1,14,3,11,22,20,0,2,0,9
E33007109,398,314,172,142,2,38,17,21,38,31,1,4,2,6
E33007110,631,439,191,248,2,64,11,53,118,100,2,12,4,8
E33007111,369,275,133,142,3,35,8,27,47,41,0,5,1,9
E33007112,277,181,72,109,3,32,13,19,53,48,0,4,1,8
E33007113,317,248,87,161,1,26,6,20,36,33,0,3,0,6
E33007114,356,265,86,179,5,21,10,11,60,55,2,3,0,5
E33007115,547,402,136,266,5,74,23,51,65,58,2,5,0,1
E33007116,383,323,194,129,3,16,4,12,34,31,0,3,0,7
E33007117,398,280,115,165,3,57,17,40,55,47,0,6,2,3
E33007118,596,448,180,268,4,58,16,42,82,72,0,9,1,4
E33007119,283,236,105,131,2,26,11,15,17,11,0,5,1,2
E33007120,594,444,149,295,5,67,19,48,72,60,0,12,0,6
E33007121,320,261,151,110,3,24,8,16,31,25,1,5,0,1
E33007122,323,254,114,140,2,33,5,28,31,28,0,3,0,3
E33007123,417,311,174,137,8,43,14,29,44,40,1,2,1,11
E33007124,322,243,68,175,1,37,13,24,39,33,1,2,3,2
E33007125,248,174,42,132,0,50,28,22,22,20,1,0,1,2
E33007126,329,220,73,147,1,43,15,28,61,56,0,5,0,4
E33007127,290,187,84,103,2,40,14,26,59,53,0,2,4,2
E33007128,495,357,116,241,2,64,23,41,68,55,1,7,5,4
E33007129,401,304,96,208,0,44,17,27,53,44,0,8,1,0
E33007130,301,227,64,163,3,24,10,14,41,35,0,4,2,6
E33007131,333,237,62,175,3,25,8,17,64,53,1,6,4,4
E33007132,287,202,51,151,1,36,15,21,47,45,0,1,1,1
E33007133,327,261,72,189,1,27,12,15,35,32,1,2,0,3
E33007134,288,234,74,160,1,17,3,14,35,32,2,1,0,1
E33007135,375,274,64,210,3,33,6,27,62,55,2,5,0,3
E33007136,325,223,77,146,0,43,17,26,58,54,1,2,1,1
E33007137,380,264,65,199,3,53,23,30,58,55,0,3,0,2
E33007138,341,276,91,185,3,14,7,7,46,41,1,4,0,2
E33007139,257,221,72,149,2,13,6,7,17,15,0,2,0,4
E33007140,455,385,143,242,2,18,7,11,49,43,2,3,1,1
E33007141,542,446,151,295,4,30,6,24,49,43,2,4,0,13
E33007142,287,247,79,168,3,18,5,13,18,16,0,2,0,1
E33007143,426,316,87,229,1,37,17,20,69,61,0,8,0,3
E33007144,772,565,120,445,4,64,20,44,129,120,0,9,0,10
E33007145,606,487,134,353,6,37,10,27,73,63,0,10,0,3
E33007146,609,441,154,287,1,91,34,57,72,66,1,5,0,4
E33007147,473,348,118,230,2,60,22,38,56,51,0,5,0,7
E33007148,291,233,79,154,0,41,26,15,16,14,0,1,1,1
E33007149,328,299,49,250,0,5,2,3,23,19,0,4,0,1
E33007150,804,619,177,442,2,50,22,28,129,114,2,10,3,4
E33007151,678,527,132,395,2,38,17,21,104,97,2,4,1,7
E33007152,228,153,44,109,1,24,4,20,46,40,1,5,0,4
E33007153,451,355,97,258,1,31,15,16,62,58,0,4,0,2
E33007154,238,166,56,110,1,16,8,8,54,51,0,2,1,1
E33007155,269,228,65,163,0,8,2,6,32,30,0,2,0,1
E33007156,354,276,69,207,1,17,7,10,54,48,1,5,0,6
E33007157,317,250,60,190,2,23,13,10,40,36,0,3,1,2
E33007158,446,308,100,208,3,37,9,28,94,93,0,1,0,4
E33007159,413,327,92,235,3,25,8,17,55,49,0,5,1,3
E33007160,551,452,121,331,4,23,10,13,70,62,0,7,1,2
E33007161,311,242,90,152,2,22,7,15,41,35,0,4,2,4
E33007162,379,294,72,222,1,22,5,17,57,53,0,4,0,5
E33007163,234,140,44,96,4,32,12,20,55,49,3,2,1,3
E33007164,432,342,89,253,1,32,12,20,55,46,0,7,2,2
E33007165,301,272,70,202,0,6,2,4,23,21,0,2,0,0
E33007166,347,248,61,187,4,27,5,22,64,54,0,10,0,4
E33007167,402,316,101,215,2,17,7,10,59,52,0,7,0,8
E33007168,367,310,76,234,1,12,6,6,43,39,0,4,0,1
E33007169,337,286,93,193,1,10,1,9,35,32,1,1,1,5
E33007170,403,323,99,224,1,15,9,6,61,48,3,4,6,3
E33007171,305,276,93,183,0,3,2,1,23,21,0,2,0,3
E33007172,374,306,100,206,0,15,10,5,49,43,0,0,6,4
E33007173,255,211,47,164,0,7,2,5,37,32,1,3,1,0
E33007174,274,206,58,148,1,12,3,9,52,44,3,5,0,3
E33007175,347,291,77,214,0,8,1,7,47,44,0,3,0,1
E33007176,331,228,73,155,0,11,5,6,90,80,3,7,0,2
E33007177,279,246,68,178,1,2,1,1,28,26,0,2,0,2
E33007178,565,436,115,321,3,17,11,6,102,98,1,3,0,7
E33007179,406,335,86,249,0,13,6,7,54,46,1,7,0,4
E33007180,420,289,72,217,2,51,29,22,74,65,0,9,0,4
E33007181,643,497,127,370,1,20,11,9,122,110,1,10,1,3
E33007182,987,829,266,563,13,25,11,14,114,103,0,11,0,6
E33007183,348,265,86,179,2,9,6,3,69,66,0,2,1,3
E33007184,488,339,92,247,3,13,9,4,130,119,2,7,2,3
E33007185,292,248,64,184,2,4,0,4,34,30,1,3,0,4
E33007186,344,272,48,224,0,15,7,8,56,50,1,5,0,1
E33007187,428,328,82,246,2,25,13,12,68,62,0,5,1,5
E33007188,524,429,104,325,3,20,10,10,71,66,0,5,0,1
E33007189,538,437,131,306,4,35,18,17,59,50,0,8,1,3
E33007190,352,277,74,203,3,15,11,4,56,47,0,8,1,1
E33007191,247,188,47,141,0,13,6,7,45,43,0,2,0,1
E33007192,362,296,69,227,0,9,4,5,52,45,0,6,1,5
E33007193,346,274,67,207,2,4,1,3,64,59,0,5,0,2
E33007194,640,415,126,289,3,55,25,30,164,148,2,10,4,3
E33007195,478,294,59,235,2,16,5,11,165,156,1,8,0,1
E33007196,309,219,56,163,2,13,4,9,75,72,0,3,0,0
E33007197,368,234,73,161,2,23,8,15,106,100,2,4,0,3
E33007198,355,222,79,143,2,19,10,9,111,103,0,5,3,1
E33007199,478,324,90,234,1,31,14,17,122,107,5,10,0,0
E33007200,260,184,46,138,0,40,25,15,34,32,0,2,0,2
E33007201,229,181,61,120,1,12,8,4,35,32,1,2,0,0
E33007202,332,209,55,154,2,86,67,19,32,26,0,6,0,3
E33007203,266,191,58,133,3,21,12,9,51,48,0,3,0,0
E33007204,321,215,56,159,2,24,14,10,78,71,1,6,0,2
E33007205,457,342,96,246,4,34,24,10,75,70,2,3,0,2
E33007206,254,156,47,109,0,26,10,16,68,65,0,3,0,4
E33007207,294,225,56,169,0,11,7,4,52,44,0,8,0,6
E33007208,334,253,71,182,0,12,7,5,66,52,1,13,0,3
E33007209,245,202,43,159,0,3,1,2,38,31,0,7,0,2
E33007210,398,289,73,216,5,14,8,6,87,78,0,7,2,3
E33007211,4581,3645,819,2826,28,134,64,70,756,690,6,57,3,18
E33007212,310,246,72,174,1,17,7,10,42,35,0,5,2,4
E33007213,391,289,79,210,1,10,3,7,88,78,1,8,1,3
E33007214,220,148,49,99,0,11,5,6,58,53,0,5,0,3
E33007215,273,183,39,144,1,17,8,9,71,69,0,2,0,1
E33007216,350,216,70,146,0,17,6,11,110,99,1,8,2,7
E33007217,522,366,72,294,3,36,17,19,114,111,0,3,0,3
E33007218,267,161,60,101,2,16,5,11,86,83,1,2,0,2
E33007219,854,652,184,468,2,33,15,18,162,146,0,14,2,5
E33007220,309,193,57,136,0,24,11,13,89,81,1,6,1,3
E33007221,341,258,58,200,2,8,2,6,71,60,1,10,0,2
E33007222,385,279,65,214,1,13,7,6,85,71,4,10,0,7
E33007223,291,217,50,167,1,9,3,6,60,56,0,4,0,4
E33007224,935,771,193,578,2,23,11,12,135,125,0,10,0,4
E33007225,298,234,67,167,1,5,5,0,54,46,0,8,0,4
E33007226,328,263,64,199,0,9,4,5,55,49,1,5,0,1
E33007227,415,250,75,175,4,24,12,12,131,124,2,5,0,6
E33007228,169,95,25,70,1,8,2,6,63,59,1,3,0,2
E33007229,299,188,45,143,1,15,7,8,88,83,0,4,1,7
E33007230,327,198,72,126,0,15,7,8,109,99,1,8,1,5
E33007231,296,201,55,146,6,10,5,5,79,71,1,7,0,0
E33007232,265,209,57,152,1,15,11,4,40,35,0,5,0,0
E33007233,228,186,52,134,0,7,4,3,35,30,2,3,0,0
E33007234,894,715,218,497,4,40,23,17,131,120,0,10,1,4
E33007235,296,227,56,171,0,38,29,9,29,24,0,5,0,2
E33007236,243,177,47,130,1,12,6,6,46,39,0,7,0,7
E33007237,1983,1576,421,1155,7,102,67,35,291,250,1,35,5,7
E33007238,257,175,36,139,0,19,9,10,59,57,0,2,0,4
E33007239,307,198,60,138,0,9,4,5,90,78,3,7,2,10
E33007240,308,230,57,173,0,13,10,3,63,56,1,6,0,2
E33007241,270,199,53,146,0,13,3,10,53,47,0,6,0,5
E33007242,352,253,73,180,0,14,3,11,82,75,0,5,2,3
E33007243,390,305,90,215,3,12,5,7,68,58,1,8,1,2
E33007244,291,234,62,172,0,9,4,5,45,40,0,4,1,3
E33007245,476,366,120,246,2,30,19,11,74,67,0,7,0,4
E33007246,316,229,64,165,2,9,4,5,72,63,0,7,2,4
E33007247,333,206,43,163,3,14,6,8,105,101,1,3,0,5
E33007248,285,220,49,171,1,4,2,2,56,51,0,5,0,4
E33007249,333,278,75,203,2,8,3,5,43,40,0,2,1,2
E33007250,276,184,54,130,1,16,12,4,72,65,0,6,1,3
E33007251,306,231,69,162,0,3,3,0,71,60,2,9,0,1
E33007252,267,191,56,135,2,6,3,3,67,64,0,3,0,1
E33007253,310,227,66,161,0,13,5,8,70,65,1,4,0,0
E33007254,611,486,126,360,3,20,15,5,101,89,0,11,1,1
E33007255,321,248,81,167,2,16,9,7,53,44,3,6,0,2
E33007256,473,393,115,278,3,9,3,6,64,55,0,8,1,4
E33007257,307,236,69,167,0,16,4,12,52,46,0,6,0,3
E33007258,359,246,81,165,1,15,9,6,95,87,0,7,1,2
E33007259,305,241,64,177,0,20,18,2,43,38,1,4,0,1
E33007260,317,248,86,162,4,6,4,2,55,51,0,4,0,4
E33007261,314,249,68,181,3,9,5,4,52,48,0,4,0,1
E33007262,304,240,71,169,0,8,6,2,54,51,0,3,0,2
E33007263,565,437,163,274,2,46,17,29,73,58,7,4,4,7
E33007264,346,295,103,192,0,21,3,18,27,23,0,2,2,3
E33007265,550,421,126,295,5,59,37,22,60,56,0,3,1,5
E33007266,253,195,63,132,1,19,6,13,34,29,0,4,1,4
E33007267,1016,722,151,571,8,75,44,31,207,194,3,8,2,4
E33007268,244,188,47,141,1,16,13,3,39,39,0,0,0,0
E33007269,340,274,79,195,1,40,26,14,19,17,1,1,0,6
E33007270,1392,1082,280,802,4,96,49,47,201,179,9,10,3,9
E33007271,268,191,58,133,0,18,15,3,55,46,7,2,0,4
E33007272,296,250,88,162,0,13,7,6,29,26,0,2,1,4
E33007273,527,458,150,308,1,15,10,5,47,40,2,2,3,6
E33007274,456,380,153,227,3,26,18,8,46,39,1,6,0,1
E33007275,245,190,64,126,1,20,7,13,30,28,2,0,0,4
E33007276,269,205,70,135,4,32,16,16,26,26,0,0,0,2
E33007277,229,180,75,105,5,18,6,12,21,17,1,3,0,5
E33007278,304,223,64,159,2,47,22,25,30,26,1,1,2,2
E33007279,258,163,51,112,2,13,6,7,78,70,2,5,1,2
E33007280,276,234,84,150,5,10,6,4,27,25,0,2,0,0
E33007281,271,223,77,146,0,13,5,8,34,26,2,2,4,1
E33007282,352,253,64,189,3,37,15,22,52,50,1,0,1,7
E33007283,503,339,114,225,11,52,27,25,98,75,11,8,4,3
E33007284,430,295,88,207,3,63,32,31,67,62,0,2,3,2
E33007285,478,326,77,249,2,108,43,65,40,36,0,3,1,2
E33007286,442,333,57,276,3,66,24,42,39,34,3,1,1,1
E33007287,295,210,67,143,1,52,25,27,30,25,3,1,1,2
E33007288,296,170,32,138,3,82,29,53,36,32,1,3,0,5
E33007289,393,296,77,219,0,57,13,44,40,28,2,10,0,0
E33007290,278,248,77,171,3,4,2,2,21,17,4,0,0,2
E33007291,206,170,77,93,1,10,1,9,25,23,0,1,1,0
E33007292,249,197,65,132,3,16,6,10,25,22,0,2,1,8
E33007293,356,283,78,205,5,20,5,15,46,41,1,4,0,2
E33007294,336,259,86,173,1,22,10,12,47,39,3,5,0,7
E33007295,265,206,72,134,1,23,13,10,32,28,2,2,0,3
E33007296,205,166,63,103,0,15,11,4,22,22,0,0,0,2
E33007297,448,364,130,234,0,18,5,13,60,57,1,2,0,6
E33007298,335,259,71,188,0,42,19,23,33,31,0,2,0,1
E33007299,583,408,141,267,2,69,42,27,97,88,2,7,0,7
E33007300,852,566,164,402,13,120,69,51,148,135,1,11,1,5
E33007301,670,457,120,337,1,67,38,29,136,124,3,8,1,9
E33007302,598,378,106,272,6,57,30,27,150,141,1,5,3,7
E33007303,372,244,67,177,5,29,19,10,91,82,0,8,1,3
E33007304,414,294,69,225,2,45,12,33,67,62,1,4,0,6
E33007305,529,349,83,266,4,52,16,36,120,107,1,11,1,4
E33007306,349,252,65,187,0,28,11,17,67,65,0,2,0,2
E33007307,395,298,89,209,1,28,12,16,66,54,1,9,2,2
E33007308,1526,1145,368,777,12,72,29,43,288,264,1,17,6,9
E33007309,451,315,89,226,6,34,14,20,95,89,1,1,4,1
E33007310,439,322,97,225,1,22,8,14,84,76,0,8,0,10
E33007311,587,361,93,268,5,88,30,58,133,122,1,10,0,0
E33007312,642,375,102,273,4,127,52,75,123,114,0,8,1,13
E33007313,335,172,49,123,6,32,12,20,121,109,1,7,4,4
E33007314,250,160,58,102,1,23,14,9,64,58,0,3,3,2
E33007315,368,274,69,205,0,31,12,19,60,54,0,2,4,3
E33007316,244,195,66,129,1,17,5,12,26,22,0,4,0,5
E33007317,452,327,105,222,1,21,9,12,102,96,1,5,0,1
E33007318,321,234,54,180,3,22,6,16,57,52,1,4,0,5
E33007319,563,484,156,328,1,24,11,13,49,43,2,3,1,5
E33007320,313,246,85,161,2,15,7,8,47,42,2,3,0,3
E33007321,380,325,104,221,0,18,10,8,34,32,1,1,0,3
E33007322,378,294,90,204,1,28,12,16,53,48,3,2,0,2
E33007323,311,223,63,160,2,21,9,12,58,49,2,4,3,7
E33007324,531,405,147,258,7,37,11,26,75,67,3,5,0,7
E33007325,272,235,75,160,1,9,4,5,25,24,0,1,0,2
E33007326,366,308,91,217,2,13,4,9,39,34,1,4,0,4
E33007327,338,270,79,191,8,13,7,6,43,39,1,1,2,4
E33007328,254,213,66,147,3,17,7,10,19,16,1,2,0,2
E33007329,342,262,95,167,1,26,6,20,49,44,1,4,0,4
E33007330,265,195,73,122,0,15,7,8,54,44,0,10,0,1
E33007331,353,251,85,166,0,28,9,19,70,66,3,1,0,4
E33007332,806,656,216,440,5,53,26,27,88,85,1,2,0,4
E33007333,276,220,59,161,1,21,8,13,33,32,0,1,0,1
E33007334,346,270,94,176,0,23,12,11,51,47,0,3,1,2
E33007335,279,226,64,162,1,27,9,18,21,18,0,3,0,4
E33007336,326,240,55,185,3,38,10,28,42,38,0,4,0,3
E33007337,365,281,61,220,6,38,17,21,39,36,1,2,0,1
E33007338,270,180,73,107,2,21,7,14,61,56,1,3,1,6
E33007339,427,358,84,274,3,24,13,11,41,38,0,3,0,1
E33007340,274,209,94,115,1,11,7,4,42,37,4,1,0,11
E33007341,316,251,95,156,4,25,6,19,32,27,2,3,0,4
E33007342,377,279,98,181,2,18,4,14,73,66,3,2,2,5
E33007343,380,240,61,179,7,16,4,12,81,74,6,0,1,36
E33007344,410,313,121,192,6,26,12,14,53,45,2,5,1,12
E33007345,223,138,60,78,2,11,4,7,65,61,1,2,1,7
E33007346,273,176,54,122,5,12,8,4,72,63,8,1,0,8
E33007347,292,215,84,131,2,25,9,16,47,43,1,3,0,3
E33007348,238,205,101,104,5,2,2,0,25,20,0,4,1,1
E33007349,372,292,92,200,2,34,17,17,42,40,0,2,0,2
E33007350,300,242,79,163,4,15,7,8,34,29,0,5,0,5
E33007351,418,317,111,206,6,21,13,8,67,57,3,6,1,7
E33007352,242,190,97,93,3,2,0,2,45,42,0,3,0,2
E33007353,460,316,119,197,4,24,8,16,108,89,10,8,1,8
E33007354,252,167,66,101,3,16,8,8,56,40,7,9,0,10
E33007355,328,247,71,176,2,17,8,9,55,49,0,5,1,7
E33007356,457,389,126,263,0,17,7,10,46,38,2,4,2,5
E33007357,636,524,170,354,6,35,13,22,61,58,1,2,0,10
E33007358,246,184,86,98,2,18,9,9,33,31,1,1,0,9
E33007359,288,239,87,152,0,13,8,5,31,29,0,2,0,5
E33007360,394,336,119,217,1,24,5,19,28,25,1,2,0,5
E33007361,433,361,141,220,1,23,8,15,42,38,1,1,2,6
E33007362,249,215,65,150,2,14,3,11,17,16,1,0,0,1
E33007363,309,277,81,196,0,9,4,5,23,22,0,1,0,0
E33007364,583,460,145,315,3,23,6,17,90,79,0,10,1,7
E33007365,369,326,89,237,0,14,4,10,26,24,0,2,0,3
E33007366,431,355,94,261,2,30,10,20,42,37,0,5,0,2
E33007367,370,308,84,224,0,23,10,13,38,34,0,3,1,1
E33007368,480,382,98,284,2,28,6,22,65,59,1,3,2,3
E33007369,639,534,127,407,2,39,17,22,63,55,2,4,2,1
E33007370,508,411,114,297,4,33,14,19,59,57,2,0,0,1
E33007371,549,459,102,357,3,34,14,20,53,48,1,4,0,0
E33007372,385,324,124,200,1,20,6,14,34,31,0,3,0,6
E33007373,301,225,52,173,0,47,14,33,28,26,0,2,0,1
E33007374,609,465,131,334,1,82,22,60,57,49,0,8,0,4
E33007375,411,340,112,228,1,25,7,18,42,37,0,5,0,3
E33007376,415,349,114,235,1,37,8,29,26,19,1,4,2,2
E33007377,655,476,146,330,1,61,19,42,107,94,0,12,1,10
E33007378,344,267,96,171,0,32,3,29,43,37,0,6,0,2
E33007379,324,243,93,150,1,31,13,18,46,31,8,5,2,3
E33007380,335,271,88,183,0,24,6,18,38,32,0,4,2,2
E33007381,593,461,151,310,1,42,8,34,86,80,1,4,1,3
E33007382,394,338,114,224,1,25,8,17,29,27,1,1,0,1
E33007383,313,271,95,176,1,22,7,15,17,15,2,0,0,2
E33007384,302,265,85,180,0,13,4,9,23,20,0,3,0,1
E33007385,491,414,119,295,0,24,9,15,48,45,0,2,1,5
E33007386,349,304,111,193,0,9,4,5,30,28,0,2,0,6
E33007387,280,235,86,149,1,13,6,7,29,25,0,3,1,2
E33007388,306,250,104,146,1,17,8,9,35,32,0,1,2,3
E33007389,275,220,75,145,1,31,6,25,23,22,1,0,0,0
E33007390,503,418,140,278,0,26,10,16,56,50,0,3,3,3
E33007391,365,329,120,209,0,12,6,6,22,21,1,0,0,2
E33007392,263,225,57,168,0,8,3,5,28,28,0,0,0,2
E33007393,231,187,61,126,4,15,4,11,24,22,2,0,0,1
E33007394,270,224,65,159,1,9,3,6,33,26,1,3,3,3
E33007395,652,539,139,400,3,23,5,18,83,76,1,6,0,4
E33007396,468,366,99,267,1,32,13,19,66,63,0,2,1,3
E33007397,651,535,173,362,4,45,17,28,65,59,0,6,0,2
E33007398,544,427,132,295,3,37,8,29,74,67,0,6,1,3
E33007399,308,238,86,152,1,33,9,24,34,30,0,2,2,2
E33007400,270,214,82,132,2,15,6,9,37,34,0,3,0,2
E33007401,277,239,98,141,0,16,3,13,22,17,1,2,2,0
E33007402,370,278,122,156,0,26,5,21,61,53,2,4,2,5
E33007403,283,218,77,141,1,25,8,17,32,28,0,2,2,7
E33007404,250,189,83,106,0,5,3,2,46,36,3,7,0,10
E33007405,387,322,134,188,6,21,6,15,31,28,0,3,0,7
E33007406,517,408,121,287,2,32,10,22,73,65,0,7,1,2
E33007407,288,223,64,159,0,30,10,20,31,27,1,1,2,4
E33007408,419,358,119,239,0,15,3,12,41,30,1,3,7,5
E33007409,465,348,112,236,2,54,12,42,56,50,0,4,2,5
E33007410,287,227,62,165,0,31,14,17,27,25,0,2,0,2
E33007411,238,214,87,127,0,8,3,5,15,15,0,0,0,1
E33007412,1007,835,247,588,0,83,47,36,80,77,0,3,0,9
E33007413,360,288,86,202,2,20,6,14,47,42,0,4,1,3
E33007414,563,452,142,310,1,37,12,25,70,64,1,5,0,3
E33007415,316,275,93,182,0,12,1,11,27,23,0,4,0,2
E33007416,796,669,127,542,1,36,16,20,86,79,1,5,1,4
E33007417,350,297,75,222,0,28,12,16,23,20,0,3,0,2
E33007418,275,230,74,156,0,14,5,9,30,21,3,3,3,1
E33007419,272,165,52,113,0,62,29,33,41,39,0,1,1,4
E33007420,268,211,59,152,1,29,12,17,25,22,1,2,0,2
E33007421,505,370,106,264,2,50,20,30,82,73,4,3,2,1
E33007422,1262,959,304,655,2,125,45,80,170,160,0,9,1,6
E33007423,278,174,64,110,3,36,11,25,65,62,0,3,0,0
E33007424,1672,1215,328,887,5,180,80,100,261,242,2,15,2,11
E33007425,290,162,34,128,2,68,25,43,55,54,1,0,0,3
E33007426,267,207,54,153,3,19,6,13,38,37,0,1,0,0
E33007427,235,201,71,130,1,12,3,9,19,14,0,5,0,2
E33007428,264,211,69,142,0,14,8,6,38,37,0,1,0,1
E33007429,244,159,39,120,4,21,7,14,58,52,0,5,1,2
E33007430,345,242,60,182,0,34,15,19,67,56,1,10,0,2
E33007431,295,199,42,157,1,46,18,28,49,46,0,3,0,0
E33007432,425,318,74,244,2,37,14,23,65,59,0,6,0,3
E33007433,739,456,112,344,2,41,18,23,237,226,0,10,1,3
E33007434,281,214,85,129,1,20,19,1,43,35,2,5,1,3
E33007435,264,224,69,155,3,10,4,6,21,19,1,1,0,6
E33007436,532,439,165,274,1,23,12,11,64,57,0,5,2,5
E33007437,335,250,49,201,1,21,7,14,60,50,3,3,4,3
E33007438,332,250,72,178,0,24,8,16,55,48,2,4,1,3
E33007439,238,207,52,155,0,9,3,6,21,17,1,2,1,1
E33007440,266,168,39,129,0,13,4,9,82,75,0,7,0,3
E33007441,335,196,61,135,5,27,16,11,105,95,6,3,1,2
E33007442,904,781,211,570,3,29,10,19,86,78,1,6,1,5
E33007443,362,242,71,171,0,42,21,21,75,62,2,8,3,3
E33007444,299,271,71,200,0,10,2,8,16,15,0,1,0,2
E33007445,483,373,96,277,0,60,30,30,47,43,0,4,0,3
E33007446,479,347,99,248,0,60,24,36,71,59,0,8,4,1
E33007447,710,550,175,375,2,41,12,29,112,101,0,11,0,5
E33007448,244,177,44,133,0,13,1,12,51,43,0,4,4,3
E33007449,559,362,98,264,3,44,14,30,145,133,3,6,3,5
E33007450,331,291,88,203,0,12,4,8,23,22,0,1,0,5
E33007451,268,249,72,177,0,3,2,1,15,12,0,1,2,1
E33007452,265,230,87,143,2,10,6,4,23,19,1,3,0,0
E33007453,335,290,99,191,0,14,4,10,26,23,0,3,0,5
E33007454,408,329,103,226,2,29,11,18,48,41,2,4,1,0
E33007455,315,223,61,162,2,31,9,22,57,53,0,3,1,2
E33007456,276,211,61,150,1,19,5,14,42,38,1,2,1,3
E33007457,263,203,70,133,3,10,3,7,42,39,0,2,1,5
E33007458,602,505,177,328,4,28,13,15,61,58,2,1,0,4
E33007459,564,469,160,309,3,18,11,7,68,47,5,11,5,6
E33007460,345,272,119,153,1,18,9,9,46,38,4,4,0,8
E33007461,581,465,170,295,3,24,8,16,82,70,6,6,0,7
E33007462,4085,3278,891,2387,17,239,80,159,534,484,6,39,5,17
E33007463,387,310,118,192,0,12,3,9,58,52,3,3,0,7
E33007464,519,421,150,271,3,25,2,23,66,61,1,2,2,4
E33007465,467,389,79,310,2,16,2,14,52,48,1,3,0,8
E33007466,267,210,63,147,1,13,8,5,40,35,2,3,0,3
E33007467,930,731,243,488,4,42,19,23,136,107,9,16,4,17
E33007468,258,212,64,148,3,12,3,9,29,25,2,2,0,2
E33007469,277,231,76,155,1,12,4,8,31,28,1,2,0,2
E33007470,451,389,126,263,2,8,3,5,50,42,0,6,2,2
E33007471,296,252,89,163,0,10,2,8,34,27,0,3,4,0
E33007472,268,174,56,118,6,21,5,16,67,65,0,2,0,0
E33007473,229,191,58,133,1,10,2,8,26,23,0,3,0,1
E33007474,253,168,44,124,0,28,10,18,57,52,4,0,1,0
E33007475,407,322,82,240,5,24,7,17,53,48,2,3,0,3
E33007476,485,412,157,255,0,24,10,14,47,44,0,2,1,2
E33007477,872,535,208,327,4,73,23,50,252,244,3,4,1,8
E33007478,901,625,182,443,10,114,37,77,147,139,0,6,2,5
E33007479,338,210,90,120,0,15,4,11,99,87,6,6,0,14
E33007480,517,406,167,239,2,25,9,16,81,73,3,5,0,3
E33007481,321,260,84,176,1,18,4,14,36,30,3,3,0,6
E33007482,618,437,152,285,3,44,29,15,125,101,14,7,3,9
E33007483,276,216,107,109,3,12,2,10,35,26,6,2,1,10
E33007484,436,340,115,225,2,23,9,14,62,51,0,8,3,9
E33007485,389,236,73,163,2,48,24,24,97,89,0,5,3,6
E33007486,416,324,105,219,0,48,26,22,42,36,0,5,1,2
E33007487,303,235,65,170,0,36,31,5,30,25,0,5,0,2
E33007488,296,236,87,149,1,35,10,25,22,21,0,1,0,2
E33007489,412,335,112,223,0,29,20,9,44,38,1,5,0,4
E33007490,737,577,176,401,4,72,43,29,80,66,3,11,0,4
E33007491,530,398,114,284,1,31,18,13,96,90,1,5,0,4
E33007492,258,231,88,143,0,7,4,3,19,19,0,0,0,1
E33007493,527,430,149,281,3,27,14,13,59,54,1,3,1,8
E33007494,322,230,63,167,1,37,26,11,50,35,5,6,4,4
E33007495,641,475,114,361,3,55,29,26,105,99,2,4,0,3
E33007496,466,362,107,255,4,50,44,6,47,40,2,5,0,3
E33007497,388,280,56,224,6,64,52,12,36,35,0,1,0,2
E33007498,418,350,108,242,0,23,12,11,42,35,0,7,0,3
E33007499,494,406,145,261,0,42,30,12,44,39,0,5,0,2
E33007500,318,231,61,170,1,43,38,5,40,36,2,2,0,3
E33007501,677,531,126,405,4,56,38,18,85,84,0,1,0,1
E33007502,466,357,83,274,4,49,37,12,54,47,0,5,2,2
E33007503,248,169,38,131,0,35,33,2,43,39,0,4,0,1
E33007504,291,234,60,174,3,15,12,3,34,30,2,2,0,5
E33007505,408,265,83,182,3,51,42,9,86,80,4,2,0,3
E33007506,592,454,138,316,3,64,50,14,65,60,0,5,0,6
E33007507,239,153,41,112,1,42,37,5,41,39,1,1,0,2
E33007508,283,225,57,168,3,24,16,8,30,25,0,5,0,1
E33007509,1775,1486,312,1174,12,141,100,41,129,120,0,9,0,7
E33007510,306,237,88,149,1,43,39,4,24,17,0,7,0,1
E33007511,327,207,52,155,2,77,72,5,35,30,0,5,0,6
E33007512,280,218,43,175,3,31,27,4,27,24,0,3,0,1
E33007513,333,246,65,181,0,47,46,1,40,33,0,3,4,0
E33007514,291,246,71,175,0,13,9,4,30,27,0,3,0,2
E33007515,426,372,91,281,1,14,8,6,36,30,0,6,0,3
E33007516,611,493,114,379,5,36,28,8,74,65,0,3,6,3
E33007517,275,192,58,134,0,58,55,3,23,19,1,3,0,2
E33007518,616,467,144,323,2,81,69,12,63,56,1,6,0,3
E33007519,337,281,78,203,0,23,19,4,32,29,1,0,2,1
E33007520,925,620,136,484,5,158,133,25,135,128,0,7,0,7
E33007521,815,561,129,432,6,123,97,26,122,112,0,10,0,3
E33007522,1175,960,272,688,9,54,34,20,148,141,0,5,2,4
E33007523,332,243,49,194,3,49,36,13,36,30,2,0,4,1
E33007524,1821,1573,414,1159,6,115,81,34,126,114,0,10,2,1
E33007525,389,317,83,234,0,44,31,13,27,22,0,3,2,1
E33007526,699,481,147,334,5,149,129,20,60,58,0,2,0,4
E33007527,338,293,85,208,1,17,9,8,26,22,0,4,0,1
E33007528,346,287,80,207,1,39,37,2,18,16,0,2,0,1
E33007529,293,239,76,163,2,24,18,6,25,22,0,3,0,3
E33007530,534,434,118,316,5,39,30,9,50,46,1,3,0,6
E33007531,752,625,134,491,7,25,13,12,87,84,0,3,0,8
E33007532,430,325,80,245,8,37,26,11,56,50,0,6,0,4
E33007533,271,218,56,162,1,22,18,4,30,26,3,1,0,0
E33007534,349,325,92,233,2,4,3,1,18,17,0,0,1,0
E33007535,358,327,90,237,3,14,9,5,12,9,0,3,0,2
E33007536,323,284,110,174,0,14,6,8,24,18,0,4,2,1
E33007537,362,286,77,209,2,18,6,12,55,48,0,2,5,1
E33007538,256,224,85,139,1,8,6,2,21,21,0,0,0,2
E33007539,398,317,105,212,4,21,12,9,44,42,1,1,0,12
E33007540,306,252,77,175,3,17,8,9,33,31,0,2,0,1
E33007541,401,349,117,232,0,19,2,17,32,27,1,4,0,1
E33007542,281,234,78,156,0,16,8,8,27,24,0,3,0,4
E33007543,296,264,83,181,1,10,3,7,20,17,0,2,1,1
E33007544,427,367,132,235,0,22,9,13,37,33,0,4,0,1
E33007545,411,361,125,236,0,15,5,10,34,31,3,0,0,1
E33007546,307,267,71,196,0,12,4,8,27,25,2,0,0,1
E33007547,269,218,71,147,1,12,3,9,36,29,0,5,2,2
E33007548,275,217,72,145,3,22,9,13,30,30,0,0,0,3
E33007549,371,340,100,240,1,7,4,3,19,17,1,1,0,4
E33007550,543,355,76,279,5,86,10,76,88,83,0,5,0,9
E33007551,420,316,89,227,2,47,5,42,50,42,2,4,2,5
E33007552,352,238,79,159,7,61,10,51,45,34,2,5,4,1
E33007553,725,522,140,382,6,79,20,59,112,103,1,8,0,6
E33007554,404,312,98,214,1,37,5,32,49,45,1,3,0,5
E33007555,398,310,74,236,0,17,1,16,69,63,0,5,1,2
E33007556,292,234,62,172,0,25,3,22,32,28,0,4,0,1
E33007557,304,264,70,194,0,3,1,2,35,32,0,3,0,2
E33007558,228,188,57,131,1,18,3,15,20,20,0,0,0,1
E33007559,280,210,59,151,2,30,7,23,35,34,0,1,0,3
E33007560,529,439,149,290,1,37,5,32,49,49,0,0,0,3
E33007561,679,564,159,405,0,26,3,23,83,77,0,6,0,6
E33007562,589,400,93,307,7,28,17,11,150,142,1,7,0,4
E33007563,430,345,95,250,0,9,2,7,76,73,2,1,0,0
E33007564,353,286,85,201,3,15,3,12,46,42,1,3,0,3
E33007565,334,269,70,199,0,13,4,9,48,46,1,0,1,4
E33007566,281,213,87,126,3,33,17,16,29,26,1,2,0,3
E33007567,486,399,126,273,3,31,7,24,49,46,0,3,0,4
E33007568,262,185,60,125,5,16,6,10,49,48,1,0,0,7
E33007569,251,203,62,141,0,9,1,8,35,31,1,3,0,4
E33007570,368,302,114,188,0,19,9,10,41,37,1,3,0,6
E33007571,317,215,74,141,3,18,9,9,72,64,1,5,2,9
E33007572,642,448,143,305,4,54,20,34,121,112,0,6,3,15
E33007573,292,225,56,169,0,28,11,17,38,37,0,1,0,1
E33007574,264,199,58,141,0,16,5,11,48,43,2,1,2,1
E33007575,285,227,63,164,0,14,4,10,44,39,0,3,2,0
E33007576,226,165,69,96,2,18,9,9,37,35,0,2,0,4
E33007577,233,153,55,98,0,16,4,12,62,54,1,3,4,2
E33007578,280,238,73,165,1,9,2,7,28,20,7,1,0,4
E33007579,301,258,73,185,0,8,4,4,32,29,1,2,0,3
E33007580,292,273,99,174,0,5,1,4,11,10,0,1,0,3
E33007581,281,236,63,173,1,11,2,9,30,25,1,2,2,3
E33007582,434,343,109,234,0,28,2,26,58,53,0,5,0,5
E33007583,302,209,62,147,0,52,8,44,37,33,0,3,1,4
E33007584,270,189,47,142,0,34,12,22,44,32,6,5,1,3
E33007585,474,386,113,273,3,16,4,12,60,54,0,6,0,9
E33007586,266,171,55,116,0,39,3,36,55,52,1,2,0,1
E33007587,240,194,72,122,0,8,2,6,37,36,0,1,0,1
E33007588,369,301,109,192,2,18,5,13,36,34,0,0,2,12
E33007589,612,491,151,340,5,19,4,15,86,81,0,4,1,11
E33007590,507,416,159,257,1,22,12,10,61,57,3,1,0,7
E33007591,242,187,58,129,2,16,3,13,29,25,1,2,1,8
E33007592,468,372,97,275,2,21,9,12,69,63,1,5,0,4
E33007593,221,171,53,118,2,6,2,4,40,40,0,0,0,2
E33007594,227,203,71,132,0,7,1,6,16,16,0,0,0,1
E33007595,279,230,74,156,1,23,3,20,25,20,1,3,1,0
E33007596,274,238,72,166,2,7,5,2,27,26,0,1,0,0
E33007597,411,296,76,220,0,27,8,19,86,82,0,4,0,2
E33007598,506,404,122,282,4,28,7,21,63,57,0,5,1,7
E33007599,397,345,109,236,0,12,2,10,35,32,1,1,1,5
E33007600,268,179,52,127,1,27,4,23,58,53,1,2,2,3
E33007601,386,286,89,197,3,26,7,19,65,57,2,6,0,6
E33007602,337,289,92,197,1,17,4,13,28,27,0,1,0,2
E33007603,275,220,82,138,1,11,4,7,39,36,1,2,0,4
E33007604,277,219,74,145,3,9,0,9,46,45,0,1,0,0
E33007605,334,281,83,198,1,18,8,10,33,30,0,0,3,1
E33007606,271,203,62,141,1,19,4,15,48,46,0,0,2,0
E33007607,219,177,50,127,0,12,4,8,28,24,0,4,0,2
E33007608,374,321,116,205,3,10,3,7,40,38,0,1,1,0
E33007609,366,275,65,210,0,11,3,8,77,72,0,5,0,3
E33007610,459,328,102,226,2,26,2,24,100,84,2,4,10,3
E33007611,480,385,110,275,4,31,12,19,57,51,1,4,1,3
E33007612,469,391,106,285,2,23,3,20,52,46,0,6,0,1
E33007613,706,591,147,444,3,12,5,7,96,92,0,3,1,4
E33007614,446,374,124,250,3,18,3,15,47,45,0,1,1,4
E33007615,509,392,140,252,2,56,18,38,56,53,0,3,0,3
E33007616,457,380,100,280,0,22,3,19,54,51,0,1,2,1
E33007617,389,343,93,250,1,19,5,14,24,24,0,0,0,2
E33007618,451,378,103,275,1,17,3,14,52,50,0,2,0,3
E33007619,266,178,51,127,2,36,12,24,46,44,0,2,0,4
E33007620,456,370,79,291,0,26,7,19,57,51,2,4,0,3
E33007621,223,147,38,109,1,31,9,22,42,41,0,1,0,2
E33007622,273,226,91,135,1,21,7,14,24,23,0,1,0,1
E33007623,449,274,80,194,4,73,30,43,93,85,2,6,0,5
E33007624,391,314,88,226,3,31,15,16,42,38,0,4,0,1
E33007625,631,465,115,350,11,71,20,51,80,72,0,8,0,4
E33007626,291,236,83,153,0,19,9,10,35,28,0,7,0,1
E33007627,660,532,173,359,3,49,19,30,71,63,2,5,1,5
E33007628,523,446,147,299,2,20,7,13,51,48,0,2,1,4
E33007629,488,364,113,251,3,48,15,33,71,63,1,7,0,2
E33007630,572,457,127,330,2,48,9,39,64,61,0,3,0,1
E33007631,444,327,105,222,4,26,7,19,86,79,0,7,0,1
E33007632,292,205,61,144,0,26,11,15,59,52,1,5,1,2
E33007633,478,347,85,262,2,44,10,34,82,79,0,2,1,3
E33007634,700,570,170,400,6,39,8,31,83,78,0,5,0,2
E33007635,335,238,66,172,2,24,5,19,69,59,0,6,4,2
E33007636,337,281,87,194,0,25,10,15,31,26,0,4,1,0
E33007637,414,290,90,200,3,73,22,51,45,38,0,7,0,3
E33007638,266,209,77,132,2,15,3,12,38,36,0,2,0,2
E33007639,333,264,76,188,2,43,20,23,22,19,0,2,1,2
E33007640,482,345,119,226,8,46,10,36,79,67,1,7,4,4
E33007641,311,243,83,160,2,25,6,19,38,34,0,2,2,3
E33007642,267,219,96,123,0,7,2,5,36,27,4,1,4,5
E33007643,251,202,65,137,1,13,6,7,30,28,0,2,0,5
E33007644,331,263,116,147,0,17,0,17,47,35,1,7,4,4
E33007645,275,199,82,117,3,18,5,13,46,40,0,4,2,9
E33007646,467,362,157,205,3,52,23,29,45,39,0,5,1,5
E33007647,359,229,93,136,1,19,3,16,96,87,7,2,0,14
E33007648,245,198,90,108,3,7,2,5,33,26,2,2,3,4
E33007649,327,277,144,133,0,6,2,4,40,32,0,6,2,4
E33007650,368,244,64,180,0,69,22,47,49,44,0,5,0,6
E33007651,270,161,40,121,6,42,6,36,60,53,0,3,4,1
E33007652,516,393,96,297,4,34,11,23,80,76,0,4,0,5
E33007653,441,323,104,219,5,36,11,25,73,69,0,2,2,4
E33007654,283,192,77,115,1,54,18,36,33,29,2,2,0,3
E33007655,324,273,92,181,0,23,9,14,22,18,0,4,0,6
E33007656,346,287,95,192,1,11,4,7,42,33,0,4,5,5
E33007657,319,246,80,166,2,32,9,23,37,30,0,4,3,2
E33007658,378,288,99,189,5,31,7,24,52,42,3,5,2,2
E33007659,291,211,62,149,7,44,10,34,27,25,0,2,0,2
E33007660,337,273,85,188,4,12,6,6,38,32,0,1,5,10
E33007661,265,198,74,124,7,22,8,14,36,33,0,3,0,2
E33007662,404,317,88,229,2,37,11,26,45,40,3,2,0,3
E33007663,386,305,110,195,3,38,20,18,38,27,2,5,4,2
E33007664,338,294,130,164,6,14,1,13,20,17,1,1,1,4
E33007665,323,272,100,172,0,19,10,9,31,25,1,2,3,1
E33007666,433,347,91,256,1,40,24,16,40,32,0,4,4,5
E33007667,420,344,86,258,1,31,23,8,38,35,2,1,0,6
E33007668,430,331,102,229,4,34,21,13,57,50,1,4,2,4
E33007669,418,345,112,233,2,7,3,4,58,53,2,3,0,6
E33007670,249,211,84,127,0,13,5,8,24,18,0,0,6,1
E33007671,613,473,133,340,5,56,21,35,76,72,0,4,0,3
E33007672,574,461,162,299,3,32,13,19,72,67,0,5,0,6
E33007673,357,285,73,212,2,21,9,12,48,44,0,3,1,1
E33007674,649,520,200,320,5,46,12,34,74,66,2,6,0,4
E33007675,266,207,78,129,0,14,6,8,41,34,1,0,6,4
E33007676,499,414,148,266,4,23,8,15,53,48,1,3,1,5
E33007677,488,386,144,242,3,31,11,20,60,52,1,4,3,8
E33007678,316,270,90,180,2,15,3,12,27,18,0,7,2,2
E33007679,705,566,166,400,5,55,22,33,74,60,1,9,4,5
E33007680,264,218,65,153,0,20,12,8,26,24,0,1,1,0
E33007681,560,435,126,309,2,44,22,22,76,69,1,5,1,3
E33007682,579,454,123,331,5,36,17,19,83,77,0,6,0,1
E33007683,342,255,76,179,2,29,18,11,47,43,0,3,1,9
E33007684,829,640,185,455,7,76,32,44,102,89,0,12,1,4
E33007685,272,230,67,163,3,14,6,8,23,22,0,1,0,2
E33007686,391,304,89,215,5,20,8,12,60,54,0,6,0,2
E33007687,317,249,73,176,4,18,15,3,46,40,0,6,0,0
E33007688,382,318,105,213,1,33,19,14,29,25,1,3,0,1
E33007689,441,332,108,224,5,52,32,20,40,39,0,1,0,12
E33007690,252,221,67,154,1,9,1,8,20,19,1,0,0,1
E33007691,294,238,73,165,2,31,16,15,22,19,0,3,0,1
E33007692,302,223,69,154,5,27,12,15,46,41,0,2,3,1
E33007693,372,307,82,225,3,12,6,6,45,43,0,2,0,5
E33007694,504,410,114,296,7,30,8,22,54,49,1,3,1,3
E33007695,411,322,90,232,1,28,16,12,60,54,1,5,0,0
E33007696,289,220,47,173,2,46,25,21,20,17,1,2,0,1
E33007697,297,235,57,178,8,28,17,11,26,16,9,0,1,0
E33007698,350,273,72,201,8,51,28,23,17,17,0,0,0,1
E33007699,306,217,57,160,3,34,16,18,51,50,0,1,0,1
E33007700,255,229,74,155,1,3,1,2,22,17,4,0,1,0
E33007701,487,422,136,286,3,18,8,10,40,36,0,4,0,4
E33007702,392,344,110,234,1,8,2,6,36,35,0,1,0,3
E33007703,310,284,52,232,5,6,0,6,14,12,0,2,0,1
E33007704,348,289,57,232,4,14,6,8,39,37,0,2,0,2
E33007705,277,207,54,153,2,23,12,11,41,30,3,5,3,4
E33007706,279,248,95,153,0,5,4,1,24,21,0,3,0,2
E33007707,358,293,106,187,3,10,4,6,49,40,1,1,7,3
E33007708,352,295,105,190,4,10,3,7,40,36,0,4,0,3
E33007709,258,206,73,133,0,19,11,8,27,20,1,6,0,6
E33007710,468,376,142,234,0,27,13,14,56,44,5,7,0,9
E33007711,335,266,66,200,1,25,8,17,40,36,2,1,1,3
E33007712,331,263,93,170,1,22,11,11,41,38,2,1,0,4
E33007713,286,243,79,164,1,21,8,13,14,14,0,0,0,7
E33007714,456,371,117,254,2,18,8,10,63,51,3,5,4,2
E33007715,475,350,85,265,2,34,10,24,84,70,3,7,4,5
E33007716,449,358,86,272,2,43,20,23,45,42,0,3,0,1
E33007717,444,212,47,165,2,84,44,40,141,134,0,7,0,5
E33007718,367,277,51,226,1,27,13,14,55,49,2,4,0,7
E33007719,344,274,62,212,1,30,17,13,37,33,0,3,1,2
E33007720,568,441,105,336,8,52,28,24,66,63,0,3,0,1
E33007721,419,356,83,273,1,23,6,17,38,32,0,5,1,1
E33007722,218,188,46,142,1,19,12,7,10,9,0,1,0,0
E33007723,557,432,94,338,0,62,26,36,59,54,2,2,1,4
E33007724,399,321,106,215,0,35,22,13,43,36,2,5,0,0
E33007725,455,393,80,313,4,17,8,9,39,31,3,4,1,2
E33007726,290,192,46,146,1,54,29,25,43,42,0,1,0,0
E33007727,1219,921,235,686,6,135,54,81,150,132,2,16,0,7
E33007728,581,433,113,320,3,79,44,35,65,59,1,5,0,1
E33007729,674,521,160,361,2,90,37,53,57,48,3,6,0,4
E33007730,322,234,72,162,4,52,22,30,25,24,0,1,0,7
E33007731,772,602,167,435,2,67,16,51,94,80,3,7,4,7
E33007732,287,251,96,155,1,11,3,8,23,21,1,1,0,1
E33007733,233,184,80,104,1,17,6,11,29,28,0,1,0,2
E33007734,273,201,91,110,4,19,9,10,46,35,7,2,2,3
E33007735,648,487,176,311,12,35,17,18,106,90,1,9,6,8
E33007736,294,229,86,143,3,14,3,11,46,44,0,2,0,2
E33007737,459,347,99,248,11,25,4,21,69,58,2,6,3,7
E33007738,403,289,111,178,3,21,6,15,83,67,8,6,2,7
E33007739,556,436,154,282,0,52,9,43,59,46,0,12,1,9
E33007740,240,191,78,113,1,22,3,19,25,23,1,1,0,1
E33007741,245,195,74,121,0,17,4,13,28,25,0,3,0,5
E33007742,481,373,145,228,4,57,4,53,43,37,0,6,0,4
E33007743,207,147,56,91,1,24,2,22,34,29,1,2,2,1
E33007744,204,178,91,87,0,9,0,9,15,14,1,0,0,2
E33007745,322,270,110,160,0,20,3,17,31,27,3,1,0,1
E33007746,280,232,115,117,0,20,3,17,24,17,2,5,0,4
E33007747,247,203,104,99,1,17,3,14,20,18,1,1,0,6
E33007748,376,286,106,180,0,49,5,44,32,25,0,7,0,9
E33007749,296,256,123,133,0,10,1,9,24,19,0,5,0,6
E33007750,344,266,136,130,3,11,2,9,55,44,1,10,0,9
E33007751,513,425,239,186,8,17,4,13,49,33,3,11,2,14
E33007752,262,227,110,117,0,6,2,4,24,21,1,2,0,5
E33007753,287,245,136,109,0,6,3,3,32,24,2,6,0,4
E33007754,332,213,112,101,0,30,4,26,77,62,7,5,3,12
E33007755,385,301,149,152,1,22,6,16,53,41,0,6,6,8
E33007756,272,229,111,118,1,9,2,7,30,20,6,4,0,3
E33007757,629,483,147,336,4,94,16,78,44,40,0,4,0,4
E33007758,486,382,172,210,3,40,7,33,56,44,1,10,1,5
E33007759,308,257,123,134,2,16,1,15,28,22,2,4,0,5
E33007760,342,264,131,133,7,19,1,18,43,32,1,9,1,9
E33007761,292,252,121,131,1,16,1,15,21,20,0,1,0,2
E33007762,356,273,155,118,0,20,0,20,43,39,1,1,2,20
E33007763,254,205,106,99,1,22,3,19,22,18,0,4,0,4
E33007764,371,307,107,200,4,27,3,24,27,23,1,2,1,6
E33007765,335,228,87,141,1,64,8,56,39,39,0,0,0,3
E33007766,324,243,95,148,1,43,6,37,34,31,0,3,0,3
E33007767,301,240,82,158,0,31,6,25,28,27,0,1,0,2
E33007768,415,309,124,185,0,61,10,51,36,32,0,4,0,9
E33007769,607,405,144,261,1,102,12,90,97,94,0,2,1,2
E33007770,446,289,100,189,0,99,13,86,49,36,3,8,2,9
E33007771,401,291,99,192,0,73,6,67,32,30,0,1,1,5
E33007772,308,259,128,131,2,16,5,11,25,21,0,4,0,6
E33007773,246,211,93,118,1,15,3,12,16,10,0,4,2,3
E33007774,325,254,99,155,0,29,5,24,34,30,0,4,0,8
E33007775,276,220,94,126,0,26,8,18,29,27,0,2,0,1
E33007776,844,647,253,394,4,65,8,57,118,107,1,7,3,10
E33007777,323,267,87,180,1,23,4,19,29,22,2,4,1,3
E33007778,298,219,78,141,4,43,4,39,32,25,1,5,1,0
E33007779,391,305,89,216,11,34,3,31,40,34,0,6,0,1
E33007780,277,228,111,117,1,23,3,20,24,20,0,3,1,1
E33007781,413,298,119,179,2,45,12,33,60,56,1,1,2,8
E33007782,362,251,112,139,3,29,6,23,65,54,5,1,5,14
E33007783,279,198,108,90,4,28,1,27,47,32,4,7,4,2
E33007784,433,342,102,240,0,50,9,41,40,36,0,2,2,1
E33007785,405,318,90,228,0,49,9,40,32,30,0,2,0,6
E33007786,418,335,111,224,1,30,6,24,48,46,0,2,0,4
E33007787,262,216,95,121,2,15,3,12,25,23,0,1,1,4
E33007788,276,223,78,145,0,35,7,28,18,16,0,2,0,0
E33007789,255,136,52,84,0,89,16,73,27,21,0,6,0,3
E33007790,728,604,195,409,2,91,17,74,30,23,1,3,3,1
E33007791,405,300,106,194,3,46,4,42,46,37,1,8,0,10
E33007792,772,626,184,442,1,71,15,56,67,59,1,4,3,7
E33007793,322,242,90,152,0,54,11,43,23,16,2,0,5,3
E33007794,402,294,110,184,3,68,9,59,36,31,0,5,0,1
E33007795,346,261,90,171,0,52,4,48,29,24,0,3,2,4
E33007796,345,284,96,188,1,34,5,29,19,19,0,0,0,7
E33007797,311,241,86,155,1,40,5,35,28,26,0,2,0,1
E33007798,434,343,134,209,1,58,11,47,23,22,0,1,0,9
E33007799,234,190,79,111,1,17,1,16,24,23,1,0,0,2
E33007800,324,240,96,144,2,41,12,29,33,26,3,1,3,8
E33007801,423,276,108,168,5,52,10,42,75,49,5,10,11,15
E33007802,244,158,64,94,3,45,10,35,38,33,1,3,1,0
E33007803,305,195,76,119,2,66,16,50,37,29,3,3,2,5
E33007804,217,146,73,73,4,22,7,15,40,35,3,1,1,5
E33007805,439,282,125,157,6,64,17,47,70,57,2,6,5,17
E33007806,235,145,63,82,1,33,2,31,45,34,3,3,5,11
E33007807,271,201,100,101,3,19,5,14,45,32,3,8,2,3
E33007808,277,252,94,158,1,5,4,1,19,19,0,0,0,0
E33007809,297,262,87,175,4,6,4,2,23,19,0,4,0,2
E33007810,273,234,76,158,0,6,6,0,28,20,3,4,1,5
E33007811,278,237,80,157,0,7,5,2,33,28,0,5,0,1
E33007812,407,303,89,214,1,26,20,6,76,67,0,8,1,1
E33007813,417,349,97,252,1,17,15,2,42,39,0,3,0,8
E33007814,268,227,85,142,0,10,8,2,29,24,4,1,0,2
E33007815,365,281,103,178,0,18,14,4,61,50,3,7,1,5
E33007816,2561,2214,653,1561,3,86,67,19,245,198,25,14,8,13
E33007817,594,521,151,370,1,14,12,2,52,47,0,4,1,6
E33007818,249,221,84,137,1,9,9,0,18,17,0,1,0,0
E33007819,482,387,89,298,0,24,19,5,66,56,0,10,0,5
E33007820,415,321,78,243,1,29,23,6,63,57,2,4,0,1
E33007821,281,227,68,159,0,28,28,0,23,20,2,1,0,3
E33007822,1270,1103,254,849,1,53,43,10,106,101,0,3,2,7
E33007823,311,261,68,193,2,15,12,3,27,27,0,0,0,6
E33007824,389,328,75,253,0,18,16,2,38,35,0,3,0,5
E33007825,522,440,124,316,0,26,20,6,54,54,0,0,0,2
E33007826,350,299,85,214,0,13,7,6,38,34,0,2,2,0
E33007827,314,232,84,148,1,27,23,4,51,49,0,0,2,3
E33007828,437,383,116,267,0,22,18,4,30,29,0,1,0,2
E33007829,293,265,77,188,1,4,4,0,21,19,0,2,0,2
E33007830,375,312,91,221,2,28,22,6,33,28,0,5,0,0
E33007831,354,299,89,210,1,16,13,3,34,27,0,6,1,4
E33007832,252,184,52,132,0,18,12,6,43,38,3,1,1,7
E33007833,428,318,70,248,0,41,32,9,56,44,1,11,0,13
E33007834,258,180,55,125,0,23,13,10,53,47,3,3,0,2
E33007835,266,215,66,149,0,6,5,1,41,39,0,2,0,4
E33007836,293,220,66,154,0,21,16,5,51,44,1,4,2,1
E33007837,301,241,57,184,0,18,7,11,42,29,0,10,3,0
E33007838,437,317,106,211,2,42,29,13,73,65,0,8,0,3
E33007839,358,237,52,185,0,37,24,13,84,72,3,5,4,0
E33007840,256,198,55,143,0,14,10,4,42,39,0,2,1,2
E33007841,306,229,79,150,0,16,13,3,56,51,0,5,0,5
E33007842,527,445,123,322,2,31,23,8,47,38,1,7,1,2
E33007843,384,302,84,218,0,12,9,3,69,61,0,8,0,1
E33007844,232,185,58,127,0,7,5,2,35,33,0,1,1,5
E33007845,501,441,132,309,0,16,14,2,41,32,1,8,0,3
E33007846,445,319,129,190,2,36,8,28,84,75,3,5,1,4
E33007847,337,274,144,130,0,14,1,13,41,38,0,3,0,8
E33007848,549,405,177,228,0,37,4,33,96,87,1,7,1,11
E33007849,235,194,110,84,1,9,0,9,21,19,1,1,0,10
E33007850,283,232,107,125,0,16,3,13,32,29,1,2,0,3
E33007851,539,417,152,265,0,45,9,36,74,62,4,6,2,3
E33007852,566,396,137,259,3,80,14,66,82,67,6,7,2,5
E33007853,235,180,90,90,1,12,3,9,39,35,0,4,0,3
E33007854,633,383,87,296,4,23,7,16,217,77,75,8,57,6
E33007855,438,337,126,211,1,29,7,22,65,57,6,1,1,6
E33007856,478,375,113,262,1,39,1,38,57,53,2,2,0,6
E33007857,239,180,71,109,0,17,4,13,39,34,0,4,1,3
E33007858,522,370,135,235,2,48,23,25,88,75,4,9,0,14
E33007859,256,200,68,132,3,8,1,7,42,36,2,4,0,3
E33007860,295,252,83,169,2,15,1,14,21,17,0,4,0,5
E33007861,405,324,65,259,1,18,3,15,58,51,0,5,2,4
E33007862,555,443,155,288,2,44,10,34,57,52,0,5,0,9
E33007863,354,290,91,199,1,20,2,18,39,32,0,7,0,4
E33007864,277,233,73,160,0,13,1,12,29,26,0,3,0,2
E33007865,541,411,132,279,3,37,6,31,87,75,2,9,1,3
E33007866,458,329,121,208,0,38,10,28,90,81,0,4,5,1
E33007867,401,329,107,222,1,27,6,21,42,37,0,4,1,2
E33007868,710,543,188,355,13,35,4,31,112,104,2,6,0,7
E33007869,336,277,114,163,2,5,1,4,49,44,0,4,1,3
E33007870,441,368,187,181,1,19,0,19,45,34,2,5,4,8
E33007871,587,490,174,316,0,25,4,21,64,58,2,4,0,8
E33007872,458,345,96,249,3,46,12,34,59,58,0,1,0,5
E33007873,216,153,37,116,3,14,4,10,42,37,0,5,0,4
E33007874,241,175,72,103,0,17,6,11,48,42,1,5,0,1
E33007875,504,386,109,277,1,29,6,23,83,73,1,8,1,5
E33007876,224,167,66,101,0,10,3,7,44,37,1,3,3,3
E33007877,400,289,96,193,2,28,3,25,78,67,0,6,5,3
E33007878,869,635,202,433,1,83,11,72,147,137,1,9,0,3
E33007879,290,231,107,124,1,12,4,8,38,35,0,3,0,8
E33007880,357,283,122,161,2,13,2,11,50,39,4,7,0,9
E33007881,295,235,87,148,1,21,1,20,30,27,2,0,1,8
E33007882,241,170,99,71,0,6,2,4,60,50,2,4,4,5
E33007883,247,203,100,103,0,3,0,3,39,32,5,0,2,2
E33007884,227,188,58,130,0,8,0,8,30,23,3,4,0,1
E33007885,553,457,170,287,4,16,4,12,65,58,1,6,0,11
E33007886,257,188,45,143,0,23,3,20,44,37,1,6,0,2
E33007887,1089,882,236,646,1,82,19,63,118,106,1,10,1,6
E33007888,244,154,42,112,0,30,7,23,60,55,0,4,1,0
E33007889,373,224,60,164,1,52,10,42,92,85,1,5,1,4
E33007890,317,244,64,180,1,42,10,32,30,27,0,3,0,0
E33007891,368,275,84,191,1,47,10,37,38,29,2,7,0,7
E33007892,409,279,71,208,2,59,8,51,63,58,0,5,0,6
E33007893,247,185,63,122,0,23,2,21,36,30,0,3,3,3
E33007894,443,316,103,213,2,38,4,34,84,77,2,5,0,3
E33007895,508,335,118,217,0,63,28,35,106,94,3,4,5,4
E33007896,289,209,68,141,1,31,7,24,42,36,1,5,0,6
E33007897,317,218,65,153,1,26,7,19,70,64,0,6,0,2
E33007898,255,183,50,133,0,17,4,13,52,45,0,7,0,3
E33007899,275,192,62,130,0,24,4,20,58,56,0,2,0,1
E33007900,684,551,138,413,5,60,8,52,62,56,0,6,0,6
E33007901,359,279,73,206,1,28,11,17,50,46,1,3,0,1
E33007902,402,308,85,223,2,57,19,38,33,29,0,4,0,2
E33007903,297,214,76,138,1,42,10,32,38,35,0,3,0,2
E33007904,377,287,90,197,2,38,8,30,42,38,1,3,0,8
E33007905,381,296,83,213,1,40,10,30,40,38,0,2,0,4
E33007906,425,345,111,234,1,26,4,22,50,41,2,7,0,3
E33007907,345,264,106,158,1,23,4,19,47,38,3,4,2,10
E33007908,346,268,116,152,4,26,10,16,42,34,0,4,4,6
E33007909,636,537,208,329,0,24,6,18,71,64,3,4,0,4
E33007910,233,196,65,131,0,15,3,12,21,20,1,0,0,1
E33007911,300,214,100,114,1,15,6,9,61,49,1,2,9,9
E33007912,930,753,214,539,5,44,4,40,124,117,2,5,0,4
E33007913,653,504,145,359,0,32,7,25,111,99,6,6,0,6
E33007914,319,235,98,137,0,52,20,32,29,22,0,7,0,3
E33007915,277,199,70,129,1,42,15,27,33,31,1,1,0,2
E33007916,455,377,154,223,1,43,12,31,30,27,0,3,0,4
E33007917,241,196,48,148,0,25,10,15,19,15,1,3,0,1
E33007918,619,471,146,325,0,91,36,55,53,46,3,4,0,4
E33007919,731,544,152,392,0,108,52,56,74,58,2,14,0,5
E33007920,331,268,76,192,0,34,14,20,25,20,1,3,1,4
E33007921,489,404,150,254,0,50,17,33,32,28,3,1,0,3
E33007922,819,693,221,472,1,51,22,29,70,57,2,9,2,4
E33007923,306,224,72,152,0,50,18,32,29,24,2,2,1,3
E33007924,1958,1676,492,1184,2,108,39,69,166,123,15,13,15,6
E33007925,380,297,90,207,0,52,22,30,29,26,0,3,0,2
E33007926,254,186,65,121,0,42,15,27,24,21,1,2,0,2
E33007927,281,201,77,124,0,51,14,37,24,20,0,4,0,5
E33007928,345,263,98,165,0,54,19,35,27,23,0,4,0,1
E33007929,425,286,130,156,1,66,19,47,62,51,2,5,4,10
E33007930,232,189,105,84,2,6,2,4,26,20,2,3,1,9
E33007931,317,253,91,162,4,33,12,21,26,21,0,5,0,1
E33007932,254,196,76,120,0,34,13,21,19,18,0,1,0,5
E33007933,393,292,75,217,0,76,41,35,20,16,0,3,1,5
E33007934,383,275,91,184,0,66,28,38,40,32,0,6,2,2
E33007935,313,188,58,130,2,83,44,39,39,27,1,10,1,1
E33007936,295,227,62,165,0,39,19,20,25,21,0,3,1,4
E33007937,293,229,96,133,2,31,13,18,29,24,0,5,0,2
E33007938,949,811,227,584,1,67,26,41,66,57,0,9,0,4
E33007939,608,467,147,320,0,79,25,54,59,49,2,7,1,3
E33007940,222,178,60,118,0,30,15,15,11,8,0,2,1,3
E33007941,345,233,103,130,0,28,8,20,65,61,0,2,2,19
E33007942,431,360,142,218,1,30,6,24,35,34,0,1,0,5
E33007943,346,311,105,206,0,16,6,10,19,16,1,2,0,0
E33007944,293,242,95,147,1,18,8,10,27,23,2,2,0,5
E33007945,234,182,66,116,0,15,11,4,33,26,5,2,0,4
E33007946,228,179,78,101,0,20,17,3,24,16,0,6,2,5
E33007947,211,186,69,117,0,5,2,3,18,16,0,2,0,2
E33007948,340,240,96,144,0,30,7,23,62,52,0,6,4,8
E33007949,275,236,76,160,0,18,7,11,18,16,1,0,1,3
E33007950,304,247,92,155,1,25,6,19,30,26,0,4,0,1
E33007951,311,228,84,144,1,37,7,30,42,37,0,5,0,3
E33007952,294,213,122,91,2,11,1,10,62,51,5,3,3,6
E33007953,262,192,102,90,0,25,5,20,36,32,0,4,0,9
E33007954,421,339,143,196,2,23,7,16,49,46,0,3,0,8
E33007955,394,314,124,190,1,25,3,22,50,42,2,6,0,4
E33007956,540,455,138,317,0,25,10,15,55,48,0,6,1,5
E33007957,384,292,186,106,2,14,3,11,60,54,1,3,2,16
E33007958,456,298,127,171,8,34,9,25,103,87,13,3,0,13
E33007959,549,435,232,203,3,24,1,23,62,50,3,7,2,25
E33007960,492,371,193,178,2,34,9,25,73,66,1,6,0,12
E33007961,366,275,120,155,0,36,3,33,53,48,1,3,1,2
E33007962,414,315,170,145,6,15,3,12,66,55,5,4,2,12
E33007963,805,568,205,363,6,82,43,39,134,124,2,8,0,15
E33007964,420,343,146,197,5,10,2,8,52,48,2,2,0,10
E33007965,472,350,150,200,1,15,2,13,94,83,2,7,2,12
E33007966,551,352,134,218,14,47,15,32,119,108,1,10,0,19
E33007967,345,250,107,143,0,28,4,24,58,54,2,2,0,9
E33007968,288,191,90,101,1,16,3,13,65,61,3,1,0,15
E33007969,367,266,97,169,3,39,6,33,57,48,1,8,0,2
E33007970,589,372,144,228,7,61,9,52,141,131,3,6,1,8
E33007971,782,491,150,341,12,105,16,89,170,154,3,12,1,4
E33007972,267,186,57,129,4,16,2,14,59,54,0,5,0,2
E33007973,680,503,181,322,7,64,12,52,102,87,4,9,2,4
E33007974,425,332,135,197,1,24,7,17,53,49,0,4,0,15
E33007975,533,397,139,258,7,28,6,22,97,81,5,10,1,4
E33007976,272,217,89,128,5,12,5,7,36,34,1,1,0,2
E33007977,396,279,116,163,4,19,5,14,88,67,5,14,2,6
E33007978,289,206,77,129,1,31,6,25,50,43,1,5,1,1
E33007979,481,345,114,231,5,43,8,35,81,73,0,3,5,7
E33007980,351,253,90,163,3,32,5,27,58,49,2,5,2,5
E33007981,259,220,75,145,0,17,0,17,19,18,0,1,0,3
E33007982,477,289,146,143,8,52,13,39,113,86,18,7,2,15
E33007983,755,505,207,298,7,38,2,36,194,171,6,15,2,11
E33007984,280,203,111,92,4,6,1,5,50,40,5,4,1,17
E33007985,259,141,82,59,1,30,3,27,70,50,16,4,0,17
E33007986,396,224,123,101,1,38,5,33,118,96,9,0,13,15
E33007987,388,295,121,174,5,25,5,20,58,51,1,4,2,5
E33007988,345,241,112,129,5,19,2,17,68,67,0,1,0,12
E33007989,506,372,151,221,2,34,3,31,91,76,5,9,1,7
E33007990,383,299,168,131,4,5,0,5,57,50,2,5,0,18
E33007991,453,337,132,205,16,31,7,24,66,60,0,5,1,3
E33007992,577,439,227,212,8,29,5,24,87,79,1,5,2,14
E33007993,285,198,76,122,1,19,4,15,58,51,0,5,2,9
E33007994,237,159,74,85,6,7,0,7,62,56,0,6,0,3
E33007995,305,210,100,110,2,18,4,14,74,67,0,4,3,1
E33007996,206,151,75,76,4,9,1,8,38,34,2,2,0,4
E33007997,277,199,100,99,1,35,8,27,34,30,0,1,3,8
E33007998,755,524,264,260,4,50,6,44,159,144,4,10,1,18
E33007999,454,309,195,114,3,19,3,16,101,90,1,9,1,22
E33008000,476,359,214,145,3,17,1,16,83,63,2,11,7,14
E33008001,594,432,191,241,5,26,7,19,122,109,2,9,2,9
E33008002,316,242,144,98,1,5,0,5,58,47,6,5,0,10
E33008003,276,212,104,108,0,23,3,20,35,31,0,3,1,6
E33008004,420,309,159,150,1,21,6,15,72,63,0,8,1,17
E33008005,521,315,104,211,2,60,24,36,136,116,12,6,2,8
E33008006,257,146,74,72,1,39,14,25,66,56,1,9,0,5
E33008007,464,283,107,176,3,51,31,20,117,104,7,5,1,10
E33008008,282,176,75,101,2,30,16,14,68,61,3,3,1,6
E33008009,336,184,84,100,2,54,22,32,78,69,4,2,3,18
E33008010,413,206,83,123,2,94,19,75,101,61,22,10,8,10
E33008011,277,194,66,128,3,20,8,12,49,41,7,1,0,11
E33008012,233,147,66,81,1,34,8,26,42,39,0,2,1,9
E33008013,360,204,88,116,3,54,20,34,90,77,7,4,2,9
E33008014,253,198,71,127,1,23,11,12,29,19,6,2,2,2
E33008015,254,171,73,98,0,27,16,11,51,43,1,5,2,5
E33008016,298,220,76,144,2,24,16,8,51,42,3,4,2,1
E33008017,431,293,119,174,4,20,9,11,107,89,13,5,0,7
E33008018,293,197,57,140,0,47,37,10,49,43,0,5,1,0
E33008019,292,224,104,120,0,17,8,9,47,41,0,6,0,4
E33008020,533,406,153,253,4,34,19,15,83,78,0,5,0,6
E33008021,213,128,47,81,0,15,10,5,67,58,5,4,0,3
E33008022,428,241,96,145,2,41,21,20,135,131,1,3,0,9
E33008023,641,495,175,320,1,37,25,12,103,93,0,6,4,5
E33008024,349,267,80,187,1,31,18,13,47,41,1,5,0,3
E33008025,726,586,195,391,2,69,28,41,64,56,0,8,0,5
E33008026,358,272,119,153,0,19,15,4,59,49,2,6,2,8
E33008027,338,259,99,160,2,33,28,5,42,40,1,1,0,2
E33008028,310,240,98,142,2,26,19,7,38,35,0,3,0,4
E33008029,390,256,88,168,2,58,44,14,71,68,0,3,0,3
E33008030,487,351,120,231,2,57,33,24,72,61,0,11,0,5
E33008031,523,381,141,240,2,52,40,12,82,69,0,12,1,6
E33008032,317,199,54,145,0,40,35,5,71,60,0,7,4,7
E33008033,598,438,119,319,4,36,20,16,109,99,0,6,4,11
E33008034,576,403,144,259,6,46,35,11,113,103,3,7,0,8
E33008035,320,262,117,145,3,11,5,6,40,31,0,9,0,4
E33008036,447,364,117,247,2,12,8,4,67,61,1,5,0,2
E33008037,277,213,77,136,1,16,11,5,44,40,0,4,0,3
E33008038,350,299,107,192,0,8,6,2,37,34,0,3,0,6
E33008039,259,198,103,95,0,10,9,1,43,38,0,5,0,8
E33008040,270,207,91,116,3,12,5,7,46,38,0,8,0,2
E33008041,369,312,115,197,0,19,12,7,35,30,0,5,0,3
E33008042,306,249,98,151,1,24,14,10,32,31,1,0,0,0
E33008043,304,253,93,160,4,7,3,4,37,35,0,2,0,3
E33008044,291,226,74,152,0,16,11,5,47,42,2,3,0,2
E33008045,1142,959,331,628,5,45,33,12,125,113,1,9,2,8
E33008046,330,254,107,147,3,6,4,2,61,46,5,9,1,6
E33008047,317,236,99,137,1,17,10,7,59,52,0,4,3,4
E33008048,229,175,82,93,5,7,5,2,41,39,0,2,0,1
E33008049,371,176,89,87,2,54,12,42,121,95,12,5,9,18
E33008050,255,202,85,117,1,19,15,4,29,28,0,1,0,4
E33008051,273,141,63,78,2,33,7,26,83,76,4,2,1,14
E33008052,268,203,112,91,2,10,9,1,46,42,1,2,1,7
E33008053,254,189,69,120,0,10,6,4,52,42,4,2,4,3
E33008054,261,190,100,90,1,8,8,0,50,45,3,2,0,12
E33008055,397,305,143,162,3,24,18,6,51,43,0,7,1,14
E33008056,338,220,97,123,3,28,11,17,77,53,11,7,6,10
E33008057,320,243,134,109,3,13,6,7,57,49,1,5,2,4
E33008058,364,209,91,118,2,36,8,28,106,78,18,3,7,11
E33008059,462,358,134,224,3,32,14,18,63,54,1,7,1,6
E33008060,236,181,92,89,0,17,11,6,35,26,1,4,4,3
E33008061,268,201,98,103,1,8,2,6,55,52,0,3,0,3
E33008062,217,163,86,77,1,15,10,5,34,28,5,1,0,4
E33008063,596,433,172,261,7,21,14,7,120,108,2,10,0,15
E33008064,407,304,151,153,4,17,10,7,73,63,1,8,1,9
E33008065,465,306,130,176,2,37,26,11,100,67,21,11,1,20
E33008066,468,349,121,228,9,23,13,10,72,65,2,5,0,15
E33008067,301,203,87,116,2,6,3,3,70,56,5,8,1,20
E33008068,273,205,117,88,1,13,5,8,42,34,2,6,0,12
E33008069,327,259,88,171,2,11,7,4,50,42,1,7,0,5
E33008070,418,324,127,197,5,24,16,8,52,45,1,6,0,13
E33008071,266,215,91,124,3,13,8,5,33,30,0,3,0,2
E33008072,407,329,112,217,3,6,5,1,65,56,2,7,0,4
E33008073,315,251,135,116,3,6,3,3,47,44,0,3,0,8
E33008074,592,461,181,280,4,22,12,10,93,80,2,9,2,12
E33008075,311,220,86,134,5,18,13,5,59,51,1,7,0,9
E33008076,664,504,189,315,2,24,18,6,118,91,15,7,5,16
E33008077,314,238,95,143,1,20,16,4,44,39,2,3,0,11
E33008078,389,318,97,221,1,32,23,9,37,32,0,4,1,1
E33008079,371,304,111,193,6,16,12,4,43,37,4,2,0,2
E33008080,301,234,75,159,2,21,18,3,42,35,3,3,1,2
E33008081,448,336,118,218,2,37,27,10,67,61,2,4,0,6
E33008082,229,181,79,102,0,11,10,1,36,31,0,2,3,1
E33008083,250,206,99,107,1,10,9,1,33,28,0,5,0,0
E33008084,294,225,61,164,0,26,23,3,42,39,0,3,0,1
E33008085,228,179,70,109,1,11,9,2,35,31,2,2,0,2
E33008086,359,306,117,189,0,17,15,2,33,29,0,3,1,3
E33008087,301,255,96,159,0,9,7,2,35,34,0,1,0,2
E33008088,413,337,96,241,1,35,30,5,39,36,2,1,0,1
E33008089,187,153,60,93,1,9,9,0,22,16,5,1,0,2
E33008090,393,318,127,191,1,23,18,5,46,40,0,5,1,5
E33008091,536,433,110,323,1,29,23,6,71,61,3,7,0,2
E33008092,281,233,63,170,1,18,10,8,27,26,0,1,0,2
E33008093,249,167,68,99,0,10,8,2,61,52,5,3,1,11
E33008094,647,510,239,271,1,36,30,6,84,75,3,5,1,16
E33008095,251,210,94,116,0,7,6,1,28,24,1,3,0,6
E33008096,279,192,77,115,1,19,11,8,65,57,1,5,2,2
E33008097,318,249,120,129,1,22,12,10,42,36,1,4,1,4
E33008098,280,178,87,91,1,13,4,9,72,62,4,6,0,16
E33008099,512,399,175,224,3,26,14,12,73,59,7,7,0,11
E33008100,437,365,137,228,6,13,10,3,45,41,0,0,4,8
E33008101,320,260,109,151,3,20,11,9,31,29,1,1,0,6
E33008102,292,256,96,160,0,14,10,4,18,16,0,1,1,4
E33008103,457,372,134,238,0,34,19,15,46,43,2,1,0,5
E33008104,288,231,64,167,1,21,6,15,34,28,2,4,0,1
E33008105,287,231,89,142,0,17,6,11,36,34,0,1,1,3
E33008106,398,335,106,229,1,19,7,12,42,39,0,2,1,1
E33008107,251,175,49,126,0,5,2,3,61,55,0,5,1,10
E33008108,410,296,87,209,2,21,6,15,90,85,0,5,0,1
E33008109,260,189,61,128,3,16,0,16,51,44,1,5,1,1
E33008110,316,245,83,162,0,8,5,3,61,55,0,5,1,2
E33008111,2325,1941,550,1391,2,95,36,59,276,239,3,30,4,11
E33008112,509,388,123,265,0,43,15,28,72,66,1,3,2,6
E33008113,332,234,96,138,0,18,6,12,72,63,0,7,2,8
E33008114,285,224,73,151,1,15,4,11,40,37,0,3,0,5
E33008115,577,439,164,275,2,45,16,29,82,74,0,8,0,9
E33008116,506,385,135,250,1,28,5,23,87,77,1,9,0,5
E33008117,285,222,111,111,3,16,4,12,39,37,0,2,0,5
E33008118,686,523,171,352,3,41,13,28,109,96,0,13,0,10
E33008119,225,169,62,107,2,11,4,7,42,35,1,4,2,1
E33008120,425,340,104,236,0,23,6,17,58,56,0,2,0,4
E33008121,283,200,52,148,0,34,16,18,46,43,0,3,0,3
E33008122,253,186,53,133,0,22,9,13,44,40,0,4,0,1
E33008123,264,183,58,125,0,20,6,14,59,53,1,5,0,2
E33008124,600,474,129,345,0,40,15,25,83,76,0,6,1,3
E33008125,378,287,79,208,0,36,12,24,49,45,0,3,1,6
E33008126,324,294,84,210,1,4,1,3,25,24,0,1,0,0
E33008127,304,261,73,188,0,8,4,4,34,27,0,7,0,1
E33008128,356,270,89,181,0,34,8,26,52,43,1,7,1,0
E33008129,308,221,53,168,1,20,9,11,60,54,0,5,1,6
E33008130,287,206,54,152,0,23,3,20,53,50,0,3,0,5
E33008131,461,329,86,243,0,35,8,27,96,85,1,10,0,1
E33008132,324,245,69,176,0,15,3,12,63,59,1,3,0,1
E33008133,641,460,170,290,1,55,17,38,115,105,0,9,1,10
E33008134,554,435,134,301,5,29,8,21,82,76,0,6,0,3
E33008135,315,242,74,168,1,19,4,15,51,42,0,9,0,2
E33008136,599,439,114,325,3,38,15,23,116,106,0,9,1,3
E33008137,328,284,93,191,0,22,8,14,21,20,0,1,0,1
E33008138,391,307,78,229,0,35,15,20,47,42,0,5,0,2
E33008139,295,244,104,140,0,5,4,1,41,38,2,1,0,5
E33008140,713,585,179,406,2,25,9,16,94,85,0,7,2,7
E33008141,277,225,86,139,3,4,3,1,41,35,0,5,1,4
E33008142,307,233,61,172,3,34,9,25,34,29,0,5,0,3
E33008143,300,232,61,171,1,15,9,6,51,47,0,3,1,1
E33008144,307,234,84,150,0,24,8,16,48,44,0,2,2,1
E33008145,352,278,89,189,3,35,16,19,36,29,0,7,0,0
E33008146,225,169,55,114,0,25,7,18,30,28,0,2,0,1
E33008147,619,446,129,317,1,55,16,39,108,96,2,10,0,9
E33008148,233,169,61,108,0,17,3,14,47,42,1,3,1,0
E33008149,1046,875,239,636,4,43,16,27,124,115,0,8,1,0
E33008150,362,325,97,228,0,11,0,11,24,23,0,1,0,2
E33008151,300,230,67,163,0,23,6,17,46,43,0,2,1,1
E33008152,421,344,87,257,0,13,2,11,63,60,0,3,0,1
E33008153,578,465,145,320,1,32,16,16,78,71,0,6,1,2
E33008154,324,197,39,158,4,67,10,57,53,47,1,2,3,3
E33008155,255,187,50,137,0,39,3,36,27,22,0,0,5,2
E33008156,674,422,137,285,5,166,12,154,78,71,0,5,2,3
E33008157,297,239,96,143,2,16,6,10,40,31,0,7,2,0
E33008158,458,354,142,212,0,25,5,20,71,64,0,6,1,8
E33008159,396,324,121,203,2,34,13,21,33,29,1,2,1,3
E33008160,329,274,104,170,0,21,4,17,31,26,0,2,3,3
E33008161,434,330,109,221,3,31,11,20,64,61,0,2,1,6
E33008162,293,246,71,175,0,19,0,19,27,26,0,1,0,1
E33008163,598,472,149,323,2,52,10,42,72,62,0,10,0,0
E33008164,317,271,74,197,1,16,2,14,26,21,1,3,1,3
E33008165,400,329,95,234,1,26,1,25,42,27,7,5,3,2
E33008166,296,245,60,185,4,22,4,18,25,24,0,1,0,0
E33008167,408,325,93,232,3,28,10,18,49,48,0,1,0,3
E33008168,247,211,75,136,0,13,4,9,23,19,0,3,1,0
E33008169,381,304,89,215,2,28,10,18,44,37,0,7,0,3
E33008170,614,506,145,361,1,30,9,21,73,66,0,6,1,4
E33008171,761,653,215,438,2,41,17,24,61,57,1,3,0,4
E33008172,411,335,114,221,0,24,3,21,49,42,2,4,1,3
E33008173,408,352,109,243,2,18,6,12,31,26,0,5,0,5
E33008174,369,328,91,237,0,12,1,11,26,20,1,4,1,3
E33008175,282,229,72,157,2,21,10,11,29,27,0,2,0,1
E33008176,277,202,51,151,1,43,16,27,30,27,0,3,0,1
E33008177,356,312,101,211,0,21,8,13,22,20,0,2,0,1
E33008178,333,237,73,164,0,34,9,25,57,55,0,2,0,5
E33008179,267,189,47,142,1,32,14,18,43,39,0,4,0,2
E33008180,243,162,48,114,0,29,4,25,50,42,1,7,0,2
E33008181,281,215,71,144,3,23,4,19,38,31,0,6,1,2
E33008182,296,212,56,156,0,33,7,26,49,39,3,6,1,2
E33008183,238,197,52,145,2,10,5,5,27,25,0,2,0,2
E33008184,348,308,99,209,2,15,2,13,20,16,0,4,0,3
E33008185,323,239,79,160,2,5,2,3,76,73,0,3,0,1
E33008186,286,225,96,129,3,23,5,18,31,27,0,4,0,4
E33008187,237,215,86,129,0,6,5,1,16,14,0,2,0,0
E33008188,300,249,81,168,0,16,1,15,30,26,3,1,0,5
E33008189,317,266,104,162,1,8,2,6,38,31,2,5,0,4
E33008190,604,431,91,340,5,44,13,31,122,116,0,4,2,2
E33008191,311,224,76,148,2,49,3,46,33,32,0,0,1,3
E33008192,302,252,74,178,2,20,4,16,25,20,0,5,0,3
E33008193,251,214,78,136,2,14,0,14,19,19,0,0,0,2
E33008194,280,243,86,157,2,11,5,6,23,21,0,2,0,1
E33008195,281,219,75,144,1,30,6,24,28,24,0,2,2,3
E33008196,651,493,155,338,9,66,21,45,79,73,0,6,0,4
E33008197,274,217,64,153,2,22,6,16,30,26,0,2,2,3
E33008198,468,369,112,257,2,46,18,28,48,44,0,4,0,3
E33008199,657,532,150,382,2,46,14,32,71,64,0,7,0,6
E33008200,288,244,66,178,1,11,4,7,30,24,1,5,0,2
E33008201,259,225,71,154,2,16,6,10,14,14,0,0,0,2
E33008202,267,202,59,143,0,18,7,11,45,35,0,9,1,2
E33008203,549,337,90,247,3,86,37,49,118,108,0,10,0,5
E33008204,291,254,73,181,0,13,4,9,24,20,1,3,0,0
E33008205,528,426,116,310,0,30,4,26,71,63,2,6,0,1
E33008206,421,348,123,225,0,22,9,13,49,42,1,6,0,2
E33008207,324,270,100,170,5,19,4,15,30,26,1,1,2,0
E33008208,349,292,105,187,1,22,6,16,33,29,1,3,0,1
E33008209,354,271,84,187,3,30,13,17,44,41,0,3,0,6
E33008210,269,238,82,156,1,3,2,1,25,21,2,2,0,2
E33008211,245,204,83,121,0,11,5,6,26,23,0,3,0,4
E33008212,273,235,68,167,4,9,2,7,23,22,0,1,0,2
E33008213,389,268,69,199,4,53,20,33,60,53,0,7,0,4
E33008214,394,315,83,232,2,18,4,14,58,54,0,4,0,1
E33008215,465,373,99,274,3,39,13,26,46,44,0,1,1,4
E33008216,255,206,45,161,0,25,12,13,22,20,0,1,1,2
E33008217,276,209,66,143,2,25,10,15,35,32,0,1,2,5
E33008218,308,248,71,177,0,24,11,13,35,32,0,2,1,1
E33008219,354,303,96,207,1,19,5,14,22,22,0,0,0,9
E33008220,505,388,107,281,3,57,24,33,54,50,0,4,0,3
E33008221,325,274,97,177,1,18,10,8,29,29,0,0,0,3
E33008222,349,297,103,194,1,13,4,9,34,29,0,3,2,4
E33008223,438,344,102,242,0,30,10,20,56,48,0,6,2,8
E33008224,485,399,157,242,2,19,6,13,57,50,0,7,0,8
E33008225,215,177,63,114,1,13,5,8,24,20,1,2,1,0
E33008226,593,489,138,351,2,25,17,8,76,61,1,9,5,1
E33008227,558,469,158,311,6,9,0,9,71,61,0,10,0,3
E33008228,696,423,96,327,1,46,14,32,220,78,88,4,50,6
E33008229,370,283,115,168,4,21,3,18,51,43,2,4,2,11
E33008230,230,194,76,118,0,5,3,2,24,19,1,2,2,7
E33008231,384,302,76,226,0,24,3,21,52,46,1,4,1,6
E33008232,603,457,134,323,6,36,8,28,97,90,0,2,5,7
E33008233,238,176,60,116,2,16,5,11,42,38,1,2,1,2
E33008234,477,370,85,285,3,41,9,32,61,52,2,7,0,2
E33008235,409,325,96,229,1,31,6,25,47,43,0,2,2,5
E33008236,468,338,99,239,4,50,17,33,71,64,1,4,2,5
E33008237,204,163,46,117,2,10,2,8,25,22,0,2,1,4
E33008238,681,471,130,341,8,71,24,47,124,107,0,14,3,7
E33008239,353,308,94,214,0,7,1,6,35,31,1,3,0,3
E33008240,384,341,88,253,1,11,1,10,28,26,0,2,0,3
E33008241,462,340,95,245,0,41,6,35,81,79,0,2,0,0
E33008242,402,315,79,236,0,31,11,20,54,48,0,4,2,2
E33008243,461,376,123,253,2,30,9,21,47,40,1,4,2,6
E33008244,312,263,89,174,0,15,5,10,32,27,2,3,0,2
E33008245,427,329,81,248,3,27,7,20,63,55,2,5,1,5
E33008246,571,474,125,349,3,24,6,18,68,59,2,6,1,2
E33008247,481,367,96,271,1,35,8,27,75,71,0,4,0,3
E33008248,299,257,80,177,1,7,3,4,32,28,0,3,1,2
E33008249,437,344,86,258,1,20,8,12,69,65,0,4,0,3
E33008250,334,273,88,185,1,12,0,12,46,37,0,8,1,2
E33008251,289,245,78,167,0,6,0,6,36,30,5,1,0,2
E33008252,269,200,62,138,0,8,4,4,57,55,0,2,0,4
E33008253,299,248,86,162,0,7,3,4,40,34,2,4,0,4
E33008254,1150,978,210,768,4,23,4,19,137,121,1,14,1,8
E33008255,356,259,69,190,4,8,6,2,81,75,2,3,1,4
E33008256,385,262,83,179,3,13,6,7,101,98,0,3,0,6
E33008257,457,322,86,236,0,17,3,14,112,107,0,5,0,6
E33008258,316,250,81,169,1,10,3,7,51,48,0,3,0,4
E33008259,280,210,59,151,1,12,3,9,52,45,0,6,1,5
E33008260,432,261,82,179,3,25,1,24,139,128,1,9,1,4
E33008261,338,217,58,159,2,11,4,7,101,91,1,9,0,7
E33008262,240,155,36,119,1,14,3,11,64,62,0,2,0,6
E33008263,281,234,77,157,3,12,1,11,31,28,0,3,0,1
E33008264,426,328,82,246,5,7,1,6,82,74,1,7,0,4
E33008265,672,465,142,323,0,30,10,20,167,152,1,12,2,10
E33008266,287,245,76,169,1,8,5,3,31,26,1,4,0,2
E33008267,233,183,61,122,4,18,4,14,28,26,0,2,0,0
E33008268,232,176,53,123,0,17,8,9,34,28,0,6,0,5
E33008269,431,342,107,235,0,41,4,37,44,33,0,9,2,4
E33008270,597,493,122,371,3,16,5,11,82,74,3,4,1,3
E33008271,264,191,68,123,0,10,1,9,57,51,0,5,1,6
E33008272,422,382,97,285,3,5,0,5,31,29,0,2,0,1
E33008273,243,197,69,128,0,4,2,2,41,36,1,4,0,1
E33008274,479,378,115,263,2,15,4,11,80,74,0,6,0,4
E33008275,376,304,92,212,1,21,5,16,50,45,0,5,0,0
E33008276,360,276,87,189,2,7,2,5,71,64,1,6,0,4
E33008277,386,304,113,191,2,13,1,12,62,60,0,2,0,5
E33008278,386,308,93,215,0,20,8,12,52,47,0,5,0,6
E33008279,347,265,83,182,2,30,10,20,49,42,0,7,0,1
E33008280,816,629,179,450,5,24,9,15,150,137,1,12,0,8
E33008281,312,248,81,167,0,11,5,6,51,42,1,5,3,2
E33008282,318,248,83,165,0,12,3,9,50,41,1,8,0,8
E33008283,346,293,101,192,2,9,1,8,40,34,0,4,2,2
E33008284,311,235,63,172,2,11,1,10,63,60,0,3,0,0
E33008285,363,268,74,194,0,14,8,6,76,68,1,6,1,5
E33008286,360,270,89,181,1,19,6,13,70,62,0,8,0,0
E33008287,489,383,109,274,0,27,11,16,78,70,0,5,3,1
E33008288,379,273,98,175,1,22,5,17,80,67,1,7,5,3
E33008289,293,235,100,135,4,14,9,5,39,35,0,4,0,1
E33008290,519,421,167,254,1,34,14,20,59,54,0,5,0,4
E33008291,293,247,76,171,2,8,2,6,33,33,0,0,0,3
E33008292,270,205,64,141,1,18,3,15,45,43,0,2,0,1
E33008293,300,209,59,150,0,18,4,14,69,62,0,7,0,4
E33008294,633,494,143,351,1,21,10,11,113,98,3,12,0,4
E33008295,430,342,106,236,0,26,9,17,60,56,1,3,0,2
E33008296,390,302,75,227,0,27,12,15,58,56,0,2,0,3
E33008297,274,209,57,152,0,12,3,9,49,37,0,8,4,4
E33008298,406,342,97,245,0,17,4,13,39,34,0,5,0,8
E33008299,336,259,71,188,0,11,4,7,64,55,2,7,0,2
E33008300,281,237,60,177,0,8,1,7,35,31,0,4,0,1
E33008301,342,268,90,178,0,13,3,10,61,55,2,4,0,0
E33008302,456,342,113,229,2,36,12,24,73,64,0,8,1,3
E33008303,275,215,57,158,0,13,7,6,46,39,1,6,0,1
E33008304,316,248,53,195,1,26,4,22,41,39,1,1,0,0
E33008305,400,324,99,225,3,21,11,10,49,43,2,4,0,3
E33008306,446,348,94,254,2,27,12,15,68,61,1,6,0,1
E33008307,322,255,72,183,0,23,6,17,40,37,0,3,0,4
E33008308,496,376,122,254,0,30,7,23,84,72,0,11,1,6
E33008309,290,237,63,174,0,7,3,4,39,35,0,4,0,7
E33008310,235,162,62,100,0,17,4,13,55,51,0,4,0,1
E33008311,364,283,87,196,1,15,2,13,63,56,1,5,1,2
E33008312,325,246,73,173,0,18,12,6,56,53,0,3,0,5
E33008313,330,255,84,171,0,25,13,12,47,42,0,5,0,3
E33008314,363,269,64,205,0,41,16,25,52,50,0,2,0,1
E33008315,347,283,95,188,2,19,10,9,42,37,0,4,1,1
E33008316,520,403,120,283,0,29,11,18,85,79,0,6,0,3
E33008317,309,227,80,147,2,28,11,17,50,48,0,2,0,2
E33008318,642,495,180,315,2,65,33,32,77,68,1,7,1,3
E33008319,664,540,172,368,3,32,8,24,84,72,1,9,2,5
E33008320,326,259,82,177,1,25,11,14,38,32,0,6,0,3
E33008321,272,216,93,123,0,14,4,10,38,37,0,1,0,4
E33008322,265,211,65,146,0,19,12,7,32,25,0,5,2,3
E33008323,372,306,152,154,1,13,3,10,45,41,0,3,1,7
E33008324,327,252,85,167,0,30,11,19,44,40,0,4,0,1
E33008325,406,277,74,203,3,42,12,30,73,64,1,6,2,11
E33008326,316,268,80,188,0,11,4,7,35,33,0,2,0,2
E33008327,314,233,71,162,0,17,6,11,59,51,1,7,0,5
E33008328,392,286,100,186,0,39,11,28,67,60,0,5,2,0
E33008329,319,273,76,197,0,17,8,9,28,26,0,2,0,1
E33008330,258,178,58,120,2,17,9,8,57,50,0,7,0,4
E33008331,384,295,92,203,0,28,12,16,58,51,0,7,0,3
E33008332,689,581,207,374,2,30,10,20,70,60,0,9,1,6
E33008333,311,283,92,191,0,5,4,1,20,19,0,1,0,3
E33008334,306,253,73,180,1,4,1,3,47,43,0,4,0,1
E33008335,279,233,69,164,0,7,2,5,35,31,0,2,2,4
E33008336,310,246,65,181,1,17,3,14,45,40,2,2,1,1
E33008337,268,236,89,147,0,7,3,4,24,19,0,1,4,1
E33008338,330,279,85,194,1,12,5,7,35,34,0,1,0,3
E33008339,565,451,137,314,2,25,7,18,79,69,0,9,1,8
E33008340,351,297,133,164,2,10,2,8,40,35,0,4,1,2
E33008341,556,423,157,266,3,42,29,13,83,75,0,7,1,5
E33008342,329,254,100,154,0,19,13,6,47,39,2,5,1,9
E33008343,358,296,78,218,3,24,16,8,34,28,1,4,1,1
E33008344,365,303,115,188,4,10,9,1,45,38,1,6,0,3
E33008345,523,397,120,277,5,27,18,9,85,78,1,6,0,9
E33008346,353,284,86,198,3,25,22,3,36,30,3,3,0,5
E33008347,262,214,140,74,1,4,3,1,33,27,0,4,2,10
E33008348,411,303,118,185,2,25,18,7,69,56,3,10,0,12
E33008349,606,485,206,279,2,30,17,13,77,53,8,12,4,12
E33008350,316,240,117,123,2,8,6,2,57,45,2,9,1,9
E33008351,355,269,115,154,3,13,10,3,64,55,3,6,0,6
E33008352,297,221,99,122,5,19,6,13,43,33,4,5,1,9
E33008353,334,297,107,190,1,4,3,1,30,23,0,7,0,2
E33008354,296,250,99,151,0,6,3,3,37,30,1,6,0,3
E33008355,312,246,101,145,2,17,10,7,44,40,0,4,0,3
E33008356,290,242,84,158,1,7,6,1,29,26,0,0,3,11
E33008357,288,217,66,151,2,12,6,6,56,53,1,2,0,1
E33008358,511,401,140,261,2,19,10,9,85,74,3,8,0,4
E33008359,336,289,115,174,3,14,6,8,27,25,0,2,0,3
E33008360,350,287,112,175,3,20,9,11,39,35,0,4,0,1
E33008361,413,326,115,211,2,23,17,6,59,52,0,4,3,3
E33008362,412,321,103,218,8,17,10,7,54,46,0,8,0,12
E33008363,261,182,50,132,2,12,5,7,64,59,2,3,0,1
E33008364,373,268,82,186,6,26,14,12,71,66,0,5,0,2
E33008365,453,366,105,261,6,7,4,3,69,58,5,6,0,5
E33008366,289,175,54,121,7,24,13,11,82,76,1,4,1,1
E33008367,365,261,79,182,6,17,6,11,81,72,2,4,3,0
E33008368,366,296,80,216,5,11,8,3,51,47,0,3,1,3
E33008369,283,193,51,142,2,13,9,4,74,65,0,8,1,1
E33008370,385,317,109,208,2,14,6,8,51,41,0,10,0,1
E33008371,528,418,126,292,4,16,12,4,88,80,0,8,0,2
E33008372,513,299,93,206,4,35,18,17,168,151,2,14,1,7
E33008373,270,180,66,114,3,14,4,10,72,70,0,1,1,1
E33008374,581,403,115,288,5,29,11,18,138,130,4,4,0,6
E33008375,371,253,80,173,3,36,32,4,77,71,1,3,2,2
E33008376,460,308,90,218,4,53,31,22,93,83,0,10,0,2
E33008377,269,216,83,133,2,20,6,14,26,25,0,1,0,5
E33008378,386,304,78,226,4,30,18,12,44,36,1,6,1,4
E33008379,328,248,62,186,6,35,32,3,33,31,0,2,0,6
E33008380,769,582,158,424,1,60,51,9,118,105,0,10,3,8
E33008381,298,224,56,168,2,35,28,7,36,33,0,3,0,1
E33008382,275,207,74,133,1,17,10,7,49,44,0,5,0,1
E33008383,901,758,201,557,3,35,25,10,102,94,0,8,0,3
E33008384,479,329,102,227,4,40,22,18,99,95,0,4,0,7
E33008385,582,421,123,298,6,34,19,15,115,109,0,4,2,6
E33008386,344,254,101,153,2,14,10,4,66,57,2,5,2,8
E33008387,309,185,64,121,1,4,2,2,116,103,2,11,0,3
E33008388,830,626,199,427,5,25,14,11,167,156,1,9,1,7
E33008389,341,249,73,176,1,13,5,8,69,65,1,3,0,9
E33008390,273,205,55,150,0,17,12,5,50,45,0,5,0,1
E33008391,303,255,68,187,1,13,7,6,31,26,1,4,0,3
E33008392,489,403,119,284,2,18,11,7,63,55,0,8,0,3
E33008393,343,267,58,209,1,22,17,5,48,40,1,7,0,5
E33008394,297,219,72,147,0,15,7,8,57,49,2,4,2,6
E33008395,543,421,128,293,2,11,4,7,106,94,4,8,0,3
E33008396,303,246,76,170,0,8,5,3,49,42,0,7,0,0
E33008397,571,430,119,311,6,39,23,16,91,79,0,12,0,5
E33008398,493,391,114,277,7,23,11,12,67,59,1,6,1,5
E33008399,478,362,144,218,3,14,9,5,96,83,0,12,1,3
E33008400,792,563,165,398,2,84,59,25,138,125,0,13,0,5
E33008401,334,280,109,171,0,12,9,3,41,37,1,1,2,1
E33008402,298,241,76,165,0,19,11,8,32,25,0,6,1,6
E33008403,446,358,115,243,0,14,9,5,71,62,1,8,0,3
E33008404,244,189,58,131,0,20,18,2,33,32,0,1,0,2
E33008405,230,119,52,67,1,3,1,2,83,77,2,0,4,24
E33008406,259,199,69,130,2,7,5,2,45,41,0,4,0,6
E33008407,295,218,83,135,1,7,6,1,59,47,1,5,6,10
E33008408,517,381,155,226,5,17,9,8,105,91,4,8,2,9
E33008409,378,300,117,183,0,19,12,7,55,47,2,6,0,4
E33008410,468,328,98,230,1,23,7,16,113,107,0,6,0,3
E33008411,286,246,92,154,1,6,1,5,30,28,1,1,0,3
E33008412,333,299,79,220,0,1,1,0,29,24,1,4,0,4
E33008413,416,340,96,244,0,12,5,7,61,58,1,2,0,3
E33008414,387,313,100,213,1,21,10,11,52,47,0,3,2,0
E33008415,317,250,83,167,1,8,3,5,58,55,1,2,0,0
E33008416,344,294,116,178,0,4,2,2,41,40,0,1,0,5
E33008417,272,216,72,144,0,6,3,3,45,39,0,6,0,5
E33008418,641,510,174,336,0,24,15,9,101,96,1,3,1,6
E33008419,353,301,104,197,0,10,2,8,37,35,0,2,0,5
E33008420,540,425,126,299,3,21,6,15,87,79,3,5,0,4
E33008421,727,585,154,431,3,31,11,20,102,89,1,10,2,6
E33008422,222,173,55,118,0,9,4,5,39,37,0,2,0,1
E33008423,593,472,142,330,2,28,15,13,89,86,0,3,0,2
E33008424,321,261,87,174,2,6,3,3,52,48,0,2,2,0
E33008425,553,421,156,265,1,42,27,15,79,65,4,9,1,10
E33008426,705,512,169,343,1,49,27,22,136,122,1,9,4,7
E33008427,267,186,46,140,2,18,10,8,55,53,1,0,1,6
E33008428,255,200,63,137,0,16,4,12,37,31,0,6,0,2
E33008429,293,217,68,149,0,32,20,12,40,38,0,2,0,4
E33008430,318,272,105,167,0,5,2,3,37,34,0,3,0,4
E33008431,287,243,89,154,1,6,5,1,35,30,1,4,0,2
E33008432,523,434,133,301,0,20,9,11,65,55,0,8,2,4
E33008433,327,264,103,161,0,15,8,7,44,39,2,3,0,4
E33008434,483,394,105,289,1,17,7,10,67,58,1,7,1,4
E33008435,467,334,97,237,0,42,24,18,88,82,0,6,0,3
E33008436,478,379,128,251,2,31,13,18,61,52,3,2,4,5
E33008437,380,332,93,239,2,12,5,7,31,29,0,2,0,3
E33008438,647,507,163,344,0,37,17,20,101,91,0,10,0,2
E33008439,306,220,83,137,1,23,8,15,61,57,0,4,0,1
E33008440,325,276,120,156,1,14,5,9,32,28,0,3,1,2
E33008441,288,236,89,147,1,4,2,2,44,39,1,4,0,3
E33008442,438,337,88,249,0,15,5,10,82,75,1,4,2,4
E33008443,328,249,80,169,0,18,11,7,57,51,1,5,0,4
E33008444,380,299,91,208,0,17,8,9,61,54,0,7,0,3
E33008445,261,212,76,136,0,6,2,4,43,40,0,0,3,0
E33008446,347,282,102,180,2,8,2,6,45,38,0,7,0,10
E33008447,517,364,113,251,1,44,18,26,105,100,0,5,0,3
E33008448,391,301,102,199,0,17,8,9,68,64,0,4,0,5
E33008449,306,250,130,120,2,8,5,3,43,37,1,5,0,3
E33008450,247,172,75,97,4,19,8,11,51,49,0,2,0,1
E33008451,477,388,92,296,2,37,26,11,49,44,0,4,1,1
E33008452,563,416,136,280,4,37,20,17,100,95,0,5,0,6
E33008453,249,189,76,113,1,25,13,12,31,24,0,4,3,3
E33008454,441,337,76,261,0,40,18,22,62,58,2,0,2,2
E33008455,410,320,127,193,1,25,4,21,62,58,0,4,0,2
E33008456,330,233,94,139,0,22,10,12,70,58,0,12,0,5
E33008457,257,185,68,117,0,18,5,13,52,45,0,6,1,2
E33008458,558,425,168,257,1,31,12,19,98,96,1,1,0,3
E33008459,459,339,128,211,2,42,22,20,73,68,1,3,1,3
E33008460,523,425,142,283,5,25,14,11,65,57,0,7,1,3
E33008461,300,243,89,154,0,7,5,2,47,44,0,3,0,3
E33008462,239,193,105,88,1,13,2,11,28,25,0,3,0,4
E33008463,621,490,158,332,2,25,11,14,100,92,0,8,0,4
E33008464,230,174,50,124,0,18,11,7,38,31,1,5,1,0
E33008465,331,282,94,188,1,19,11,8,27,24,0,3,0,2
E33008466,436,330,119,211,0,46,26,20,54,49,1,4,0,6
E33008467,251,210,79,131,1,12,6,6,27,20,0,6,1,1
E33008468,347,307,110,197,1,8,6,2,23,19,0,4,0,8
E33008469,374,293,137,156,0,17,9,8,59,54,3,2,0,5
E33008470,332,269,115,154,0,13,9,4,46,40,1,5,0,4
E33008471,423,342,133,209,3,25,7,18,49,47,0,2,0,4
E33008472,243,191,70,121,1,12,5,7,36,26,0,7,3,3
E33008473,424,323,131,192,1,22,2,20,70,53,2,11,4,8
E33008474,364,307,157,150,2,11,4,7,39,37,1,1,0,5
E33008475,835,647,183,464,3,48,13,35,135,119,2,11,3,2
E33008476,453,391,120,271,3,18,5,13,37,29,0,3,5,4
E33008477,370,292,116,176,3,16,5,11,51,42,2,6,1,8
E33008478,544,456,171,285,1,18,3,15,61,51,0,9,1,8
E33008479,335,264,96,168,2,15,2,13,39,29,1,7,2,15
E33008480,294,271,86,185,0,8,1,7,14,14,0,0,0,1
E33008481,826,700,186,514,4,26,5,21,94,81,1,11,1,2
E33008482,391,286,92,194,2,19,5,14,75,70,0,4,1,9
E33008483,450,404,111,293,2,8,0,8,34,32,0,2,0,2
E33008484,266,230,74,156,1,6,2,4,29,24,0,5,0,0
E33008485,248,219,77,142,1,8,3,5,19,17,0,2,0,1
E33008486,307,253,83,170,0,14,2,12,38,34,0,3,1,2
E33008487,454,390,110,280,0,20,3,17,43,40,1,2,0,1
E33008488,269,218,47,171,6,14,4,10,29,25,2,2,0,2
E33008489,621,449,137,312,4,61,15,46,99,93,0,6,0,8
E33008490,562,410,95,315,2,47,10,37,100,88,1,10,1,3
E33008491,251,169,47,122,1,46,4,42,31,28,0,3,0,4
E33008492,266,166,52,114,0,70,6,64,29,29,0,0,0,1
E33008493,255,170,34,136,4,56,16,40,22,19,1,2,0,3
E33008494,448,356,120,236,3,31,2,29,52,42,5,1,4,6
E33008495,265,216,74,142,2,17,3,14,28,27,0,0,1,2
E33008496,279,247,82,165,0,6,2,4,24,22,0,2,0,2
E33008497,311,247,86,161,1,20,4,16,37,33,0,4,0,6
E33008498,333,265,84,181,2,24,4,20,41,38,0,3,0,1
E33008499,336,267,47,220,2,33,6,27,32,27,0,5,0,2
E33008500,669,485,148,337,5,65,21,44,112,105,0,6,1,2
E33008501,367,269,81,188,2,57,17,40,39,31,2,4,2,0
E33008502,949,688,192,496,10,87,26,61,156,142,2,9,3,8
E33008503,617,420,87,333,2,69,16,53,116,65,27,2,22,10
E33008504,280,205,75,130,2,25,6,19,45,41,0,3,1,3
E33008505,975,774,196,578,2,77,19,58,120,114,0,6,0,2
E33008506,624,534,164,370,1,32,9,23,52,46,0,6,0,5
E33008507,492,396,119,277,2,35,8,27,56,53,0,2,1,3
E33008508,265,207,56,151,0,24,5,19,32,27,0,5,0,2
E33008509,233,158,37,121,0,45,13,32,29,27,0,2,0,1
E33008510,299,205,59,146,4,55,20,35,35,29,2,4,0,0
E33008511,366,269,62,207,1,61,26,35,32,27,2,3,0,3
E33008512,456,333,88,245,1,52,14,38,67,55,0,6,6,3
E33008513,253,169,50,119,2,51,16,35,27,24,1,2,0,4
E33008514,463,370,128,242,2,36,7,29,55,52,0,3,0,0
E33008515,615,399,115,284,7,74,12,62,131,126,0,4,1,4
E33008516,302,279,52,227,1,5,0,5,15,14,0,1,0,2
E33008517,920,726,187,539,7,44,12,32,139,126,1,11,1,4
E33008518,757,587,124,463,3,40,8,32,123,115,1,7,0,4
E33008519,264,218,69,149,0,10,3,7,36,31,1,4,0,0
E33008520,1669,1233,240,993,4,105,29,76,321,285,1,33,2,6
E33008521,297,226,58,168,1,26,3,23,42,38,1,3,0,2
E33008522,294,217,58,159,3,26,4,22,44,41,0,2,1,4
E33008523,744,557,172,385,6,48,8,40,123,113,0,10,0,10
E33008524,346,246,69,177,1,36,8,28,61,54,0,6,1,2
E33008525,719,552,192,360,6,55,9,46,98,86,3,7,2,8
E33008526,290,221,62,159,2,15,0,15,49,42,0,5,2,3
E33008527,544,408,123,285,7,52,13,39,75,70,0,5,0,2
E33008528,284,219,46,173,2,26,2,24,34,34,0,0,0,3
E33008529,693,528,126,402,4,64,9,55,95,86,1,7,1,2
E33008530,280,192,37,155,0,13,3,10,73,65,1,4,3,2
E33008531,255,160,50,110,0,25,5,20,68,57,6,5,0,2
E33008532,376,270,90,180,3,45,10,35,55,52,1,2,0,3
E33008533,262,178,53,125,2,24,4,20,57,52,0,5,0,1
E33008534,991,643,158,485,3,72,9,63,265,236,0,27,2,8
E33008535,384,286,78,208,1,41,9,32,56,52,0,4,0,0
E33008536,400,299,88,211,1,27,4,23,67,63,2,2,0,6
E33008537,328,262,54,208,3,25,12,13,35,32,1,1,1,3
E33008538,340,254,79,175,5,38,10,28,42,38,0,4,0,1
E33008539,414,287,86,201,2,44,9,35,77,73,0,4,0,4
E33008540,365,271,76,195,3,60,11,49,31,26,0,5,0,0
E33008541,235,171,52,119,2,15,1,14,44,42,0,2,0,3
E33008542,281,179,58,121,3,44,8,36,49,41,2,6,0,6
E33008543,235,180,63,117,2,13,2,11,38,33,0,4,1,2
E33008544,290,207,65,142,3,28,12,16,46,42,1,3,0,6
E33008545,343,252,72,180,0,51,14,37,36,29,3,4,0,4
E33008546,244,162,40,122,4,36,6,30,41,38,0,1,2,1
E33008547,209,142,47,95,2,26,6,20,33,29,0,4,0,6
E33008548,379,268,90,178,4,42,14,28,61,53,1,6,1,4
E33008549,684,531,118,413,3,40,11,29,104,96,2,6,0,6
E33008550,225,152,44,108,2,28,3,25,41,38,1,2,0,2
E33008551,430,316,115,201,3,42,9,33,68,62,0,4,2,1
E33008552,367,246,73,173,2,63,12,51,52,43,2,5,2,4
E33008553,706,480,158,322,2,63,13,50,157,150,0,5,2,4
E33008554,668,507,180,327,2,50,9,41,101,93,1,3,4,8
E33008555,231,138,42,96,1,39,9,30,47,43,0,4,0,6
E33008556,262,183,60,123,1,19,0,19,58,55,0,3,0,1
E33008557,283,188,66,122,2,24,3,21,64,58,1,5,0,5
E33008558,487,369,115,254,2,48,3,45,64,61,0,3,0,4
E33008559,388,321,97,224,3,20,6,14,41,36,0,5,0,3
E33008560,235,161,55,106,0,42,5,37,30,29,0,1,0,2
E33008561,365,284,95,189,2,19,2,17,56,55,1,0,0,4
E33008562,206,156,76,80,1,9,2,7,39,36,0,3,0,1
E33008563,544,262,94,168,10,29,15,14,234,220,5,6,3,9
E33008564,352,252,105,147,0,16,2,14,75,72,0,1,2,9
E33008565,269,213,87,126,8,8,1,7,35,27,2,4,2,5
E33008566,258,186,85,101,1,7,6,1,55,49,3,3,0,9
E33008567,309,239,91,148,0,15,3,12,54,45,3,5,1,1
E33008568,278,180,99,81,1,8,1,7,83,67,6,2,8,6
E33008569,211,109,52,57,2,5,1,4,89,80,5,4,0,6
E33008570,332,266,108,158,2,11,0,11,48,41,2,2,3,5
E33008571,472,310,117,193,2,17,4,13,123,70,48,3,2,20
E33008572,246,175,75,100,0,27,13,14,41,33,1,6,1,3
E33008573,595,518,132,386,6,11,4,7,60,43,4,12,1,0
E33008574,312,241,74,167,1,19,5,14,45,39,1,2,3,6
E33008575,635,497,140,357,2,36,8,28,95,87,2,5,1,5
E33008576,649,490,154,336,6,50,12,38,95,84,2,9,0,8
E33008577,309,241,89,152,1,18,7,11,46,38,2,6,0,3
E33008578,320,253,94,159,3,15,2,13,47,40,0,7,0,2
E33008579,602,491,173,318,5,32,6,26,69,64,1,4,0,5
E33008580,247,181,66,115,0,24,6,18,41,35,0,6,0,1
E33008581,386,282,88,194,1,39,8,31,59,54,0,4,1,5
E33008582,269,222,83,139,0,19,6,13,27,25,0,1,1,1
E33008583,262,200,73,127,1,21,7,14,37,32,0,5,0,3
E33008584,299,225,74,151,1,27,5,22,39,34,0,5,0,7
E33008585,312,264,81,183,1,12,7,5,33,26,1,2,4,2
E33008586,325,265,115,150,1,8,2,6,40,32,5,0,3,11
E33008587,350,265,87,178,2,31,8,23,51,42,0,9,0,1
E33008588,444,363,142,221,2,15,3,12,53,43,1,5,4,11
E33008589,309,212,103,109,0,16,4,12,70,54,2,2,12,11
E33008590,493,370,105,265,1,20,4,16,99,88,1,6,4,3
E33008591,261,211,67,144,0,13,1,12,34,30,1,1,2,3
E33008592,245,195,75,120,0,8,2,6,39,36,2,0,1,3
E33008593,300,201,65,136,1,19,5,14,76,66,2,7,1,3
E33008594,293,226,81,145,1,16,3,13,49,39,1,9,0,1
E33008595,284,231,86,145,2,10,1,9,36,30,0,3,3,5
E33008596,463,374,149,225,0,28,6,22,58,50,4,4,0,3
E33008597,231,183,60,123,2,16,4,12,26,24,0,2,0,4
E33008598,625,460,153,307,3,26,7,19,134,121,1,11,1,2
E33008599,464,379,135,244,5,18,2,16,59,51,1,7,0,3
E33008600,575,445,134,311,1,34,12,22,93,81,2,8,2,2
E33008601,326,263,93,170,3,16,4,12,40,33,0,6,1,4
E33008602,512,386,128,258,0,23,6,17,96,87,0,6,3,7
E33008603,432,343,100,243,1,15,3,12,72,64,2,5,1,1
E33008604,529,443,151,292,6,19,7,12,58,52,1,4,1,3
E33008605,251,189,43,146,0,7,2,5,48,41,0,6,1,7
E33008606,1270,985,255,730,4,77,22,55,195,160,21,11,3,9
E33008607,287,246,82,164,2,11,3,8,25,20,1,4,0,3
E33008608,253,211,68,143,0,4,0,4,38,37,1,0,0,0
E33008609,270,197,45,152,2,11,3,8,57,50,0,6,1,3
E33008610,271,204,71,133,0,12,5,7,51,46,0,3,2,4
E33008611,256,207,70,137,1,14,2,12,30,26,0,4,0,4
E33008612,364,284,125,159,3,12,3,9,61,42,8,9,2,4
E33008613,258,208,66,142,0,5,1,4,35,26,3,4,2,10
E33008614,307,262,87,175,0,7,3,4,33,28,0,4,1,5
E33008615,246,173,35,138,2,23,7,16,45,32,1,4,8,3
E33008616,296,253,71,182,0,8,3,5,33,28,1,4,0,2
E33008617,314,286,105,181,0,8,1,7,17,15,0,2,0,3
E33008618,740,592,167,425,2,41,19,22,100,86,3,8,3,5
E33008619,276,232,82,150,0,10,5,5,30,22,2,6,0,4
E33008620,351,294,99,195,4,15,3,12,38,33,0,4,1,0
E33008621,312,282,86,196,0,8,4,4,21,17,0,4,0,1
E33008622,281,214,64,150,1,27,4,23,37,33,0,4,0,2
E33008623,240,171,68,103,0,31,12,19,33,29,0,4,0,5
E33008624,643,491,161,330,2,52,20,32,94,83,1,8,2,4
E33008625,236,182,50,132,0,20,7,13,33,28,0,5,0,1
E33008626,384,329,105,224,2,14,2,12,36,31,0,5,0,3
E33008627,289,232,67,165,0,18,7,11,38,33,1,4,0,1
E33008628,566,450,122,328,2,32,10,22,79,72,0,6,1,3
E33008629,257,225,71,154,0,14,5,9,16,14,0,2,0,2
E33008630,289,220,83,137,1,26,7,19,41,35,0,5,1,1
E33008631,323,253,64,189,0,26,14,12,43,38,0,5,0,1
E33008632,363,259,81,178,0,52,34,18,49,43,1,5,0,3
E33008633,381,315,91,224,0,20,12,8,43,41,0,2,0,3
E33008634,385,287,93,194,1,29,15,14,64,57,0,7,0,4
E33008635,424,342,119,223,4,22,11,11,51,48,0,3,0,5
E33008636,268,212,70,142,1,18,7,11,36,30,1,5,0,1
E33008637,407,331,104,227,1,18,6,12,52,48,0,4,0,5
E33008638,835,656,208,448,8,57,23,34,108,97,0,10,1,6
E33008639,469,383,127,256,1,33,19,14,51,44,0,7,0,1
E33008640,560,411,122,289,0,59,19,40,88,75,1,12,0,2
E33008641,286,223,73,150,0,29,11,18,33,32,0,0,1,1
E33008642,268,223,64,159,0,11,3,8,33,29,0,4,0,1
E33008643,413,335,102,233,1,18,5,13,59,46,0,13,0,0
E33008644,256,169,46,123,0,34,13,21,51,47,0,4,0,2
E33008645,242,178,58,120,3,19,11,8,39,33,0,6,0,3
E33008646,761,606,165,441,4,47,18,29,103,91,1,10,1,1
E33008647,308,239,91,148,2,20,16,4,44,39,0,5,0,3
E33008648,690,560,174,386,2,36,16,20,92,86,1,4,1,0
E33008649,454,360,113,247,4,26,12,14,59,55,0,4,0,5
E33008650,792,667,186,481,0,31,13,18,92,82,1,9,0,2
E33008651,318,264,78,186,2,10,4,6,41,38,0,2,1,1
E33008652,285,238,63,175,0,19,11,8,27,23,2,2,0,1
E33008653,300,227,64,163,0,32,18,14,39,33,0,6,0,2
E33008654,570,464,136,328,1,41,29,12,61,57,0,4,0,3
E33008655,332,255,78,177,1,30,21,9,41,37,0,4,0,5
E33008656,283,229,68,161,0,19,4,15,34,29,0,5,0,1
E33008657,602,498,134,364,3,35,4,31,63,58,0,5,0,3
E33008658,489,439,158,281,2,14,3,11,30,30,0,0,0,4
E33008659,255,218,61,157,2,11,3,8,23,19,0,4,0,1
E33008660,301,266,91,175,1,6,0,6,26,21,1,2,2,2
E33008661,395,319,113,206,0,29,9,20,43,42,0,0,1,4
E33008662,266,234,73,161,0,6,1,5,25,22,1,2,0,1
E33008663,321,286,106,180,0,6,0,6,26,23,0,2,1,3
E33008664,368,262,78,184,1,26,7,19,78,76,0,2,0,1
E33008665,283,240,83,157,0,13,4,9,29,27,0,1,1,1
E33008666,303,282,85,197,1,7,2,5,12,10,0,2,0,1
E33008667,468,391,131,260,4,29,5,24,41,38,0,3,0,3
E33008668,311,262,74,188,0,17,4,13,31,27,0,4,0,1
E33008669,381,310,90,220,5,10,1,9,54,47,1,6,0,2
E33008670,256,219,53,166,2,15,2,13,20,17,0,3,0,0
E33008671,1255,937,280,657,6,86,15,71,219,203,4,11,1,7
E33008672,287,225,56,169,1,13,0,13,47,43,0,0,4,1
E33008673,258,212,64,148,0,14,1,13,28,24,3,0,1,4
E33008674,481,392,131,261,1,32,8,24,55,44,3,8,0,1
E33008675,263,197,48,149,0,36,2,34,29,25,0,1,3,1
E33008676,234,163,34,129,4,32,7,25,35,31,0,3,1,0
E33008677,324,252,85,167,2,35,7,28,31,29,0,2,0,4
E33008678,245,192,44,148,2,25,4,21,25,23,0,2,0,1
E33008679,293,197,58,139,1,40,6,34,51,44,0,7,0,4
E33008680,476,395,121,274,2,32,6,26,44,40,1,3,0,3
E33008681,286,237,61,176,1,14,0,14,33,26,0,7,0,1
E33008682,317,254,62,192,2,17,3,14,43,37,0,5,1,1
E33008683,297,235,61,174,1,30,0,30,28,25,0,3,0,3
E33008684,359,252,60,192,2,35,5,30,69,61,0,4,4,1
E33008685,1346,1072,328,744,5,100,13,87,166,148,1,16,1,3
E33008686,261,210,53,157,1,30,3,27,19,15,0,4,0,1
E33008687,336,275,74,201,1,11,2,9,45,35,3,7,0,4
E33008688,313,263,96,167,1,14,2,12,33,32,0,1,0,2
E33008689,486,375,111,264,6,46,9,37,57,50,1,6,0,2
E33008690,288,212,60,152,1,28,3,25,39,33,1,4,1,8
E33008691,378,335,95,240,0,6,0,6,34,33,0,1,0,3
E33008692,261,230,87,143,0,5,0,5,23,21,0,1,1,3
E33008693,534,478,84,394,1,12,7,5,41,29,7,5,0,2
E33008694,336,289,86,203,2,11,0,11,29,25,2,2,0,5
E33008695,232,199,74,125,2,10,3,7,21,19,2,0,0,0
E33008696,376,325,118,207,0,14,3,11,34,29,1,4,0,3
E33008697,436,311,112,199,3,14,3,11,104,101,0,3,0,4
E33008698,299,251,98,153,1,13,1,12,34,27,2,5,0,0
E33008699,254,225,95,130,3,2,0,2,21,17,4,0,0,3
E33008700,350,272,108,164,1,20,9,11,52,43,1,4,4,5
E33008701,290,248,88,160,1,12,0,12,29,29,0,0,0,0
E33008702,460,390,140,250,0,16,2,14,50,46,0,4,0,4
E33008703,602,488,107,381,2,43,18,25,68,61,0,6,1,1
E33008704,275,217,51,166,0,15,4,11,41,36,1,4,0,2
E33008705,466,379,102,277,1,39,4,35,45,42,0,2,1,2
E33008706,380,303,90,213,2,29,0,29,42,34,3,5,0,4
E33008707,712,540,128,412,1,74,8,66,89,80,0,9,0,8
E33008708,310,256,59,197,0,21,2,19,29,28,0,1,0,4
E33008709,483,375,97,278,4,52,4,48,50,45,0,4,1,2
E33008710,243,196,56,140,0,20,3,17,26,21,3,2,0,1
E33008711,631,474,126,348,5,70,17,53,80,70,0,10,0,2
E33008712,236,195,53,142,1,13,2,11,24,21,0,1,2,3
E33008713,246,194,54,140,1,31,1,30,20,18,0,2,0,0
E33008714,672,469,118,351,3,87,24,63,107,105,0,2,0,6
E33008715,235,149,43,106,3,47,3,44,36,32,4,0,0,0
E33008716,877,677,177,500,5,85,18,67,106,96,0,9,1,4
E33008717,300,263,69,194,0,11,1,10,25,23,0,2,0,1
E33008718,1295,1047,330,717,9,115,17,98,118,110,3,3,2,6
E33008719,399,319,81,238,3,47,6,41,29,25,0,4,0,1
E33008720,1174,1011,260,751,6,58,3,55,90,71,1,18,0,9
E33008721,370,283,79,204,2,33,5,28,51,46,0,5,0,1
E33008722,292,212,45,167,4,21,4,17,54,49,1,4,0,1
E33008723,414,347,101,246,2,17,2,15,42,37,0,5,0,6
E33008724,431,383,125,258,2,15,5,10,27,26,0,1,0,4
E33008725,260,212,49,163,3,13,2,11,31,29,0,2,0,1
E33008726,344,264,80,184,0,39,1,38,39,35,0,3,1,2
E33008727,406,296,82,214,5,61,5,56,42,37,1,4,0,2
E33008728,367,241,52,189,1,86,4,82,39,33,1,3,2,0
E33008729,330,272,92,180,0,7,5,2,50,42,1,5,2,1
E33008730,245,212,68,144,1,9,4,5,22,22,0,0,0,1
E33008731,253,222,86,136,1,4,2,2,25,24,0,1,0,1
E33008732,448,372,135,237,4,19,13,6,50,43,1,4,2,3
E33008733,289,245,108,137,3,3,1,2,38,33,0,5,0,0
E33008734,417,365,111,254,3,16,10,6,28,24,1,3,0,5
E33008735,609,455,189,266,5,30,17,13,113,89,12,7,5,6
E33008736,405,330,110,220,4,23,13,10,39,38,0,1,0,9
E33008737,407,333,126,207,3,14,12,2,52,46,1,3,2,5
E33008738,271,221,70,151,2,12,5,7,27,25,0,2,0,9
E33008739,749,478,217,261,7,35,18,17,226,213,1,9,3,3
E33008740,287,245,93,152,5,13,9,4,19,16,0,3,0,5
E33008741,296,227,65,162,0,17,5,12,51,39,0,7,5,1
E33008742,273,239,99,140,0,9,6,3,21,16,2,2,1,4
E33008743,435,332,105,227,3,28,24,4,69,57,0,12,0,3
E33008744,275,187,71,116,1,20,17,3,59,51,3,3,2,8
E33008745,308,252,94,158,2,16,9,7,32,28,0,4,0,6
E33008746,539,443,151,292,2,27,12,15,62,47,3,12,0,5
E33008747,441,311,102,209,6,12,6,6,112,100,2,10,0,0
E33008748,264,218,61,157,1,21,16,5,21,19,0,2,0,3
E33008749,774,606,195,411,2,57,41,16,108,95,1,10,2,1
E33008750,361,293,80,213,3,27,15,12,36,34,0,1,1,2
E33008751,406,332,121,211,0,27,25,2,42,34,0,6,2,5
E33008752,365,315,84,231,3,19,13,6,27,22,1,1,3,1
E33008753,668,556,153,403,4,54,39,15,52,43,0,8,1,2
E33008754,316,252,73,179,0,39,35,4,25,24,0,1,0,0
E33008755,654,523,166,357,2,42,28,14,83,75,1,7,0,4
E33008756,288,250,93,157,0,7,6,1,25,15,2,6,2,6
E33008757,573,476,166,310,5,29,23,6,56,52,0,3,1,7
E33008758,271,234,92,142,0,9,6,3,26,23,0,3,0,2
E33008759,300,256,92,164,2,11,9,2,28,25,0,3,0,3
E33008760,277,222,70,152,1,12,9,3,38,34,0,2,2,4
E33008761,322,210,72,138,3,21,18,3,87,83,0,3,1,1
E33008762,247,214,58,156,3,8,5,3,20,19,0,1,0,2
E33008763,619,491,174,317,6,59,39,20,62,60,0,2,0,1
E33008764,613,508,150,358,4,32,25,7,65,57,2,4,2,4
E33008765,284,220,66,154,0,23,19,4,40,36,0,4,0,1
E33008766,403,287,84,203,1,52,28,24,61,52,3,6,0,2
E33008767,317,238,73,165,0,22,15,7,56,54,0,2,0,1
E33008768,433,307,96,211,0,33,21,12,89,85,1,3,0,4
E33008769,270,218,58,160,0,11,5,6,40,35,0,4,1,1
E33008770,272,223,79,144,0,11,9,2,33,28,2,3,0,5
E33008771,263,187,60,127,0,14,11,3,61,52,1,7,1,1
E33008772,700,530,157,373,0,79,56,23,87,78,0,9,0,4
E33008773,316,234,70,164,0,22,18,4,57,54,0,3,0,3
E33008774,261,215,96,119,0,11,8,3,31,28,2,1,0,4
E33008775,1039,877,211,666,1,61,47,14,97,94,1,2,0,3
E33008776,290,241,39,202,2,18,18,0,28,24,0,4,0,1
E33008777,296,256,62,194,0,20,18,2,20,19,0,1,0,0
E33008778,1300,964,247,717,4,147,111,36,183,171,1,8,3,2
E33008779,713,560,130,430,1,81,67,14,68,66,0,2,0,3
E33008780,279,197,48,149,1,46,45,1,34,31,0,3,0,1
E33008781,536,386,102,284,0,94,79,15,56,53,0,3,0,0
E33008782,683,539,124,415,1,66,52,14,73,66,0,7,0,4
E33008783,295,241,68,173,0,34,29,5,18,15,0,3,0,2
E33008784,546,389,88,301,2,86,75,11,65,57,0,8,0,4
E33008785,484,379,105,274,1,60,46,14,40,38,0,2,0,4
E33008786,558,426,87,339,1,55,47,8,73,70,0,3,0,3
E33008787,250,205,62,143,1,16,11,5,27,24,0,2,1,1
E33008788,391,340,123,217,1,11,10,1,36,34,0,2,0,3
E33008789,496,418,147,271,1,25,17,8,50,44,0,6,0,2
E33008790,300,246,99,147,4,20,13,7,26,25,0,1,0,4
E33008791,773,580,145,435,1,115,102,13,73,64,1,8,0,4
E33008792,312,238,64,174,1,37,33,4,34,32,0,2,0,2
E33008793,274,171,47,124,0,64,59,5,32,30,1,1,0,7
E33008794,323,240,53,187,1,34,32,2,46,42,0,4,0,2
E33008795,1766,1314,314,1000,16,183,144,39,250,237,1,11,1,3
E33008796,437,349,89,260,0,37,27,10,48,44,1,3,0,3
E33008797,285,248,64,184,0,8,6,2,26,21,0,4,1,3
E33008798,324,240,78,162,0,29,25,4,46,41,1,4,0,9
E33008799,257,196,49,147,2,18,14,4,40,33,0,3,4,1
E33008800,388,317,112,205,1,29,22,7,37,25,2,6,4,4
E33008801,487,362,97,265,2,28,1,27,87,84,0,3,0,8
E33008802,326,249,59,190,0,21,3,18,53,47,0,6,0,3
E33008803,444,334,96,238,4,20,4,16,84,79,2,3,0,2
E33008804,520,390,129,261,2,36,6,30,88,82,1,3,2,4
E33008805,308,250,59,191,2,6,1,5,46,41,1,4,0,4
E33008806,386,297,88,209,1,38,14,24,43,36,4,3,0,7
E33008807,300,234,69,165,5,23,2,21,36,29,1,4,2,2
E33008808,254,185,60,125,0,29,7,22,37,35,0,2,0,3
E33008809,320,261,87,174,3,20,9,11,30,24,2,3,1,6
E33008810,691,470,120,350,1,86,21,65,122,88,20,12,2,12
E33008811,306,248,87,161,1,7,0,7,49,39,0,7,3,1
E33008812,324,281,101,180,1,4,1,3,37,31,0,6,0,1
E33008813,301,243,72,171,2,9,3,6,44,34,4,5,1,3
E33008814,247,211,87,124,6,8,2,6,21,19,0,2,0,1
E33008815,295,229,83,146,1,15,1,14,39,36,0,2,1,11
E33008816,366,287,102,185,0,13,1,12,63,49,3,9,2,3
E33008817,368,314,121,193,3,15,5,10,31,29,1,1,0,5
E33008818,418,357,110,247,1,9,0,9,51,42,0,9,0,0
E33008819,616,459,122,337,1,73,23,50,78,71,1,6,0,5
E33008820,238,148,67,81,1,12,5,7,74,68,4,0,2,3
E33008821,743,604,205,399,4,21,1,20,94,76,7,11,0,20
E33008822,402,307,119,188,3,23,6,17,67,58,1,8,0,2
E33008823,634,485,180,305,10,36,3,33,88,78,4,6,0,15
E33008824,243,197,98,99,1,4,2,2,30,26,2,2,0,11
E33008825,269,206,73,133,9,19,1,18,32,30,1,0,1,3
E33008826,494,374,166,208,9,28,13,15,75,73,0,2,0,8
E33008827,243,194,81,113,2,6,0,6,41,35,3,2,1,0
E33008828,282,235,79,156,6,10,3,7,26,25,0,1,0,5
E33008829,377,306,121,185,1,22,5,17,44,39,0,4,1,4
E33008830,402,331,111,220,8,22,3,19,39,35,1,2,1,2
E33008831,345,260,96,164,11,7,0,7,62,52,0,9,1,5
E33008832,336,280,109,171,1,13,2,11,38,34,2,2,0,4
E33008833,347,294,102,192,2,10,1,9,38,33,2,3,0,3
E33008834,300,241,86,155,1,12,1,11,40,32,3,5,0,6
E33008835,633,513,140,373,5,15,1,14,95,87,2,6,0,5
E33008836,601,419,122,297,1,34,8,26,146,133,4,8,1,1
E33008837,421,299,91,208,7,18,7,11,94,83,1,8,2,3
E33008838,425,339,85,254,0,15,1,14,69,65,0,4,0,2
E33008839,291,255,110,145,0,7,2,5,25,20,0,4,1,4
E33008840,468,399,171,228,2,16,5,11,42,33,0,6,3,9
E33008841,228,175,67,108,2,14,3,11,32,27,0,5,0,5
E33008842,297,234,88,146,6,13,3,10,42,38,1,3,0,2
E33008843,367,304,113,191,2,15,6,9,42,40,0,2,0,4
E33008844,336,287,131,156,1,9,1,8,37,32,1,1,3,2
E33008845,227,188,87,101,1,11,3,8,24,22,0,2,0,3
E33008846,527,459,153,306,2,15,0,15,48,41,0,7,0,3
E33008847,547,447,148,299,0,27,9,18,65,55,0,9,1,8
E33008848,308,240,56,184,0,12,1,11,54,45,3,5,1,2
E33008849,281,227,72,155,1,5,2,3,46,42,0,3,1,2
E33008850,363,313,86,227,2,6,2,4,38,36,0,1,1,4
E33008851,490,394,103,291,5,18,5,13,68,61,1,6,0,5
E33008852,492,424,99,325,2,11,2,9,54,47,0,7,0,1
E33008853,372,320,74,246,4,4,0,4,38,31,1,6,0,6
E33008854,361,304,74,230,2,8,1,7,46,41,2,3,0,1
E33008855,487,444,146,298,0,10,3,7,30,29,0,1,0,3
E33008856,235,194,57,137,1,7,1,6,29,28,0,1,0,4
E33008857,1353,1119,330,789,11,39,14,25,170,151,1,18,0,14
E33008858,288,248,69,179,0,5,0,5,33,28,2,3,0,2
E33008859,439,352,107,245,3,16,2,14,63,55,1,6,1,5
E33008860,383,305,104,201,3,17,4,13,50,48,0,2,0,8
E33008861,286,242,74,168,0,2,1,1,41,36,0,5,0,1
E33008862,311,282,71,211,0,5,0,5,23,20,0,3,0,1
E33008863,451,374,127,247,0,9,0,9,64,61,0,3,0,4
E33008864,407,341,111,230,0,3,2,1,60,55,0,4,1,3
E33008865,298,214,82,132,2,31,11,20,44,38,1,4,1,7
E33008866,230,148,62,86,2,52,19,33,25,25,0,0,0,3
E33008867,554,402,107,295,6,56,28,28,87,78,0,9,0,3
E33008868,514,438,143,295,0,21,8,13,48,44,0,4,0,7
E33008869,247,166,64,102,1,42,16,26,32,30,0,2,0,6
E33008870,339,256,85,171,0,22,8,14,56,51,1,2,2,5
E33008871,394,302,125,177,1,35,9,26,47,43,0,3,1,9
E33008872,256,198,61,137,0,26,15,11,30,29,0,1,0,2
E33008873,347,282,75,207,2,18,11,7,44,36,0,5,3,1
E33008874,634,542,152,390,2,14,7,7,71,64,1,5,1,5
E33008875,400,326,101,225,2,27,12,15,40,31,2,7,0,5
E33008876,323,246,66,180,2,38,32,6,36,33,0,3,0,1
E33008877,361,304,101,203,0,13,9,4,38,32,0,4,2,6
E33008878,444,380,118,262,1,15,5,10,44,36,1,7,0,4
E33008879,334,251,68,183,2,26,12,14,52,49,1,1,1,3
E33008880,300,241,82,159,1,9,3,6,46,46,0,0,0,3
E33008881,430,353,109,244,0,32,11,21,43,38,1,4,0,2
E33008882,369,277,86,191,2,27,7,20,59,55,0,4,0,4
E33008883,248,207,83,124,0,19,4,15,22,16,1,5,0,0
E33008884,324,268,83,185,0,25,10,15,30,26,0,3,1,1
E33008885,496,363,110,253,1,58,21,37,64,54,0,8,2,10
E33008886,275,215,59,156,2,21,8,13,34,32,0,2,0,3
E33008887,303,254,70,184,2,14,8,6,32,24,0,7,1,1
E33008888,520,405,127,278,0,50,23,27,63,52,0,8,3,2
E33008889,463,351,101,250,2,42,15,27,64,59,1,4,0,4
E33008890,422,353,121,232,3,24,9,15,42,37,2,2,1,0
E33008891,396,305,100,205,0,27,8,19,61,55,0,6,0,3
E33008892,274,144,42,102,4,84,64,20,38,32,3,3,0,4
E33008893,425,216,49,167,2,66,28,38,133,123,0,7,3,8
E33008894,246,101,31,70,1,11,10,1,131,124,0,7,0,2
E33008895,256,155,53,102,2,11,7,4,86,86,0,0,0,2
E33008896,417,256,62,194,1,42,25,17,117,112,0,3,2,1
E33008897,543,417,85,332,1,33,16,17,91,80,0,7,4,1
E33008898,304,185,28,157,1,31,21,10,83,79,0,3,1,4
E33008899,272,139,31,108,3,32,8,24,93,89,0,3,1,5
E33008900,1105,538,138,400,12,183,90,93,360,349,0,9,2,12
E33008901,360,198,42,156,4,30,10,20,125,119,0,5,1,3
E33008902,344,228,38,190,1,12,8,4,103,100,0,3,0,0
E33008903,423,206,39,167,1,43,11,32,172,158,2,6,6,1
E33008904,300,184,42,142,2,16,9,7,96,94,0,2,0,2
E33008905,415,169,54,115,4,30,7,23,211,195,6,7,3,1
E33008906,929,455,119,336,7,81,29,52,378,356,1,18,3,8
E33008907,292,211,55,156,0,35,17,18,43,40,0,2,1,3
E33008908,356,228,47,181,4,36,16,20,88,83,0,5,0,0
E33008909,303,179,54,125,2,23,11,12,96,93,0,3,0,3
E33008910,300,181,53,128,2,39,17,22,77,76,0,1,0,1
E33008911,699,474,148,326,5,41,18,23,174,164,0,9,1,5
E33008912,948,558,136,422,8,68,26,42,311,288,0,18,5,3
E33008913,272,156,40,116,3,45,26,19,65,60,0,5,0,3
E33008914,596,366,118,248,6,58,29,29,165,159,1,5,0,1
E33008915,250,133,38,95,2,47,20,27,66,61,1,3,1,2
E33008916,300,163,73,90,3,57,16,41,71,66,0,4,1,6
E33008917,1098,631,166,465,9,210,120,90,235,218,0,15,2,13
E33008918,538,344,115,229,1,90,64,26,89,82,1,4,2,14
E33008919,811,535,131,404,6,157,84,73,110,96,1,12,1,3
E33008920,1099,634,145,489,5,75,34,41,375,341,1,30,3,10
E33008921,430,302,88,214,4,23,11,12,95,91,0,4,0,6
E33008922,345,219,66,153,0,47,12,35,74,71,0,3,0,5
E33008923,1005,644,138,506,7,73,21,52,277,261,0,16,0,4
E33008924,1630,1096,250,846,7,91,39,52,427,404,1,21,1,9
E33008925,583,344,69,275,5,74,32,42,157,151,0,6,0,3
E33008926,1127,771,199,572,5,127,44,83,221,208,0,11,2,3
E33008927,459,313,59,254,7,24,10,14,110,104,0,3,3,5
E33008928,1305,903,237,666,5,74,23,51,321,300,2,15,4,2
E33008929,256,124,33,91,2,72,39,33,56,49,0,7,0,2
E33008930,374,216,55,161,2,70,40,30,82,73,0,9,0,4
E33008931,395,146,28,118,7,54,20,34,188,187,0,0,1,0
E33008932,394,219,69,150,2,110,63,47,57,55,1,1,0,6
E33008933,346,194,53,141,1,32,16,16,117,111,0,4,2,2
E33008934,309,172,53,119,1,61,29,32,74,69,1,3,1,1
E33008935,350,212,42,170,0,62,22,40,74,71,0,3,0,2
E33008936,269,123,36,87,1,87,17,70,56,53,0,2,1,2
E33008937,627,323,61,262,8,44,16,28,251,240,3,7,1,1
E33008938,421,222,48,174,5,43,20,23,144,139,0,4,1,7
E33008939,552,374,75,299,1,24,10,14,148,139,0,8,1,5
E33008940,1951,1324,271,1053,11,52,23,29,557,531,2,24,0,7
E33008941,491,332,84,248,6,19,10,9,132,124,0,7,1,2
E33008942,396,233,74,159,2,32,14,18,122,110,0,10,2,7
E33008943,471,322,56,266,3,29,11,18,116,106,1,8,1,1
E33008944,429,299,69,230,1,14,9,5,112,100,0,11,1,3
E33008945,686,429,70,359,3,24,8,16,227,213,1,12,1,3
E33008946,424,246,76,170,1,79,16,63,96,93,0,2,1,2
E33008947,368,231,77,154,3,44,3,41,88,81,0,5,2,2
E33008948,359,193,40,153,2,25,3,22,137,132,0,3,2,2
E33008949,865,524,137,387,12,113,20,93,210,197,3,6,4,6
E33008950,580,318,75,243,2,95,20,75,158,147,2,8,1,7
E33008951,447,310,82,228,7,42,3,39,87,80,1,6,0,1
E33008952,533,293,93,200,2,42,5,37,192,185,0,5,2,4
E33008953,353,187,43,144,4,54,10,44,106,100,1,3,2,2
E33008954,274,186,54,132,1,38,7,31,48,43,1,3,1,1
E33008955,285,141,39,102,1,41,14,27,94,85,2,4,3,8
E33008956,4186,3236,600,2636,15,241,63,178,683,625,1,52,5,11
E33008957,497,213,41,172,2,63,16,47,214,208,0,3,3,5
E33008958,502,264,62,202,2,49,9,40,183,175,0,5,3,4
E33008959,366,212,67,145,2,47,7,40,103,96,0,6,1,2
E33008960,289,189,60,129,4,42,6,36,50,47,0,2,1,4
E33008961,468,325,96,229,3,46,7,39,92,89,1,1,1,2
E33008962,619,385,99,286,6,61,10,51,164,151,1,11,1,3
E33008963,718,409,92,317,6,93,20,73,209,199,2,8,0,1
E33008964,959,690,137,553,2,63,12,51,198,190,1,6,1,6
E33008965,467,329,78,251,3,27,6,21,105,99,0,6,0,3
E33008966,675,481,147,334,1,101,88,13,88,82,0,6,0,4
E33008967,1011,738,227,511,0,168,146,22,103,97,0,6,0,2
E33008968,558,443,118,325,0,65,53,12,50,45,1,4,0,0
E33008969,229,164,50,114,2,20,17,3,41,38,0,2,1,2
E33008970,254,207,69,138,0,16,13,3,31,30,0,1,0,0
E33008971,461,378,109,269,0,38,35,3,45,42,0,2,1,0
E33008972,594,414,127,287,4,84,67,17,86,73,1,9,3,6
E33008973,420,334,95,239,1,29,23,6,54,48,1,5,0,2
E33008974,884,762,193,569,4,38,33,5,77,69,0,7,1,3
E33008975,460,359,97,262,1,44,39,5,54,49,0,3,2,2
E33008976,449,329,108,221,2,38,33,5,76,67,2,5,2,4
E33008977,397,316,109,207,0,38,29,9,43,39,0,4,0,0
E33008978,204,130,36,94,1,30,24,6,34,32,0,0,2,9
E33008979,274,217,41,176,2,21,17,4,31,23,1,7,0,3
E33008980,204,178,44,134,2,10,7,3,14,12,0,2,0,0
E33008981,202,159,55,104,1,18,17,1,21,20,0,0,1,3
E33008982,579,457,124,333,4,53,48,5,63,55,1,6,1,2
E33008983,808,566,142,424,2,139,114,25,93,82,0,11,0,8
E33008984,289,193,58,135,1,47,41,6,46,44,0,2,0,2
E33008985,460,319,95,224,1,58,46,12,80,76,0,3,1,2
E33008986,331,259,77,182,1,31,27,4,37,34,1,2,0,3
E33008987,824,656,203,453,3,76,59,17,81,68,0,13,0,8
E33008988,339,241,74,167,1,51,45,6,46,43,0,3,0,0
E33008989,493,398,115,283,0,42,39,3,44,41,0,3,0,9
E33008990,1263,1004,285,719,4,105,84,21,138,130,0,6,2,12
E33008991,789,631,156,475,1,76,64,12,78,69,0,8,1,3
E33008992,731,635,146,489,2,22,13,9,66,57,2,7,0,6
E33008993,303,240,88,152,1,20,19,1,35,28,1,2,4,7
E33008994,257,220,92,128,0,20,19,1,17,13,1,3,0,0
E33008995,222,200,75,125,1,8,7,1,13,12,0,1,0,0
E33008996,240,201,60,141,0,19,17,2,19,15,0,4,0,1
E33008997,316,255,52,203,1,27,22,5,32,31,0,1,0,1
E33008998,1198,936,295,641,4,148,137,11,102,89,0,13,0,8
E33008999,993,722,206,516,4,153,133,20,108,102,0,6,0,6
E33009000,860,640,180,460,5,106,91,15,101,88,0,7,6,8
E33009001,317,241,65,176,1,28,19,9,42,37,0,5,0,5
E33009002,994,778,216,562,1,97,87,10,115,103,0,12,0,3
E33009003,371,293,75,218,1,24,24,0,51,46,0,5,0,2
E33009004,1038,542,111,431,5,89,57,32,394,381,1,10,2,8
E33009005,1009,671,152,519,1,89,77,12,243,230,2,11,0,5
E33009006,651,481,158,323,0,78,68,10,86,78,2,3,3,6
E33009007,1944,1617,401,1216,3,102,80,22,212,186,3,22,1,10
E33009008,2001,1537,334,1203,9,165,137,28,286,251,1,31,3,4
E33009009,387,302,67,235,1,18,17,1,57,51,0,6,0,9
E33009010,202,149,47,102,0,17,15,2,36,32,2,2,0,0
E33009011,1326,982,197,785,2,74,66,8,258,228,3,26,1,10
E33009012,638,548,133,415,1,31,20,11,52,47,0,4,1,6
E33009013,555,445,143,302,0,32,27,5,77,74,0,2,1,1
E33009014,2076,1547,315,1232,12,142,123,19,366,335,3,27,1,9
E33009015,563,487,123,364,2,33,26,7,41,37,1,2,1,0
E33009016,351,243,43,200,0,37,28,9,71,69,0,2,0,0
E33009017,336,249,64,185,2,27,23,4,54,47,4,3,0,4
E33009018,218,192,41,151,2,11,11,0,12,11,1,0,0,1
E33009019,588,447,96,351,1,58,51,7,78,70,0,6,2,4
E33009020,245,160,24,136,0,32,21,11,52,46,0,6,0,1
E33009021,289,235,75,160,0,17,14,3,35,30,1,4,0,2
E33009022,776,648,164,484,4,41,33,8,79,72,0,6,1,4
E33009023,380,308,96,212,0,15,11,4,53,49,1,3,0,4
E33009024,452,366,100,266,0,15,13,2,69,58,0,11,0,2
E33009025,669,545,117,428,4,38,30,8,79,72,0,7,0,3
E33009026,1148,820,191,629,7,108,93,15,207,188,7,8,4,6
E33009027,416,363,115,248,1,17,15,2,28,24,1,2,1,7
E33009028,572,420,128,292,2,65,60,5,82,74,0,5,3,3
E33009029,1905,1242,305,937,4,222,179,43,425,398,6,18,3,12
E33009030,449,307,63,244,4,42,36,6,96,88,1,7,0,0
E33009031,209,153,42,111,0,17,16,1,39,36,0,3,0,0
E33009032,578,429,138,291,1,39,26,13,104,98,1,5,0,5
E33009033,322,248,62,186,4,19,13,6,51,46,1,3,1,0
E33009034,376,301,80,221,1,18,10,8,56,52,0,4,0,0
E33009035,321,255,64,191,0,22,19,3,41,38,0,3,0,3
E33009036,1392,962,262,700,7,109,88,21,302,280,1,19,2,12
E33009037,231,190,55,135,0,9,8,1,30,28,0,2,0,2
E33009038,1413,1044,265,779,3,122,95,27,237,215,1,20,1,7
E33009039,246,192,41,151,0,21,19,2,32,30,0,2,0,1
E33009040,571,427,107,320,2,52,40,12,88,78,0,8,2,2
E33009041,206,158,50,108,0,18,14,4,29,23,1,2,3,1
E33009042,763,616,164,452,4,49,41,8,89,76,0,12,1,5
E33009043,208,158,31,127,0,13,12,1,36,30,0,5,1,1
E33009044,272,200,57,143,0,31,28,3,39,37,1,1,0,2
E33009045,351,239,72,167,0,34,21,13,76,69,0,5,2,2
E33009046,211,166,52,114,1,12,9,3,31,29,0,2,0,1
E33009047,323,241,63,178,0,18,17,1,61,56,0,5,0,3
E33009048,246,205,68,137,0,17,14,3,20,20,0,0,0,4
E33009049,1565,1338,342,996,2,75,67,8,142,130,0,10,2,8
E33009050,663,491,136,355,2,59,50,9,108,101,0,7,0,3
E33009051,553,436,105,331,0,47,42,5,64,62,0,2,0,6
E33009052,364,289,71,218,2,25,24,1,46,41,0,4,1,2
E33009053,208,147,30,117,0,17,11,6,38,33,0,5,0,6
E33009054,294,237,53,184,0,16,13,3,39,38,0,1,0,2
E33009055,1036,667,153,514,7,117,93,24,241,226,0,14,1,4
E33009056,582,506,122,384,0,28,22,6,45,38,0,7,0,3
E33009057,278,200,61,139,0,31,26,5,44,39,1,3,1,3
E33009058,733,575,156,419,1,73,62,11,83,76,0,7,0,1
E33009059,527,352,92,260,2,59,52,7,111,97,0,14,0,3
E33009060,481,381,99,282,0,32,24,8,61,54,1,6,0,7
E33009061,319,268,69,199,0,13,13,0,37,31,0,5,1,1
E33009062,224,158,48,110,3,21,16,5,40,37,0,3,0,2
E33009063,597,510,143,367,0,32,23,9,52,48,0,4,0,3
E33009064,410,303,79,224,2,35,26,9,68,61,0,6,1,2
E33009065,255,218,60,158,0,12,10,2,24,20,0,3,1,1
E33009066,271,198,54,144,3,32,29,3,37,35,0,2,0,1
E33009067,366,300,83,217,1,17,13,4,46,38,0,6,2,2
E33009068,394,313,80,233,0,24,18,6,54,51,0,3,0,3
E33009069,2453,1853,365,1488,11,172,147,25,407,357,1,46,3,10
E33009070,891,699,209,490,3,70,57,13,107,100,0,7,0,12
E33009071,244,158,41,117,0,35,31,4,49,47,0,2,0,2
E33009072,843,639,210,429,4,83,73,10,113,104,1,7,1,4
E33009073,224,164,50,114,1,23,21,2,33,30,2,1,0,3
E33009074,416,302,110,192,2,38,26,12,71,64,2,4,1,3
E33009075,236,190,41,149,1,13,11,2,31,31,0,0,0,1
E33009076,273,209,63,146,0,13,8,5,47,44,0,2,1,4
E33009077,196,132,44,88,1,23,21,2,36,35,0,0,1,4
E33009078,260,177,45,132,0,35,31,4,44,41,0,2,1,4
E33009079,211,156,55,101,2,21,20,1,31,26,0,2,3,1
E33009080,211,143,42,101,0,24,20,4,42,40,0,2,0,2
E33009081,332,211,43,168,0,40,37,3,79,75,0,3,1,2
E33009082,401,311,88,223,2,31,28,3,52,49,0,3,0,5
E33009083,1388,990,227,763,4,121,106,15,266,253,1,12,0,7
E33009084,650,473,128,345,1,70,60,10,102,91,1,9,1,4
E33009085,928,698,175,523,1,113,79,34,114,106,0,8,0,2
E33009086,3855,3189,816,2373,6,257,204,53,390,360,6,23,1,13
E33009087,667,532,129,403,1,61,48,13,73,63,0,9,1,0
E33009088,251,202,56,146,0,17,17,0,32,29,0,3,0,0
E33009089,526,420,94,326,1,32,25,7,71,65,0,6,0,2
E33009090,962,771,218,553,3,94,80,14,93,85,1,4,3,1
E33009091,355,238,63,175,1,66,55,11,48,40,0,7,1,2
E33009092,818,595,180,415,2,87,65,22,127,117,1,8,1,7
E33009093,530,431,110,321,2,47,38,9,48,46,0,2,0,2
E33009094,916,705,188,517,5,84,74,10,116,105,2,6,3,6
E33009095,1308,857,251,606,5,186,161,25,251,233,1,16,1,9
E33009096,375,307,81,226,0,37,33,4,28,27,0,1,0,3
E33009097,237,158,53,105,0,35,30,5,44,43,0,1,0,0
E33009098,469,340,113,227,0,66,56,10,61,58,0,3,0,2
E33009099,690,588,159,429,1,48,45,3,49,47,0,2,0,4
E33009100,303,228,70,158,1,41,35,6,31,29,0,1,1,2
E33009101,287,217,59,158,2,35,26,9,32,29,1,2,0,1
E33009102,1114,891,260,631,2,122,106,16,98,87,0,9,2,1
E33009103,800,687,179,508,5,61,50,11,46,40,1,4,1,1
E33009104,474,355,111,244,1,54,43,11,58,54,0,3,1,6
E33009105,472,364,100,264,1,54,45,9,50,49,0,1,0,3
E33009106,338,277,79,198,0,33,27,6,27,20,0,7,0,1
E33009107,230,172,63,109,1,32,29,3,24,19,2,3,0,1
E33009108,466,347,111,236,3,47,39,8,67,58,0,8,1,2
E33009109,280,213,45,168,1,31,23,8,35,33,0,2,0,0
E33009110,413,341,76,265,0,25,23,2,47,44,0,3,0,0
E33009111,705,512,128,384,2,121,109,12,66,62,0,4,0,4
E33009112,477,338,84,254,0,67,63,4,67,62,0,4,1,5
E33009113,341,255,68,187,1,39,30,9,44,40,0,4,0,2
E33009114,1508,1021,275,746,5,182,152,30,293,278,0,14,1,7
E33009115,1667,1173,331,842,5,282,241,41,198,176,0,20,2,9
E33009116,255,186,37,149,2,45,39,6,21,18,0,3,0,1
E33009117,254,191,50,141,0,27,21,6,31,27,0,4,0,5
E33009118,255,196,49,147,0,33,27,6,25,23,0,1,1,1
E33009119,211,161,31,130,0,25,19,6,24,19,0,5,0,1
E33009120,251,186,33,153,0,32,25,7,32,31,0,1,0,1
E33009121,380,295,76,219,1,39,33,6,45,42,0,3,0,0
E33009122,389,292,74,218,1,32,25,7,62,60,0,1,1,2
E33009123,274,223,63,160,0,23,19,4,24,20,1,2,1,4
E33009124,550,338,82,256,1,81,68,13,126,118,4,2,2,4
E33009125,583,452,132,320,1,74,62,12,55,50,1,4,0,1
E33009126,201,152,42,110,0,24,22,2,22,19,0,2,1,3
E33009127,5045,3390,758,2632,18,608,499,109,1006,917,6,78,5,23
E33009128,609,395,80,315,3,90,79,11,116,106,1,9,0,5
E33009129,1771,1401,319,1082,10,130,105,25,224,206,1,17,0,6
E33009130,551,418,123,295,1,55,47,8,75,71,2,2,0,2
E33009131,597,432,128,304,2,95,84,11,66,61,0,5,0,2
E33009132,228,153,29,124,0,25,21,4,45,38,0,5,2,5
E33009133,686,482,118,364,3,68,54,14,130,116,0,14,0,3
E33009134,767,503,165,338,12,131,103,28,116,110,0,5,1,5
E33009135,316,225,69,156,1,26,21,5,63,57,0,6,0,1
E33009136,705,548,171,377,3,67,47,20,81,73,1,6,1,6
E33009137,245,180,52,128,2,27,16,11,35,33,0,1,1,1
E33009138,260,196,42,154,0,31,22,9,31,31,0,0,0,2
E33009139,665,489,93,396,2,71,53,18,100,89,0,9,2,3
E33009140,609,473,117,356,4,57,50,7,75,73,0,2,0,0
E33009141,467,297,79,218,0,42,29,13,125,117,3,2,3,3
E33009142,583,479,151,328,3,25,14,11,75,62,1,4,8,1
E33009143,396,231,63,168,4,29,14,15,128,123,0,3,2,4
E33009144,773,604,152,452,2,52,36,16,108,99,0,8,1,7
E33009145,2118,1590,385,1205,8,121,84,37,392,367,2,19,4,7
E33009146,627,233,51,182,2,37,15,22,353,337,1,8,7,2
E33009147,466,283,88,195,2,9,6,3,167,155,0,11,1,5
E33009148,265,209,76,133,1,12,10,2,41,40,0,1,0,2
E33009149,5239,3870,1037,2833,22,492,338,154,826,762,15,40,9,29
E33009150,1051,866,212,654,4,72,51,21,107,95,4,7,1,2
E33009151,649,367,107,260,0,59,39,20,218,201,3,9,5,5
E33009152,222,173,45,128,1,10,8,2,38,36,0,1,1,0
E33009153,358,232,71,161,2,36,24,12,88,82,1,4,1,0
E33009154,279,194,52,142,2,37,24,13,44,39,2,3,0,2
E33009155,661,531,155,376,2,65,48,17,60,57,0,2,1,3
E33009156,244,194,51,143,1,24,16,8,24,22,0,2,0,1
E33009157,666,505,155,350,3,90,66,24,63,51,1,9,2,5
E33009158,311,245,104,141,0,52,35,17,11,10,0,0,1,3
E33009159,556,393,111,282,3,99,74,25,61,57,1,1,2,0
E33009160,315,225,75,150,1,51,43,8,36,32,0,4,0,2
E33009161,601,495,151,344,0,68,53,15,37,32,0,5,0,1
E33009162,1479,956,204,752,10,168,116,52,338,300,2,34,2,7
E33009163,297,211,45,166,1,52,25,27,32,28,0,4,0,1
E33009164,379,282,80,202,2,54,38,16,41,35,1,5,0,0
E33009165,263,207,65,142,0,34,27,7,22,21,0,1,0,0
E33009166,271,172,49,123,2,66,26,40,31,27,0,4,0,0
E33009167,394,278,71,207,1,70,46,24,44,41,1,2,0,1
E33009168,1593,1215,260,955,4,110,77,33,257,229,0,25,3,7
E33009169,720,512,121,391,1,88,59,29,116,108,1,5,2,3
E33009170,505,367,91,276,2,58,47,11,77,72,1,3,1,1
E33009171,6879,4547,1148,3399,22,806,556,250,1473,1352,4,93,24,31
E33009172,264,199,57,142,0,26,19,7,38,34,0,4,0,1
E33009173,417,266,61,205,2,33,20,13,110,104,0,5,1,6
E33009174,155,101,37,64,0,23,10,13,26,24,0,2,0,5
E33009175,283,217,68,149,1,38,29,9,25,23,0,2,0,2
E33009176,719,554,155,399,3,77,55,22,84,76,0,7,1,1
E33009177,391,278,62,216,2,29,20,9,82,74,0,8,0,0
E33009178,447,341,97,244,2,40,25,15,63,57,0,6,0,1
E33009179,622,382,99,283,1,97,78,19,138,131,1,4,2,4
E33009180,1641,1215,290,925,3,237,168,69,183,169,1,9,4,3
E33009181,359,249,61,188,3,54,48,6,51,47,0,3,1,2
E33009182,299,204,55,149,2,51,40,11,39,36,2,1,0,3
E33009183,574,422,92,330,2,55,36,19,91,86,0,5,0,4
E33009184,282,204,69,135,0,35,20,15,43,39,1,0,3,0
E33009185,687,588,166,422,1,30,24,6,65,61,0,2,2,3
E33009186,509,356,62,294,0,41,27,14,110,103,0,7,0,2
E33009187,900,736,171,565,2,37,25,12,121,110,0,10,1,4
E33009188,590,441,121,320,2,77,61,16,68,60,0,6,2,2
E33009189,549,360,83,277,1,71,54,17,115,111,0,4,0,2
E33009190,870,725,212,513,3,39,30,9,91,82,2,6,1,12
E33009191,346,265,93,172,0,40,27,13,41,35,0,6,0,0
E33009192,503,367,95,272,3,45,33,12,86,76,0,6,4,2
E33009193,528,394,90,304,3,41,32,9,85,79,0,5,1,5
E33009194,912,686,187,499,5,88,52,36,126,118,1,7,0,7
E33009195,860,640,180,460,1,135,90,45,84,77,1,5,1,0
E33009196,1167,833,183,650,0,200,155,45,127,111,0,14,2,7
E33009197,539,423,96,327,2,60,40,20,54,49,1,3,1,0
E33009198,321,260,58,202,1,28,21,7,32,29,2,1,0,0
E33009199,323,272,42,230,0,16,10,6,34,32,0,2,0,1
E33009200,1464,956,218,738,5,236,177,59,262,251,1,9,1,5
E33009201,407,313,81,232,2,45,39,6,46,44,0,0,2,1
E33009202,279,202,59,143,0,52,46,6,23,22,0,1,0,2
E33009203,277,206,58,148,0,37,32,5,31,27,1,2,1,3
E33009204,477,377,133,244,0,56,42,14,38,38,0,0,0,6
E33009205,631,471,123,348,3,78,61,17,76,71,0,5,0,3
E33009206,541,413,86,327,1,56,45,11,67,53,1,13,0,4
E33009207,277,166,44,122,0,30,17,13,80,72,1,5,2,1
E33009208,304,232,87,145,0,22,16,6,47,42,0,5,0,3
E33009209,502,391,120,271,2,35,27,8,70,65,0,5,0,4
E33009210,740,404,97,307,2,141,94,47,184,172,4,8,0,9
E33009211,262,162,58,104,2,34,19,15,61,57,0,3,1,3
E33009212,513,335,81,254,1,93,68,25,82,69,0,12,1,2
E33009213,644,457,103,354,5,69,48,21,107,101,1,5,0,6
E33009214,3586,2527,726,1801,10,176,113,63,863,803,10,35,15,10
E33009215,902,733,237,496,2,73,61,12,91,82,3,6,0,3
E33009216,275,169,43,126,1,51,39,12,51,46,1,4,0,3
E33009217,267,195,54,141,0,31,25,6,41,40,0,1,0,0
E33009218,598,396,104,292,1,124,89,35,74,67,1,6,0,3
E33009219,563,438,113,325,2,48,40,8,75,70,0,5,0,0
E33009220,827,623,217,406,4,126,79,47,73,69,0,4,0,1
E33009221,297,200,42,158,2,55,34,21,40,35,0,3,2,0
E33009222,229,169,43,126,1,30,24,6,25,21,2,2,0,4
E33009223,837,609,163,446,1,134,103,31,92,82,1,8,1,1
E33009224,436,278,69,209,1,58,46,12,98,96,0,2,0,1
E33009225,637,479,122,357,3,87,62,25,67,56,1,9,1,1
E33009226,221,144,31,113,1,40,23,17,34,31,0,2,1,2
E33009227,628,449,144,305,3,107,79,28,63,57,0,4,2,6
E33009228,1015,703,234,469,2,195,140,55,113,100,0,12,1,2
E33009229,328,224,72,152,2,36,24,12,64,61,0,3,0,2
E33009230,372,295,81,214,0,21,15,6,51,46,0,4,1,5
E33009231,352,221,65,156,1,47,43,4,81,74,1,6,0,2
E33009232,633,456,155,301,4,85,61,24,85,79,0,5,1,3
E33009233,500,249,61,188,0,109,72,37,141,134,2,2,3,1
E33009234,563,428,115,313,1,32,27,5,100,93,1,5,1,2
E33009235,694,417,92,325,3,57,37,20,211,204,0,6,1,6
E33009236,327,240,67,173,0,33,25,8,50,42,0,7,1,4
E33009237,267,172,34,138,1,72,50,22,22,21,0,1,0,0
E33009238,1009,721,197,524,6,150,112,38,129,113,1,13,2,3
E33009239,228,166,47,119,0,37,30,7,25,25,0,0,0,0
E33009240,375,262,62,200,2,58,41,17,51,47,1,3,0,2
E33009241,558,359,103,256,3,92,72,20,95,90,0,4,1,9
E33009242,369,328,109,219,2,16,6,10,22,20,0,2,0,1
E33009243,754,535,128,407,4,67,40,27,145,135,2,8,0,3
E33009244,251,183,52,131,0,22,8,14,44,40,1,3,0,2
E33009245,278,202,61,141,2,15,5,10,56,50,0,6,0,3
E33009246,206,161,40,121,1,11,6,5,32,30,0,2,0,1
E33009247,735,570,163,407,2,48,24,24,112,103,1,7,1,3
E33009248,696,559,148,411,5,29,14,15,97,85,0,11,1,6
E33009249,266,199,54,145,0,27,20,7,40,36,0,3,1,0
E33009250,331,274,84,190,3,20,11,9,32,27,0,4,1,2
E33009251,294,227,79,148,1,20,10,10,41,38,0,3,0,5
E33009252,288,219,49,170,0,25,9,16,43,41,0,2,0,1
E33009253,404,290,86,204,2,38,21,17,70,63,1,6,0,4
E33009254,379,289,80,209,2,36,18,18,50,48,0,2,0,2
E33009255,1576,1268,285,983,9,112,51,61,178,159,1,16,2,9
E33009256,711,584,178,406,3,42,16,26,73,70,0,1,2,9
E33009257,247,175,55,120,0,26,12,14,42,39,0,3,0,4
E33009258,381,263,87,176,1,32,14,18,79,73,0,4,2,6
E33009259,765,566,91,475,2,66,37,29,129,121,0,7,1,2
E33009260,291,244,61,183,0,6,4,2,38,33,1,4,0,3
E33009261,1037,741,193,548,1,96,38,58,192,179,1,10,2,7
E33009262,332,257,57,200,0,26,16,10,49,46,0,3,0,0
E33009263,536,418,129,289,1,40,16,24,73,62,0,11,0,4
E33009264,4284,3073,772,2301,25,401,243,158,766,709,4,50,3,19
E33009265,1225,653,178,475,13,133,53,80,421,402,5,8,6,5
E33009266,917,665,165,500,5,35,15,20,207,191,2,13,1,5
E33009267,381,318,75,243,2,31,16,15,30,27,0,3,0,0
E33009268,385,273,68,205,5,29,18,11,71,68,0,2,1,7
E33009269,365,282,88,194,2,13,9,4,64,60,1,3,0,4
E33009270,215,168,57,111,2,5,1,4,37,35,0,2,0,3
E33009271,238,167,58,109,1,19,8,11,51,50,0,1,0,0
E33009272,200,166,47,119,2,6,3,3,25,25,0,0,0,1
E33009273,448,351,111,240,3,16,7,9,72,67,0,5,0,6
E33009274,339,286,85,201,0,18,12,6,32,28,2,2,0,3
E33009275,468,335,110,225,5,43,24,19,83,82,0,1,0,2
E33009276,561,426,123,303,3,48,20,28,81,72,1,8,0,3
E33009277,341,246,54,192,3,23,6,17,67,64,1,2,0,2
E33009278,708,533,156,377,4,38,16,22,127,114,0,11,2,6
E33009279,525,407,106,301,6,42,24,18,66,61,0,5,0,4
E33009280,483,372,106,266,2,22,15,7,84,75,2,7,0,3
E33009281,456,354,120,234,0,26,8,18,72,68,0,4,0,4
E33009282,899,715,167,548,3,34,15,19,140,134,0,6,0,7
E33009283,205,145,42,103,2,19,9,10,39,37,0,2,0,0
E33009284,483,356,106,250,2,37,15,22,82,68,1,12,1,6
E33009285,224,168,59,109,0,18,6,12,37,33,0,4,0,1
E33009286,262,200,49,151,4,16,7,9,40,35,0,5,0,2
E33009287,528,411,143,268,2,34,14,20,80,73,1,5,1,1
E33009288,249,203,64,139,2,15,5,10,29,28,0,1,0,0
E33009289,312,231,84,147,0,29,14,15,49,44,0,3,2,3
E33009290,257,212,55,157,2,10,5,5,30,25,0,5,0,3
E33009291,249,195,70,125,2,8,3,5,42,42,0,0,0,2
E33009292,767,578,180,398,8,67,32,35,112,103,0,9,0,2
E33009293,222,165,56,109,2,20,15,5,33,31,1,0,1,2
E33009294,249,212,56,156,2,7,1,6,26,21,0,5,0,2
E33009295,244,182,63,119,2,15,8,7,40,34,0,5,1,5
E33009296,975,842,260,582,2,40,19,21,89,80,1,8,0,2
E33009297,215,159,60,99,0,17,7,10,37,35,0,2,0,2
E33009298,216,158,38,120,0,23,10,13,35,32,0,2,1,0
E33009299,858,733,130,603,8,24,10,14,90,82,0,6,2,3
E33009300,208,153,54,99,0,19,5,14,34,32,0,2,0,2
E33009301,417,314,90,224,3,29,14,15,69,65,0,2,2,2
E33009302,562,361,86,275,1,50,25,25,144,138,1,5,0,6
E33009303,942,685,183,502,3,76,38,38,171,159,2,9,1,7
E33009304,375,292,71,221,3,21,12,9,57,49,0,8,0,2
E33009305,1180,930,216,714,3,34,11,23,206,194,1,11,0,7
E33009306,446,326,81,245,1,37,21,16,80,69,0,11,0,2
E33009307,254,207,76,131,2,12,7,5,31,29,0,1,1,2
E33009308,366,284,80,204,1,25,9,16,56,43,0,11,2,0
E33009309,284,187,56,131,4,25,6,19,66,59,1,6,0,2
E33009310,258,192,36,156,1,25,9,16,39,32,0,7,0,1
E33009311,482,364,98,266,1,41,24,17,72,66,1,5,0,4
E33009312,215,158,32,126,2,10,5,5,44,39,1,4,0,1
E33009313,228,182,46,136,0,12,7,5,33,29,0,3,1,1
E33009314,319,249,71,178,3,16,6,10,49,44,1,1,3,2
E33009315,376,284,110,174,3,30,14,16,52,44,0,8,0,7
E33009316,5043,3973,1003,2970,12,216,100,116,818,760,10,46,2,24
E33009317,1092,838,226,612,4,88,53,35,155,145,3,6,1,7
E33009318,383,272,64,208,2,36,17,19,68,62,0,6,0,5
E33009319,640,438,107,331,2,78,46,32,116,106,0,9,1,6
E33009320,357,261,59,202,2,24,19,5,66,61,0,5,0,4
E33009321,1601,1227,303,924,8,121,61,60,235,210,0,25,0,10
E33009322,212,153,47,106,0,20,16,4,35,30,0,4,1,4
E33009323,226,180,51,129,1,14,7,7,27,24,0,3,0,4
E33009324,1085,705,165,540,2,153,71,82,219,208,2,6,3,6
E33009325,423,333,102,231,1,16,10,6,70,68,1,1,0,3
E33009326,476,359,108,251,2,35,14,21,75,71,0,1,3,5
E33009327,492,384,97,287,3,35,13,22,62,53,1,8,0,8
E33009328,459,333,90,243,2,29,14,15,91,83,1,7,0,4
E33009329,306,231,63,168,0,23,9,14,52,51,0,1,0,0
E33009330,224,164,65,99,2,24,13,11,32,29,0,2,1,2
E33009331,213,150,55,95,1,21,10,11,38,38,0,0,0,3
E33009332,131,99,36,63,1,13,6,7,16,13,1,2,0,2
E33009333,452,336,76,260,2,31,21,10,81,76,0,5,0,2
E33009334,365,260,91,169,3,31,11,20,70,59,0,7,4,1
E33009335,242,201,76,125,1,11,2,9,27,25,0,0,2,2
E33009336,294,226,77,149,0,20,10,10,46,45,0,1,0,2
E33009337,330,248,75,173,1,30,8,22,51,48,0,3,0,0
E33009338,830,571,173,398,4,75,40,35,172,165,0,4,3,8
E33009339,242,149,49,100,1,17,11,6,66,60,0,6,0,9
E33009340,387,299,104,195,1,18,5,13,66,57,0,7,2,3
E33009341,529,374,113,261,2,42,15,27,109,100,0,8,1,2
E33009342,263,199,64,135,0,21,10,11,40,39,0,1,0,3
E33009343,376,316,68,248,2,25,11,14,32,30,0,2,0,1
E33009344,654,512,106,406,2,46,31,15,91,82,0,8,1,3
E33009345,295,221,52,169,0,17,7,10,54,50,0,4,0,3
E33009346,218,178,55,123,1,15,6,9,21,19,0,2,0,3
E33009347,255,208,71,137,0,11,6,5,26,23,0,2,1,10
E33009348,255,186,52,134,2,15,8,7,51,47,0,1,3,1
E33009349,494,386,81,305,3,43,29,14,58,51,0,5,2,4
E33009350,327,227,50,177,4,31,21,10,64,54,0,10,0,1
E33009351,311,224,71,153,2,26,12,14,58,58,0,0,0,1
E33009352,564,477,145,332,1,24,17,7,59,56,0,2,1,3
E33009353,300,208,70,138,1,23,9,14,63,55,0,8,0,5
E33009354,287,200,69,131,0,22,5,17,62,51,0,11,0,3
E33009355,635,509,167,342,1,33,20,13,85,78,0,7,0,7
E33009356,823,616,160,456,2,64,45,19,138,134,0,4,0,3
E33009357,1146,820,165,655,5,121,53,68,191,165,0,20,6,9
E33009358,274,211,48,163,1,17,8,9,45,39,0,6,0,0
E33009359,419,330,74,256,0,29,15,14,56,53,1,2,0,4
E33009360,244,173,43,130,0,16,8,8,49,43,0,6,0,6
E33009361,968,729,200,529,6,86,37,49,145,125,2,13,5,2
E33009362,429,292,82,210,3,32,10,22,97,83,1,11,2,5
E33009363,218,157,49,108,0,20,5,15,41,35,0,6,0,0
E33009364,659,527,165,362,1,31,15,16,100,88,1,11,0,0
E33009365,297,233,71,162,1,20,4,16,42,40,0,2,0,1
E33009366,379,286,88,198,3,29,15,14,58,55,3,0,0,3
E33009367,253,192,54,138,0,17,8,9,44,44,0,0,0,0
E33009368,364,267,85,182,1,32,14,18,62,58,0,4,0,2
E33009369,196,167,58,109,1,8,2,6,17,16,0,1,0,3
E33009370,259,199,61,138,3,18,6,12,38,34,0,3,1,1
E33009371,244,183,50,133,2,17,7,10,42,38,0,4,0,0
E33009372,659,504,160,344,1,50,27,23,101,90,0,9,2,3
E33009373,353,249,73,176,3,38,24,14,61,56,0,5,0,2
E33009374,310,219,95,124,2,42,22,20,47,37,1,7,2,0
E33009375,227,174,56,118,2,15,4,11,34,31,0,1,2,2
E33009376,229,190,58,132,1,17,5,12,20,19,0,1,0,1
E33009377,330,247,93,154,2,36,15,21,42,36,1,5,0,3
E33009378,897,719,215,504,5,54,23,31,117,111,0,5,1,2
E33009379,433,282,93,189,1,53,27,26,93,84,0,9,0,4
E33009380,487,361,105,256,3,34,10,24,83,78,0,5,0,6
E33009381,225,150,40,110,2,16,5,11,53,48,0,2,3,4
E33009382,836,577,190,387,4,111,37,74,139,127,0,12,0,5
E33009383,298,243,76,167,0,17,4,13,38,34,0,4,0,0
E33009384,280,237,76,161,0,21,9,12,21,21,0,0,0,1
E33009385,292,199,60,139,1,25,8,17,64,60,0,4,0,3
E33009386,562,331,76,255,10,67,34,33,149,138,2,8,1,5
E33009387,425,315,106,209,1,39,11,28,65,60,0,3,2,5
E33009388,298,244,50,194,3,10,5,5,41,37,0,4,0,0
E33009389,341,231,66,165,0,29,10,19,75,66,1,6,2,6
E33009390,593,462,129,333,2,35,16,19,88,79,0,6,3,6
E33009391,476,361,108,253,1,48,20,28,63,52,0,10,1,3
E33009392,544,411,121,290,2,52,24,28,76,73,0,2,1,3
E33009393,412,313,76,237,1,34,15,19,60,47,0,12,1,4
E33009394,211,153,43,110,0,10,6,4,46,44,0,2,0,2
E33009395,3710,3182,536,2646,16,85,38,47,404,369,2,29,4,23
E33009396,356,292,93,199,2,27,7,20,32,32,0,0,0,3
E33009397,222,167,44,123,2,16,7,9,35,31,0,4,0,2
E33009398,293,221,62,159,0,21,5,16,49,42,0,7,0,2
E33009399,318,235,75,160,3,18,9,9,60,55,0,3,2,2
E33009400,215,165,56,109,1,11,4,7,38,36,0,2,0,0
E33009401,247,166,44,122,2,28,19,9,48,41,0,6,1,3
E33009402,988,732,207,525,5,67,35,32,176,162,0,13,1,8
E33009403,533,397,109,288,1,29,15,14,99,90,0,7,2,7
E33009404,399,311,75,236,3,31,7,24,52,44,0,6,2,2
E33009405,263,196,73,123,1,29,23,6,35,31,0,4,0,2
E33009406,922,684,217,467,9,99,70,29,125,116,2,7,0,5
E33009407,366,282,82,200,0,35,27,8,45,43,0,2,0,4
E33009408,294,196,65,131,3,42,37,5,51,47,0,2,2,2
E33009409,655,423,138,285,3,101,80,21,125,116,0,6,3,3
E33009410,263,217,63,154,0,16,12,4,26,25,0,1,0,4
E33009411,243,174,61,113,2,31,27,4,34,31,0,3,0,2
E33009412,1052,861,251,610,7,59,47,12,122,100,0,14,8,3
E33009413,856,677,151,526,1,68,59,9,108,97,0,11,0,2
E33009414,686,480,105,375,4,52,38,14,145,129,0,15,1,5
E33009415,568,418,111,307,1,67,48,19,79,75,0,4,0,3
E33009416,1187,850,203,647,5,107,70,37,215,202,0,11,2,10
E33009417,885,656,133,523,5,59,46,13,162,151,0,9,2,3
E33009418,226,173,42,131,1,17,13,4,33,29,0,4,0,2
E33009419,435,337,85,252,3,38,27,11,53,49,0,4,0,4
E33009420,254,197,43,154,0,24,19,5,29,28,0,1,0,4
E33009421,456,303,49,254,6,38,20,18,108,103,0,5,0,1
E33009422,335,261,71,190,1,31,29,2,33,31,0,2,0,9
E33009423,280,220,52,168,1,17,14,3,39,33,0,4,2,3
E33009424,281,213,61,152,0,14,8,6,49,46,1,2,0,5
E33009425,246,209,51,158,1,9,6,3,24,21,0,3,0,3
E33009426,362,294,65,229,0,17,12,5,50,45,0,4,1,1
E33009427,363,273,86,187,1,37,21,16,49,44,0,2,3,3
E33009428,262,172,67,105,2,24,17,7,60,57,0,2,1,4
E33009429,1091,789,172,617,7,82,68,14,203,186,0,15,2,10
E33009430,219,177,34,143,0,13,11,2,29,28,0,1,0,0
E33009431,746,497,136,361,4,99,73,26,142,132,0,9,1,4
E33009432,317,210,54,156,1,27,16,11,77,69,1,6,1,2
E33009433,447,321,91,230,2,42,32,10,80,74,1,5,0,2
E33009434,784,590,165,425,3,72,59,13,114,110,0,3,1,5
E33009435,775,568,129,439,2,46,38,8,152,146,0,5,1,7
E33009436,258,194,51,143,2,14,12,2,46,43,0,3,0,2
E33009437,599,445,138,307,2,41,30,11,106,101,0,5,0,5
E33009438,204,142,57,85,0,27,21,6,34,31,0,3,0,1
E33009439,509,423,134,289,2,29,24,5,54,49,0,4,1,1
E33009440,570,411,91,320,0,36,26,10,118,102,2,13,1,5
E33009441,375,301,71,230,1,21,18,3,49,44,0,5,0,3
E33009442,557,409,120,289,1,46,40,6,97,81,0,16,0,4
E33009443,277,225,81,144,0,24,14,10,25,24,0,1,0,3
E33009444,1423,1114,288,826,3,66,42,24,236,216,3,16,1,4
E33009445,455,323,101,222,1,38,24,14,86,78,0,8,0,7
E33009446,403,283,66,217,1,26,20,6,92,88,0,4,0,1
E33009447,760,494,159,335,2,81,68,13,174,162,0,12,0,9
E33009448,805,680,221,459,0,47,30,17,72,64,0,7,1,6
E33009449,266,171,44,127,0,18,15,3,77,71,0,5,1,0
E33009450,308,239,60,179,1,14,11,3,52,48,0,3,1,2
E33009451,487,352,109,243,3,37,29,8,90,82,0,8,0,5
E33009452,398,320,109,211,0,17,14,3,57,51,0,6,0,4
E33009453,219,148,52,96,1,22,15,7,47,40,0,4,3,1
E33009454,201,141,29,112,1,13,10,3,43,39,0,4,0,3
E33009455,410,295,85,210,2,43,31,12,66,58,1,7,0,4
E33009456,224,171,56,115,0,16,14,2,34,30,0,4,0,3
E33009457,254,169,54,115,1,15,12,3,68,64,0,4,0,1
E33009458,326,255,72,183,1,26,23,3,44,42,0,1,1,0
E33009459,530,391,116,275,1,33,21,12,102,93,0,9,0,3
E33009460,299,179,48,131,2,20,15,5,96,91,0,5,0,2
E33009461,251,177,56,121,0,19,15,4,51,48,0,3,0,4
E33009462,852,527,154,373,5,84,56,28,233,223,0,7,3,3
E33009463,674,505,139,366,3,58,52,6,106,91,5,9,1,2
E33009464,216,181,47,134,1,4,4,0,27,25,0,2,0,3
E33009465,253,194,88,106,0,20,12,8,37,33,0,4,0,2
E33009466,1329,959,243,716,4,146,108,38,215,193,1,21,0,5
E33009467,200,149,54,95,1,19,13,6,25,24,0,1,0,6
E33009468,271,214,65,149,0,23,15,8,30,26,0,4,0,4
E33009469,263,213,51,162,0,19,14,5,29,24,0,5,0,2
E33009470,222,175,71,104,1,16,11,5,28,21,2,4,1,2
E33009471,246,193,42,151,0,14,11,3,36,35,0,1,0,3
E33009472,512,367,138,229,0,60,44,16,82,77,0,4,1,3
E33009473,533,389,116,273,4,53,49,4,82,76,1,5,0,5
E33009474,436,328,97,231,0,22,21,1,85,75,2,7,1,1
E33009475,700,504,152,352,0,69,54,15,119,101,3,12,3,8
E33009476,245,187,62,125,0,17,10,7,37,34,1,2,0,4
E33009477,284,183,62,121,0,45,35,10,51,46,0,4,1,5
E33009478,213,156,50,106,0,28,22,6,29,24,1,4,0,0
E33009479,541,401,147,254,1,53,40,13,84,76,0,7,1,2
E33009480,527,351,99,252,3,100,76,24,69,65,0,2,2,4
E33009481,433,321,76,245,0,39,31,8,71,63,1,7,0,2
E33009482,642,478,148,330,1,52,45,7,108,99,3,3,3,3
E33009483,751,513,141,372,3,84,59,25,148,133,1,13,1,3
E33009484,300,253,83,170,0,10,8,2,33,26,1,5,1,4
E33009485,214,164,58,106,0,10,9,1,38,33,0,3,2,2
E33009486,270,220,80,140,2,11,9,2,37,33,0,4,0,0
E33009487,312,238,93,145,2,14,9,5,54,53,0,1,0,4
E33009488,306,262,86,176,0,8,6,2,34,28,2,2,2,2
E33009489,228,162,46,116,0,27,23,4,39,36,0,3,0,0
E33009490,692,487,133,354,4,76,59,17,118,110,0,6,2,7
E33009491,903,635,176,459,5,87,62,25,164,145,1,8,10,12
E33009492,2720,2133,556,1577,4,167,121,46,403,350,19,31,3,13
E33009493,267,198,46,152,2,24,18,6,42,39,0,2,1,1
E33009494,769,666,186,480,0,34,29,5,62,57,0,5,0,7
E33009495,674,587,101,486,1,21,9,12,64,55,0,9,0,1
E33009496,484,399,118,281,5,36,31,5,42,37,0,5,0,2
E33009497,439,291,95,196,1,65,51,14,80,74,2,4,0,2
E33009498,1048,857,276,581,2,66,53,13,117,106,1,10,0,6
E33009499,320,265,81,184,0,13,8,5,38,36,0,1,1,4
E33009500,363,296,92,204,0,25,21,4,41,37,2,2,0,1
E33009501,208,127,41,86,2,18,10,8,61,57,0,4,0,0
E33009502,124,93,29,64,0,9,6,3,22,21,0,1,0,0
E33009503,322,234,70,164,0,22,16,6,59,55,0,3,1,7
E33009504,211,148,28,120,1,11,9,2,51,48,0,3,0,0
E33009505,400,283,70,213,3,35,22,13,78,70,3,5,0,1
E33009506,212,164,63,101,0,12,8,4,34,33,0,0,1,2
E33009507,296,223,71,152,1,28,22,6,40,33,2,5,0,4
E33009508,290,223,59,164,1,29,22,7,35,27,0,7,1,2
E33009509,255,181,58,123,0,37,29,8,35,30,4,1,0,2
E33009510,322,228,92,136,1,36,26,10,53,48,1,4,0,4
E33009511,447,328,73,255,2,38,31,7,68,64,0,4,0,11
E33009512,665,479,147,332,1,92,75,17,86,75,1,10,0,7
E33009513,371,273,105,168,1,33,26,7,63,56,2,2,3,1
E33009514,1323,1007,288,719,4,104,72,32,198,181,3,14,0,10
E33009515,704,507,161,346,3,89,72,17,96,89,0,5,2,9
E33009516,246,204,59,145,2,14,11,3,25,23,0,2,0,1
E33009517,349,269,86,183,2,21,21,0,55,46,3,6,0,2
E33009518,542,380,130,250,3,67,51,16,86,77,1,7,1,6
E33009519,629,443,112,331,1,116,93,23,68,61,2,5,0,1
E33009520,658,461,97,364,2,108,85,23,86,77,1,7,1,1
E33009521,246,198,53,145,0,26,24,2,20,20,0,0,0,2
E33009522,239,176,28,148,1,24,22,2,37,33,0,4,0,1
E33009523,307,230,59,171,1,36,31,5,37,35,0,2,0,3
E33009524,309,227,68,159,1,34,30,4,46,40,0,6,0,1
E33009525,661,435,108,327,2,82,65,17,137,129,0,8,0,5
E33009526,380,231,59,172,1,84,68,16,62,61,0,1,0,2
E33009527,438,260,48,212,2,84,66,18,88,85,1,1,1,4
E33009528,672,521,130,391,2,61,45,16,87,74,0,10,3,1
E33009529,374,279,66,213,0,49,40,9,43,37,0,4,2,3
E33009530,498,320,79,241,5,85,69,16,85,80,0,5,0,3
E33009531,534,359,91,268,2,63,52,11,110,103,0,7,0,0
E33009532,803,650,162,488,2,48,37,11,100,90,0,9,1,3
E33009533,454,374,100,274,1,24,21,3,52,49,0,3,0,3
E33009534,354,282,99,183,1,40,29,11,29,29,0,0,0,2
E33009535,445,272,73,199,4,103,92,11,61,54,0,5,2,5
E33009536,1097,783,197,586,3,165,136,29,141,135,0,6,0,5
E33009537,374,252,71,181,2,42,30,12,74,70,0,3,1,4
E33009538,374,265,70,195,1,49,40,9,58,54,0,4,0,1
E33009539,716,551,93,458,1,70,58,12,90,82,0,8,0,4
E33009540,339,234,42,192,1,65,60,5,38,35,0,3,0,1
E33009541,304,212,55,157,0,35,27,8,55,48,1,5,1,2
E33009542,339,235,45,190,2,15,11,4,84,79,0,5,0,3
E33009543,248,212,40,172,0,18,14,4,18,16,0,2,0,0
E33009544,765,522,105,417,3,68,49,19,167,160,0,7,0,5
E33009545,603,382,97,285,4,68,48,20,145,139,0,6,0,4
E33009546,981,608,143,465,5,158,112,46,206,197,0,6,3,4
E33009547,2590,1851,298,1553,13,189,129,60,527,492,0,34,1,10
E33009548,1464,1074,225,849,6,152,112,40,224,205,2,15,2,8
E33009549,441,228,46,182,2,64,46,18,142,129,1,12,0,5
E33009550,397,314,92,222,0,32,20,12,49,46,0,3,0,2
E33009551,208,131,30,101,0,51,44,7,26,24,1,1,0,0
E33009552,240,173,42,131,1,32,27,5,32,31,0,1,0,2
E33009553,208,153,50,103,0,22,19,3,33,29,0,4,0,0
E33009554,231,163,33,130,1,23,16,7,44,39,3,2,0,0
E33009555,469,325,76,249,6,66,54,12,70,70,0,0,0,2
E33009556,377,232,50,182,1,45,34,11,97,92,0,4,1,2
E33009557,737,509,110,399,6,54,42,12,159,146,1,11,1,9
E33009558,1358,977,275,702,5,195,159,36,175,157,0,17,1,6
E33009559,182,141,42,99,1,19,16,3,19,18,0,0,1,2
E33009560,505,324,74,250,2,69,43,26,104,96,0,5,3,6
E33009561,405,311,68,243,3,46,32,14,43,41,0,2,0,2
E33009562,521,409,108,301,0,50,42,8,59,54,0,5,0,3
E33009563,326,249,76,173,1,26,20,6,49,43,0,5,1,1
E33009564,213,159,34,125,1,11,9,2,40,36,1,3,0,2
E33009565,251,185,61,124,0,25,22,3,40,34,0,5,1,1
E33009566,543,419,92,327,2,27,17,10,90,84,0,6,0,5
E33009567,586,384,90,294,4,89,55,34,102,98,0,3,1,7
E33009568,565,429,100,329,1,36,32,4,97,87,2,8,0,2
E33009569,641,488,101,387,3,71,60,11,76,66,0,10,0,3
E33009570,414,304,92,212,7,58,50,8,41,40,0,1,0,4
E33009571,500,312,94,218,5,89,74,15,92,85,0,4,3,2
E33009572,678,450,103,347,6,146,112,34,73,68,0,4,1,3
E33009573,495,365,89,276,1,69,56,13,55,50,0,3,2,5
E33009574,2570,1971,367,1604,16,133,82,51,440,400,7,33,0,10
E33009575,781,573,169,404,1,92,71,21,111,102,0,9,0,4
E33009576,665,502,127,375,2,20,15,5,125,112,2,10,1,16
E33009577,836,583,118,465,3,95,68,27,151,146,1,4,0,4
E33009578,427,345,69,276,0,15,9,6,64,57,0,4,3,3
E33009579,321,217,73,144,4,63,56,7,34,32,0,1,1,3
E33009580,566,399,112,287,2,81,66,15,79,74,0,5,0,5
E33009581,403,294,53,241,3,30,29,1,71,69,0,2,0,5
E33009582,267,181,42,139,1,40,33,7,41,36,0,4,1,4
E33009583,339,198,41,157,1,57,42,15,79,76,0,3,0,4
E33009584,355,249,76,173,2,63,43,20,38,31,1,4,2,3
E33009585,238,170,35,135,0,32,26,6,35,32,0,3,0,1
E33009586,1203,999,243,756,5,60,48,12,134,124,0,8,2,5
E33009587,436,284,64,220,1,74,65,9,72,68,0,3,1,5
E33009588,1860,1292,257,1035,4,202,144,58,352,326,0,24,2,10
E33009589,2119,1570,373,1197,9,267,207,60,266,251,2,9,4,7
E33009590,264,196,47,149,0,41,23,18,27,26,0,1,0,0
E33009591,242,165,54,111,0,43,34,9,32,30,0,2,0,2
E33009592,304,203,51,152,0,64,51,13,37,31,0,6,0,0
E33009593,828,571,149,422,2,131,97,34,122,110,1,9,2,2
E33009594,223,169,34,135,1,23,17,6,29,27,0,2,0,1
E33009595,450,319,73,246,0,29,26,3,97,94,1,2,0,5
E33009596,2138,1770,187,1583,15,80,63,17,267,245,1,21,0,6
E33009597,736,542,111,431,5,94,72,22,92,86,0,6,0,3
E33009598,739,534,117,417,6,114,90,24,79,72,1,6,0,6
E33009599,250,161,38,123,1,47,34,13,40,35,0,3,2,1
E33009600,722,371,87,284,7,149,126,23,185,179,0,6,0,10
E33009601,610,275,73,202,1,88,61,27,236,231,0,4,1,10
E33009602,803,478,116,362,4,145,117,28,171,151,4,15,1,5
E33009603,231,147,50,97,0,37,28,9,44,39,1,4,0,3
E33009604,556,435,100,335,0,27,23,4,92,84,1,7,0,2
E33009605,557,424,98,326,1,33,24,9,95,84,0,11,0,4
E33009606,291,228,63,165,0,23,13,10,37,35,0,2,0,3
E33009607,1471,1097,254,843,8,142,110,32,218,196,0,21,1,6
E33009608,344,256,57,199,1,26,24,2,59,51,1,7,0,2
E33009609,348,259,79,180,0,39,34,5,47,38,2,7,0,3
E33009610,495,371,80,291,1,33,23,10,90,84,0,5,1,0
E33009611,1433,1053,187,866,5,111,79,32,260,234,3,20,3,4
E33009612,425,328,81,247,1,53,40,13,42,39,0,3,0,1
E33009613,303,242,44,198,0,17,13,4,42,40,0,2,0,2
E33009614,3410,2513,464,2049,18,205,131,74,657,608,2,44,3,17
E33009615,2972,2081,517,1564,12,327,236,91,537,502,0,31,4,15
E33009616,220,147,38,109,1,37,31,6,34,31,0,3,0,1
E33009617,240,177,50,127,0,25,14,11,38,35,0,3,0,0
E33009618,596,418,116,302,2,53,45,8,113,102,0,9,2,10
E33009619,237,156,40,116,0,32,20,12,46,41,0,3,2,3
E33009620,825,641,140,501,6,73,62,11,101,88,1,12,0,4
E33009621,1062,750,164,586,1,114,81,33,194,180,1,12,1,3
E33009622,1524,1147,323,824,6,192,139,53,169,158,0,9,2,10
E33009623,945,689,188,501,5,110,91,19,135,125,0,9,1,6
E33009624,693,496,111,385,3,73,59,14,115,108,0,6,1,6
E33009625,517,373,82,291,4,42,32,10,92,82,0,10,0,6
E33009626,1133,833,216,617,4,95,61,34,192,172,1,17,2,9
E33009627,403,326,101,225,2,21,15,6,51,45,3,2,1,3
E33009628,224,163,53,110,0,28,22,6,29,29,0,0,0,4
E33009629,217,164,43,121,0,29,25,4,24,24,0,0,0,0
E33009630,245,192,61,131,1,13,11,2,36,30,0,3,3,3
E33009631,213,150,45,105,1,19,15,4,37,31,0,6,0,6
E33009632,725,498,154,344,3,97,85,12,121,110,3,6,2,6
E33009633,674,494,103,391,2,51,44,7,119,112,0,7,0,8
E33009634,385,280,74,206,1,38,27,11,61,57,0,4,0,5
E33009635,276,198,55,143,1,33,26,7,39,31,3,4,1,5
E33009636,288,219,49,170,2,41,34,7,24,22,0,2,0,2
E33009637,307,228,67,161,1,46,42,4,31,26,0,5,0,1
E33009638,1071,763,260,503,4,153,125,28,144,131,1,11,1,7
E33009639,313,237,73,164,2,30,20,10,42,37,0,5,0,2
E33009640,664,508,129,379,1,85,68,17,67,62,0,3,2,3
E33009641,341,251,58,193,2,49,40,9,39,35,0,3,1,0
E33009642,435,335,71,264,3,24,19,5,70,64,0,4,2,3
E33009643,1150,871,213,658,3,68,35,33,197,173,6,16,2,11
E33009644,610,469,111,358,2,58,45,13,79,70,0,9,0,2
E33009645,475,367,102,265,1,48,41,7,55,52,1,2,0,4
E33009646,688,481,86,395,2,87,68,19,118,110,0,7,1,0
E33009647,448,288,51,237,1,71,62,9,86,81,0,5,0,2
E33009648,671,492,120,372,3,103,89,14,70,60,2,7,1,3
E33009649,219,156,54,102,0,32,27,5,29,25,0,4,0,2
E33009650,677,459,108,351,4,124,111,13,86,78,1,7,0,4
E33009651,646,474,120,354,4,88,77,11,79,71,0,8,0,1
E33009652,726,491,94,397,3,94,77,17,134,127,0,6,1,4
E33009653,239,172,41,131,0,28,21,7,39,36,0,2,1,0
E33009654,747,549,149,400,3,94,77,17,98,94,0,3,1,3
E33009655,245,157,36,121,2,49,35,14,33,31,0,1,1,4
E33009656,254,188,34,154,2,35,27,8,27,25,1,1,0,2
E33009657,607,475,144,331,0,66,55,11,60,50,0,8,2,6
E33009658,565,457,123,334,1,40,27,13,62,60,0,2,0,5
E33009659,456,324,100,224,1,39,34,5,82,77,0,4,1,10
E33009660,261,174,30,144,0,16,10,6,69,65,0,3,1,2
E33009661,842,587,133,454,3,76,55,21,173,164,0,7,2,3
E33009662,197,125,36,89,2,40,27,13,30,29,0,1,0,0
E33009663,579,364,103,261,4,97,64,33,112,106,0,6,0,2
E33009664,356,212,62,150,1,65,46,19,73,67,0,5,1,5
E33009665,258,125,27,98,2,22,13,9,107,103,0,4,0,2
E33009666,519,346,95,251,2,34,21,13,135,120,2,12,1,2
E33009667,525,220,57,163,1,36,20,16,267,249,1,14,3,1
E33009668,769,537,136,401,6,66,47,19,157,151,0,6,0,3
E33009669,377,304,59,245,1,18,12,6,52,50,0,1,1,2
E33009670,1118,805,182,623,4,72,55,17,230,211,3,13,3,7
E33009671,669,501,134,367,3,39,18,21,124,121,0,3,0,2
E33009672,714,570,120,450,1,41,26,15,101,96,1,3,1,1
E33009673,315,215,59,156,3,39,31,8,57,55,0,2,0,1
E33009674,886,661,159,502,1,88,66,22,131,122,0,8,1,5
E33009675,278,213,39,174,0,30,25,5,34,32,0,2,0,1
E33009676,589,450,111,339,5,68,52,16,65,62,0,2,1,1
E33009677,376,296,62,234,4,25,19,6,50,48,0,2,0,1
E33009678,302,230,53,177,0,32,21,11,39,37,0,2,0,1
E33009679,1112,877,232,645,5,59,46,13,163,159,0,4,0,8
E33009680,239,179,57,122,1,25,13,12,31,29,0,0,2,3
E33009681,296,190,49,141,1,70,60,10,35,30,0,5,0,0
E33009682,1245,891,186,705,5,146,130,16,198,188,1,9,0,5
E33009683,502,215,38,177,0,99,74,25,187,180,0,7,0,1
E33009684,345,258,64,194,0,40,32,8,44,40,1,3,0,3
E33009685,674,488,119,369,4,117,99,18,61,52,0,6,3,4
E33009686,900,650,157,493,2,121,99,22,126,120,0,6,0,1
E33009687,277,183,38,145,0,32,28,4,59,57,0,2,0,3
E33009688,845,606,182,424,3,141,121,20,92,84,0,8,0,3
E33009689,901,680,198,482,7,98,79,19,110,97,2,11,0,6
E33009690,552,418,122,296,2,75,57,18,57,52,1,4,0,0
E33009691,545,403,116,287,4,75,57,18,62,56,0,6,0,1
E33009692,548,432,98,334,2,50,33,17,62,58,0,4,0,2
E33009693,274,182,44,138,0,31,20,11,61,59,1,0,1,0
E33009694,1657,1101,294,807,4,236,186,50,305,285,2,17,1,11
E33009695,594,454,133,321,2,70,53,17,63,56,0,7,0,5
E33009696,249,212,47,165,1,12,8,4,24,19,0,5,0,0
E33009697,602,466,145,321,4,76,60,16,51,44,0,5,2,5
E33009698,212,174,59,115,1,19,16,3,15,14,0,1,0,3
E33009699,363,290,77,213,0,39,32,7,34,28,1,5,0,0
E33009700,375,234,74,160,2,91,78,13,46,38,4,4,0,2
E33009701,1083,844,184,660,8,84,60,24,143,126,2,14,1,4
E33009702,583,303,94,209,1,81,68,13,197,187,0,10,0,1
E33009703,1782,1276,263,1013,9,195,156,39,299,284,0,14,1,3
E33009704,232,204,61,143,0,14,8,6,12,12,0,0,0,2
E33009705,682,529,138,391,4,55,41,14,93,86,0,6,1,1
E33009706,350,273,82,191,0,27,18,9,46,39,5,2,0,4
E33009707,613,516,112,404,1,48,37,11,47,46,0,1,0,1
E33009708,575,429,106,323,2,57,48,9,85,74,1,9,1,2
E33009709,223,148,55,93,1,38,32,6,35,31,0,3,1,1
E33009710,703,477,122,355,2,91,66,25,121,117,0,4,0,12
E33009711,651,516,143,373,1,63,48,15,71,67,0,3,1,0
E33009712,213,151,41,110,1,24,21,3,37,32,1,4,0,0
E33009713,353,261,73,188,0,44,36,8,44,41,0,2,1,4
E33009714,479,386,111,275,1,28,22,6,59,54,0,5,0,5
E33009715,215,159,48,111,2,31,26,5,22,18,1,3,0,1
E33009716,394,294,81,213,0,37,26,11,58,52,1,4,1,5
E33009717,338,260,54,206,2,23,17,6,50,41,1,8,0,3
E33009718,204,154,45,109,0,32,24,8,16,16,0,0,0,2
E33009719,320,265,65,200,0,25,15,10,28,26,0,1,1,2
E33009720,222,162,52,110,1,31,25,6,27,26,0,1,0,1
E33009721,200,153,44,109,1,21,16,5,20,19,0,1,0,5
E33009722,674,505,126,379,3,76,47,29,88,80,1,5,2,2
E33009723,946,708,175,533,7,122,86,36,105,98,0,6,1,4
E33009724,244,184,58,126,2,35,24,11,22,19,1,2,0,1
E33009725,289,228,62,166,1,31,22,9,26,26,0,0,0,3
E33009726,674,528,167,361,3,77,61,16,64,58,2,2,2,2
E33009727,247,223,67,156,0,12,8,4,10,7,0,3,0,2
E33009728,230,187,44,143,0,16,11,5,27,26,0,1,0,0
E33009729,311,220,53,167,7,44,30,14,35,32,0,3,0,5
E33009730,321,243,72,171,4,39,27,12,34,28,0,6,0,1
E33009731,341,265,69,196,1,41,35,6,30,29,0,0,1,4
E33009732,294,213,52,161,3,41,28,13,37,33,2,1,1,0
E33009733,2204,1609,407,1202,5,252,200,52,329,295,3,25,6,9
E33009734,1917,1107,245,862,5,278,205,73,521,502,1,18,0,6
E33009735,1244,859,233,626,2,127,95,32,250,236,3,10,1,6
E33009736,377,275,78,197,4,51,33,18,47,42,0,4,1,0
E33009737,1177,895,227,668,2,157,121,36,114,106,2,6,0,9
E33009738,1526,1078,224,854,9,191,143,48,240,213,2,25,0,8
E33009739,458,335,60,275,0,41,31,10,79,72,0,5,2,3
E33009740,264,211,52,159,1,11,9,2,39,37,0,2,0,2
E33009741,412,332,53,279,1,41,32,9,36,33,0,2,1,2
E33009742,2015,1523,336,1187,11,196,143,53,278,264,1,11,2,7
E33009743,3407,2504,500,2004,19,299,216,83,579,546,1,27,5,6
E33009744,480,339,73,266,2,71,56,15,67,64,0,3,0,1
E33009745,510,393,85,308,1,37,26,11,74,70,0,4,0,5
E33009746,347,256,81,175,0,48,31,17,35,35,0,0,0,8
E33009747,676,419,97,322,2,106,80,26,146,141,0,4,1,3
E33009748,698,480,133,347,2,91,71,20,122,111,0,10,1,3
E33009749,300,220,51,169,3,31,26,5,43,38,0,5,0,3
E33009750,484,370,99,271,7,45,30,15,58,51,0,7,0,4
E33009751,201,151,49,102,0,31,25,6,19,17,0,2,0,0
E33009752,335,258,79,179,1,37,27,10,38,36,0,2,0,1
E33009753,470,350,87,263,1,48,34,14,67,56,0,11,0,4
E33009754,243,174,51,123,1,25,17,8,41,38,1,2,0,2
E33009755,284,192,59,133,0,42,31,11,49,44,0,5,0,1
E33009756,250,191,46,145,0,32,22,10,22,19,0,3,0,5
E33009757,365,273,96,177,4,41,29,12,46,40,3,2,1,1
E33009758,227,157,51,106,1,33,25,8,32,26,0,4,2,4
E33009759,840,576,121,455,7,92,64,28,160,145,0,15,0,5
E33009760,721,481,146,335,2,101,68,33,135,124,1,10,0,2
E33009761,357,279,82,197,4,34,21,13,38,33,0,3,2,2
E33009762,209,124,36,88,1,35,24,11,49,45,0,3,1,0
E33009763,352,253,76,177,4,31,20,11,56,45,1,5,5,8
E33009764,562,434,144,290,2,69,48,21,54,51,0,3,0,3
E33009765,566,430,117,313,0,44,31,13,85,67,2,14,2,7
E33009766,623,463,118,345,3,80,66,14,74,61,2,10,1,3
E33009767,375,275,83,192,0,42,32,10,56,50,0,6,0,2
E33009768,262,199,58,141,1,25,13,12,36,34,0,2,0,1
E33009769,307,244,55,189,0,20,16,4,40,34,0,6,0,3
E33009770,684,529,124,405,4,55,34,21,94,89,0,5,0,2
E33009771,675,471,145,326,5,96,74,22,101,84,1,12,4,2
E33009772,274,190,37,153,0,32,21,11,48,42,0,6,0,4
E33009773,394,285,56,229,0,34,25,9,74,66,0,7,1,1
E33009774,217,161,56,105,0,27,24,3,25,21,0,4,0,4
E33009775,815,689,166,523,0,33,22,11,89,81,1,7,0,4
E33009776,231,180,46,134,0,14,10,4,36,33,0,2,1,1
E33009777,216,167,40,127,0,26,20,6,23,22,0,0,1,0
E33009778,388,297,72,225,1,26,18,8,60,55,0,5,0,4
E33009779,222,171,38,133,0,20,18,2,28,27,0,0,1,3
E33009780,255,175,43,132,1,22,18,4,54,49,2,3,0,3
E33009781,284,202,62,140,1,21,13,8,55,45,3,6,1,5
E33009782,454,359,87,272,1,43,35,8,49,48,0,1,0,2
E33009783,238,188,38,150,0,13,8,5,36,32,0,4,0,1
E33009784,1058,834,176,658,4,62,43,19,149,135,1,11,2,9
E33009785,473,354,67,287,3,50,42,8,65,57,2,6,0,1
E33009786,898,663,216,447,1,150,109,41,78,69,0,7,2,6
E33009787,278,208,39,169,2,21,18,3,46,42,0,2,2,1
E33009788,311,234,54,180,0,27,21,6,50,45,1,3,1,0
E33009789,877,611,137,474,2,158,127,31,101,92,0,7,2,5
E33009790,956,739,153,586,1,63,50,13,151,143,0,8,0,2
E33009791,689,508,151,357,1,75,60,15,101,92,1,5,3,4
E33009792,471,302,76,226,2,81,62,19,80,70,0,8,2,6
E33009793,1475,988,213,775,2,73,59,14,400,380,1,18,1,12
E33009794,207,154,39,115,1,12,10,2,39,34,0,5,0,1
E33009795,241,188,55,133,0,17,13,4,36,32,0,4,0,0
E33009796,233,201,44,157,1,13,12,1,17,17,0,0,0,1
E33009797,285,220,52,168,0,30,23,7,34,28,0,4,2,1
E33009798,1321,959,238,721,2,175,140,35,178,163,1,13,1,7
E33009799,329,245,70,175,2,27,22,5,52,49,0,3,0,3
E33009800,315,241,48,193,2,19,16,3,47,45,0,2,0,6
E33009801,539,406,105,301,1,49,42,7,83,71,1,11,0,0
E33009802,539,385,87,298,2,66,50,16,78,69,0,9,0,8
E33009803,281,224,47,177,0,26,23,3,31,27,0,4,0,0
E33009804,295,210,59,151,0,36,29,7,49,39,0,1,9,0
E33009805,990,515,119,396,0,200,161,39,274,262,2,8,2,1
E33009806,780,582,151,431,4,83,64,19,107,100,1,6,0,4
E33009807,534,376,100,276,1,59,51,8,97,91,0,5,1,1
E33009808,498,327,73,254,1,79,64,15,91,84,0,5,2,0
E33009809,206,157,28,129,0,25,18,7,23,21,0,2,0,1
E33009810,2525,1438,309,1129,6,363,299,64,710,685,2,19,4,8
E33009811,777,624,162,462,0,76,62,14,72,65,0,7,0,5
E33009812,505,396,101,295,1,47,43,4,60,53,1,6,0,1
E33009813,430,325,54,271,1,42,33,9,62,61,0,1,0,0
E33009814,590,475,117,358,2,37,34,3,75,69,0,6,0,1
E33009815,278,208,55,153,1,30,24,6,38,36,0,2,0,1
E33009816,525,411,90,321,1,50,35,15,63,61,0,2,0,0
E33009817,316,244,53,191,3,26,22,4,43,35,0,8,0,0
E33009818,679,531,158,373,1,60,45,15,82,74,1,6,1,5
E33009819,213,164,40,124,0,32,26,6,17,17,0,0,0,0
E33009820,1226,924,178,746,3,118,89,29,177,168,1,8,0,4
E33009821,916,648,159,489,1,119,97,22,142,130,2,9,1,6
E33009822,246,181,46,135,1,20,20,0,44,40,0,4,0,0
E33009823,565,419,114,305,0,57,44,13,86,77,0,9,0,3
E33009824,216,154,39,115,0,26,22,4,34,28,0,6,0,2
E33009825,357,241,67,174,2,36,29,7,77,74,1,2,0,1
E33009826,260,207,67,140,0,25,23,2,26,24,0,2,0,2
E33009827,654,484,118,366,0,41,29,12,129,120,0,8,1,0
E33009828,1019,632,137,495,1,165,136,29,220,209,0,9,2,1
E33009829,225,174,46,128,1,8,6,2,41,41,0,0,0,1
E33009830,207,140,42,98,0,26,21,5,40,35,0,5,0,1
E33009831,309,235,52,183,1,41,38,3,31,30,0,1,0,1
E33009832,232,156,31,125,0,21,14,7,54,46,0,4,4,1
E33009833,225,136,30,106,0,13,12,1,74,68,0,4,2,2
E33009834,322,209,36,173,1,32,30,2,74,71,0,3,0,6
E33009835,978,751,163,588,7,74,58,16,142,135,2,4,1,4
E33009836,273,206,42,164,0,25,22,3,42,38,0,4,0,0
E33009837,212,139,45,94,0,26,23,3,44,39,0,4,1,3
E33009838,538,461,93,368,0,25,22,3,50,43,1,6,0,2
E33009839,1561,929,195,734,6,190,150,40,431,411,1,11,8,5
E33009840,240,204,48,156,0,16,12,4,20,18,0,2,0,0
E33009841,366,249,52,197,1,26,20,6,87,76,0,9,2,3
E33009842,485,428,92,336,0,19,19,0,37,34,0,2,1,1
E33009843,239,164,37,127,1,28,22,6,45,45,0,0,0,1
E33009844,630,452,103,349,1,58,44,14,116,111,0,3,2,3
E33009845,331,243,87,156,1,33,27,6,52,47,1,4,0,2
E33009846,615,514,126,388,0,41,32,9,59,52,0,5,2,1
E33009847,335,241,61,180,1,37,28,9,55,49,0,3,3,1
E33009848,248,153,31,122,1,17,15,2,74,68,1,5,0,3
E33009849,677,495,120,375,1,39,28,11,142,130,0,10,2,0
E33009850,438,301,74,227,1,28,23,5,103,98,0,5,0,5
E33009851,893,609,152,457,4,95,68,27,180,171,1,8,0,5
E33009852,209,128,22,106,0,28,20,8,52,51,0,1,0,1
E33009853,385,226,57,169,2,42,37,5,108,105,1,1,1,7
E33009854,413,324,69,255,1,33,24,9,54,52,0,2,0,1
E33009855,609,381,116,265,1,86,68,18,137,128,0,9,0,4
E33009856,265,174,51,123,2,25,21,4,62,58,0,4,0,2
E33009857,457,317,65,252,1,41,39,2,95,89,0,4,2,3
E33009858,569,370,95,275,2,91,69,22,104,92,2,9,1,2
E33009859,353,264,53,211,1,30,24,6,57,52,0,5,0,1
E33009860,204,145,29,116,0,11,9,2,48,43,1,4,0,0
E33009861,248,172,38,134,1,16,11,5,58,56,0,2,0,1
E33009862,216,136,27,109,0,36,24,12,44,43,0,1,0,0
E33009863,311,213,66,147,0,44,34,10,54,52,1,1,0,0
E33009864,258,154,33,121,2,45,37,8,57,50,0,7,0,0
E33009865,461,319,53,266,0,48,37,11,90,84,0,6,0,4
E33009866,5372,4089,911,3178,15,337,270,67,909,834,10,59,6,22
E33009867,780,504,123,381,1,94,69,25,177,158,2,13,4,4
E33009868,1134,841,175,666,5,81,67,14,203,179,1,23,0,4
E33009869,1928,1523,298,1225,4,128,108,20,263,245,1,11,6,10
E33009870,746,541,119,422,5,83,64,19,112,102,0,8,2,5
E33009871,275,166,46,120,2,36,32,4,71,70,0,1,0,0
E33009872,312,228,55,173,1,25,19,6,57,51,1,5,0,1
E33009873,909,612,142,470,1,107,84,23,180,171,0,9,0,9
E33009874,306,249,77,172,0,23,18,5,32,29,0,2,1,2
E33009875,837,562,144,418,4,95,78,17,171,165,1,5,0,5
E33009876,640,402,93,309,3,103,86,17,130,115,1,13,1,2
E33009877,471,344,78,266,1,49,38,11,73,64,0,9,0,4
E33009878,209,131,34,97,0,29,23,6,47,43,0,4,0,2
E33009879,493,328,93,235,1,59,47,12,104,101,0,3,0,1
E33009880,295,190,56,134,1,42,33,9,62,59,0,2,1,0
E33009881,212,171,42,129,0,20,17,3,20,19,0,1,0,1
E33009882,238,175,47,128,3,24,19,5,35,33,0,2,0,1
E33009883,336,247,58,189,1,25,22,3,62,55,0,7,0,1
E33009884,237,178,37,141,3,25,21,4,30,28,0,2,0,1
E33009885,259,158,39,119,0,44,39,5,57,53,0,4,0,0
E33009886,219,137,29,108,0,37,30,7,43,37,0,6,0,2
E33009887,638,469,136,333,2,79,63,16,85,77,0,7,1,3
E33009888,502,371,103,268,1,29,16,13,95,88,0,7,0,6
E33009889,293,205,77,128,1,15,13,2,70,62,4,3,1,2
E33009890,244,169,59,110,1,21,11,10,50,45,2,2,1,3
E33009891,448,306,95,211,1,30,20,10,107,97,4,6,0,4
E33009892,232,163,44,119,2,10,7,3,55,52,1,2,0,2
E33009893,323,178,64,114,2,29,16,13,113,98,2,13,0,1
E33009894,3633,2893,656,2237,7,251,196,55,469,436,5,26,2,13
E33009895,207,163,48,115,1,8,6,2,32,26,2,3,1,3
E33009896,871,675,143,532,3,73,60,13,116,107,2,4,3,4
E33009897,811,639,168,471,3,37,34,3,132,120,2,10,0,0
E33009898,406,308,88,220,3,13,10,3,79,69,2,7,1,3
E33009899,283,218,77,141,0,13,9,4,49,47,0,2,0,3
E33009900,426,342,108,234,0,20,16,4,60,55,0,5,0,4
E33009901,1700,1140,338,802,5,111,84,27,427,402,1,21,3,17
E33009902,680,570,185,385,0,36,29,7,70,65,1,3,1,4
E33009903,295,222,59,163,0,29,23,6,42,41,0,1,0,2
E33009904,230,167,62,105,3,25,23,2,34,27,0,4,3,1
E33009905,246,201,54,147,1,13,11,2,26,23,0,3,0,5
E33009906,237,169,47,122,0,22,17,5,45,43,0,2,0,1
E33009907,291,213,46,167,2,28,20,8,47,45,0,2,0,1
E33009908,224,159,42,117,2,27,22,5,36,36,0,0,0,0
E33009909,309,241,74,167,1,25,22,3,42,39,0,2,1,0
E33009910,623,509,188,321,2,36,26,10,73,63,2,8,0,3
E33009911,256,198,67,131,0,22,20,2,34,34,0,0,0,2
E33009912,1354,1072,228,844,1,79,65,14,198,187,1,9,1,4
E33009913,212,176,40,136,0,8,5,3,26,24,0,2,0,2
E33009914,665,533,106,427,1,37,30,7,92,87,1,3,1,2
E33009915,910,667,182,485,3,31,23,8,204,193,0,9,2,5
E33009916,878,716,197,519,2,40,30,10,115,107,0,8,0,5
E33009917,379,259,65,194,4,28,18,10,83,73,0,5,5,5
E33009918,311,258,111,147,0,10,6,4,41,34,3,3,1,2
E33009919,857,690,199,491,4,54,44,10,101,93,0,6,2,8
E33009920,317,212,61,151,0,44,35,9,60,52,0,7,1,1
E33009921,633,492,106,386,4,52,41,11,81,77,0,4,0,4
E33009922,992,722,226,496,5,72,58,14,186,177,3,6,0,7
E33009923,205,159,40,119,0,6,4,2,35,31,0,4,0,5
E33009924,359,285,91,194,1,16,11,5,40,37,2,1,0,17
E33009925,221,166,39,127,1,12,4,8,41,37,1,3,0,1
E33009926,329,259,73,186,5,19,13,6,41,34,3,3,1,5
E33009927,322,256,82,174,0,20,14,6,43,36,0,6,1,3
E33009928,266,189,64,125,0,25,21,4,52,51,0,0,1,0
E33009929,226,173,51,122,1,15,13,2,34,32,0,2,0,3
E33009930,543,423,134,289,0,39,27,12,78,73,1,2,2,3
E33009931,2146,1828,522,1306,7,85,66,19,218,191,1,24,2,8
E33009932,452,341,105,236,0,38,30,8,62,53,0,8,1,11
E33009933,193,146,36,110,2,6,2,4,35,30,0,2,3,4
E33009934,208,155,43,112,1,11,9,2,41,36,0,5,0,0
E33009935,322,277,72,205,0,18,15,3,26,26,0,0,0,1
E33009936,413,339,91,248,0,10,10,0,63,62,0,1,0,1
E33009937,506,427,126,301,1,22,11,11,54,50,0,3,1,2
E33009938,605,449,106,343,0,59,49,10,90,86,1,3,0,7
E33009939,384,270,66,204,2,53,42,11,58,53,0,5,0,1
E33009940,338,245,53,192,1,28,23,5,61,57,0,0,4,3
E33009941,1491,1232,333,899,1,67,57,10,186,167,4,15,0,5
E33009942,142,102,33,69,0,6,6,0,34,33,0,1,0,0
E33009943,545,415,105,310,0,49,43,6,81,73,0,8,0,0
E33009944,546,469,120,349,2,18,11,7,54,51,1,2,0,3
E33009945,286,251,89,162,1,8,6,2,25,23,0,2,0,1
E33009946,629,519,134,385,2,11,3,8,96,83,1,10,2,1
E33009947,213,159,54,105,0,17,8,9,35,32,0,3,0,2
E33009948,336,234,46,188,0,32,15,17,70,67,0,2,1,0
E33009949,247,188,48,140,0,13,4,9,45,43,0,1,1,1
E33009950,558,394,89,305,1,50,18,32,112,108,0,4,0,1
E33009951,198,150,58,92,0,18,11,7,28,26,0,2,0,2
E33009952,1447,975,234,741,4,108,43,65,354,329,0,22,3,6
E33009953,242,189,61,128,0,17,5,12,35,30,0,3,2,1
E33009954,287,204,51,153,1,23,9,14,56,52,0,4,0,3
E33009955,1116,805,244,561,7,94,27,67,201,183,0,14,4,9
E33009956,200,158,36,122,0,8,3,5,34,26,1,6,1,0
E33009957,289,207,49,158,1,18,2,16,61,59,0,2,0,2
E33009958,281,199,60,139,2,20,7,13,58,51,0,7,0,2
E33009959,500,385,74,311,6,25,11,14,82,69,1,9,3,2
E33009960,506,387,85,302,2,35,14,21,79,77,0,2,0,3
E33009961,342,285,67,218,3,16,2,14,36,35,0,1,0,2
E33009962,1808,1385,331,1054,4,127,48,79,288,265,0,20,3,4
E33009963,523,415,102,313,0,27,7,20,78,69,2,7,0,3
E33009964,237,192,47,145,2,12,2,10,30,21,0,8,1,1
E33009965,460,293,55,238,0,40,15,25,121,114,0,7,0,6
E33009966,1432,1245,292,953,1,43,16,27,139,127,4,8,0,4
E33009967,557,453,108,345,0,17,6,11,84,75,4,4,1,3
E33009968,887,688,174,514,2,79,25,54,115,111,0,4,0,3
E33009969,617,512,137,375,1,32,12,20,69,65,0,4,0,3
E33009970,1067,861,225,636,4,46,16,30,149,139,1,7,2,7
E33009971,228,203,37,166,0,8,4,4,16,15,0,1,0,1
E33009972,374,320,81,239,1,10,6,4,40,33,0,7,0,3
E33009973,327,274,58,216,1,14,3,11,37,33,0,4,0,1
E33009974,376,305,63,242,0,25,6,19,43,37,0,6,0,3
E33009975,319,249,56,193,1,10,2,8,57,46,0,11,0,2
E33009976,209,168,58,110,0,11,10,1,30,28,0,2,0,0
E33009977,1122,939,228,711,2,50,24,26,126,111,2,11,2,5
E33009978,337,271,73,198,1,25,10,15,39,35,3,1,0,1
E33009979,442,367,92,275,1,16,7,9,56,49,0,7,0,2
E33009980,199,166,37,129,1,4,3,1,28,24,0,4,0,0
E33009981,343,272,82,190,0,19,8,11,50,46,1,3,0,2
E33009982,460,353,82,271,2,17,6,11,85,76,1,7,1,3
E33009983,276,251,50,201,0,2,0,2,23,23,0,0,0,0
E33009984,380,336,76,260,2,14,9,5,28,27,0,1,0,0
E33009985,509,406,104,302,1,26,10,16,74,65,1,6,2,2
E33009986,1063,876,230,646,3,45,13,32,136,119,1,14,2,3
E33009987,697,520,123,397,5,38,6,32,128,110,1,17,0,6
E33009988,1397,1130,294,836,4,77,22,55,179,160,1,16,2,7
E33009989,274,208,59,149,1,17,3,14,48,45,0,3,0,0
E33009990,264,204,73,131,1,25,9,16,32,30,0,2,0,2
E33009991,348,243,55,188,6,25,8,17,72,66,0,2,4,2
E33009992,938,764,168,596,3,43,21,22,125,109,1,14,1,3
E33009993,560,406,130,276,0,44,14,30,108,100,0,4,4,2
E33009994,385,334,83,251,0,13,5,8,37,34,0,2,1,1
E33009995,715,631,109,522,2,19,8,11,60,48,0,11,1,3
E33009996,325,265,72,193,0,15,4,11,42,40,0,2,0,3
E33009997,404,302,87,215,3,30,7,23,68,64,1,3,0,1
E33009998,239,185,61,124,1,12,7,5,37,36,0,1,0,4
E33009999,258,194,50,144,0,10,5,5,54,52,0,2,0,0
E33010000,512,341,100,241,6,34,13,21,128,123,0,5,0,3
E33010001,559,420,123,297,2,43,19,24,89,84,0,4,1,5
E33010002,295,217,49,168,7,9,3,6,62,57,0,4,1,0
E33010003,567,432,114,318,0,36,8,28,97,87,0,9,1,2
E33010004,203,164,31,133,0,9,4,5,28,26,0,2,0,2
E33010005,371,238,50,188,3,32,14,18,95,85,2,6,2,3
E33010006,283,218,57,161,0,13,2,11,49,44,0,5,0,3
E33010007,335,233,62,171,1,27,4,23,72,67,0,5,0,2
E33010008,279,243,65,178,0,5,0,5,30,28,0,2,0,1
E33010009,639,459,95,364,1,48,13,35,126,116,1,9,0,5
E33010010,237,192,43,149,0,7,3,4,38,31,0,7,0,0
E33010011,232,172,40,132,0,16,8,8,42,41,0,0,1,2
E33010012,564,424,107,317,0,36,19,17,101,92,0,9,0,3
E33010013,456,302,81,221,0,59,24,35,95,88,1,5,1,0
E33010014,1177,934,188,746,3,55,15,40,182,165,0,14,3,3
E33010015,467,383,84,299,3,22,10,12,56,50,0,6,0,3
E33010016,734,590,94,496,1,40,22,18,101,97,0,4,0,2
E33010017,346,244,72,172,1,43,23,20,55,45,2,7,1,3
E33010018,408,322,75,247,0,31,12,19,53,44,2,7,0,2
E33010019,251,187,63,124,0,26,10,16,35,32,0,3,0,3
E33010020,581,443,109,334,1,37,15,22,98,92,2,4,0,2
E33010021,255,190,61,129,1,24,13,11,36,29,0,7,0,4
E33010022,327,265,88,177,0,19,7,12,43,37,0,4,2,0
E33010023,269,224,64,160,0,7,4,3,33,30,2,1,0,5
E33010024,312,255,92,163,2,19,7,12,35,30,0,5,0,1
E33010025,777,584,136,448,3,49,23,26,132,120,2,9,1,9
E33010026,631,508,101,407,2,38,20,18,81,74,0,7,0,2
E33010027,1009,661,108,553,5,75,34,41,266,245,4,13,4,2
E33010028,489,344,69,275,2,47,26,21,90,84,1,5,0,6
E33010029,431,343,111,232,0,31,15,16,53,48,0,5,0,4
E33010030,623,479,106,373,0,50,21,29,92,84,2,4,2,2
E33010031,646,384,100,284,2,33,16,17,221,209,1,11,0,6
E33010032,1598,903,224,679,6,161,91,70,523,504,0,14,5,5
E33010033,643,486,135,351,1,64,26,38,89,83,1,5,0,3
E33010034,1467,797,163,634,11,153,74,79,488,465,1,16,6,18
E33010035,676,532,144,388,2,20,11,9,117,101,3,13,0,5
E33010036,1071,932,200,732,0,36,18,18,100,88,3,9,0,3
E33010037,4009,3402,857,2545,8,218,100,118,364,334,1,28,1,17
E33010038,704,479,122,357,4,91,43,48,127,123,0,3,1,3
E33010039,1175,803,169,634,6,88,45,43,273,254,3,13,3,5
E33010040,627,480,153,327,2,68,36,32,72,67,0,5,0,5
E33010041,530,430,98,332,2,34,16,18,61,58,0,3,0,3
E33010042,210,163,38,125,0,16,5,11,29,28,0,1,0,2
E33010043,432,327,99,228,1,44,26,18,55,49,0,6,0,5
E33010044,344,257,67,190,0,41,22,19,44,33,1,8,2,2
E33010045,1019,871,248,623,2,51,15,36,85,73,2,10,0,10
E33010046,822,685,177,508,1,50,28,22,81,64,9,8,0,5
E33010047,568,400,95,305,3,54,29,25,108,94,1,13,0,3
E33010048,216,168,60,108,0,25,11,14,23,20,0,3,0,0
E33010049,440,382,117,265,0,21,5,16,37,36,0,1,0,0
E33010050,1504,1122,334,788,4,170,79,91,200,176,3,14,7,8
E33010051,293,248,59,189,0,10,3,7,31,29,1,1,0,4
E33010052,264,197,54,143,0,29,21,8,32,30,2,0,0,6
E33010053,288,233,76,157,0,10,7,3,44,42,0,2,0,1
E33010054,254,168,50,118,1,31,21,10,51,48,0,1,2,3
E33010055,550,432,119,313,2,37,20,17,76,67,0,8,1,3
E33010056,286,237,95,142,1,25,15,10,19,17,0,1,1,4
E33010057,1438,1127,369,758,10,143,106,37,149,141,1,6,1,9
E33010058,635,357,110,247,7,100,69,31,166,156,1,7,2,5
E33010059,1133,791,169,622,7,63,26,37,262,243,4,13,2,10
E33010060,732,584,123,461,4,18,11,7,122,106,2,8,6,4
E33010061,282,207,44,163,3,12,6,6,59,52,2,4,1,1
E33010062,669,418,103,315,3,54,22,32,193,80,67,1,45,1
E33010063,213,112,35,77,2,20,14,6,76,70,1,3,2,3
E33010064,1043,702,176,526,9,73,41,32,250,238,3,8,1,9
E33010065,206,134,51,83,0,8,4,4,60,57,0,3,0,4
E33010066,292,215,57,158,5,12,6,6,54,52,0,2,0,6
E33010067,433,315,87,228,2,27,21,6,89,82,1,3,3,0
E33010068,352,208,71,137,2,41,22,19,93,88,0,3,2,8
E33010069,253,142,36,106,1,23,13,10,80,71,3,4,2,7
E33010070,437,250,67,183,1,32,20,12,151,141,0,7,3,3
E33010071,348,177,54,123,3,23,15,8,133,121,3,9,0,12
E33010072,433,230,88,142,5,35,17,18,160,155,0,3,2,3
E33010073,318,172,48,124,1,31,19,12,111,99,0,12,0,3
E33010074,640,473,143,330,1,66,34,32,96,86,3,6,1,4
E33010075,285,143,47,96,2,17,9,8,117,115,0,1,1,6
E33010076,729,436,141,295,5,57,35,22,227,213,2,7,5,4
E33010077,228,146,52,94,1,14,10,4,65,58,1,2,4,2
E33010078,292,184,46,138,3,14,8,6,90,84,0,5,1,1
E33010079,317,177,65,112,3,17,7,10,112,104,0,7,1,8
E33010080,395,220,52,168,4,31,22,9,139,129,1,5,4,1
E33010081,615,500,139,361,6,25,14,11,82,78,0,4,0,2
E33010082,929,519,164,355,8,87,50,37,306,287,2,14,3,9
E33010083,378,218,72,146,7,41,23,18,103,101,0,1,1,9
E33010084,467,333,122,211,0,27,19,8,105,95,2,5,3,2
E33010085,249,194,58,136,0,11,8,3,43,42,0,1,0,1
E33010086,222,104,30,74,1,24,14,10,90,84,1,4,1,3
E33010087,228,138,31,107,2,8,6,2,77,71,1,3,2,3
E33010088,266,147,42,105,1,27,17,10,89,77,3,7,2,2
E33010089,272,175,51,124,4,17,12,5,75,63,0,12,0,1
E33010090,193,92,32,60,0,28,20,8,71,66,0,3,2,2
E33010091,418,286,85,201,5,38,21,17,87,76,1,9,1,2
E33010092,283,167,67,100,1,23,15,8,91,83,1,4,3,1
E33010093,399,191,63,128,1,22,11,11,184,176,0,8,0,1
E33010094,195,113,24,89,1,11,7,4,66,57,1,4,4,4
E33010095,341,235,61,174,1,20,15,5,85,79,0,6,0,0
E33010096,198,110,36,74,1,28,22,6,58,56,0,2,0,1
E33010097,425,228,55,173,1,35,23,12,160,145,2,8,5,1
E33010098,343,204,63,141,4,28,13,15,101,97,0,3,1,6
E33010099,432,265,91,174,5,43,32,11,117,111,0,5,1,2
E33010100,485,381,126,255,2,23,15,8,79,75,0,3,1,0
E33010101,273,194,41,153,1,28,19,9,49,46,3,0,0,1
E33010102,436,337,79,258,2,19,12,7,75,70,0,4,1,3
E33010103,527,371,119,252,6,60,25,35,87,80,1,6,0,3
E33010104,273,161,45,116,0,39,26,13,64,56,1,6,1,9
E33010105,831,684,179,505,6,51,14,37,89,79,1,8,1,1
E33010106,419,304,73,231,5,36,18,18,73,62,4,4,3,1
E33010107,1715,1151,310,841,21,151,75,76,387,366,4,10,7,5
E33010108,845,543,173,370,10,115,63,52,170,159,2,7,2,7
E33010109,814,624,155,469,2,34,12,22,147,133,2,9,3,7
E33010110,557,453,129,324,0,19,14,5,80,74,0,6,0,5
E33010111,216,173,61,112,1,6,3,3,26,25,0,0,1,10
E33010112,530,386,110,276,2,21,10,11,117,109,1,7,0,4
E33010113,394,274,121,153,2,33,21,12,83,76,2,5,0,2
E33010114,236,183,39,144,0,24,16,8,28,23,1,4,0,1
E33010115,677,504,159,345,2,58,41,17,110,101,0,9,0,3
E33010116,504,391,132,259,1,16,14,2,81,65,9,4,3,15
E33010117,213,152,46,106,0,17,12,5,39,34,1,3,1,5
E33010118,461,343,89,254,2,35,19,16,78,69,3,5,1,3
E33010119,528,311,66,245,3,69,43,26,141,130,5,5,1,4
E33010120,221,186,40,146,2,10,5,5,21,16,2,3,0,2
E33010121,279,207,64,143,0,27,14,13,44,40,0,4,0,1
E33010122,301,203,66,137,2,25,18,7,70,65,0,5,0,1
E33010123,451,341,72,269,0,19,6,13,87,78,0,9,0,4
E33010124,422,326,98,228,2,37,25,12,55,48,1,6,0,2
E33010125,400,311,72,239,2,19,9,10,67,62,0,4,1,1
E33010126,341,228,53,175,6,34,23,11,71,63,3,5,0,2
E33010127,237,165,43,122,1,21,13,8,50,45,0,5,0,0
E33010128,354,282,75,207,2,21,9,12,47,40,0,6,1,2
E33010129,324,220,57,163,1,25,17,8,78,75,0,3,0,0
E33010130,336,299,64,235,0,5,3,2,30,30,0,0,0,2
E33010131,296,230,45,185,0,17,10,7,48,43,0,4,1,1
E33010132,369,254,59,195,2,39,25,14,70,65,1,2,2,4
E33010133,843,521,155,366,7,136,80,56,176,164,5,6,1,3
E33010134,205,142,32,110,0,12,8,4,48,44,2,1,1,3
E33010135,707,491,117,374,5,62,34,28,142,123,2,16,1,7
E33010136,375,271,112,159,4,29,18,11,67,57,0,5,5,4
E33010137,850,673,214,459,6,69,47,22,95,88,1,6,0,7
E33010138,218,122,46,76,1,5,0,5,69,58,10,1,0,21
E33010139,247,164,58,106,1,13,4,9,68,61,1,5,1,1
E33010140,250,207,66,141,1,6,0,6,33,32,1,0,0,3
E33010141,212,155,49,106,0,15,7,8,39,38,0,1,0,3
E33010142,181,128,33,95,1,15,7,8,37,36,0,1,0,0
E33010143,230,176,57,119,0,17,7,10,36,32,1,3,0,1
E33010144,229,172,53,119,0,9,3,6,42,41,0,1,0,6
E33010145,242,182,47,135,1,15,5,10,40,37,0,3,0,4
E33010146,214,174,59,115,0,4,1,3,33,32,1,0,0,3
E33010147,220,186,50,136,0,3,0,3,31,30,0,1,0,0
E33010148,243,184,63,121,6,17,9,8,34,30,0,4,0,2
E33010149,482,376,139,237,1,27,12,15,72,68,1,2,1,6
E33010150,965,668,199,469,4,90,45,45,190,179,4,7,0,13
E33010151,638,462,110,352,0,7,2,5,158,138,4,9,7,11
E33010152,402,298,102,196,2,38,11,27,60,51,2,4,3,4
E33010153,327,209,68,141,1,31,10,21,83,73,4,3,3,3
E33010154,259,221,84,137,1,8,4,4,27,18,1,5,3,2
E33010155,869,682,172,510,2,79,29,50,101,93,0,8,0,5
E33010156,2376,1691,575,1116,8,138,64,74,518,476,17,20,5,21
E33010157,736,388,91,297,2,85,33,52,255,224,12,11,8,6
E33010158,198,129,40,89,0,21,6,15,43,35,3,1,4,5
E33010159,531,328,91,237,1,66,17,49,132,113,6,3,10,4
E33010160,321,257,95,162,1,13,2,11,46,44,0,2,0,4
E33010161,1663,1344,393,951,10,83,25,58,211,182,6,18,5,15
E33010162,209,148,49,99,1,22,4,18,34,25,5,4,0,4
E33010163,900,547,162,385,4,155,16,139,184,167,7,6,4,10
E33010164,201,147,46,101,1,22,3,19,30,27,0,2,1,1
E33010165,419,284,110,174,1,47,5,42,83,75,2,6,0,4
E33010166,1058,724,204,520,9,108,20,88,206,177,5,21,3,11
E33010167,561,425,114,311,4,49,7,42,80,69,5,2,4,3
E33010168,327,253,74,179,2,33,8,25,37,35,0,2,0,2
E33010169,995,741,183,558,6,87,16,71,148,130,7,8,3,13
E33010170,162,109,27,82,0,16,3,13,36,28,1,4,3,1
E33010171,165,112,38,74,0,29,3,26,21,18,0,1,2,3
E33010172,253,175,61,114,0,26,3,23,47,44,0,3,0,5
E33010173,375,297,108,189,0,27,4,23,47,36,5,4,2,4
E33010174,707,504,126,378,3,66,15,51,129,93,18,2,16,5
E33010175,547,379,131,248,1,76,11,65,88,81,4,1,2,3
E33010176,218,160,69,91,3,23,9,14,30,29,1,0,0,2
E33010177,737,560,178,382,4,70,21,49,95,83,1,10,1,8
E33010178,217,137,38,99,1,23,2,21,51,46,3,2,0,5
E33010179,210,153,52,101,1,16,5,11,37,30,2,4,1,3
E33010180,345,202,65,137,2,46,15,31,87,73,2,7,5,8
E33010181,1082,862,191,671,5,45,6,39,161,133,9,13,6,9
E33010182,1063,744,178,566,4,99,21,78,207,190,3,12,2,9
E33010183,2727,2074,590,1484,16,124,61,63,501,461,8,27,5,12
E33010184,521,388,124,264,4,37,20,17,91,87,0,4,0,1
E33010185,472,344,108,236,4,41,22,19,77,66,0,10,1,6
E33010186,271,164,60,104,0,26,17,9,81,75,1,4,1,0
E33010187,494,373,78,295,0,5,4,1,114,102,1,10,1,2
E33010188,277,182,62,120,4,18,11,7,70,63,5,2,0,3
E33010189,377,217,46,171,3,51,29,22,103,96,0,3,4,3
E33010190,341,247,90,157,0,12,4,8,78,75,0,2,1,4
E33010191,339,273,81,192,2,12,7,5,51,46,1,4,0,1
E33010192,331,240,55,185,2,18,10,8,68,64,0,4,0,3
E33010193,501,367,83,284,0,24,16,8,109,105,3,1,0,1
E33010194,1254,899,249,650,11,56,33,23,281,255,6,18,2,7
E33010195,208,160,55,105,0,5,2,3,43,42,0,1,0,0
E33010196,952,557,104,453,6,139,78,61,239,127,61,5,46,11
E33010197,597,415,158,257,3,38,15,23,131,108,8,13,2,10
E33010198,470,396,106,290,1,13,3,10,56,51,1,4,0,4
E33010199,585,447,98,349,1,22,11,11,114,109,0,4,1,1
E33010200,594,422,117,305,3,38,20,18,129,116,0,13,0,2
E33010201,609,441,120,321,1,48,30,18,117,106,1,9,1,2
E33010202,308,139,38,101,1,17,7,10,150,145,1,4,0,1
E33010203,226,184,58,126,1,3,1,2,38,33,1,4,0,0
E33010204,254,181,43,138,1,14,2,12,56,53,2,1,0,2
E33010205,564,382,99,283,2,29,17,12,151,137,3,9,2,0
E33010206,204,135,35,100,1,17,10,7,49,46,0,2,1,2
E33010207,452,294,108,186,4,27,13,14,122,106,3,10,3,5
E33010208,198,144,45,99,3,11,9,2,38,37,0,1,0,2
E33010209,202,134,34,100,1,12,6,6,55,49,0,5,1,0
E33010210,311,189,37,152,2,19,10,9,92,88,0,4,0,9
E33010211,498,370,119,251,4,37,16,21,85,83,0,2,0,2
E33010212,523,323,88,235,4,24,13,11,168,160,0,8,0,4
E33010213,297,242,60,182,0,5,3,2,47,44,2,0,1,3
E33010214,300,215,57,158,1,9,6,3,73,65,2,6,0,2
E33010215,383,234,57,177,3,35,20,15,110,98,1,10,1,1
E33010216,209,164,49,115,2,6,0,6,36,33,0,2,1,1
E33010217,310,218,61,157,6,13,6,7,70,66,1,3,0,3
E33010218,210,154,37,117,0,8,5,3,44,40,2,2,0,4
E33010219,231,147,40,107,1,12,4,8,69,65,0,4,0,2
E33010220,237,164,45,119,4,10,5,5,57,51,2,4,0,2
E33010221,362,289,85,204,1,18,12,6,50,47,1,2,0,4
E33010222,228,173,56,117,2,7,6,1,45,40,2,3,0,1
E33010223,340,258,64,194,4,10,7,3,67,58,3,6,0,1
E33010224,348,248,77,171,3,15,11,4,79,73,0,6,0,3
E33010225,864,568,160,408,5,60,29,31,215,206,2,5,2,16
E33010226,246,144,47,97,4,24,8,16,59,55,0,3,1,15
E33010227,207,143,49,94,1,10,3,7,52,51,1,0,0,1
E33010228,712,539,164,375,5,51,35,16,107,96,0,10,1,10
E33010229,326,241,66,175,1,23,18,5,55,50,0,5,0,6
E33010230,961,615,182,433,9,77,36,41,250,224,8,16,2,10
E33010231,211,157,60,97,0,15,8,7,29,25,2,1,1,10
E33010232,482,318,114,204,1,43,21,22,109,88,10,6,5,11
E33010233,238,161,55,106,5,28,15,13,43,35,1,4,3,1
E33010234,608,413,135,278,3,55,27,28,133,112,9,9,3,4
E33010235,1030,775,152,623,3,40,27,13,210,191,1,16,2,2
E33010236,1347,957,214,743,9,25,13,12,346,330,2,12,2,10
E33010237,333,263,44,219,3,9,7,2,56,49,0,7,0,2
E33010238,409,343,93,250,2,22,10,12,41,39,0,2,0,1
E33010239,585,318,62,256,2,71,38,33,190,117,36,6,31,4
E33010240,487,231,40,191,4,35,9,26,215,64,101,2,48,2
E33010241,222,149,44,105,2,14,7,7,54,23,17,0,14,3
E33010242,589,401,156,245,6,37,16,21,127,116,4,3,4,18
E33010243,765,478,139,339,3,88,52,36,185,122,32,8,23,11
E33010244,341,219,74,145,0,38,28,10,82,63,10,4,5,2
E33010245,429,302,101,201,1,50,37,13,72,56,3,10,3,4
E33010246,198,140,45,95,1,11,10,1,46,41,1,3,1,0
E33010247,538,352,113,239,2,56,39,17,123,104,6,7,6,5
E33010248,734,430,108,322,4,67,27,40,230,90,73,4,63,3
E33010249,391,232,71,161,0,41,8,33,118,110,2,6,0,0
E33010250,538,375,121,254,1,42,6,36,111,103,1,5,2,9
E33010251,210,137,68,69,1,18,3,15,50,43,0,7,0,4
E33010252,218,153,52,101,1,25,2,23,36,32,1,3,0,3
E33010253,248,172,51,121,1,24,5,19,49,45,1,2,1,2
E33010254,219,162,52,110,2,16,1,15,35,31,1,2,1,4
E33010255,228,146,60,86,0,13,2,11,62,54,3,3,2,7
E33010256,430,251,73,178,2,79,8,71,94,87,1,6,0,4
E33010257,283,190,93,97,1,39,8,31,50,44,1,5,0,3
E33010258,211,163,62,101,0,19,4,15,28,26,0,2,0,1
E33010259,858,671,180,491,4,28,18,10,146,136,2,4,4,9
E33010260,214,154,45,109,1,10,1,9,48,41,3,2,2,1
E33010261,469,308,98,210,2,30,8,22,127,120,0,3,4,2
E33010262,249,154,40,114,4,16,6,10,74,68,1,4,1,1
E33010263,1056,790,223,567,3,76,20,56,179,169,1,9,0,8
E33010264,552,336,105,231,6,29,6,23,175,160,1,11,3,6
E33010265,364,229,80,149,0,31,9,22,100,96,0,3,1,4
E33010266,530,326,83,243,1,28,8,20,170,157,3,6,4,5
E33010267,305,194,67,127,2,18,4,14,89,79,3,6,1,2
E33010268,331,222,46,176,1,13,1,12,95,89,0,6,0,0
E33010269,301,210,64,146,1,21,7,14,68,64,0,3,1,1
E33010270,863,523,162,361,9,55,10,45,270,251,0,9,10,6
E33010271,327,214,74,140,0,8,1,7,103,92,3,7,1,2
E33010272,256,127,54,73,2,30,7,23,94,90,2,2,0,3
E33010273,237,176,35,141,1,5,0,5,54,51,1,2,0,1
E33010274,735,577,131,446,4,39,12,27,110,108,1,0,1,5
E33010275,878,689,185,504,2,43,11,32,140,119,2,14,5,4
E33010276,433,357,105,252,2,13,1,12,58,51,2,4,1,3
E33010277,645,478,130,348,4,35,6,29,126,120,0,4,2,2
E33010278,282,205,67,138,0,24,7,17,51,48,3,0,0,2
E33010279,354,255,113,142,2,29,9,20,63,57,0,6,0,5
E33010280,1709,1195,344,851,8,128,41,87,370,340,1,25,4,8
E33010281,913,751,206,545,2,45,12,33,112,106,0,6,0,3
E33010282,272,185,53,132,1,24,5,19,61,58,0,2,1,1
E33010283,293,191,65,126,1,42,7,35,54,49,0,3,2,5
E33010284,213,161,50,111,0,15,1,14,36,32,1,3,0,1
E33010285,300,207,72,135,2,29,7,22,53,43,0,3,7,9
E33010286,650,504,144,360,2,26,5,21,110,98,5,6,1,8
E33010287,1126,980,329,651,4,46,29,17,95,85,2,8,0,1
E33010288,823,716,207,509,6,39,29,10,57,55,0,2,0,5
E33010289,630,358,99,259,9,46,38,8,216,206,4,6,0,1
E33010290,381,248,83,165,2,39,21,18,86,82,1,2,1,6
E33010291,319,248,81,167,1,23,12,11,44,44,0,0,0,3
E33010292,451,350,83,267,2,42,18,24,55,51,1,1,2,2
E33010293,409,317,96,221,0,25,20,5,63,56,1,4,2,4
E33010294,225,184,45,139,0,20,10,10,21,21,0,0,0,0
E33010295,299,217,50,167,1,32,14,18,49,40,3,6,0,0
E33010296,394,274,69,205,8,46,34,12,61,56,1,4,0,5
E33010297,938,577,128,449,2,162,102,60,191,181,2,7,1,6
E33010298,541,298,70,228,5,67,46,21,163,153,2,8,0,8
E33010299,345,272,73,199,0,22,15,7,50,46,0,4,0,1
E33010300,350,281,67,214,1,24,18,6,43,43,0,0,0,1
E33010301,284,187,40,147,3,30,22,8,63,61,1,1,0,1
E33010302,808,612,179,433,6,68,43,25,120,110,0,9,1,2
E33010303,492,422,100,322,1,29,24,5,37,33,0,3,1,3
E33010304,358,281,65,216,1,9,7,2,64,58,4,2,0,3
E33010305,879,713,204,509,1,54,44,10,99,78,16,5,0,12
E33010306,884,551,149,402,3,203,161,42,124,111,2,11,0,3
E33010307,544,447,127,320,2,35,27,8,58,58,0,0,0,2
E33010308,1915,1388,317,1071,11,110,76,34,394,367,0,25,2,12
E33010309,783,630,172,458,0,73,63,10,74,69,0,5,0,6
E33010310,261,197,58,139,0,21,18,3,40,39,0,1,0,3
E33010311,402,288,59,229,2,56,44,12,54,51,0,3,0,2
E33010312,361,242,60,182,1,46,31,15,72,65,1,5,1,0
E33010313,499,355,108,247,1,83,64,19,58,55,1,2,0,2
E33010314,215,160,58,102,1,27,18,9,27,25,1,1,0,0
E33010315,1581,1086,250,836,9,191,146,45,289,259,2,23,5,6
E33010316,531,444,114,330,0,34,25,9,51,47,1,3,0,2
E33010317,1563,1297,292,1005,3,103,69,34,150,132,1,17,0,10
E33010318,2694,1704,353,1351,16,351,269,82,610,579,3,25,3,13
E33010319,910,547,108,439,10,110,74,36,242,239,1,2,0,1
E33010320,1922,1570,424,1146,4,157,117,40,176,164,4,8,0,15
E33010321,643,531,119,412,1,37,21,16,70,65,0,5,0,4
E33010322,707,563,179,384,3,61,47,14,75,69,0,4,2,5
E33010323,356,293,83,210,0,21,19,2,37,33,0,4,0,5
E33010324,894,679,174,505,0,107,96,11,104,97,0,6,1,4
E33010325,263,188,50,138,0,37,30,7,37,33,0,2,2,1
E33010326,820,627,146,481,3,71,55,16,110,103,0,6,1,9
E33010327,312,241,72,169,0,38,35,3,32,30,0,1,1,1
E33010328,291,185,49,136,1,59,48,11,45,41,0,3,1,1
E33010329,814,657,183,474,3,81,68,13,68,65,0,2,1,5
E33010330,371,281,92,189,1,47,37,10,39,35,0,4,0,3
E33010331,207,159,38,121,1,18,16,2,25,22,0,2,1,4
E33010332,228,167,49,118,1,28,20,8,29,27,0,1,1,3
E33010333,277,189,35,154,1,49,47,2,36,33,1,1,1,2
E33010334,401,309,80,229,0,45,29,16,45,41,0,3,1,2
E33010335,498,421,98,323,2,22,17,5,48,45,0,3,0,5
E33010336,266,177,54,123,0,48,41,7,41,38,0,3,0,0
E33010337,298,224,60,164,2,33,26,7,35,29,0,4,2,4
E33010338,454,324,99,225,0,81,77,4,47,45,0,1,1,2
E33010339,221,194,51,143,0,9,5,4,16,12,2,2,0,2
E33010340,536,417,110,307,1,36,23,13,77,71,0,6,0,5
E33010341,480,358,83,275,5,57,47,10,56,49,1,5,1,4
E33010342,296,220,80,140,1,26,18,8,48,45,0,3,0,1
E33010343,864,625,159,466,2,45,30,15,189,174,0,11,4,3
E33010344,667,480,104,376,3,58,45,13,124,119,2,2,1,2
E33010345,298,215,54,161,5,32,21,11,44,41,0,3,0,2
E33010346,763,572,114,458,3,32,21,11,154,145,0,8,1,2
E33010347,818,613,122,491,4,51,30,21,149,140,0,9,0,1
E33010348,259,164,34,130,3,26,21,5,64,56,7,1,0,2
E33010349,543,378,101,277,2,60,46,14,96,87,0,7,2,7
E33010350,632,486,106,380,3,50,36,14,93,89,0,4,0,0
E33010351,292,168,35,133,1,45,34,11,73,65,1,5,2,5
E33010352,6138,4112,1177,2935,19,266,156,110,1704,1608,18,61,17,37
E33010353,611,404,94,310,2,55,40,15,141,127,2,10,2,9
E33010354,397,295,95,200,8,35,30,5,55,49,0,6,0,4
E33010355,501,359,86,273,2,34,27,7,106,100,0,6,0,0
E33010356,952,725,142,583,5,31,20,11,187,174,0,12,1,4
E33010357,1061,813,190,623,2,59,41,18,184,172,2,7,3,3
E33010358,510,371,73,298,1,34,22,12,103,90,1,12,0,1
E33010359,390,281,56,225,4,19,12,7,78,74,0,3,1,8
E33010360,632,461,118,343,2,29,17,12,136,126,2,8,0,4
E33010361,5682,4071,855,3216,23,544,399,145,1010,936,7,58,9,34
E33010362,801,608,110,498,5,41,21,20,146,136,0,8,2,1
E33010363,810,593,103,490,4,73,50,23,137,129,1,5,2,3
E33010364,312,237,54,183,0,7,5,2,66,61,0,4,1,2
E33010365,276,193,35,158,1,11,7,4,68,64,0,3,1,3
E33010366,717,530,129,401,1,43,30,13,140,132,2,4,2,3
E33010367,508,338,69,269,4,47,37,10,107,103,1,3,0,12
E33010368,1452,1078,216,862,6,69,51,18,289,274,3,10,2,10
E33010369,268,152,40,112,1,17,15,2,97,89,0,8,0,1
E33010370,576,478,119,359,5,30,17,13,59,52,0,7,0,4
E33010371,716,484,122,362,3,89,67,22,136,127,0,7,2,4
E33010372,1155,886,202,684,5,91,59,32,162,152,0,8,2,11
E33010373,337,226,73,153,4,24,16,8,82,81,0,1,0,1
E33010374,340,193,45,148,1,30,18,12,111,106,1,3,1,5
E33010375,949,746,190,556,3,106,89,17,92,86,1,4,1,2
E33010376,438,322,87,235,1,21,15,6,92,87,1,4,0,2
E33010377,671,284,87,197,0,101,70,31,278,266,0,7,5,8
E33010378,1104,857,221,636,7,86,55,31,149,132,0,12,5,5
E33010379,1337,871,195,676,7,171,122,49,275,254,0,20,1,13
E33010380,591,292,69,223,3,114,91,23,181,168,3,9,1,1
E33010381,248,117,25,92,0,42,28,14,88,84,0,2,2,1
E33010382,562,446,120,326,3,52,43,9,61,58,0,3,0,0
E33010383,535,298,84,214,5,48,39,9,183,176,0,7,0,1
E33010384,468,305,88,217,1,22,16,6,136,135,0,1,0,4
E33010385,1108,690,131,559,5,132,100,32,272,256,1,14,1,9
E33010386,957,724,184,540,7,86,67,19,131,120,0,10,1,9
E33010387,902,689,120,569,2,51,35,16,156,145,2,8,1,4
E33010388,478,279,55,224,2,58,43,15,133,125,3,5,0,6
E33010389,538,312,80,232,1,87,65,22,135,130,0,3,2,3
E33010390,436,298,68,230,2,50,38,12,84,78,0,6,0,2
E33010391,269,173,45,128,4,39,29,10,52,48,0,4,0,1
E33010392,495,352,102,250,4,50,39,11,88,73,0,15,0,1
E33010393,1266,759,147,612,11,141,110,31,343,326,0,16,1,12
E33010394,579,408,91,317,4,42,30,12,118,111,0,4,3,7
E33010395,510,258,72,186,0,127,89,38,117,112,1,4,0,8
E33010396,278,139,34,105,2,22,15,7,115,110,0,4,1,0
E33010397,214,91,25,66,0,32,22,10,88,87,0,1,0,3
E33010398,470,363,114,249,1,35,25,10,67,61,0,5,1,4
E33010399,254,177,61,116,0,48,38,10,28,24,0,4,0,1
E33010400,355,181,47,134,1,93,71,22,77,73,0,4,0,3
E33010401,514,319,81,238,4,41,22,19,149,140,0,9,0,1
E33010402,277,147,37,110,2,40,26,14,83,73,0,7,3,5
E33010403,2764,2268,503,1765,8,109,71,38,371,355,2,14,0,8
E33010404,261,123,37,86,2,34,27,7,97,95,0,2,0,5
E33010405,517,380,82,298,1,14,11,3,120,112,1,7,0,2
E33010406,514,366,78,288,2,66,58,8,78,76,0,2,0,2
E33010407,220,162,36,126,0,19,16,3,37,33,0,4,0,2
E33010408,539,404,77,327,4,14,6,8,116,111,0,4,1,1
E33010409,292,138,41,97,1,37,24,13,111,105,2,4,0,5
E33010410,1246,873,147,726,2,67,49,18,296,280,0,16,0,8
E33010411,332,123,26,97,2,39,27,12,166,164,0,2,0,2
E33010412,333,256,71,185,0,17,5,12,58,56,0,2,0,2
E33010413,684,481,97,384,2,58,45,13,142,135,0,6,1,1
E33010414,740,546,127,419,0,37,32,5,153,149,0,4,0,4
E33010415,278,191,37,154,0,7,5,2,80,75,0,3,2,0
E33010416,322,166,47,119,0,59,41,18,97,92,0,4,1,0
E33010417,254,138,41,97,0,52,40,12,62,60,0,2,0,2
E33010418,587,354,121,233,5,85,69,16,138,128,1,6,3,5
E33010419,400,244,59,185,0,54,35,19,98,89,0,8,1,4
E33010420,270,202,38,164,2,14,12,2,51,49,0,2,0,1
E33010421,419,317,62,255,2,16,10,6,84,78,0,6,0,0
E33010422,290,131,32,99,0,42,33,9,116,111,0,5,0,1
E33010423,359,192,32,160,2,34,23,11,129,121,1,6,1,2
E33010424,691,443,81,362,4,50,32,18,190,183,1,6,0,4
E33010425,616,328,70,258,2,54,38,16,230,218,0,10,2,2
E33010426,620,312,83,229,4,77,51,26,225,214,0,8,3,2
E33010427,544,297,62,235,1,45,31,14,198,186,3,8,1,3
E33010428,529,327,62,265,3,60,47,13,137,131,0,5,1,2
E33010429,297,140,38,102,3,21,15,6,132,126,0,4,2,1
E33010430,234,119,23,96,1,26,22,4,88,88,0,0,0,0
E33010431,328,175,44,131,3,30,18,12,109,101,3,5,0,11
E33010432,925,621,102,519,3,31,19,12,267,253,1,13,0,3
E33010433,564,363,80,283,3,42,34,8,153,141,1,11,0,3
E33010434,442,180,56,124,3,49,27,22,207,199,1,6,1,3
E33010435,289,221,61,160,1,15,10,5,51,44,0,6,1,1
E33010436,466,334,64,270,1,38,30,8,91,85,1,4,1,2
E33010437,309,222,67,155,1,18,14,4,64,58,0,6,0,4
E33010438,298,155,34,121,3,46,38,8,93,91,0,2,0,1
E33010439,838,602,152,450,3,47,36,11,186,177,0,3,6,0
E33010440,1200,909,165,744,5,42,28,14,237,223,1,12,1,7
E33010441,1095,798,202,596,0,64,43,21,226,205,1,18,2,7
E33010442,389,287,48,239,0,23,15,8,75,75,0,0,0,4
E33010443,1274,874,172,702,6,103,71,32,282,254,1,27,0,9
E33010444,879,548,129,419,9,140,99,41,182,173,0,8,1,0
E33010445,909,629,117,512,3,49,34,15,226,213,1,11,1,2
E33010446,294,202,40,162,0,22,12,10,69,63,0,5,1,1
E33010447,505,328,73,255,0,28,22,6,145,134,3,8,0,4
E33010448,350,184,45,139,3,26,17,9,136,127,0,7,2,1
E33010449,861,548,107,441,3,79,61,18,228,222,0,5,1,3
E33010450,757,510,87,423,2,63,48,15,176,164,0,12,0,6
E33010451,517,334,92,242,0,74,56,18,104,92,2,8,2,5
E33010452,213,115,32,83,0,64,45,19,34,33,0,1,0,0
E33010453,212,140,34,106,0,30,21,9,41,37,0,3,1,1
E33010454,374,274,61,213,2,20,11,9,76,73,0,3,0,2
E33010455,434,315,72,243,2,30,16,14,84,80,0,3,1,3
E33010456,594,465,85,380,5,18,16,2,102,94,0,7,1,4
E33010457,4835,3460,616,2844,17,316,208,108,1017,960,3,52,2,25
E33010458,720,549,133,416,3,64,48,16,103,99,0,4,0,1
E33010459,1654,1124,226,898,9,112,79,33,399,377,1,20,1,10
E33010460,1266,867,160,707,6,48,34,14,340,321,0,18,1,5
E33010461,424,317,75,242,3,30,21,9,74,72,0,2,0,0
E33010462,236,171,45,126,2,36,32,4,25,23,0,2,0,2
E33010463,857,545,106,439,3,150,115,35,156,145,0,10,1,3
E33010464,572,298,70,228,1,182,151,31,86,80,0,5,1,5
E33010465,427,270,57,213,1,65,46,19,88,81,0,6,1,3
E33010466,211,134,43,91,1,45,37,8,29,27,0,1,1,2
E33010467,351,254,59,195,1,45,35,10,49,47,0,2,0,2
E33010468,309,218,47,171,1,48,39,9,40,39,1,0,0,2
E33010469,252,167,59,108,0,27,25,2,50,48,0,2,0,8
E33010470,232,110,30,80,1,50,37,13,68,65,0,3,0,3
E33010471,571,308,76,232,1,49,36,13,207,200,0,6,1,6
E33010472,223,148,37,111,3,19,13,6,52,52,0,0,0,1
E33010473,905,686,171,515,5,50,30,20,161,151,0,7,3,3
E33010474,337,200,47,153,2,30,26,4,103,101,0,2,0,2
E33010475,480,352,79,273,2,47,38,9,79,75,2,2,0,0
E33010476,556,375,79,296,4,20,10,10,154,141,2,11,0,3
E33010477,1265,910,209,701,6,70,53,17,272,255,2,15,0,7
E33010478,222,154,69,85,1,7,1,6,40,28,7,4,1,20
E33010479,785,583,155,428,4,88,52,36,107,101,1,5,0,3
E33010480,219,170,54,116,1,18,9,9,27,26,0,0,1,3
E33010481,294,235,76,159,1,18,10,8,39,35,2,2,0,1
E33010482,287,218,66,152,6,21,11,10,41,39,0,2,0,1
E33010483,2620,1717,517,1200,18,90,43,47,774,723,12,35,4,21
E33010484,199,117,39,78,1,13,7,6,67,65,0,2,0,1
E33010485,798,594,115,479,5,27,12,15,169,157,1,10,1,3
E33010486,452,313,71,242,1,11,7,4,123,117,0,6,0,4
E33010487,1155,886,231,655,8,54,30,24,193,179,3,11,0,14
E33010488,549,412,125,287,3,28,19,9,105,101,0,4,0,1
E33010489,513,379,109,270,1,32,21,11,97,86,3,7,1,4
E33010490,268,159,45,114,2,14,9,5,93,75,1,16,1,0
E33010491,515,298,98,200,3,49,31,18,160,152,0,7,1,5
E33010492,1094,806,154,652,4,60,39,21,214,197,0,15,2,10
E33010493,1140,892,188,704,6,31,19,12,206,198,0,6,2,5
E33010494,276,180,56,124,4,24,11,13,63,60,0,3,0,5
E33010495,375,300,64,236,0,21,12,9,54,50,0,4,0,0
E33010496,529,370,118,252,3,108,72,36,43,37,1,5,0,5
E33010497,686,459,150,309,8,112,79,33,102,97,1,3,1,5
E33010498,207,118,30,88,0,18,9,9,70,67,2,1,0,1
E33010499,669,493,163,330,3,70,45,25,101,89,2,10,0,2
E33010500,627,493,148,345,5,42,25,17,84,79,0,4,1,3
E33010501,469,335,123,212,2,32,24,8,79,73,2,4,0,21
E33010502,1093,824,171,653,2,21,12,9,245,232,3,8,2,1
E33010503,1017,710,109,601,5,40,28,12,259,247,0,12,0,3
E33010504,880,610,123,487,4,27,13,14,237,230,1,6,0,2
E33010505,707,510,137,373,3,94,79,15,99,90,0,6,3,1
E33010506,743,482,120,362,1,71,45,26,187,175,2,9,1,2
E33010507,288,135,22,113,1,38,30,8,111,109,0,2,0,3
E33010508,274,180,38,142,4,33,30,3,55,48,0,5,2,2
E33010509,842,679,184,495,5,51,42,9,103,95,3,4,1,4
E33010510,454,369,94,275,1,32,26,6,49,45,0,2,2,3
E33010511,386,300,72,228,1,22,16,6,59,54,0,5,0,4
E33010512,212,163,47,116,0,13,9,4,34,33,0,1,0,2
E33010513,272,195,44,151,1,33,26,7,40,39,0,1,0,3
E33010514,228,145,33,112,2,18,14,4,59,56,0,3,0,4
E33010515,300,177,45,132,0,44,39,5,78,74,0,4,0,1
E33010516,313,242,56,186,0,20,13,7,48,46,1,1,0,3
E33010517,307,228,60,168,1,22,20,2,55,52,0,3,0,1
E33010518,350,220,46,174,1,28,20,8,98,91,0,7,0,3
E33010519,202,161,35,126,1,9,6,3,31,29,0,2,0,0
E33010520,319,212,44,168,1,27,22,5,78,69,0,8,1,1
E33010521,297,188,47,141,0,46,38,8,58,55,0,2,1,5
E33010522,768,664,135,529,2,36,30,6,62,57,0,4,1,4
E33010523,239,184,42,142,1,21,20,1,32,27,0,5,0,1
E33010524,498,361,103,258,3,64,55,9,69,65,0,3,1,1
E33010525,227,149,46,103,0,27,19,8,51,49,0,2,0,0
E33010526,151,124,41,83,0,14,13,1,13,12,0,1,0,0
E33010527,1106,860,193,667,3,91,77,14,146,134,1,11,0,6
E33010528,358,278,65,213,2,42,27,15,35,35,0,0,0,1
E33010529,209,158,32,126,2,12,9,3,35,34,0,1,0,2
E33010530,606,502,131,371,2,35,27,8,67,64,0,3,0,0
E33010531,616,429,101,328,0,49,43,6,130,124,1,5,0,8
E33010532,254,201,66,135,0,31,21,10,22,20,0,2,0,0
E33010533,610,413,88,325,0,60,41,19,133,125,0,7,1,4
E33010534,354,228,58,170,1,33,22,11,92,83,0,9,0,0
E33010535,472,326,97,229,5,21,15,6,115,106,2,6,1,5
E33010536,262,158,50,108,2,10,5,5,77,70,2,5,0,15
E33010537,553,323,76,247,7,46,20,26,166,67,68,5,26,11
E33010538,981,864,183,681,1,29,25,4,83,71,2,10,0,4
E33010539,262,183,40,143,1,24,18,6,54,47,0,7,0,0
E33010540,2596,1889,509,1380,4,245,201,44,446,419,1,24,2,12
E33010541,580,392,96,296,1,37,20,17,147,138,4,5,0,3
E33010542,418,195,57,138,5,113,89,24,105,101,0,2,2,0
E33010543,380,273,72,201,2,20,10,10,83,76,0,6,1,2
E33010544,349,235,65,170,2,34,27,7,78,74,1,3,0,0
E33010545,321,226,52,174,0,24,16,8,69,66,0,3,0,2
E33010546,1986,1768,304,1464,5,62,45,17,148,127,1,18,2,3
E33010547,452,291,64,227,1,52,38,14,107,100,0,5,2,1
E33010548,206,144,30,114,3,14,8,6,45,43,0,2,0,0
E33010549,335,175,55,120,1,53,34,19,106,100,1,3,2,0
E33010550,878,608,154,454,5,104,74,30,158,148,1,5,4,3
E33010551,373,211,53,158,0,56,37,19,102,98,1,3,0,4
E33010552,300,191,56,135,5,22,15,7,82,76,0,5,1,0
E33010553,353,249,60,189,3,34,22,12,64,57,0,6,1,3
E33010554,1599,1281,360,921,6,141,107,34,160,147,1,12,0,11
E33010555,1496,1137,310,827,1,137,85,52,209,200,1,6,2,12
E33010556,423,236,63,173,4,55,40,15,126,117,0,5,4,2
E33010557,742,612,122,490,1,25,17,8,103,91,1,9,2,1
E33010558,404,248,70,178,0,44,34,10,104,99,0,3,2,8
E33010559,1063,590,160,430,6,128,77,51,335,315,2,10,8,4
E33010560,221,135,27,108,1,18,14,4,67,64,0,2,1,0
E33010561,627,491,118,373,1,44,24,20,89,82,0,7,0,2
E33010562,715,504,130,374,4,81,58,23,123,108,1,12,2,3
E33010563,266,197,53,144,1,24,16,8,43,42,0,1,0,1
E33010564,407,276,61,215,2,26,17,9,97,91,2,4,0,6
E33010565,882,552,120,432,4,69,45,24,254,237,1,12,4,3
E33010566,395,260,54,206,2,57,39,18,70,67,0,3,0,6
E33010567,757,628,133,495,2,28,24,4,99,90,0,9,0,0
E33010568,710,531,119,412,1,32,22,10,144,138,0,4,2,2
E33010569,387,275,75,200,0,19,10,9,93,87,0,6,0,0
E33010570,420,299,64,235,4,23,18,5,93,90,0,3,0,1
E33010571,415,333,93,240,2,20,15,5,55,48,0,6,1,5
E33010572,380,311,87,224,0,20,14,6,47,46,0,1,0,2
E33010573,700,466,118,348,3,75,56,19,153,146,0,6,1,3
E33010574,551,422,115,307,6,49,30,19,73,67,0,5,1,1
E33010575,465,332,99,233,3,55,41,14,74,63,1,8,2,1
E33010576,382,251,66,185,1,44,25,19,86,77,2,6,1,0
E33010577,277,197,52,145,1,28,14,14,46,43,1,1,1,5
E33010578,1092,786,228,558,4,190,139,51,108,95,0,9,4,4
E33010579,339,259,75,184,0,40,30,10,39,36,0,2,1,1
E33010580,814,600,150,450,3,65,44,21,141,135,1,5,0,5
E33010581,406,292,78,214,3,54,41,13,54,47,0,7,0,3
E33010582,862,658,220,438,0,118,82,36,83,78,0,5,0,3
E33010583,608,452,147,305,2,100,76,24,51,46,0,5,0,3
E33010584,298,238,81,157,0,34,26,8,25,21,0,3,1,1
E33010585,235,163,52,111,0,32,20,12,39,36,0,2,1,1
E33010586,815,597,148,449,6,115,92,23,94,85,0,8,1,3
E33010587,271,191,53,138,0,39,29,10,40,35,0,5,0,1
E33010588,1584,1244,298,946,1,133,96,37,201,189,1,10,1,5
E33010589,559,443,114,329,3,58,33,25,53,52,0,1,0,2
E33010590,834,595,149,446,1,100,79,21,132,123,0,8,1,6
E33010591,979,659,122,537,5,126,89,37,186,164,1,19,2,3
E33010592,221,154,48,106,0,44,25,19,22,22,0,0,0,1
E33010593,486,331,85,246,6,45,36,9,102,91,0,10,1,2
E33010594,252,189,59,130,0,45,34,11,18,18,0,0,0,0
E33010595,199,124,41,83,2,47,30,17,23,19,0,4,0,3
E33010596,1629,1249,371,878,7,201,147,54,168,153,0,11,4,4
E33010597,218,149,39,110,0,28,11,17,41,37,1,2,1,0
E33010598,383,301,77,224,2,48,33,15,30,28,0,2,0,2
E33010599,223,153,30,123,1,26,10,16,41,39,0,2,0,2
E33010600,341,228,71,157,0,55,43,12,57,54,0,3,0,1
E33010601,792,596,171,425,1,125,103,22,67,60,1,6,0,3
E33010602,363,257,78,179,0,68,54,14,38,33,0,4,1,0
E33010603,902,744,192,552,0,49,35,14,105,98,0,7,0,4
E33010604,415,260,88,172,2,30,19,11,119,112,1,4,2,4
E33010605,626,455,116,339,1,57,35,22,106,96,0,9,1,7
E33010606,779,441,88,353,2,106,77,29,226,208,0,13,5,4
E33010607,291,192,51,141,3,30,17,13,64,60,2,2,0,2
E33010608,483,283,57,226,0,60,39,21,140,129,0,8,3,0
E33010609,1072,784,185,599,3,89,58,31,190,172,3,14,1,6
E33010610,830,543,174,369,4,177,120,57,104,91,0,10,3,2
E33010611,923,601,159,442,5,88,68,20,222,206,0,14,2,7
E33010612,384,221,77,144,0,26,10,16,137,127,2,5,3,0
E33010613,368,129,25,104,2,41,22,19,191,172,2,9,8,5
E33010614,1121,796,216,580,9,50,34,16,258,237,1,17,3,8
E33010615,209,96,32,64,1,21,15,6,90,83,0,5,2,1
E33010616,257,209,43,166,1,20,16,4,27,26,0,1,0,0
E33010617,226,127,26,101,2,16,11,5,74,72,1,0,1,7
E33010618,373,182,38,144,0,87,71,16,104,102,1,1,0,0
E33010619,199,141,34,107,0,22,14,8,35,32,0,3,0,1
E33010620,341,262,66,196,2,27,19,8,50,48,1,1,0,0
E33010621,333,227,50,177,1,18,12,6,85,79,0,5,1,2
E33010622,269,176,38,138,1,32,25,7,57,49,1,5,2,3
E33010623,759,452,91,361,4,41,16,25,258,245,0,6,7,4
E33010624,1013,780,223,557,3,117,71,46,113,98,2,10,3,0
E33010625,712,546,180,366,0,54,38,16,107,98,1,7,1,5
E33010626,430,248,89,159,2,92,64,28,87,77,0,9,1,1
E33010627,441,291,62,229,2,44,30,14,102,98,0,2,2,2
E33010628,505,329,71,258,1,36,24,12,138,127,1,8,2,1
E33010629,946,672,151,521,2,162,114,48,110,100,0,9,1,0
E33010630,206,174,49,125,0,13,9,4,19,16,0,3,0,0
E33010631,225,164,46,118,1,30,23,7,25,25,0,0,0,5
E33010632,223,126,27,99,6,31,17,14,60,59,0,1,0,0
E33010633,252,202,47,155,1,10,4,6,39,34,1,4,0,0
E33010634,1516,1323,270,1053,1,42,27,15,145,127,2,14,2,5
E33010635,228,171,46,125,0,14,6,8,39,37,0,2,0,4
E33010636,209,153,39,114,1,11,5,6,41,37,0,4,0,3
E33010637,207,141,42,99,0,13,8,5,50,46,0,3,1,3
E33010638,352,285,75,210,1,11,6,5,49,45,0,4,0,6
E33010639,219,161,30,131,0,19,12,7,37,34,0,3,0,2
E33010640,341,204,48,156,0,30,14,16,104,102,0,2,0,3
E33010641,254,186,44,142,0,11,5,6,54,49,1,4,0,3
E33010642,240,189,43,146,0,15,5,10,34,32,0,2,0,2
E33010643,283,188,41,147,0,49,24,25,43,41,0,2,0,3
E33010644,260,194,40,154,1,23,10,13,40,37,0,3,0,2
E33010645,376,302,68,234,2,21,8,13,49,41,4,4,0,2
E33010646,358,257,66,191,0,36,21,15,60,56,0,4,0,5
E33010647,1099,835,244,591,2,50,38,12,207,193,3,9,2,5
E33010648,502,383,110,273,0,58,45,13,57,49,0,8,0,4
E33010649,262,186,60,126,0,37,33,4,39,34,1,4,0,0
E33010650,254,186,46,140,4,31,21,10,31,23,0,7,1,2
E33010651,305,228,74,154,1,28,20,8,48,43,0,5,0,0
E33010652,225,189,50,139,1,11,8,3,22,17,0,4,1,2
E33010653,280,188,57,131,1,35,25,10,53,51,0,1,1,3
E33010654,532,447,88,359,2,23,18,5,58,51,1,6,0,2
E33010655,200,146,64,82,0,23,15,8,31,29,0,2,0,0
E33010656,553,393,145,248,2,69,60,9,85,80,0,5,0,4
E33010657,256,202,51,151,5,6,3,3,42,40,0,1,1,1
E33010658,232,165,40,125,0,13,4,9,51,49,0,1,1,3
E33010659,1132,774,233,541,3,98,43,55,254,234,1,17,2,3
E33010660,300,168,46,122,1,27,9,18,104,99,0,4,1,0
E33010661,225,147,36,111,1,22,14,8,53,44,0,8,1,2
E33010662,261,199,45,154,0,18,6,12,41,38,0,3,0,3
E33010663,339,225,67,158,0,40,22,18,70,62,1,5,2,4
E33010664,334,238,65,173,4,27,10,17,63,59,0,4,0,2
E33010665,221,154,46,108,0,11,0,11,54,52,0,0,2,2
E33010666,203,142,49,93,1,11,5,6,49,44,0,5,0,0
E33010667,1652,1208,262,946,8,89,38,51,332,297,2,31,2,15
E33010668,484,310,99,211,5,43,16,27,124,119,0,4,1,2
E33010669,568,416,105,311,5,32,13,19,110,94,3,13,0,5
E33010670,196,142,28,114,3,14,4,10,36,32,0,4,0,1
E33010671,270,175,42,133,1,26,9,17,65,60,1,4,0,3
E33010672,872,778,241,537,6,26,15,11,59,55,1,3,0,3
E33010673,998,769,224,545,4,79,29,50,139,124,0,13,2,7
E33010674,1046,872,246,626,3,46,15,31,121,108,1,9,3,4
E33010675,317,198,54,144,1,43,17,26,74,67,0,7,0,1
E33010676,1498,1142,277,865,6,86,30,56,256,234,1,21,0,8
E33010677,1517,1297,392,905,9,63,27,36,143,125,2,14,2,5
E33010678,1008,784,235,549,4,77,34,43,137,124,3,9,1,6
E33010679,358,254,80,174,2,22,7,15,76,75,0,1,0,4
E33010680,449,386,124,262,0,24,12,12,37,35,0,2,0,2
E33010681,249,154,51,103,1,11,4,7,81,76,0,5,0,2
E33010682,304,234,91,143,0,17,6,11,46,43,0,2,1,7
E33010683,1788,1300,433,867,6,67,24,43,403,377,4,20,2,12
E33010684,1544,1182,425,757,8,86,39,47,255,229,2,22,2,13
E33010685,674,513,222,291,3,47,19,28,99,88,0,9,2,12
E33010686,364,268,56,212,0,30,16,14,64,59,0,5,0,2
E33010687,392,273,60,213,1,33,9,24,79,75,0,3,1,6
E33010688,447,347,77,270,0,27,12,15,73,64,0,9,0,0
E33010689,645,372,94,278,6,76,43,33,188,175,0,12,1,3
E33010690,736,541,122,419,3,67,29,38,122,116,0,6,0,3
E33010691,366,221,46,175,0,16,10,6,124,109,9,6,0,5
E33010692,355,280,76,204,0,20,7,13,53,46,0,6,1,2
E33010693,852,649,199,450,1,77,30,47,120,108,1,11,0,5
E33010694,244,177,42,135,4,15,7,8,47,41,0,5,1,1
E33010695,731,575,171,404,1,51,20,31,98,93,0,4,1,6
E33010696,306,231,68,163,2,33,9,24,35,34,0,1,0,5
E33010697,553,416,128,288,2,41,19,22,83,70,0,13,0,11
E33010698,338,258,87,171,1,35,32,3,36,35,0,1,0,8
E33010699,328,257,66,191,1,38,34,4,31,29,0,1,1,1
E33010700,304,254,87,167,0,24,23,1,24,20,0,4,0,2
E33010701,557,398,120,278,3,72,59,13,77,74,1,2,0,7
E33010702,367,304,90,214,0,35,31,4,24,21,0,3,0,4
E33010703,248,202,63,139,1,19,16,3,25,24,0,1,0,1
E33010704,276,211,45,166,0,26,25,1,37,35,0,2,0,2
E33010705,280,234,84,150,0,20,17,3,23,22,0,1,0,3
E33010706,279,214,52,162,0,32,27,5,30,27,0,3,0,3
E33010707,521,386,109,277,0,71,53,18,59,49,3,5,2,5
E33010708,312,248,70,178,0,25,24,1,35,34,0,1,0,4
E33010709,276,234,88,146,1,22,22,0,16,13,1,1,1,3
E33010710,829,568,192,376,2,96,83,13,155,142,2,10,1,8
E33010711,485,386,118,268,0,45,43,2,50,45,1,1,3,4
E33010712,281,222,51,171,0,18,13,5,41,39,0,2,0,0
E33010713,280,235,61,174,1,16,14,2,26,26,0,0,0,2
E33010714,372,288,86,202,0,44,41,3,39,35,1,3,0,1
E33010715,271,221,64,157,0,23,19,4,25,24,0,0,1,2
E33010716,367,290,93,197,0,34,32,2,43,39,0,3,1,0
E33010717,306,239,79,160,0,34,30,4,32,29,0,3,0,1
E33010718,459,343,98,245,0,55,40,15,59,55,0,4,0,2
E33010719,320,193,57,136,1,47,33,14,69,68,0,1,0,10
E33010720,292,199,42,157,7,61,59,2,24,22,0,2,0,1
E33010721,293,185,45,140,0,71,63,8,34,28,3,2,1,3
E33010722,953,752,194,558,2,104,93,11,92,83,1,7,1,3
E33010723,420,271,73,198,2,89,77,12,54,50,0,4,0,4
E33010724,265,188,42,146,1,49,45,4,22,21,0,1,0,5
E33010725,305,249,64,185,0,22,19,3,30,28,0,2,0,4
E33010726,297,234,57,177,1,17,14,3,45,36,1,8,0,0
E33010727,831,456,95,361,5,102,87,15,260,251,1,7,1,8
E33010728,510,372,129,243,0,66,58,8,68,63,0,5,0,4
E33010729,402,324,93,231,1,34,26,8,39,33,3,3,0,4
E33010730,290,228,66,162,0,20,18,2,34,31,0,2,1,8
E33010731,356,268,65,203,0,55,52,3,32,28,2,2,0,1
E33010732,338,282,86,196,0,29,23,6,24,22,0,2,0,3
E33010733,690,505,180,325,3,96,87,9,78,68,1,7,2,8
E33010734,902,688,212,476,3,111,95,16,91,76,0,14,1,9
E33010735,319,245,69,176,1,25,23,2,48,39,1,7,1,0
E33010736,443,352,90,262,0,34,27,7,51,48,0,3,0,6
E33010737,251,199,62,137,0,15,11,4,37,36,0,1,0,0
E33010738,631,468,151,317,1,99,85,14,60,52,1,7,0,3
E33010739,234,142,24,118,3,64,51,13,25,20,0,5,0,0
E33010740,349,260,59,201,1,48,44,4,38,31,0,6,1,2
E33010741,614,468,144,324,2,86,71,15,55,44,3,8,0,3
E33010742,548,449,111,338,1,44,37,7,52,46,0,6,0,2
E33010743,356,309,125,184,1,14,14,0,28,27,0,0,1,4
E33010744,815,665,158,507,2,58,52,6,85,78,0,7,0,5
E33010745,290,224,79,145,0,31,28,3,30,26,0,4,0,5
E33010746,3309,2654,658,1996,12,248,208,40,381,346,2,28,5,14
E33010747,457,375,119,256,1,26,21,5,51,46,0,4,1,4
E33010748,335,263,79,184,0,34,29,5,36,30,0,6,0,2
E33010749,498,404,111,293,1,36,33,3,55,49,0,6,0,2
E33010750,344,254,85,169,0,40,37,3,48,46,0,2,0,2
E33010751,464,354,93,261,1,32,25,7,71,61,1,8,1,6
E33010752,293,226,65,161,1,20,13,7,41,37,0,4,0,5
E33010753,505,369,119,250,3,63,50,13,70,60,2,3,5,0
E33010754,494,416,129,287,1,22,19,3,55,49,1,4,1,0
E33010755,591,420,144,276,4,85,68,17,76,71,0,4,1,6
E33010756,426,328,102,226,4,30,25,5,61,52,1,7,1,3
E33010757,398,304,97,207,0,30,23,7,61,56,0,5,0,3
E33010758,811,546,153,393,3,66,54,12,187,177,3,7,0,9
E33010759,382,310,90,220,1,29,23,6,37,32,0,5,0,5
E33010760,333,276,62,214,1,23,19,4,31,28,0,3,0,2
E33010761,352,245,89,156,4,52,28,24,51,43,0,8,0,0
E33010762,360,265,81,184,0,39,25,14,54,48,2,4,0,2
E33010763,277,204,65,139,0,36,28,8,33,32,0,1,0,4
E33010764,441,338,98,240,2,55,36,19,44,41,0,3,0,2
E33010765,523,393,122,271,2,76,47,29,49,42,1,5,1,3
E33010766,1228,984,246,738,7,101,80,21,133,120,2,11,0,3
E33010767,432,340,110,230,1,35,32,3,44,38,1,5,0,12
E33010768,794,620,183,437,3,70,61,9,100,90,0,7,3,1
E33010769,377,309,130,179,3,16,13,3,45,32,0,9,4,4
E33010770,506,432,164,268,1,20,16,4,52,47,1,4,0,1
E33010771,640,497,200,297,7,56,42,14,73,65,2,2,4,7
E33010772,276,236,80,156,1,14,10,4,24,18,2,4,0,1
E33010773,287,203,64,139,0,30,25,5,47,42,0,5,0,7
E33010774,402,327,82,245,0,37,29,8,36,35,0,1,0,2
E33010775,386,248,72,176,0,73,54,19,61,55,0,4,2,4
E33010776,535,390,113,277,1,67,51,16,71,63,1,5,2,6
E33010777,292,169,31,138,0,59,49,10,62,51,3,8,0,2
E33010778,345,267,75,192,2,41,38,3,31,28,0,2,1,4
E33010779,375,263,58,205,2,58,54,4,48,46,0,2,0,4
E33010780,322,215,55,160,0,54,52,2,48,44,0,3,1,5
E33010781,1041,766,217,549,0,106,86,20,162,148,3,9,2,7
E33010782,722,557,131,426,1,44,35,9,116,106,2,7,1,4
E33010783,330,258,81,177,0,38,34,4,34,27,0,4,3,0
E33010784,315,226,80,146,1,52,47,5,31,26,1,4,0,5
E33010785,476,370,104,266,1,46,40,6,55,52,0,3,0,4
E33010786,343,259,73,186,1,34,28,6,45,45,0,0,0,4
E33010787,538,411,138,273,0,54,46,8,67,58,2,6,1,6
E33010788,309,222,55,167,0,51,45,6,34,29,0,5,0,2
E33010789,300,231,83,148,0,44,41,3,21,19,0,2,0,4
E33010790,831,640,191,449,2,108,98,10,74,67,0,7,0,7
E33010791,381,270,85,185,1,60,54,6,46,41,0,5,0,4
E33010792,457,330,75,255,2,56,43,13,63,60,1,1,1,6
E33010793,316,232,61,171,0,37,31,6,46,41,3,2,0,1
E33010794,376,271,87,184,1,46,39,7,50,46,0,4,0,8
E33010795,1138,840,222,618,2,137,122,15,157,143,2,12,0,2
E33010796,385,300,82,218,1,38,34,4,44,42,0,2,0,2
E33010797,498,375,110,265,0,69,61,8,52,48,0,4,0,2
E33010798,428,312,98,214,2,48,42,6,63,58,0,5,0,3
E33010799,335,236,60,176,2,54,48,6,42,38,1,3,0,1
E33010800,542,452,123,329,2,43,35,8,44,43,0,1,0,1
E33010801,343,274,92,182,1,39,22,17,27,25,0,2,0,2
E33010802,261,226,81,145,1,18,15,3,15,12,0,3,0,1
E33010803,434,347,121,226,3,28,16,12,50,47,0,1,2,6
E33010804,338,294,102,192,2,12,10,2,27,25,1,1,0,3
E33010805,415,342,112,230,2,27,19,8,43,41,0,2,0,1
E33010806,323,246,100,146,0,30,23,7,30,23,1,4,2,17
E33010807,617,492,158,334,1,54,42,12,66,57,1,6,2,4
E33010808,545,410,105,305,2,50,46,4,82,75,2,4,1,1
E33010809,463,338,106,232,0,55,48,7,66,59,1,6,0,4
E33010810,290,222,66,156,0,46,44,2,22,18,0,2,2,0
E33010811,372,247,83,164,2,64,58,6,54,51,0,3,0,5
E33010812,934,579,139,440,3,147,127,20,199,183,0,14,2,6
E33010813,364,280,61,219,0,33,28,5,47,47,0,0,0,4
E33010814,291,211,54,157,0,50,41,9,29,25,0,4,0,1
E33010815,271,222,73,149,0,33,23,10,14,12,0,2,0,2
E33010816,456,286,78,208,3,44,37,7,121,115,1,4,1,2
E33010817,306,240,91,149,1,28,25,3,36,31,0,3,2,1
E33010818,250,197,57,140,3,16,12,4,30,23,3,2,2,4
E33010819,350,278,119,159,3,27,23,4,36,30,2,2,2,6
E33010820,216,154,68,86,0,15,11,4,45,36,9,0,0,2
E33010821,455,352,125,227,1,20,16,4,75,71,2,0,2,7
E33010822,382,283,77,206,4,41,38,3,46,39,3,4,0,8
E33010823,436,342,110,232,2,44,28,16,44,38,1,4,1,4
E33010824,280,220,79,141,2,30,28,2,24,23,0,1,0,4
E33010825,348,266,70,196,2,38,38,0,39,37,0,2,0,3
E33010826,500,392,108,284,0,54,46,8,53,44,2,7,0,1
E33010827,413,337,106,231,1,27,25,2,45,42,0,3,0,3
E33010828,722,540,160,380,3,77,72,5,89,79,0,6,4,13
E33010829,292,215,63,152,2,43,43,0,32,30,0,0,2,0
E33010830,313,249,71,178,0,22,19,3,40,30,0,6,4,2
E33010831,625,437,129,308,2,92,81,11,91,77,2,10,2,3
E33010832,517,386,121,265,0,61,55,6,70,58,1,9,2,0
E33010833,401,311,110,201,0,51,45,6,32,24,2,3,3,7
E33010834,385,268,74,194,0,68,66,2,47,42,1,3,1,2
E33010835,264,205,57,148,2,32,31,1,24,20,0,4,0,1
E33010836,840,605,183,422,3,86,72,14,141,124,1,15,1,5
E33010837,399,317,81,236,3,38,33,5,40,35,0,5,0,1
E33010838,338,271,72,199,0,26,25,1,39,35,2,2,0,2
E33010839,395,340,89,251,0,23,20,3,30,20,2,6,2,2
E33010840,543,414,126,288,1,52,52,0,70,65,1,4,0,6
E33010841,311,238,86,152,2,24,19,5,41,37,1,0,3,6
E33010842,529,406,116,290,1,42,41,1,71,66,0,5,0,9
E33010843,416,324,95,229,1,35,31,4,52,50,0,2,0,4
E33010844,298,236,104,132,0,20,17,3,35,27,2,6,0,7
E33010845,382,286,79,207,1,38,33,5,55,49,1,5,0,2
E33010846,265,189,48,141,0,37,34,3,36,32,2,2,0,3
E33010847,614,507,157,350,3,42,37,5,59,51,1,7,0,3
E33010848,292,230,76,154,2,23,17,6,35,30,0,5,0,2
E33010849,401,326,90,236,2,33,28,5,32,28,1,3,0,8
E33010850,373,263,87,176,2,41,31,10,63,57,2,4,0,4
E33010851,373,298,62,236,2,44,41,3,29,24,1,4,0,0
E33010852,309,186,58,128,1,66,56,10,55,45,3,7,0,1
E33010853,493,371,132,239,0,56,47,9,63,54,1,8,0,3
E33010854,423,341,137,204,1,35,30,5,42,36,2,3,1,4
E33010855,636,520,157,363,0,57,51,6,54,50,0,4,0,5
E33010856,264,224,72,152,1,16,16,0,21,19,0,2,0,2
E33010857,266,202,49,153,0,34,28,6,30,28,0,2,0,0
E33010858,649,482,128,354,2,82,71,11,79,73,3,3,0,4
E33010859,329,249,51,198,4,20,19,1,50,44,1,3,2,6
E33010860,408,315,78,237,1,34,28,6,57,45,0,12,0,1
E33010861,324,237,65,172,0,36,36,0,41,33,0,8,0,10
E33010862,530,426,123,303,2,43,40,3,55,48,0,7,0,4
E33010863,343,285,106,179,0,25,22,3,31,25,2,4,0,2
E33010864,303,248,88,160,1,20,18,2,31,26,0,3,2,3
E33010865,428,389,127,262,0,15,12,3,19,16,0,3,0,5
E33010866,243,184,67,117,0,20,19,1,38,32,0,6,0,1
E33010867,242,198,64,134,0,18,16,2,22,19,2,1,0,4
E33010868,605,454,130,324,1,44,37,7,105,91,6,5,3,1
E33010869,350,272,72,200,4,25,21,4,45,36,0,7,2,4
E33010870,241,195,66,129,0,27,25,2,17,15,0,2,0,2
E33010871,259,211,77,134,0,15,12,3,33,30,0,3,0,0
E33010872,293,226,73,153,1,27,25,2,35,32,0,3,0,4
E33010873,341,271,75,196,0,36,31,5,30,25,3,1,1,4
E33010874,356,253,65,188,4,37,26,11,60,45,0,15,0,2
E33010875,320,245,53,192,0,38,37,1,32,30,1,1,0,5
E33010876,301,223,60,163,0,29,24,5,42,29,2,10,1,7
E33010877,260,194,65,129,2,31,28,3,30,29,0,1,0,3
E33010878,460,370,113,257,0,34,32,2,54,48,0,6,0,2
E33010879,295,242,83,159,0,34,30,4,19,18,1,0,0,0
E33010880,274,171,36,135,0,58,47,11,40,39,0,1,0,5
E33010881,291,224,54,170,0,34,34,0,31,28,2,1,0,2
E33010882,337,264,76,188,3,30,24,6,39,35,0,4,0,1
E33010883,482,374,120,254,2,51,41,10,52,48,2,2,0,3
E33010884,266,225,58,167,1,8,6,2,32,29,2,1,0,0
E33010885,344,271,74,197,1,20,16,4,49,44,0,5,0,3
E33010886,333,297,84,213,0,10,7,3,26,22,0,4,0,0
E33010887,434,352,104,248,2,28,25,3,51,45,1,3,2,1
E33010888,391,321,80,241,0,26,24,2,44,40,0,4,0,0
E33010889,499,404,108,296,1,29,25,4,63,55,0,8,0,2
E33010890,288,211,76,135,0,46,41,5,31,26,0,5,0,0
E33010891,567,439,131,308,3,45,43,2,79,64,8,5,2,1
E33010892,392,266,81,185,0,28,18,10,94,85,6,3,0,4
E33010893,323,245,82,163,0,34,27,7,39,34,1,4,0,5
E33010894,257,201,54,147,2,17,15,2,36,32,1,3,0,1
E33010895,611,479,117,362,0,41,36,5,88,67,1,17,3,3
E33010896,727,531,151,380,7,84,71,13,100,91,2,7,0,5
E33010897,367,277,65,212,1,48,47,1,36,34,0,1,1,5
E33010898,451,336,105,231,0,31,28,3,81,75,2,3,1,3
E33010899,378,296,91,205,0,41,35,6,38,32,0,5,1,3
E33010900,534,408,90,318,0,43,43,0,79,76,0,3,0,4
E33010901,666,519,145,374,2,46,40,6,96,84,1,6,5,3
E33010902,346,251,67,184,0,41,35,6,53,51,0,2,0,1
E33010903,579,465,102,363,2,58,53,5,53,48,1,4,0,1
E33010904,337,241,64,177,0,57,54,3,38,35,0,2,1,1
E33010905,423,320,77,243,1,37,23,14,62,52,1,9,0,3
E33010906,807,627,158,469,2,72,67,5,103,89,1,13,0,3
E33010907,460,389,140,249,1,23,20,3,41,34,0,7,0,6
E33010908,308,267,76,191,0,12,10,2,27,25,0,2,0,2
E33010909,300,233,57,176,1,21,20,1,45,42,1,2,0,0
E33010910,416,354,113,241,1,18,13,5,34,28,0,6,0,9
E33010911,516,428,104,324,1,35,33,2,50,47,0,3,0,2
E33010912,326,293,105,188,1,5,5,0,26,21,0,5,0,1
E33010913,259,185,44,141,0,41,37,4,28,25,2,1,0,5
E33010914,613,467,123,344,0,43,40,3,96,78,1,17,0,7
E33010915,4872,3998,1076,2922,11,242,203,39,601,527,15,54,5,20
E33010916,303,232,54,178,0,23,21,2,46,35,1,10,0,2
E33010917,304,221,60,161,0,52,47,5,30,25,1,3,1,1
E33010918,339,214,37,177,0,73,72,1,49,45,0,4,0,3
E33010919,635,482,121,361,2,48,39,9,97,83,3,11,0,6
E33010920,336,239,83,156,2,26,19,7,65,59,1,5,0,4
E33010921,615,441,133,308,1,36,26,10,131,122,2,2,5,6
E33010922,627,438,129,309,2,63,48,15,120,113,2,5,0,4
E33010923,302,230,61,169,1,20,15,5,49,44,2,3,0,2
E33010924,283,222,57,165,0,11,7,4,49,42,1,5,1,1
E33010925,280,193,53,140,1,14,11,3,72,70,2,0,0,0
E33010926,386,310,95,215,0,17,14,3,58,58,0,0,0,1
E33010927,436,347,104,243,3,24,17,7,56,48,3,2,3,6
E33010928,237,152,62,90,1,13,13,0,62,57,4,1,0,9
E33010929,595,491,165,326,1,39,33,6,61,59,0,2,0,3
E33010930,323,279,89,190,0,5,5,0,33,31,2,0,0,6
E33010931,391,328,82,246,2,13,13,0,43,36,0,7,0,5
E33010932,268,239,71,168,0,4,4,0,25,21,0,4,0,0
E33010933,312,250,73,177,0,11,9,2,51,45,0,2,4,0
E33010934,410,255,102,153,1,47,36,11,101,93,3,4,1,6
E33010935,451,246,65,181,2,63,57,6,137,126,1,9,1,3
E33010936,489,328,110,218,0,43,38,5,113,108,1,4,0,5
E33010937,607,449,109,340,1,49,42,7,104,92,5,7,0,4
E33010938,329,202,52,150,0,72,70,2,53,51,0,2,0,2
E33010939,266,202,70,132,0,16,13,3,45,43,0,2,0,3
E33010940,230,170,50,120,1,31,28,3,28,25,1,2,0,0
E33010941,322,236,53,183,1,44,43,1,41,39,0,2,0,0
E33010942,452,359,110,249,6,32,30,2,48,44,0,4,0,7
E33010943,364,285,98,187,1,25,23,2,51,42,0,8,1,2
E33010944,1496,1072,307,765,1,193,150,43,218,199,1,17,1,12
E33010945,395,307,92,215,0,21,11,10,61,55,1,5,0,6
E33010946,327,255,75,180,0,38,34,4,33,32,0,1,0,1
E33010947,357,306,112,194,0,17,11,6,31,30,1,0,0,3
E33010948,527,430,144,286,0,23,16,7,67,53,1,13,0,7
E33010949,315,269,82,187,1,14,10,4,30,21,2,7,0,1
E33010950,374,306,118,188,2,11,9,2,54,45,1,7,1,1
E33010951,392,310,110,200,0,9,3,6,71,67,2,2,0,2
E33010952,375,323,120,203,0,17,16,1,35,33,0,2,0,0
E33010953,311,222,68,154,0,34,31,3,53,51,0,2,0,2
E33010954,922,706,146,560,7,49,41,8,151,139,1,10,1,9
E33010955,461,318,86,232,0,42,30,12,96,87,0,9,0,5
E33010956,580,419,85,334,1,46,35,11,107,101,0,4,2,7
E33010957,429,327,105,222,1,47,42,5,49,41,2,6,0,5
E33010958,689,543,144,399,0,39,29,10,104,97,0,7,0,3
E33010959,377,302,80,222,0,29,23,6,46,39,0,5,2,0
E33010960,305,203,47,156,2,62,54,8,36,30,1,5,0,2
E33010961,338,251,75,176,1,52,47,5,31,23,5,3,0,3
E33010962,615,435,155,280,1,74,65,9,98,82,1,10,5,7
E33010963,351,266,76,190,0,61,59,2,22,20,0,2,0,2
E33010964,273,224,68,156,0,19,19,0,27,25,1,1,0,3
E33010965,672,571,185,386,0,50,45,5,50,45,0,5,0,1
E33010966,400,336,98,238,0,29,22,7,35,31,0,3,1,0
E33010967,337,215,71,144,0,61,51,10,55,49,1,5,0,6
E33010968,330,251,75,176,0,31,26,5,47,42,0,4,1,1
E33010969,379,217,57,160,2,81,71,10,76,69,1,6,0,3
E33010970,259,204,50,154,0,19,15,4,32,27,0,3,2,4
E33010971,267,192,56,136,1,42,35,7,29,24,0,4,1,3
E33010972,784,588,127,461,4,97,83,14,92,87,1,4,0,3
E33010973,484,340,96,244,1,92,85,7,44,38,3,3,0,7
E33010974,350,264,82,182,2,42,39,3,39,36,0,3,0,3
E33010975,924,722,221,501,1,67,55,12,125,118,0,5,2,9
E33010976,343,272,98,174,0,22,19,3,45,39,0,6,0,4
E33010977,382,317,89,228,0,27,26,1,38,33,0,5,0,0
E33010978,500,367,100,267,0,50,45,5,81,71,2,7,1,2
E33010979,677,508,151,357,0,90,84,6,74,60,0,14,0,5
E33010980,344,274,75,199,1,27,23,4,39,32,0,3,4,3
E33010981,419,326,86,240,0,40,37,3,50,42,0,8,0,3
E33010982,522,418,126,292,0,43,39,4,59,54,0,5,0,2
E33010983,340,283,52,231,0,14,10,4,40,30,6,4,0,3
E33010984,284,228,57,171,0,16,14,2,39,23,0,11,5,1
E33010985,478,380,92,288,2,38,30,8,54,47,1,6,0,4
E33010986,272,198,58,140,0,31,30,1,35,31,0,4,0,8
E33010987,289,222,55,167,0,33,33,0,34,31,0,3,0,0
E33010988,334,247,73,174,0,46,44,2,39,32,3,4,0,2
E33010989,612,463,126,337,2,77,66,11,64,59,1,3,1,6
E33010990,422,326,85,241,1,41,33,8,49,41,2,5,1,5
E33010991,559,457,122,335,3,16,9,7,82,74,0,7,1,1
E33010992,429,340,85,255,2,21,14,7,64,62,0,2,0,2
E33010993,580,450,153,297,3,64,37,27,56,48,1,7,0,7
E33010994,268,219,73,146,2,13,11,2,31,26,0,4,1,3
E33010995,402,327,123,204,1,13,11,2,57,45,2,3,7,4
E33010996,374,326,114,212,0,15,15,0,26,23,0,3,0,7
E33010997,287,237,83,154,1,18,16,2,29,25,0,2,2,2
E33010998,1183,872,218,654,6,159,139,20,143,130,1,10,2,3
E33010999,389,300,86,214,0,54,48,6,32,26,0,5,1,3
E33011000,423,317,106,211,0,51,44,7,52,49,0,2,1,3
E33011001,438,350,81,269,3,43,32,11,41,38,1,2,0,1
E33011002,737,559,123,436,1,76,56,20,97,91,0,5,1,4
E33011003,749,575,130,445,2,80,68,12,88,76,0,12,0,4
E33011004,560,443,122,321,3,56,48,8,56,49,0,7,0,2
E33011005,376,308,86,222,1,33,24,9,34,32,0,2,0,0
E33011006,330,241,61,180,1,50,43,7,34,33,1,0,0,4
E33011007,384,288,75,213,3,42,37,5,51,47,0,3,1,0
E33011008,425,358,114,244,0,35,27,8,26,22,0,4,0,6
E33011009,585,496,128,368,1,39,29,10,44,35,0,9,0,5
E33011010,287,218,85,133,3,36,33,3,27,22,0,3,2,3
E33011011,327,273,75,198,0,26,23,3,28,24,2,2,0,0
E33011012,656,517,155,362,2,68,58,10,62,53,0,8,1,7
E33011013,274,219,75,144,0,23,21,2,31,23,2,6,0,1
E33011014,595,472,120,352,1,67,65,2,52,48,0,4,0,3
E33011015,293,204,49,155,0,55,50,5,34,28,0,4,2,0
E33011016,323,258,71,187,0,29,25,4,34,33,0,1,0,2
E33011017,357,269,83,186,1,51,43,8,36,32,1,3,0,0
E33011018,282,204,52,152,1,41,36,5,35,29,0,4,2,1
E33011019,341,241,75,166,1,60,52,8,38,37,0,1,0,1
E33011020,630,483,128,355,3,70,62,8,67,57,1,9,0,7
E33011021,462,344,134,210,0,39,29,10,64,58,0,2,4,15
E33011022,381,331,113,218,1,13,6,7,32,26,1,2,3,4
E33011023,479,370,102,268,0,34,24,10,70,64,1,3,2,5
E33011024,423,304,68,236,1,71,64,7,43,36,0,5,2,4
E33011025,412,286,89,197,1,67,59,8,53,50,2,1,0,5
E33011026,558,415,124,291,1,72,53,19,69,57,1,8,3,1
E33011027,291,201,48,153,0,49,42,7,39,33,0,5,1,2
E33011028,534,357,101,256,1,121,108,13,53,47,1,3,2,2
E33011029,369,256,60,196,1,72,67,5,38,32,0,4,2,2
E33011030,296,218,75,143,0,49,43,6,27,20,2,5,0,2
E33011031,253,193,62,131,0,30,25,5,30,28,1,0,1,0
E33011032,604,426,121,305,0,103,97,6,64,58,0,3,3,11
E33011033,271,207,42,165,0,47,47,0,15,9,0,6,0,2
E33011034,256,170,40,130,0,65,60,5,19,19,0,0,0,2
E33011035,311,214,54,160,0,65,64,1,25,25,0,0,0,7
E33011036,674,578,175,403,4,32,27,5,54,44,3,5,2,6
E33011037,380,321,60,261,0,13,10,3,45,37,1,5,2,1
E33011038,321,222,54,168,0,66,61,5,32,29,0,3,0,1
E33011039,737,481,129,352,1,166,144,22,84,73,2,7,2,5
E33011040,270,206,54,152,0,43,43,0,19,14,1,4,0,2
E33011041,342,282,91,191,1,28,23,5,30,29,1,0,0,1
E33011042,308,209,71,138,1,63,42,21,34,31,0,3,0,1
E33011043,336,251,66,185,1,43,33,10,40,36,0,4,0,1
E33011044,280,184,49,135,0,60,52,8,31,27,0,4,0,5
E33011045,281,163,49,114,1,65,43,22,49,44,1,3,1,3
E33011046,357,274,69,205,0,27,23,4,54,50,1,3,0,2
E33011047,1166,932,232,700,6,126,106,20,98,94,1,3,0,4
E33011048,299,220,73,147,1,36,27,9,33,30,1,2,0,9
E33011049,297,238,80,158,2,38,35,3,18,16,1,1,0,1
E33011050,241,165,66,99,1,35,24,11,36,28,0,7,1,4
E33011051,669,537,144,393,4,63,47,16,53,47,0,6,0,12
E33011052,472,364,81,283,1,50,43,7,52,48,0,4,0,5
E33011053,416,259,70,189,3,82,51,31,70,66,1,3,0,2
E33011054,788,544,177,367,2,125,100,25,106,97,1,8,0,11
E33011055,286,210,70,140,0,37,24,13,33,27,0,4,2,6
E33011056,626,436,137,299,2,120,89,31,66,59,1,5,1,2
E33011057,373,225,89,136,0,49,35,14,97,82,0,11,4,2
E33011058,353,239,65,174,1,29,21,8,82,65,0,5,12,2
E33011059,556,418,133,285,2,65,49,16,64,57,0,5,2,7
E33011060,312,238,63,175,0,29,25,4,40,37,0,3,0,5
E33011061,470,402,90,312,1,22,18,4,42,36,0,1,5,3
E33011062,300,271,70,201,1,6,3,3,17,15,1,1,0,5
E33011063,1581,1270,360,910,3,136,113,23,159,144,4,8,3,13
E33011064,417,362,87,275,0,23,20,3,31,23,2,6,0,1
E33011065,350,253,64,189,0,48,38,10,41,38,0,3,0,8
E33011066,380,335,90,245,1,15,14,1,28,26,0,1,1,1
E33011067,305,249,77,172,0,31,30,1,24,24,0,0,0,1
E33011068,288,217,68,149,1,15,8,7,54,53,0,1,0,1
E33011069,328,260,66,194,0,24,18,6,42,40,0,2,0,2
E33011070,686,523,148,375,1,49,40,9,102,94,0,8,0,11
E33011071,302,237,70,167,0,26,12,14,38,28,0,6,4,1
E33011072,515,372,111,261,0,66,48,18,72,64,0,6,2,5
E33011073,267,192,62,130,2,28,20,8,37,28,1,6,2,8
E33011074,368,283,90,193,1,38,30,8,39,33,1,4,1,7
E33011075,657,545,174,371,0,62,41,21,48,42,1,4,1,2
E33011076,465,319,105,214,3,68,52,16,67,62,0,4,1,8
E33011077,288,230,52,178,0,28,22,6,26,23,0,3,0,4
E33011078,328,243,55,188,1,50,44,6,31,28,0,3,0,3
E33011079,318,265,81,184,1,20,18,2,28,23,3,2,0,4
E33011080,299,240,83,157,1,13,12,1,44,41,0,2,1,1
E33011081,367,295,89,206,4,23,20,3,37,32,0,5,0,8
E33011082,598,511,127,384,3,17,15,2,64,54,2,8,0,3
E33011083,245,181,45,136,0,23,18,5,37,35,0,2,0,4
E33011084,747,617,142,475,2,49,40,9,71,62,0,7,2,8
E33011085,426,355,97,258,0,17,15,2,50,37,2,11,0,4
E33011086,1037,846,242,604,5,74,57,17,104,96,0,8,0,8
E33011087,317,288,107,181,0,10,6,4,16,13,0,3,0,3
E33011088,686,577,208,369,0,44,36,8,62,55,0,7,0,3
E33011089,280,227,82,145,1,22,16,6,29,25,3,1,0,1
E33011090,361,245,79,166,2,41,34,7,71,56,5,10,0,2
E33011091,340,275,87,188,1,32,27,5,31,24,0,7,0,1
E33011092,579,442,136,306,1,42,35,7,88,79,4,4,1,6
E33011093,378,322,87,235,1,20,19,1,32,30,0,2,0,3
E33011094,2081,1643,427,1216,8,201,165,36,217,197,0,19,1,12
E33011095,834,670,147,523,0,76,63,13,85,76,0,8,1,3
E33011096,440,377,115,262,2,16,14,2,42,35,1,6,0,3
E33011097,415,337,90,247,0,30,26,4,46,41,1,2,2,2
E33011098,527,450,126,324,2,13,10,3,59,52,1,3,3,3
E33011099,269,205,67,138,3,22,20,2,39,36,0,3,0,0
E33011100,504,391,100,291,0,63,54,9,43,43,0,0,0,7
E33011101,295,220,63,157,1,32,31,1,42,41,0,0,1,0
E33011102,308,228,61,167,0,26,24,2,52,49,1,2,0,2
E33011103,279,220,65,155,0,23,19,4,32,23,3,4,2,4
E33011104,1348,995,255,740,5,130,101,29,209,195,1,11,2,9
E33011105,312,257,74,183,0,21,18,3,31,31,0,0,0,3
E33011106,351,262,52,210,1,38,33,5,42,40,0,2,0,8
E33011107,1068,795,203,592,2,134,117,17,132,119,0,9,4,5
E33011108,308,229,38,191,0,25,19,6,52,42,0,8,2,2
E33011109,293,228,88,140,0,17,13,4,47,38,0,4,5,1
E33011110,431,348,96,252,1,34,29,5,47,45,0,1,1,1
E33011111,1007,815,204,611,5,48,38,10,130,119,1,10,0,9
E33011112,718,575,175,400,6,56,44,12,76,60,0,14,2,5
E33011113,452,345,71,274,2,35,29,6,65,62,0,3,0,5
E33011114,401,308,96,212,1,32,27,5,54,45,3,5,1,6
E33011115,285,257,71,186,0,9,7,2,17,14,1,2,0,2
E33011116,428,356,96,260,1,23,19,4,47,44,1,2,0,1
E33011117,738,590,184,406,1,51,40,11,91,86,2,3,0,5
E33011118,273,249,88,161,1,8,8,0,15,14,0,1,0,0
E33011119,291,222,57,165,0,29,23,6,40,36,0,4,0,0
E33011120,388,313,100,213,2,29,23,6,43,36,0,5,2,1
E33011121,381,297,89,208,0,25,21,4,58,52,0,4,2,1
E33011122,341,275,94,181,0,41,30,11,25,21,0,4,0,0
E33011123,290,263,67,196,1,8,7,1,17,12,0,5,0,1
E33011124,263,231,49,182,0,7,6,1,23,20,0,2,1,2
E33011125,283,223,62,161,0,28,21,7,28,25,0,2,1,4
E33011126,614,508,133,375,0,49,46,3,54,46,0,6,2,3
E33011127,278,240,78,162,0,17,16,1,19,13,0,4,2,2
E33011128,333,305,92,213,0,13,13,0,14,13,0,1,0,1
E33011129,250,203,84,119,0,17,16,1,29,28,0,1,0,1
E33011130,362,297,83,214,2,24,23,1,39,36,1,2,0,0
E33011131,295,239,75,164,0,26,24,2,25,24,0,1,0,5
E33011132,501,391,85,306,3,44,35,9,61,55,1,5,0,2
E33011133,392,297,90,207,1,41,32,9,48,43,0,3,2,5
E33011134,312,263,69,194,0,21,15,6,24,23,0,1,0,4
E33011135,365,317,93,224,1,18,18,0,29,27,1,1,0,0
E33011136,398,305,103,202,1,40,36,4,50,36,0,12,2,2
E33011137,490,407,127,280,2,40,32,8,34,31,0,3,0,7
E33011138,939,793,208,585,2,65,45,20,76,70,2,4,0,3
E33011139,356,293,79,214,0,39,30,9,23,20,0,3,0,1
E33011140,763,628,205,423,0,38,30,8,91,82,0,8,1,6
E33011141,261,222,67,155,0,19,18,1,17,15,0,2,0,3
E33011142,691,556,156,400,1,50,42,8,77,74,0,3,0,7
E33011143,413,341,85,256,0,32,25,7,33,30,0,2,1,7
E33011144,401,311,73,238,1,53,52,1,31,30,0,1,0,5
E33011145,398,321,87,234,0,40,36,4,34,31,0,3,0,3
E33011146,356,285,87,198,0,34,31,3,35,34,0,1,0,2
E33011147,322,272,78,194,0,30,24,6,20,19,0,1,0,0
E33011148,484,413,120,293,2,34,28,6,33,30,0,2,1,2
E33011149,404,307,93,214,2,42,34,8,47,40,2,5,0,6
E33011150,313,261,72,189,0,20,17,3,30,28,1,1,0,2
E33011151,2821,2213,509,1704,8,235,173,62,354,334,0,18,2,11
E33011152,291,246,79,167,1,22,17,5,22,19,0,3,0,0
E33011153,442,334,118,216,3,49,42,7,48,45,1,2,0,8
E33011154,535,456,132,324,0,25,23,2,53,50,0,3,0,1
E33011155,532,410,109,301,2,65,50,15,50,45,0,3,2,5
E33011156,280,243,67,176,0,12,9,3,24,23,0,1,0,1
E33011157,492,353,107,246,0,88,56,32,46,43,0,2,1,5
E33011158,260,210,73,137,0,15,13,2,32,27,0,1,4,3
E33011159,356,289,101,188,2,36,29,7,28,26,1,1,0,1
E33011160,295,241,93,148,1,23,20,3,27,26,1,0,0,3
E33011161,413,312,104,208,2,64,47,17,33,25,2,6,0,2
E33011162,480,383,83,300,3,35,30,5,59,51,2,4,2,0
E33011163,273,224,66,158,0,27,22,5,20,19,0,1,0,2
E33011164,352,278,61,217,5,47,38,9,22,22,0,0,0,0
E33011165,327,261,68,193,0,41,35,6,24,20,0,4,0,1
E33011166,403,281,66,215,0,79,27,52,42,36,0,5,1,1
E33011167,296,199,45,154,0,73,20,53,23,18,0,4,1,1
E33011168,287,235,60,175,2,20,14,6,27,18,0,2,7,3
E33011169,353,284,68,216,0,32,19,13,36,35,0,0,1,1
E33011170,240,195,72,123,0,22,20,2,23,23,0,0,0,0
E33011171,384,306,69,237,0,46,36,10,31,25,2,3,1,1
E33011172,373,269,131,138,1,28,23,5,62,51,1,7,3,13
E33011173,438,372,116,256,0,27,23,4,36,28,0,6,2,3
E33011174,274,214,57,157,1,18,4,14,38,35,2,1,0,3
E33011175,337,224,57,167,0,83,78,5,24,16,0,8,0,6
E33011176,442,332,99,233,0,66,61,5,42,35,2,5,0,2
E33011177,295,161,45,116,1,113,101,12,16,13,0,3,0,4
E33011178,340,242,69,173,2,62,56,6,32,30,1,1,0,2
E33011179,271,166,38,128,1,77,34,43,25,21,0,2,2,2
E33011180,490,337,69,268,2,82,28,54,64,56,0,8,0,5
E33011181,268,179,52,127,1,57,45,12,30,26,0,3,1,1
E33011182,329,190,53,137,1,93,72,21,44,39,0,5,0,1
E33011183,405,293,76,217,0,66,51,15,40,36,1,3,0,6
E33011184,404,268,64,204,0,82,58,24,51,49,0,1,1,3
E33011185,270,202,64,138,0,40,25,15,27,25,0,2,0,1
E33011186,299,170,45,125,0,106,95,11,22,19,3,0,0,1
E33011187,323,236,61,175,0,49,42,7,36,31,0,3,2,2
E33011188,386,267,68,199,0,88,82,6,30,29,0,0,1,1
E33011189,372,260,86,174,1,71,52,19,36,30,1,5,0,4
E33011190,428,295,82,213,1,90,81,9,41,38,0,2,1,1
E33011191,460,312,75,237,2,113,91,22,30,29,0,1,0,3
E33011192,643,461,99,362,3,128,73,55,48,42,1,4,1,3
E33011193,430,329,91,238,1,55,31,24,43,39,0,4,0,2
E33011194,395,299,97,202,1,49,26,23,39,39,0,0,0,7
E33011195,361,263,80,183,2,46,34,12,48,39,3,6,0,2
E33011196,394,250,66,184,1,63,41,22,79,74,0,4,1,1
E33011197,281,194,39,155,0,67,59,8,18,17,0,1,0,2
E33011198,1273,933,222,711,3,197,157,40,137,123,7,5,2,3
E33011199,382,236,58,178,0,116,91,25,30,23,0,4,3,0
E33011200,432,355,115,240,0,29,16,13,47,39,1,3,4,1
E33011201,332,241,70,171,0,44,17,27,44,43,0,1,0,3
E33011202,384,284,71,213,2,33,23,10,58,53,0,5,0,7
E33011203,637,458,110,348,0,102,71,31,76,66,0,8,2,1
E33011204,334,261,66,195,0,29,25,4,43,37,0,5,1,1
E33011205,425,325,75,250,0,52,42,10,45,41,0,4,0,3
E33011206,277,209,64,145,0,28,25,3,39,30,0,7,2,1
E33011207,353,256,85,171,1,59,55,4,34,33,0,1,0,3
E33011208,672,506,116,390,2,55,44,11,108,93,2,11,2,1
E33011209,531,370,150,220,3,72,55,17,82,61,1,17,3,4
E33011210,532,401,122,279,1,68,54,14,60,52,1,6,1,2
E33011211,328,217,58,159,1,61,44,17,44,38,1,4,1,5
E33011212,296,227,82,145,4,19,13,6,42,39,0,2,1,4
E33011213,308,166,46,120,1,110,98,12,26,25,0,1,0,5
E33011214,467,353,94,259,1,62,41,21,49,49,0,0,0,2
E33011215,472,322,58,264,3,108,96,12,38,34,0,4,0,1
E33011216,329,206,62,144,0,70,53,17,50,50,0,0,0,3
E33011217,347,211,58,153,2,76,49,27,54,47,0,7,0,4
E33011218,384,244,72,172,0,75,33,42,57,52,1,3,1,8
E33011219,402,278,126,152,1,41,26,15,70,67,0,1,2,12
E33011220,302,207,82,125,4,49,37,12,35,34,1,0,0,7
E33011221,368,230,102,128,2,85,64,21,49,45,0,2,2,2
E33011222,535,382,122,260,2,89,69,20,56,46,1,7,2,6
E33011223,325,254,73,181,1,28,18,10,40,31,2,4,3,2
E33011224,750,581,166,415,1,86,41,45,78,69,1,5,3,4
E33011225,286,214,50,164,1,34,25,9,33,29,0,4,0,4
E33011226,451,287,92,195,3,76,43,33,84,75,0,8,1,1
E33011227,516,360,86,274,1,77,47,30,75,71,0,3,1,3
E33011228,374,276,77,199,5,55,33,22,35,31,0,3,1,3
E33011229,316,182,92,90,2,45,28,17,80,75,0,2,3,7
E33011230,424,319,86,233,10,47,30,17,44,40,0,3,1,4
E33011231,309,179,63,116,4,92,63,29,31,30,0,1,0,3
E33011232,357,224,67,157,2,44,28,16,81,80,0,1,0,6
E33011233,290,171,54,117,0,82,49,33,34,27,0,6,1,3
E33011234,620,446,143,303,3,78,58,20,92,88,0,4,0,1
E33011235,313,267,109,158,0,20,18,2,21,18,0,2,1,5
E33011236,395,309,84,225,1,44,25,19,39,36,0,2,1,2
E33011237,889,732,212,520,3,91,74,17,60,53,4,1,2,3
E33011238,239,193,78,115,1,13,7,6,29,18,1,10,0,3
E33011239,446,295,91,204,0,28,21,7,118,102,1,11,4,5
E33011240,380,317,95,222,2,19,7,12,42,37,0,2,3,0
E33011241,323,252,79,173,0,14,9,5,52,50,1,1,0,5
E33011242,281,180,49,131,0,14,11,3,87,82,0,5,0,0
E33011243,289,205,57,148,1,42,32,10,41,39,0,2,0,0
E33011244,278,227,64,163,0,31,26,5,17,15,0,2,0,3
E33011245,425,330,100,230,0,64,60,4,29,24,1,2,2,2
E33011246,455,309,88,221,2,72,53,19,68,64,0,4,0,4
E33011247,284,150,41,109,2,57,37,20,73,67,1,4,1,2
E33011248,499,369,92,277,1,53,35,18,72,61,1,7,3,4
E33011249,262,122,38,84,1,92,80,12,42,40,0,2,0,5
E33011250,868,648,188,460,6,136,98,38,75,63,4,8,0,3
E33011251,899,500,155,345,4,172,118,54,222,213,2,7,0,1
E33011252,587,405,93,312,7,52,33,19,119,108,0,10,1,4
E33011253,341,258,79,179,1,36,21,15,44,43,0,1,0,2
E33011254,274,170,41,129,4,51,11,40,44,39,0,3,2,5
E33011255,826,639,199,440,7,105,82,23,71,65,0,6,0,4
E33011256,345,224,70,154,1,68,46,22,49,42,0,7,0,3
E33011257,335,166,39,127,2,34,22,12,123,107,2,14,0,10
E33011258,333,218,67,151,3,12,8,4,94,88,1,5,0,6
E33011259,323,161,54,107,8,24,18,6,125,111,0,13,1,5
E33011260,231,115,51,64,1,19,12,7,88,77,0,10,1,8
E33011261,289,188,56,132,0,23,15,8,76,71,0,4,1,2
E33011262,280,194,72,122,1,13,10,3,71,65,1,4,1,1
E33011263,288,179,56,123,1,37,26,11,66,59,0,6,1,5
E33011264,539,345,83,262,2,92,78,14,98,92,0,6,0,2
E33011265,479,290,102,188,2,28,17,11,156,148,1,6,1,3
E33011266,333,253,73,180,0,20,10,10,59,57,0,2,0,1
E33011267,334,160,51,109,1,20,10,10,153,145,0,7,1,0
E33011268,397,260,78,182,3,52,30,22,80,73,0,6,1,2
E33011269,485,404,166,238,0,43,31,12,37,33,0,4,0,1
E33011270,297,243,74,169,0,14,10,4,36,30,0,6,0,4
E33011271,643,510,138,372,4,75,55,20,54,50,0,3,1,0
E33011272,558,398,119,279,0,90,64,26,70,62,0,6,2,0
E33011273,356,276,85,191,1,38,25,13,41,40,0,1,0,0
E33011274,573,404,96,308,1,91,66,25,75,65,1,8,1,2
E33011275,364,301,103,198,1,27,16,11,29,26,1,2,0,6
E33011276,259,208,69,139,1,12,10,2,38,37,1,0,0,0
E33011277,475,383,124,259,0,17,12,5,67,60,0,5,2,8
E33011278,452,339,119,220,0,42,26,16,64,60,0,2,2,7
E33011279,330,249,92,157,1,18,13,5,56,49,2,3,2,6
E33011280,400,254,89,165,1,28,18,10,113,84,10,4,15,4
E33011281,440,295,77,218,1,34,16,18,109,105,1,2,1,1
E33011282,359,241,89,152,0,17,11,6,92,87,0,1,4,9
E33011283,529,297,113,184,1,38,26,12,191,185,2,1,3,2
E33011284,312,176,47,129,0,32,23,9,102,93,0,4,5,2
E33011285,322,243,49,194,1,45,28,17,29,24,0,5,0,4
E33011286,328,255,66,189,1,33,24,9,38,34,0,4,0,1
E33011287,756,497,135,362,3,165,82,83,85,70,0,13,2,6
E33011288,295,237,57,180,1,22,12,10,35,31,2,2,0,0
E33011289,448,353,129,224,0,24,16,8,62,57,1,4,0,9
E33011290,215,155,46,109,0,9,4,5,47,42,0,2,3,4
E33011291,288,221,66,155,3,15,11,4,47,46,0,1,0,2
E33011292,430,351,113,238,2,20,16,4,55,49,1,2,3,2
E33011293,326,189,65,124,1,31,18,13,103,81,5,3,14,2
E33011294,732,492,121,371,2,162,54,108,70,60,0,10,0,6
E33011295,652,430,123,307,3,153,77,76,63,54,0,8,1,3
E33011296,399,256,73,183,0,79,34,45,64,58,4,2,0,0
E33011297,513,377,90,287,2,40,31,9,91,87,1,3,0,3
E33011298,752,430,103,327,5,110,90,20,198,182,1,12,3,9
E33011299,327,158,37,121,2,75,61,14,89,80,3,4,2,3
E33011300,244,167,58,109,0,35,23,12,42,38,3,1,0,0
E33011301,331,207,66,141,1,41,25,16,80,75,0,5,0,2
E33011302,1782,1295,278,1017,3,125,79,46,353,315,1,32,5,6
E33011303,289,209,59,150,0,27,22,5,49,44,0,3,2,4
E33011304,259,189,76,113,0,19,16,3,47,42,2,2,1,4
E33011305,251,221,92,129,0,8,4,4,19,15,0,4,0,3
E33011306,443,398,128,270,0,12,10,2,30,23,0,7,0,3
E33011307,778,629,208,421,1,63,46,17,80,72,0,6,2,5
E33011308,558,379,101,278,1,77,59,18,93,91,0,2,0,8
E33011309,285,178,51,127,1,38,23,15,68,59,0,2,7,0
E33011310,235,146,26,120,0,20,14,6,67,56,6,3,2,2
E33011311,570,376,105,271,1,107,73,34,81,74,0,5,2,5
E33011312,443,269,76,193,2,45,30,15,116,107,0,8,1,11
E33011313,457,337,110,227,1,29,24,5,84,77,0,6,1,6
E33011314,570,409,91,318,4,40,21,19,114,100,0,10,4,3
E33011315,252,173,45,128,1,44,30,14,34,30,1,3,0,0
E33011316,590,341,78,263,1,123,96,27,125,115,2,4,4,0
E33011317,238,135,29,106,1,58,38,20,42,37,1,4,0,2
E33011318,484,402,94,308,1,36,28,8,40,37,0,3,0,5
E33011319,910,723,187,536,1,112,88,24,72,67,1,3,1,2
E33011320,522,401,97,304,1,63,47,16,56,51,1,3,1,1
E33011321,303,227,56,171,1,47,38,9,28,25,0,3,0,0
E33011322,400,258,58,200,0,101,50,51,38,33,0,4,1,3
E33011323,299,259,71,188,0,10,9,1,25,17,0,3,5,5
E33011324,327,269,80,189,0,11,9,2,46,41,0,5,0,1
E33011325,483,318,96,222,1,25,19,6,138,129,0,9,0,1
E33011326,306,181,48,133,0,20,14,6,105,94,1,9,1,0
E33011327,281,159,56,103,0,20,16,4,94,89,0,5,0,8
E33011328,364,303,86,217,1,22,15,7,37,34,0,3,0,1
E33011329,349,214,77,137,3,30,22,8,99,93,1,5,0,3
E33011330,319,277,93,184,0,12,10,2,28,25,0,3,0,2
E33011331,271,206,65,141,1,15,13,2,44,42,0,2,0,5
E33011332,270,194,55,139,3,14,8,6,56,53,0,3,0,3
E33011333,291,268,86,182,2,3,1,2,16,15,0,1,0,2
E33011334,227,186,62,124,0,8,4,4,32,26,1,5,0,1
E33011335,275,169,35,134,1,83,74,9,22,18,0,4,0,0
E33011336,422,223,57,166,2,147,119,28,45,41,0,3,1,5
E33011337,368,272,65,207,2,63,58,5,27,23,1,3,0,4
E33011338,430,277,73,204,2,98,92,6,53,46,2,3,2,0
E33011339,855,606,182,424,0,115,85,30,126,115,3,5,3,8
E33011340,384,289,89,200,0,20,12,8,71,64,0,7,0,4
E33011341,333,223,74,149,7,35,30,5,66,64,1,1,0,2
E33011342,290,234,58,176,1,20,15,5,33,31,0,2,0,2
E33011343,317,242,88,154,1,22,15,7,50,45,0,4,1,2
E33011344,387,271,71,200,1,38,29,9,73,66,0,7,0,4
E33011345,300,203,84,119,2,21,15,6,68,67,0,1,0,6
E33011346,357,206,65,141,0,53,36,17,96,94,0,2,0,2
E33011347,318,226,78,148,0,15,7,8,75,67,0,8,0,2
E33011348,358,250,66,184,0,56,44,12,45,35,2,8,0,7
E33011349,920,670,210,460,4,156,119,37,89,81,0,8,0,1
E33011350,370,216,75,141,3,78,49,29,70,65,0,1,4,3
E33011351,456,279,79,200,3,130,117,13,43,38,3,2,0,1
E33011352,382,311,88,223,2,31,25,6,34,30,1,3,0,4
E33011353,553,407,98,309,4,80,54,26,60,50,0,8,2,2
E33011354,240,177,48,129,0,27,21,6,33,29,1,3,0,3
E33011355,302,254,67,187,0,28,23,5,19,18,1,0,0,1
E33011356,300,209,62,147,0,41,27,14,48,46,0,2,0,2
E33011357,491,387,108,279,0,23,18,5,61,51,0,10,0,20
E33011358,322,239,62,177,0,23,19,4,59,53,0,6,0,1
E33011359,373,256,73,183,0,31,20,11,84,79,0,5,0,2
E33011360,307,232,74,158,3,18,11,7,47,40,1,5,1,7
E33011361,384,294,78,216,1,35,29,6,52,46,0,6,0,2
E33011362,435,325,75,250,2,64,54,10,41,34,0,6,1,3
E33011363,254,193,54,139,0,24,20,4,27,25,0,2,0,10
E33011364,232,188,72,116,1,4,3,1,37,33,0,3,1,2
E33011365,239,211,76,135,0,8,7,1,20,17,1,2,0,0
E33011366,368,314,120,194,1,15,6,9,35,28,4,3,0,3
E33011367,221,164,59,105,0,8,5,3,47,43,0,3,1,2
E33011368,275,241,87,154,0,8,4,4,25,22,1,1,1,1
E33011369,700,621,208,413,0,10,7,3,67,65,0,1,1,2
E33011370,247,210,62,148,0,14,11,3,21,19,0,2,0,2
E33011371,329,278,110,168,0,15,11,4,33,31,1,0,1,3
E33011372,622,473,90,383,1,86,74,12,57,44,0,10,3,5
E33011373,567,438,111,327,0,45,34,11,83,71,3,5,4,1
E33011374,454,358,101,257,0,35,26,9,56,52,1,3,0,5
E33011375,326,231,65,166,0,34,24,10,59,51,0,8,0,2
E33011376,520,330,88,242,0,135,118,17,51,43,2,3,3,4
E33011377,304,271,75,196,2,12,10,2,15,14,0,1,0,4
E33011378,521,438,101,337,0,54,41,13,27,24,0,3,0,2
E33011379,337,299,77,222,0,13,10,3,24,20,1,3,0,1
E33011380,537,406,81,325,2,65,53,12,61,53,1,6,1,3
E33011381,422,366,92,274,1,18,13,5,36,32,1,3,0,1
E33011382,455,369,93,276,2,37,25,12,44,38,1,5,0,3
E33011383,381,319,94,225,0,23,16,7,37,32,1,4,0,2
E33011384,244,197,79,118,3,24,14,10,19,17,1,1,0,1
E33011385,353,288,107,181,3,28,22,6,31,23,0,5,3,3
E33011386,566,434,135,299,5,62,48,14,64,52,3,7,2,1
E33011387,304,257,73,184,2,27,20,7,15,15,0,0,0,3
E33011388,346,265,68,197,0,40,32,8,37,32,0,5,0,4
E33011389,504,357,114,243,1,97,80,17,47,39,1,5,2,2
E33011390,501,368,82,286,2,78,65,13,49,42,1,5,1,4
E33011391,393,321,67,254,1,34,28,6,37,31,1,5,0,0
E33011392,305,273,69,204,2,8,8,0,21,18,0,2,1,1
E33011393,264,225,65,160,0,11,8,3,27,21,1,4,1,1
E33011394,313,260,76,184,1,17,16,1,34,31,0,2,1,1
E33011395,517,404,130,274,2,60,51,9,48,42,0,5,1,3
E33011396,388,316,128,188,1,26,16,10,42,39,1,2,0,3
E33011397,553,462,163,299,1,22,18,4,63,52,1,7,3,5
E33011398,366,308,111,197,0,16,16,0,39,33,1,5,0,3
E33011399,463,362,135,227,2,37,24,13,52,42,6,4,0,10
E33011400,310,244,74,170,1,26,23,3,33,32,1,0,0,6
E33011401,312,251,77,174,0,12,10,2,46,39,3,3,1,3
E33011402,257,215,91,124,0,8,8,0,34,32,1,1,0,0
E33011403,431,267,60,207,3,130,121,9,29,24,0,4,1,2
E33011404,496,393,127,266,1,37,34,3,59,46,7,4,2,6
E33011405,282,194,42,152,0,59,54,5,26,25,0,1,0,3
E33011406,235,147,45,102,2,60,54,6,25,25,0,0,0,1
E33011407,473,280,64,216,1,143,137,6,47,44,0,3,0,2
E33011408,251,203,62,141,1,12,9,3,34,32,2,0,0,1
E33011409,440,371,121,250,0,37,29,8,31,24,2,5,0,1
E33011410,451,375,103,272,0,45,34,11,25,21,0,3,1,6
E33011411,224,163,56,107,0,18,7,11,38,37,0,1,0,5
E33011412,443,348,122,226,2,23,14,9,67,63,3,1,0,3
E33011413,424,355,116,239,2,15,6,9,49,42,0,5,2,3
E33011414,352,291,119,172,3,11,4,7,39,35,2,2,0,8
E33011415,398,315,120,195,2,19,11,8,54,44,3,5,2,8
E33011416,262,199,60,139,3,14,9,5,43,43,0,0,0,3
E33011417,447,354,114,240,1,24,10,14,62,54,1,7,0,6
E33011418,307,240,79,161,1,23,8,15,42,36,0,3,3,1
E33011419,258,216,61,155,0,7,1,6,35,28,1,6,0,0
E33011420,428,333,122,211,1,22,10,12,69,67,0,2,0,3
E33011421,300,246,84,162,0,18,8,10,30,29,0,1,0,6
E33011422,211,186,78,108,0,1,1,0,14,13,0,1,0,10
E33011423,297,242,92,150,2,13,4,9,37,36,0,1,0,3
E33011424,545,408,131,277,4,24,11,13,106,97,0,8,1,3
E33011425,354,266,96,170,3,24,15,9,56,49,0,6,1,5
E33011426,262,225,81,144,2,12,7,5,20,16,0,4,0,3
E33011427,287,210,71,139,4,20,7,13,52,45,0,6,1,1
E33011428,299,219,65,154,0,19,13,6,59,52,1,6,0,2
E33011429,313,257,92,165,0,11,7,4,42,37,0,5,0,3
E33011430,334,271,72,199,0,7,3,4,55,51,0,2,2,1
E33011431,527,345,107,238,3,45,21,24,131,123,0,8,0,3
E33011432,549,439,146,293,6,19,11,8,75,64,0,7,4,10
E33011433,259,210,61,149,3,7,4,3,37,33,0,4,0,2
E33011434,680,533,185,348,6,18,12,6,116,111,0,4,1,7
E33011435,467,390,134,256,0,13,6,7,59,51,1,7,0,5
E33011436,249,200,57,143,1,14,6,8,33,26,1,3,3,1
E33011437,290,232,74,158,0,15,5,10,43,39,0,4,0,0
E33011438,2951,2435,676,1759,7,99,45,54,393,360,8,25,0,17
E33011439,406,352,130,222,2,17,8,9,31,28,0,3,0,4
E33011440,247,177,57,120,1,20,12,8,49,43,2,3,1,0
E33011441,415,340,123,217,4,17,8,9,46,38,0,4,4,8
E33011442,287,249,89,160,1,4,2,2,30,28,0,2,0,3
E33011443,218,168,48,120,0,16,8,8,30,28,0,2,0,4
E33011444,294,250,80,170,0,6,5,1,36,31,0,5,0,2
E33011445,376,322,72,250,6,11,5,6,35,31,0,4,0,2
E33011446,327,235,93,142,0,8,4,4,71,66,1,3,1,13
E33011447,282,239,83,156,0,11,8,3,29,26,0,2,1,3
E33011448,319,267,71,196,0,14,8,6,36,36,0,0,0,2
E33011449,761,590,189,401,3,54,22,32,105,98,0,7,0,9
E33011450,651,507,127,380,2,38,16,22,100,89,1,10,0,4
E33011451,281,217,66,151,1,14,4,10,45,41,1,2,1,4
E33011452,226,158,57,101,1,12,6,6,50,45,0,5,0,5
E33011453,261,214,77,137,0,11,5,6,35,29,1,2,3,1
E33011454,370,297,82,215,4,29,18,11,35,30,1,1,3,5
E33011455,267,227,74,153,1,11,1,10,28,23,1,4,0,0
E33011456,575,411,156,255,2,22,8,14,133,120,1,11,1,7
E33011457,690,538,170,368,2,30,9,21,113,104,1,5,3,7
E33011458,399,307,102,205,2,17,8,9,66,56,0,7,3,7
E33011459,398,326,115,211,4,18,6,12,49,43,1,5,0,1
E33011460,311,244,79,165,0,36,19,17,27,23,0,4,0,4
E33011461,269,211,75,136,5,16,11,5,37,30,0,5,2,0
E33011462,318,241,76,165,2,14,4,10,55,46,3,6,0,6
E33011463,320,214,56,158,0,35,14,21,68,61,0,7,0,3
E33011464,294,254,72,182,0,0,0,0,38,31,0,6,1,2
E33011465,354,281,104,177,2,25,9,16,44,42,0,2,0,2
E33011466,563,449,153,296,1,21,10,11,87,82,0,5,0,5
E33011467,296,229,77,152,1,18,8,10,37,33,2,2,0,11
E33011468,329,258,81,177,0,24,14,10,44,43,0,1,0,3
E33011469,634,478,170,308,3,43,26,17,107,99,2,5,1,3
E33011470,254,189,74,115,1,19,11,8,44,42,1,1,0,1
E33011471,497,392,119,273,2,34,14,20,65,60,0,5,0,4
E33011472,222,191,47,144,0,6,4,2,25,24,0,1,0,0
E33011473,1047,868,218,650,7,55,34,21,108,94,0,14,0,9
E33011474,421,325,110,215,1,16,10,6,76,69,0,6,1,3
E33011475,606,475,113,362,1,29,15,14,89,80,3,6,0,12
E33011476,312,266,82,184,0,8,4,4,36,27,7,2,0,2
E33011477,302,266,72,194,0,4,3,1,27,19,2,6,0,5
E33011478,488,414,139,275,2,25,13,12,44,40,0,4,0,3
E33011479,482,387,101,286,14,15,4,11,63,52,2,7,2,3
E33011480,535,441,131,310,6,19,8,11,64,55,0,8,1,5
E33011481,454,349,124,225,1,45,16,29,58,56,0,2,0,1
E33011482,415,332,107,225,2,13,5,8,68,58,0,6,4,0
E33011483,496,384,115,269,1,25,13,12,83,74,0,9,0,3
E33011484,294,239,84,155,0,18,9,9,37,36,0,1,0,0
E33011485,331,288,87,201,0,14,8,6,28,23,4,1,0,1
E33011486,244,207,54,153,2,9,3,6,25,21,2,2,0,1
E33011487,562,431,108,323,2,27,17,10,99,87,0,11,1,3
E33011488,324,251,57,194,2,32,21,11,39,33,0,5,1,0
E33011489,487,404,99,305,2,30,19,11,48,40,0,6,2,3
E33011490,513,341,83,258,6,61,23,38,99,89,0,10,0,6
E33011491,435,319,85,234,3,47,26,21,59,55,0,3,1,7
E33011492,539,423,88,335,1,44,25,19,66,61,0,5,0,5
E33011493,403,338,94,244,3,15,10,5,44,42,0,2,0,3
E33011494,388,280,80,200,1,28,11,17,74,68,0,6,0,5
E33011495,335,257,73,184,4,34,18,16,39,34,1,4,0,1
E33011496,495,376,111,265,0,18,8,10,97,90,0,7,0,4
E33011497,278,199,61,138,0,19,12,7,58,53,1,4,0,2
E33011498,368,253,83,170,1,27,15,12,83,80,0,2,1,4
E33011499,454,349,84,265,2,21,5,16,81,79,0,2,0,1
E33011500,343,246,65,181,3,32,18,14,59,52,0,6,1,3
E33011501,301,261,52,209,1,10,6,4,27,26,0,1,0,2
E33011502,692,520,120,400,2,54,30,24,111,101,1,8,1,5
E33011503,239,169,38,131,1,21,12,9,44,44,0,0,0,4
E33011504,654,526,134,392,5,40,24,16,79,70,2,2,5,4
E33011505,280,207,56,151,3,20,10,10,40,35,0,5,0,10
E33011506,320,264,68,196,4,17,11,6,34,27,1,5,1,1
E33011507,404,296,83,213,1,23,9,14,79,64,0,6,9,5
E33011508,364,261,77,184,2,17,9,8,81,76,2,1,2,3
E33011509,824,665,161,504,3,33,21,12,115,105,2,7,1,8
E33011510,334,265,74,191,1,26,12,14,38,35,1,2,0,4
E33011511,463,376,114,262,2,19,8,11,64,59,2,3,0,2
E33011512,1304,1010,282,728,6,48,19,29,232,219,0,12,1,8
E33011513,865,636,197,439,2,92,45,47,129,116,0,11,2,6
E33011514,274,210,61,149,4,11,4,7,45,37,0,6,2,4
E33011515,607,484,108,376,1,45,17,28,75,72,0,3,0,2
E33011516,334,288,90,198,2,12,6,6,29,26,0,2,1,3
E33011517,387,302,81,221,1,28,16,12,55,55,0,0,0,1
E33011518,294,223,62,161,4,25,12,13,41,39,0,2,0,1
E33011519,273,204,52,152,0,23,15,8,45,33,2,10,0,1
E33011520,247,179,43,136,1,33,18,15,32,27,0,3,2,2
E33011521,274,223,66,157,2,25,13,12,22,19,0,3,0,2
E33011522,458,375,105,270,2,11,4,7,68,62,2,4,0,2
E33011523,518,448,148,300,0,11,4,7,57,44,1,7,5,2
E33011524,441,358,100,258,2,18,12,6,56,50,2,3,1,7
E33011525,578,444,122,322,2,31,18,13,97,90,0,7,0,4
E33011526,330,253,52,201,1,28,12,16,44,38,0,6,0,4
E33011527,356,286,91,195,0,28,6,22,39,36,0,2,1,3
E33011528,351,282,111,171,2,4,3,1,59,55,0,4,0,4
E33011529,457,373,116,257,4,13,5,8,60,55,0,2,3,7
E33011530,282,232,77,155,0,9,6,3,36,32,0,3,1,5
E33011531,359,293,99,194,1,8,4,4,56,49,1,6,0,1
E33011532,274,215,76,139,1,5,3,2,49,44,1,3,1,4
E33011533,265,215,59,156,0,3,0,3,42,39,0,3,0,5
E33011534,442,343,102,241,2,10,3,7,81,77,0,4,0,6
E33011535,241,196,58,138,0,6,0,6,36,32,1,2,1,3
E33011536,352,299,78,221,3,5,2,3,41,36,0,5,0,4
E33011537,307,222,41,181,1,30,18,12,50,45,0,5,0,4
E33011538,394,259,68,191,2,51,22,29,75,73,0,2,0,7
E33011539,439,363,83,280,1,15,9,6,57,53,0,3,1,3
E33011540,301,234,63,171,1,13,7,6,49,47,0,1,1,4
E33011541,270,212,63,149,1,11,8,3,43,36,0,5,2,3
E33011542,339,257,89,168,3,15,7,8,63,62,0,1,0,1
E33011543,501,375,134,241,1,28,10,18,85,80,0,3,2,12
E33011544,329,229,63,166,1,39,18,21,59,51,0,7,1,1
E33011545,280,228,69,159,1,18,6,12,30,29,0,1,0,3
E33011546,700,521,126,395,3,60,40,20,113,103,0,10,0,3
E33011547,659,487,122,365,4,56,32,24,106,94,0,8,4,6
E33011548,314,227,66,161,5,46,29,17,35,28,1,5,1,1
E33011549,547,385,107,278,1,76,41,35,84,76,0,6,2,1
E33011550,250,170,34,136,0,46,28,18,34,34,0,0,0,0
E33011551,652,540,142,398,4,22,10,12,81,69,1,8,3,5
E33011552,342,248,82,166,2,20,12,8,70,70,0,0,0,2
E33011553,316,254,77,177,1,19,13,6,41,34,2,5,0,1
E33011554,295,239,71,168,1,17,9,8,36,33,0,3,0,2
E33011555,284,199,68,131,2,22,11,11,58,47,1,10,0,3
E33011556,250,198,67,131,2,7,2,5,41,38,0,3,0,2
E33011557,374,288,90,198,0,15,10,5,66,54,1,10,1,5
E33011558,817,590,132,458,3,65,38,27,143,128,1,13,1,16
E33011559,1618,1256,284,972,7,84,44,40,261,245,1,14,1,10
E33011560,462,369,102,267,1,21,12,9,67,63,0,4,0,4
E33011561,493,380,97,283,3,48,22,26,56,49,0,6,1,6
E33011562,242,197,81,116,2,10,5,5,30,26,0,4,0,3
E33011563,482,302,92,210,1,29,17,12,145,121,22,2,0,5
E33011564,323,254,88,166,0,9,6,3,55,46,0,7,2,5
E33011565,302,254,88,166,2,16,3,13,24,21,0,3,0,6
E33011566,310,257,64,193,5,9,3,6,37,32,2,3,0,2
E33011567,261,209,61,148,1,14,6,8,37,29,0,7,1,0
E33011568,367,294,88,206,1,17,11,6,53,48,1,3,1,2
E33011569,280,222,70,152,2,12,3,9,40,35,0,3,2,4
E33011570,421,354,100,254,7,14,6,8,40,37,0,3,0,6
E33011571,308,273,101,172,0,5,1,4,28,20,1,4,3,2
E33011572,355,281,114,167,1,9,4,5,58,56,0,2,0,6
E33011573,577,445,144,301,2,36,12,24,85,79,0,6,0,9
E33011574,392,291,117,174,2,36,12,24,59,57,0,2,0,4
E33011575,294,207,89,118,0,24,7,17,55,49,1,5,0,8
E33011576,373,297,124,173,0,23,6,17,46,38,2,5,1,7
E33011577,287,228,106,122,0,15,6,9,38,35,0,2,1,6
E33011578,220,187,61,126,1,6,0,6,20,14,1,4,1,6
E33011579,246,134,46,88,2,44,10,34,62,58,4,0,0,4
E33011580,525,389,142,247,3,42,13,29,78,77,0,1,0,13
E33011581,327,228,79,149,1,32,18,14,65,62,0,3,0,1
E33011582,321,227,68,159,1,19,9,10,66,54,0,11,1,8
E33011583,501,396,141,255,3,38,11,27,58,55,0,2,1,6
E33011584,338,250,92,158,0,24,12,12,60,55,0,5,0,4
E33011585,738,560,162,398,2,41,15,26,130,116,1,12,1,5
E33011586,315,272,89,183,1,6,1,5,35,26,2,6,1,1
E33011587,359,251,58,193,3,38,22,16,64,57,2,3,2,3
E33011588,372,258,87,171,1,38,22,16,74,65,1,8,0,1
E33011589,330,254,71,183,0,39,15,24,36,33,0,1,2,1
E33011590,341,270,88,182,2,19,7,12,45,40,0,4,1,5
E33011591,328,278,87,191,3,12,3,9,34,30,1,2,1,1
E33011592,286,226,76,150,1,9,5,4,48,40,0,8,0,2
E33011593,299,214,75,139,1,37,19,18,42,42,0,0,0,5
E33011594,421,322,126,196,2,29,14,15,63,60,0,2,1,5
E33011595,648,454,158,296,3,63,29,34,121,112,1,8,0,7
E33011596,394,322,106,216,1,23,14,9,47,41,0,5,1,1
E33011597,395,288,102,186,4,32,15,17,66,59,0,7,0,5
E33011598,626,487,151,336,2,34,19,15,102,91,0,10,1,1
E33011599,340,254,76,178,0,34,16,18,45,36,0,6,3,7
E33011600,501,363,130,233,4,49,18,31,78,75,1,2,0,7
E33011601,723,522,154,368,2,91,37,54,102,91,0,9,2,6
E33011602,584,427,121,306,1,43,9,34,107,96,0,11,0,6
E33011603,345,235,87,148,4,48,18,30,50,45,0,5,0,8
E33011604,585,340,116,224,5,88,38,50,149,142,0,4,3,3
E33011605,261,204,83,121,0,37,20,17,18,15,0,3,0,2
E33011606,313,210,66,144,4,24,7,17,71,59,0,11,1,4
E33011607,610,422,135,287,3,55,30,25,127,118,0,6,3,3
E33011608,634,441,161,280,4,64,33,31,119,105,1,10,3,6
E33011609,334,249,101,148,2,22,2,20,57,47,0,10,0,4
E33011610,242,184,59,125,0,14,4,10,43,39,0,4,0,1
E33011611,234,178,44,134,1,22,13,9,29,29,0,0,0,4
E33011612,252,189,53,136,2,20,14,6,39,35,0,3,1,2
E33011613,256,211,54,157,0,14,5,9,28,24,0,1,3,3
E33011614,320,226,52,174,3,35,15,20,54,52,1,1,0,2
E33011615,264,172,70,102,2,14,4,10,71,69,0,2,0,5
E33011616,637,435,168,267,3,62,23,39,129,118,0,9,2,8
E33011617,496,384,120,264,3,20,11,9,87,81,0,3,3,2
E33011618,326,234,76,158,6,32,17,15,53,49,0,2,2,1
E33011619,216,148,50,98,1,25,8,17,38,35,0,3,0,4
E33011620,427,292,87,205,1,37,8,29,87,77,0,9,1,10
E33011621,485,361,141,220,1,31,13,18,83,77,0,4,2,9
E33011622,381,322,120,202,0,14,3,11,42,42,0,0,0,3
E33011623,384,281,139,142,2,20,5,15,74,66,3,4,1,7
E33011624,382,337,109,228,0,7,6,1,35,30,0,3,2,3
E33011625,662,516,139,377,2,53,23,30,86,70,0,12,4,5
E33011626,405,321,79,242,2,30,12,18,48,41,1,4,2,4
E33011627,654,510,148,362,0,40,16,24,93,85,1,6,1,11
E33011628,324,235,90,145,4,17,7,10,58,54,0,2,2,10
E33011629,349,287,118,169,3,7,2,5,46,39,1,3,3,6
E33011630,348,232,117,115,0,20,8,12,86,81,0,2,3,10
E33011631,557,414,106,308,2,31,13,18,105,97,0,5,3,5
E33011632,223,159,76,83,0,10,5,5,47,44,1,2,0,7
E33011633,243,162,73,89,1,13,6,7,60,57,0,2,1,7
E33011634,503,398,116,282,2,24,9,15,76,70,0,6,0,3
E33011635,352,277,61,216,1,27,11,16,44,37,1,6,0,3
E33011636,593,475,169,306,2,39,11,28,69,61,2,6,0,8
E33011637,404,316,95,221,3,25,19,6,57,51,0,6,0,3
E33011638,581,470,143,327,6,36,17,19,64,58,0,6,0,5
E33011639,376,275,81,194,2,37,24,13,60,51,1,6,2,2
E33011640,400,277,87,190,4,59,18,41,53,50,0,3,0,7
E33011641,639,487,139,348,3,57,33,24,90,82,1,5,2,2
E33011642,392,221,56,165,3,90,16,74,77,67,3,2,5,1
E33011643,576,405,112,293,3,57,23,34,106,93,0,9,4,5
E33011644,285,203,45,158,0,19,8,11,60,54,2,4,0,3
E33011645,228,152,53,99,1,27,17,10,43,36,0,6,1,5
E33011646,222,158,31,127,1,19,6,13,42,37,0,3,2,2
E33011647,404,344,105,239,0,12,5,7,47,39,0,6,2,1
E33011648,317,274,103,171,1,14,5,9,26,19,1,5,1,2
E33011649,451,352,111,241,3,31,11,20,61,49,0,9,3,4
E33011650,531,353,125,228,5,45,15,30,117,109,5,1,2,11
E33011651,791,630,152,478,5,59,14,45,90,77,0,8,5,7
E33011652,1242,941,276,665,2,125,72,53,165,149,2,14,0,9
E33011653,618,451,135,316,4,42,13,29,118,108,3,5,2,3
E33011654,260,187,91,96,0,13,4,9,53,46,1,6,0,7
E33011655,247,193,60,133,0,20,11,9,32,31,0,1,0,2
E33011656,320,203,64,139,4,33,12,21,77,72,1,4,0,3
E33011657,317,240,70,170,3,25,12,13,44,41,0,3,0,5
E33011658,283,230,83,147,1,10,5,5,39,33,0,4,2,3
E33011659,406,305,68,237,2,26,9,17,65,60,0,5,0,8
E33011660,340,244,79,165,1,25,20,5,65,58,0,6,1,5
E33011661,404,292,98,194,1,37,17,20,68,65,0,3,0,6
E33011662,515,386,120,266,2,40,25,15,83,77,2,4,0,4
E33011663,624,442,145,297,3,54,21,33,119,111,2,4,2,6
E33011664,581,427,117,310,5,51,19,32,93,84,0,8,1,5
E33011665,278,206,71,135,1,22,5,17,47,40,0,4,3,2
E33011666,256,197,76,121,1,22,9,13,35,30,1,4,0,1
E33011667,452,340,94,246,2,52,35,17,55,53,0,2,0,3
E33011668,284,223,88,135,4,11,1,10,38,35,0,3,0,8
E33011669,317,208,46,162,1,48,28,20,55,48,1,6,0,5
E33011670,252,156,27,129,2,48,21,27,42,41,0,1,0,4
E33011671,507,293,62,231,2,128,68,60,80,77,0,3,0,4
E33011672,363,233,78,155,5,62,34,28,59,53,0,5,1,4
E33011673,276,193,72,121,1,23,8,15,53,52,0,0,1,6
E33011674,275,172,56,116,2,38,19,19,60,55,0,4,1,3
E33011675,2051,1613,345,1268,10,119,44,75,299,269,2,24,4,10
E33011676,405,301,90,211,3,25,16,9,70,62,0,7,1,6
E33011677,292,214,54,160,1,16,4,12,56,54,0,2,0,5
E33011678,409,322,83,239,0,27,14,13,58,55,0,3,0,2
E33011679,302,206,63,143,4,25,12,13,62,57,0,5,0,5
E33011680,286,235,68,167,1,13,8,5,35,30,2,2,1,2
E33011681,391,315,84,231,1,18,9,9,55,49,1,4,1,2
E33011682,292,220,56,164,2,19,9,10,48,44,0,3,1,3
E33011683,388,286,45,241,1,26,14,12,74,69,0,4,1,1
E33011684,580,467,126,341,1,36,21,15,72,66,2,4,0,4
E33011685,418,317,67,250,1,43,23,20,54,44,1,7,2,3
E33011686,288,206,63,143,1,26,8,18,52,50,0,0,2,3
E33011687,873,605,152,453,5,82,49,33,173,170,1,1,1,8
E33011688,328,186,40,146,3,50,30,20,87,80,0,6,1,2
E33011689,384,254,56,198,7,42,22,20,75,69,1,4,1,6
E33011690,278,199,68,131,1,38,20,18,39,36,0,3,0,1
E33011691,385,280,68,212,0,38,25,13,64,60,0,2,2,3
E33011692,306,210,57,153,0,40,16,24,51,50,0,1,0,5
E33011693,517,405,85,320,0,35,15,20,71,67,0,4,0,6
E33011694,555,468,110,358,2,24,12,12,53,45,1,6,1,8
E33011695,260,206,59,147,0,8,3,5,40,37,0,1,2,6
E33011696,349,303,81,222,0,14,4,10,31,23,2,3,3,1
E33011697,314,238,70,168,0,13,5,8,60,54,1,5,0,3
E33011698,512,427,129,298,4,10,8,2,67,62,1,4,0,4
E33011699,387,254,52,202,1,68,38,30,58,52,1,5,0,6
E33011700,336,266,71,195,0,29,17,12,38,34,0,4,0,3
E33011701,393,322,116,206,0,41,27,14,29,29,0,0,0,1
E33011702,288,218,39,179,0,36,18,18,30,22,0,8,0,4
E33011703,228,188,47,141,0,14,4,10,26,25,0,1,0,0
E33011704,238,198,49,149,0,17,10,7,21,19,0,2,0,2
E33011705,237,193,61,132,0,11,7,4,31,18,1,6,6,2
E33011706,359,290,84,206,1,23,6,17,40,40,0,0,0,5
E33011707,322,270,73,197,1,13,7,6,38,33,1,4,0,0
E33011708,483,344,79,265,0,43,21,22,93,85,0,7,1,3
E33011709,625,500,125,375,4,41,23,18,75,61,1,10,3,5
E33011710,548,412,101,311,2,47,21,26,81,73,0,7,1,6
E33011711,494,407,83,324,1,15,6,9,68,63,1,4,0,3
E33011712,243,168,39,129,0,15,8,7,53,47,4,2,0,7
E33011713,407,318,79,239,2,28,17,11,50,45,0,2,3,9
E33011714,949,823,186,637,2,44,25,19,72,64,0,8,0,8
E33011715,862,653,177,476,5,59,40,19,139,124,3,11,1,6
E33011716,257,192,49,143,2,18,13,5,44,39,0,5,0,1
E33011717,384,263,68,195,2,35,14,21,78,75,0,1,2,6
E33011718,267,216,71,145,2,21,9,12,27,24,0,2,1,1
E33011719,558,461,151,310,0,24,17,7,67,58,6,3,0,6
E33011720,402,299,83,216,0,39,23,16,59,56,1,2,0,5
E33011721,544,411,101,310,2,38,25,13,92,78,1,11,2,1
E33011722,301,258,91,167,0,9,7,2,32,19,3,10,0,2
E33011723,511,362,107,255,0,58,24,34,83,63,11,7,2,8
E33011724,521,425,107,318,3,46,22,24,46,42,0,1,3,1
E33011725,509,358,96,262,0,90,43,47,58,56,0,2,0,3
E33011726,354,229,67,162,0,37,16,21,82,75,2,4,1,6
E33011727,291,240,77,163,3,3,2,1,40,36,0,4,0,5
E33011728,287,235,61,174,1,4,1,3,43,39,1,3,0,4
E33011729,264,229,55,174,0,7,2,5,27,26,1,0,0,1
E33011730,372,315,110,205,0,9,5,4,46,41,0,4,1,2
E33011731,411,351,92,259,1,13,7,6,45,43,0,2,0,1
E33011732,376,296,82,214,0,25,12,13,53,45,3,1,4,2
E33011733,336,261,115,146,9,23,5,18,41,37,0,2,2,2
E33011734,294,238,96,142,3,10,2,8,42,38,0,4,0,1
E33011735,632,508,177,331,4,33,14,19,86,77,0,7,2,1
E33011736,325,265,121,144,1,11,6,5,41,37,3,1,0,7
E33011737,344,285,120,165,0,7,3,4,45,39,0,5,1,7
E33011738,356,260,117,143,1,29,7,22,64,59,0,4,1,2
E33011739,452,356,96,260,5,34,17,17,54,49,1,4,0,3
E33011740,308,213,52,161,0,37,19,18,58,51,0,7,0,0
E33011741,469,359,85,274,2,47,24,23,56,52,0,4,0,5
E33011742,412,311,67,244,3,49,25,24,47,43,0,4,0,2
E33011743,346,253,71,182,2,32,12,20,55,44,2,8,1,4
E33011744,433,300,67,233,3,66,27,39,62,57,0,5,0,2
E33011745,288,222,51,171,3,29,16,13,30,26,0,4,0,4
E33011746,311,242,96,146,4,6,4,2,56,51,0,4,1,3
E33011747,316,250,87,163,0,15,8,7,48,44,0,4,0,3
E33011748,306,218,77,141,0,28,11,17,56,49,0,6,1,4
E33011749,241,190,66,124,0,7,3,4,40,39,0,1,0,4
E33011750,556,401,107,294,1,29,15,14,123,118,0,5,0,2
E33011751,344,275,97,178,0,27,11,16,38,32,2,3,1,4
E33011752,6087,4919,970,3949,31,236,104,132,873,792,3,71,7,28
E33011753,673,469,137,332,2,38,13,25,159,145,1,9,4,5
E33011754,240,179,53,126,2,19,4,15,38,36,0,2,0,2
E33011755,501,384,106,278,2,37,16,21,75,69,0,6,0,3
E33011756,252,193,48,145,1,19,5,14,37,33,0,4,0,2
E33011757,307,234,63,171,3,38,12,26,32,32,0,0,0,0
E33011758,610,486,101,385,3,31,9,22,87,71,0,14,2,3
E33011759,359,285,88,197,0,33,12,21,37,32,0,5,0,4
E33011760,260,223,89,134,0,10,4,6,22,15,0,5,2,5
E33011761,326,255,65,190,0,22,8,14,45,41,0,4,0,4
E33011762,441,341,106,235,0,40,13,27,58,49,1,8,0,2
E33011763,214,166,41,125,0,15,9,6,32,30,0,2,0,1
E33011764,368,270,75,195,3,24,7,17,67,59,1,6,1,4
E33011765,1009,753,228,525,3,110,37,73,130,116,1,12,1,13
E33011766,291,233,75,158,0,14,6,8,39,33,1,5,0,5
E33011767,373,298,103,195,2,10,3,7,62,56,0,6,0,1
E33011768,369,306,97,209,1,24,10,14,37,33,1,3,0,1
E33011769,805,625,179,446,4,61,36,25,111,99,0,10,2,4
E33011770,954,741,270,471,4,75,27,48,121,105,0,15,1,13
E33011771,444,328,119,209,0,29,9,20,82,72,2,6,2,5
E33011772,366,267,92,175,4,42,14,28,50,44,0,6,0,3
E33011773,282,212,68,144,3,34,17,17,30,25,1,4,0,3
E33011774,692,549,178,371,2,34,12,22,106,99,0,7,0,1
E33011775,302,236,86,150,0,19,6,13,45,39,1,5,0,2
E33011776,285,183,42,141,0,41,16,25,58,52,0,4,2,3
E33011777,529,421,137,284,5,41,14,27,60,58,1,1,0,2
E33011778,406,326,91,235,2,38,12,26,37,33,2,1,1,3
E33011779,334,261,110,151,1,18,7,11,53,44,0,9,0,1
E33011780,442,341,121,220,2,27,12,15,66,59,3,3,1,6
E33011781,258,190,60,130,1,11,3,8,54,48,4,1,1,2
E33011782,339,261,96,165,5,22,8,14,50,45,0,5,0,1
E33011783,637,474,162,312,7,34,18,16,116,93,0,14,9,6
E33011784,332,232,53,179,7,39,17,22,50,43,0,5,2,4
E33011785,578,393,117,276,4,54,24,30,124,108,7,5,4,3
E33011786,280,225,75,150,2,13,3,10,37,36,0,1,0,3
E33011787,414,305,115,190,3,30,10,20,73,65,3,4,1,3
E33011788,812,594,156,438,1,77,24,53,132,118,1,9,4,8
E33011789,397,322,115,207,0,18,4,14,53,52,0,1,0,4
E33011790,398,302,87,215,2,24,17,7,66,62,1,2,1,4
E33011791,240,199,66,133,0,10,5,5,27,24,0,3,0,4
E33011792,347,276,85,191,0,32,25,7,37,32,0,3,2,2
E33011793,388,301,64,237,2,26,15,11,56,50,2,3,1,3
E33011794,778,638,177,461,1,36,18,18,99,88,1,9,1,4
E33011795,269,192,68,124,1,16,3,13,52,47,1,4,0,8
E33011796,306,251,81,170,0,14,8,6,39,34,2,2,1,2
E33011797,289,212,69,143,1,17,3,14,53,47,0,5,1,6
E33011798,243,191,47,144,1,11,8,3,40,35,0,5,0,0
E33011799,278,231,59,172,1,7,2,5,37,31,0,3,3,2
E33011800,312,222,56,166,1,27,10,17,60,51,0,7,2,2
E33011801,1791,1443,287,1156,6,54,22,32,278,244,2,29,3,10
E33011802,420,307,95,212,4,36,12,24,71,65,0,5,1,2
E33011803,286,214,55,159,2,23,10,13,43,40,0,3,0,4
E33011804,580,419,102,317,5,41,15,26,108,102,0,4,2,7
E33011805,400,291,65,226,4,28,8,20,71,67,2,2,0,6
E33011806,293,249,82,167,0,14,8,6,26,22,0,4,0,4
E33011807,512,373,103,270,6,20,9,11,105,96,3,6,0,8
E33011808,362,296,80,216,1,15,5,10,49,46,0,3,0,1
E33011809,399,298,62,236,3,23,9,14,71,59,1,11,0,4
E33011810,384,299,94,205,0,30,21,9,51,48,0,2,1,4
E33011811,401,303,91,212,2,30,18,12,65,61,0,4,0,1
E33011812,431,322,95,227,0,40,24,16,63,61,0,2,0,6
E33011813,524,447,101,346,1,18,12,6,55,49,0,6,0,3
E33011814,247,160,34,126,1,21,5,16,64,63,1,0,0,1
E33011815,512,395,89,306,0,51,27,24,65,57,0,7,1,1
E33011816,401,327,83,244,2,26,11,15,44,40,1,2,1,2
E33011817,601,446,140,306,2,40,24,16,112,103,1,7,1,1
E33011818,241,202,54,148,0,6,4,2,31,27,1,3,0,2
E33011819,537,412,120,292,2,27,16,11,93,73,2,16,2,3
E33011820,358,276,84,192,1,38,14,24,37,33,0,4,0,6
E33011821,252,195,49,146,0,25,8,17,31,30,0,1,0,1
E33011822,267,214,71,143,0,14,6,8,32,31,0,1,0,7
E33011823,526,434,145,289,1,23,11,12,60,52,0,6,2,8
E33011824,504,401,104,297,2,29,6,23,66,58,1,4,3,6
E33011825,529,381,132,249,5,37,13,24,100,89,1,8,2,6
E33011826,398,319,105,214,0,26,4,22,52,48,0,4,0,1
E33011827,2649,2057,543,1514,7,175,71,104,403,363,8,30,2,7
E33011828,294,233,73,160,1,13,6,7,43,37,1,4,1,4
E33011829,266,206,61,145,3,12,2,10,43,40,0,3,0,2
E33011830,285,217,83,134,1,18,10,8,46,42,2,2,0,3
E33011831,559,416,123,293,6,33,17,16,102,100,0,2,0,2
E33011832,246,201,61,140,0,8,3,5,37,31,3,3,0,0
E33011833,326,249,102,147,0,23,12,11,52,39,6,5,2,2
E33011834,328,242,81,161,4,25,11,14,56,50,2,2,2,1
E33011835,271,235,79,156,0,13,9,4,22,17,0,5,0,1
E33011836,306,205,64,141,1,34,20,14,63,60,0,3,0,3
E33011837,321,249,73,176,1,28,19,9,41,38,1,2,0,2
E33011838,274,235,65,170,0,16,9,7,23,20,1,2,0,0
E33011839,250,179,37,142,0,17,10,7,52,46,2,4,0,2
E33011840,581,460,110,350,1,51,33,18,62,59,0,2,1,7
E33011841,258,205,67,138,0,16,6,10,33,24,2,3,4,4
E33011842,290,230,63,167,0,23,14,9,32,27,0,5,0,5
E33011843,245,201,68,133,1,6,2,4,36,30,0,6,0,1
E33011844,454,315,100,215,2,50,20,30,84,77,0,5,2,3
E33011845,595,480,150,330,1,29,16,13,80,74,2,4,0,5
E33011846,929,734,205,529,2,65,37,28,126,105,1,20,0,2
E33011847,218,173,52,121,0,14,6,8,30,27,2,1,0,1
E33011848,285,212,51,161,2,27,12,15,41,36,0,5,0,3
E33011849,421,322,92,230,0,27,12,15,67,60,1,3,3,5
E33011850,420,323,81,242,3,35,27,8,57,49,1,6,1,2
E33011851,535,389,109,280,1,42,28,14,100,98,0,2,0,3
E33011852,449,349,95,254,3,32,11,21,61,56,0,5,0,4
E33011853,360,226,77,149,1,63,37,26,69,64,0,4,1,1
E33011854,265,215,67,148,2,11,2,9,35,28,0,7,0,2
E33011855,361,279,68,211,1,21,9,12,57,52,0,5,0,3
E33011856,230,202,59,143,0,5,2,3,23,18,0,3,2,0
E33011857,710,514,143,371,2,58,32,26,130,121,2,6,1,6
E33011858,292,239,86,153,1,7,4,3,45,34,2,8,1,0
E33011859,374,312,96,216,0,16,7,9,40,34,0,4,2,6
E33011860,305,248,62,186,4,7,0,7,44,43,0,1,0,2
E33011861,312,240,83,157,3,19,4,15,46,45,0,1,0,4
E33011862,245,200,66,134,1,6,3,3,34,28,0,3,3,4
E33011863,842,700,222,478,3,28,14,14,108,95,1,12,0,3
E33011864,280,224,84,140,1,17,9,8,33,31,0,1,1,5
E33011865,340,248,85,163,1,23,17,6,61,54,0,6,1,7
E33011866,334,276,57,219,1,11,9,2,39,35,0,4,0,7
E33011867,1030,894,191,703,1,33,19,14,96,80,0,15,1,6
E33011868,333,287,91,196,0,6,6,0,37,32,0,5,0,3
E33011869,543,431,125,306,3,53,38,15,54,47,1,6,0,2
E33011870,318,222,52,170,3,58,53,5,28,24,1,3,0,7
E33011871,379,294,99,195,1,39,32,7,39,35,0,2,2,6
E33011872,592,446,146,300,1,55,43,12,82,74,2,4,2,8
E33011873,490,382,103,279,2,51,39,12,54,47,0,7,0,1
E33011874,543,449,119,330,1,20,11,9,70,63,1,4,2,3
E33011875,412,318,88,230,2,29,25,4,58,53,0,3,2,5
E33011876,741,585,140,445,3,41,28,13,106,89,0,16,1,6
E33011877,366,313,85,228,0,9,7,2,42,34,0,4,4,2
E33011878,412,347,99,248,1,17,14,3,39,36,0,3,0,8
E33011879,307,217,45,172,2,38,29,9,47,45,0,2,0,3
E33011880,304,240,60,180,0,23,14,9,39,34,0,4,1,2
E33011881,306,232,71,161,1,39,32,7,33,28,0,5,0,1
E33011882,674,531,141,390,3,53,41,12,84,76,1,6,1,3
E33011883,318,209,77,132,4,38,29,9,66,61,0,5,0,1
E33011884,265,201,54,147,1,10,5,5,50,47,0,3,0,3
E33011885,438,308,108,200,0,33,28,5,95,86,0,7,2,2
E33011886,418,355,89,266,1,13,12,1,47,41,0,6,0,2
E33011887,278,196,52,144,4,27,23,4,50,44,0,4,2,1
E33011888,448,363,126,237,3,18,15,3,60,54,0,6,0,4
E33011889,248,178,54,124,1,24,16,8,45,38,0,7,0,0
E33011890,274,223,72,151,0,12,9,3,36,31,0,3,2,3
E33011891,277,207,67,140,1,28,24,4,39,39,0,0,0,2
E33011892,255,171,43,128,0,32,29,3,49,43,1,4,1,3
E33011893,239,195,59,136,1,21,11,10,20,19,0,1,0,2
E33011894,547,429,141,288,1,53,37,16,58,56,0,2,0,6
E33011895,270,205,57,148,0,31,16,15,31,27,1,2,1,3
E33011896,440,352,114,238,1,30,15,15,50,46,0,4,0,7
E33011897,189,147,45,102,0,25,16,9,15,13,0,2,0,2
E33011898,286,245,69,176,1,9,6,3,31,25,0,6,0,0
E33011899,500,402,104,298,1,53,47,6,42,41,0,1,0,2
E33011900,211,163,67,96,0,10,9,1,34,28,0,2,4,4
E33011901,632,374,96,278,3,98,70,28,154,148,0,6,0,3
E33011902,285,224,51,173,0,35,26,9,25,24,0,1,0,1
E33011903,271,225,70,155,0,13,7,6,30,27,0,3,0,3
E33011904,221,175,36,139,0,18,10,8,25,22,0,2,1,3
E33011905,535,405,101,304,2,45,37,8,80,77,0,3,0,3
E33011906,225,169,65,104,1,37,25,12,17,16,0,1,0,1
E33011907,615,449,109,340,6,75,53,22,73,62,0,7,4,12
E33011908,403,319,118,201,1,43,31,12,39,31,2,5,1,1
E33011909,281,221,55,166,0,24,20,4,35,31,0,4,0,1
E33011910,301,252,68,184,2,14,11,3,31,27,0,3,1,2
E33011911,325,228,72,156,1,28,20,8,65,58,0,6,1,3
E33011912,608,446,126,320,2,66,46,20,78,73,1,3,1,16
E33011913,447,386,124,262,1,20,16,4,34,28,1,5,0,6
E33011914,286,225,71,154,0,30,26,4,31,24,0,6,1,0
E33011915,384,310,86,224,3,23,18,5,45,38,1,4,2,3
E33011916,535,403,126,277,4,52,43,9,71,64,0,7,0,5
E33011917,871,653,182,471,4,65,50,15,138,129,0,9,0,11
E33011918,793,574,242,332,2,79,63,16,135,122,0,12,1,3
E33011919,265,177,77,100,1,43,32,11,43,41,0,2,0,1
E33011920,405,329,167,162,2,39,23,16,27,25,0,2,0,8
E33011921,273,214,60,154,3,15,15,0,39,37,0,2,0,2
E33011922,336,269,91,178,0,28,24,4,34,28,0,6,0,5
E33011923,317,273,111,162,0,16,15,1,24,21,0,3,0,4
E33011924,565,415,131,284,0,61,46,15,83,75,1,6,1,6
E33011925,407,355,102,253,0,16,10,6,34,26,0,8,0,2
E33011926,678,479,137,342,10,72,56,16,110,105,0,4,1,7
E33011927,338,279,92,187,0,16,12,4,38,35,0,3,0,5
E33011928,264,207,64,143,2,16,13,3,35,32,0,1,2,4
E33011929,276,195,55,140,0,32,30,2,47,42,0,5,0,2
E33011930,539,419,123,296,5,36,30,6,77,67,0,6,4,2
E33011931,342,253,75,178,1,31,23,8,53,49,0,4,0,4
E33011932,2336,1859,501,1358,14,173,137,36,277,240,8,25,4,13
E33011933,436,319,85,234,4,54,41,13,55,49,0,6,0,4
E33011934,571,431,131,300,1,47,31,16,90,85,0,4,1,2
E33011935,467,316,92,224,1,84,69,15,65,60,2,3,0,1
E33011936,295,223,92,131,1,30,19,11,38,36,0,2,0,3
E33011937,300,204,75,129,1,28,18,10,59,54,0,5,0,8
E33011938,476,358,103,255,2,50,36,14,61,56,1,4,0,5
E33011939,386,307,112,195,4,17,15,2,56,52,0,4,0,2
E33011940,347,255,66,189,0,50,44,6,41,37,1,3,0,1
E33011941,499,396,113,283,0,55,48,7,46,44,0,2,0,2
E33011942,289,218,49,169,1,41,41,0,28,26,0,2,0,1
E33011943,283,209,54,155,3,20,15,5,49,44,2,1,2,2
E33011944,331,281,75,206,2,21,19,2,23,18,0,4,1,4
E33011945,540,371,118,253,3,94,73,21,67,61,0,5,1,5
E33011946,352,241,78,163,1,56,46,10,51,48,2,1,0,3
E33011947,374,311,98,213,0,20,18,2,40,37,1,2,0,3
E33011948,446,376,116,260,2,8,6,2,55,51,2,2,0,5
E33011949,340,267,92,175,1,27,20,7,44,41,0,3,0,1
E33011950,349,271,59,212,4,32,30,2,40,38,0,2,0,2
E33011951,684,514,135,379,0,72,49,23,89,79,1,7,2,9
E33011952,504,398,125,273,0,23,17,6,82,73,2,3,4,1
E33011953,870,659,176,483,2,57,41,16,147,130,1,12,4,5
E33011954,299,234,66,168,1,11,8,3,46,44,0,2,0,7
E33011955,747,634,205,429,0,34,24,10,76,70,0,5,1,3
E33011956,297,230,75,155,2,26,23,3,35,33,0,2,0,4
E33011957,265,210,78,132,0,24,16,8,27,25,0,1,1,4
E33011958,362,246,95,151,2,46,27,19,63,58,0,4,1,5
E33011959,939,685,169,516,3,111,90,21,124,107,0,17,0,16
E33011960,391,301,78,223,1,35,32,3,49,43,1,4,1,5
E33011961,666,415,158,257,3,62,51,11,175,160,0,13,2,11
E33011962,413,335,162,173,1,32,26,6,33,31,0,2,0,12
E33011963,388,294,106,188,0,42,29,13,47,43,0,3,1,5
E33011964,254,192,82,110,3,27,23,4,22,20,0,2,0,10
E33011965,308,230,98,132,3,38,26,12,31,28,0,3,0,6
E33011966,552,395,130,265,6,81,69,12,65,60,0,5,0,5
E33011967,272,197,62,135,1,34,30,4,33,28,2,3,0,7
E33011968,580,376,116,260,0,108,77,31,91,84,0,7,0,5
E33011969,537,401,128,273,3,74,65,9,56,50,3,2,1,3
E33011970,377,267,77,190,2,29,25,4,76,68,2,5,1,3
E33011971,563,464,135,329,2,28,21,7,66,57,1,5,3,3
E33011972,595,485,162,323,0,32,24,8,74,71,1,2,0,4
E33011973,424,339,104,235,1,36,29,7,46,41,1,3,1,2
E33011974,410,358,88,270,0,19,14,5,32,26,2,4,0,1
E33011975,304,245,73,172,1,15,12,3,40,35,0,2,3,3
E33011976,337,283,117,166,0,11,8,3,38,33,0,5,0,5
E33011977,268,235,73,162,0,8,5,3,22,20,0,2,0,3
E33011978,358,298,91,207,2,7,6,1,47,44,0,3,0,4
E33011979,302,242,80,162,1,10,9,1,46,45,0,1,0,3
E33011980,236,200,81,119,3,9,9,0,21,16,0,3,2,3
E33011981,333,226,55,171,0,71,70,1,36,22,1,11,2,0
E33011982,239,186,43,143,0,24,23,1,27,22,2,2,1,2
E33011983,324,247,84,163,0,40,36,4,37,34,0,3,0,0
E33011984,390,265,68,197,3,59,47,12,61,55,2,4,0,2
E33011985,246,180,54,126,0,28,22,6,32,30,1,1,0,6
E33011986,1121,839,211,628,6,110,89,21,162,148,0,13,1,4
E33011987,533,396,128,268,1,57,45,12,77,72,0,5,0,2
E33011988,255,144,49,95,1,46,38,8,62,59,0,3,0,2
E33011989,266,204,69,135,1,12,7,5,48,46,0,0,2,1
E33011990,283,243,80,163,0,9,4,5,28,24,0,4,0,3
E33011991,631,479,139,340,1,29,21,8,114,100,1,12,1,8
E33011992,312,224,84,140,3,22,12,10,61,56,0,5,0,2
E33011993,501,338,111,227,1,39,25,14,120,115,0,3,2,3
E33011994,246,209,75,134,0,11,11,0,25,24,0,0,1,1
E33011995,290,194,73,121,2,44,30,14,38,33,0,5,0,12
E33011996,272,241,74,167,1,13,12,1,17,16,0,1,0,0
E33011997,339,273,79,194,0,12,10,2,51,42,2,5,2,3
E33011998,367,274,93,181,0,23,14,9,68,56,0,7,5,2
E33011999,326,233,59,174,2,17,13,4,68,62,1,5,0,6
E33012000,405,293,90,203,2,17,7,10,90,84,0,5,1,3
E33012001,320,233,68,165,2,20,15,5,64,57,1,4,2,1
E33012002,434,317,125,192,0,36,21,15,74,68,1,4,1,7
E33012003,322,226,82,144,0,12,10,2,78,71,2,5,0,6
E33012004,294,228,87,141,1,14,7,7,48,44,2,2,0,3
E33012005,310,247,81,166,0,11,7,4,52,49,0,3,0,0
E33012006,296,204,61,143,0,28,15,13,58,54,0,4,0,6
E33012007,368,270,95,175,1,22,10,12,70,64,0,5,1,5
E33012008,347,252,91,161,1,28,11,17,63,62,0,1,0,3
E33012009,343,255,67,188,2,27,15,12,52,47,0,4,1,7
E33012010,438,315,93,222,2,81,73,8,39,31,0,5,3,1
E33012011,288,188,52,136,2,31,22,9,61,51,1,9,0,6
E33012012,289,255,81,174,0,7,5,2,25,23,1,1,0,2
E33012013,263,220,91,129,4,6,1,5,33,32,0,1,0,0
E33012014,294,249,90,159,2,7,7,0,35,33,0,2,0,1
E33012015,293,231,62,169,0,17,13,4,44,38,2,4,0,1
E33012016,415,341,97,244,0,8,5,3,61,48,1,6,6,5
E33012017,605,468,156,312,2,52,36,16,81,73,1,7,0,2
E33012018,373,286,82,204,1,34,26,8,49,40,0,6,3,3
E33012019,279,229,64,165,1,25,23,2,20,17,0,3,0,4
E33012020,586,488,133,355,1,23,12,11,72,65,3,0,4,2
E33012021,315,243,66,177,0,9,8,1,60,55,0,5,0,3
E33012022,499,395,118,277,1,40,36,4,59,49,2,7,1,4
E33012023,279,207,70,137,1,21,16,5,42,37,0,5,0,8
E33012024,287,213,88,125,0,21,12,9,46,40,0,6,0,7
E33012025,316,262,66,196,1,17,12,5,33,27,2,4,0,3
E33012026,333,245,74,171,4,29,21,8,50,47,0,2,1,5
E33012027,216,148,41,107,0,25,15,10,42,42,0,0,0,1
E33012028,261,202,60,142,4,6,5,1,48,45,0,3,0,1
E33012029,253,175,43,132,0,29,26,3,45,35,0,7,3,4
E33012030,321,252,60,192,0,43,38,5,25,23,0,1,1,1
E33012031,250,185,54,131,0,5,4,1,57,54,0,3,0,3
E33012032,332,281,83,198,1,18,16,2,28,24,1,3,0,4
E33012033,234,191,54,137,2,21,15,6,20,16,0,4,0,0
E33012034,367,240,64,176,1,57,50,7,67,59,0,7,1,2
E33012035,269,165,41,124,0,53,48,5,49,43,0,5,1,2
E33012036,508,391,118,273,4,36,21,15,76,72,0,4,0,1
E33012037,435,342,112,230,1,16,9,7,70,63,3,4,0,6
E33012038,795,587,166,421,2,43,36,7,161,147,0,12,2,2
E33012039,375,257,92,165,0,36,33,3,81,77,0,3,1,1
E33012040,232,174,49,125,1,13,9,4,41,36,1,3,1,3
E33012041,2760,2096,643,1453,9,136,93,43,507,474,4,26,3,12
E33012042,296,217,79,138,2,29,24,5,47,45,0,2,0,1
E33012043,760,614,214,400,3,33,20,13,105,97,1,6,1,5
E33012044,353,257,108,149,2,26,14,12,62,55,1,6,0,6
E33012045,564,392,138,254,0,46,25,21,114,107,1,6,0,12
E33012046,443,330,116,214,2,31,17,14,78,70,0,8,0,2
E33012047,250,191,73,118,0,21,19,2,37,35,0,2,0,1
E33012048,366,300,88,212,2,21,17,4,42,32,0,10,0,1
E33012049,267,213,76,137,0,21,11,10,31,24,2,4,1,2
E33012050,242,177,41,136,1,31,27,4,31,31,0,0,0,2
E33012051,261,200,46,154,4,12,8,4,44,39,0,5,0,1
E33012052,657,508,152,356,4,45,40,5,95,86,0,8,1,5
E33012053,285,204,57,147,0,27,25,2,49,45,0,2,2,5
E33012054,367,290,95,195,0,23,14,9,51,46,0,5,0,3
E33012055,226,175,52,123,0,11,8,3,39,34,0,5,0,1
E33012056,519,369,122,247,2,53,29,24,90,82,0,8,0,5
E33012057,329,268,91,177,0,21,20,1,35,34,0,0,1,5
E33012058,335,279,74,205,0,19,14,5,36,33,0,2,1,1
E33012059,1215,865,257,608,6,114,85,29,214,199,0,12,3,16
E33012060,405,264,79,185,3,48,39,9,83,78,0,5,0,7
E33012061,293,234,62,172,2,9,6,3,47,37,0,7,3,1
E33012062,483,393,124,269,1,34,28,6,55,50,1,3,1,0
E33012063,277,190,65,125,4,29,21,8,53,46,0,6,1,1
E33012064,334,244,91,153,2,31,19,12,53,47,0,5,1,4
E33012065,539,433,142,291,6,32,26,6,64,58,0,5,1,4
E33012066,506,363,127,236,2,63,43,20,77,69,2,6,0,1
E33012067,435,331,103,228,0,30,26,4,71,65,0,6,0,3
E33012068,724,581,185,396,2,34,28,6,105,98,1,4,2,2
E33012069,343,283,74,209,1,11,8,3,47,43,0,3,1,1
E33012070,730,580,184,396,3,47,38,9,92,85,1,6,0,8
E33012071,351,284,87,197,3,16,12,4,46,42,0,3,1,2
E33012072,238,192,75,117,0,9,7,2,36,25,2,3,6,1
E33012073,492,402,131,271,3,33,29,4,54,47,0,6,1,0
E33012074,359,298,98,200,0,32,29,3,28,25,1,2,0,1
E33012075,325,244,67,177,0,31,26,5,46,41,0,5,0,4
E33012076,382,304,83,221,1,24,21,3,50,43,2,5,0,3
E33012077,433,355,117,238,1,22,13,9,47,42,1,4,0,8
E33012078,255,211,74,137,2,10,7,3,32,31,0,0,1,0
E33012079,374,299,101,198,1,17,8,9,56,52,0,4,0,1
E33012080,664,546,166,380,1,23,19,4,87,79,0,6,2,7
E33012081,348,259,79,180,1,31,24,7,55,53,0,2,0,2
E33012082,446,357,124,233,0,18,15,3,64,57,0,7,0,7
E33012083,292,226,75,151,4,11,8,3,48,46,0,1,1,3
E33012084,310,250,77,173,0,6,5,1,46,41,2,2,1,8
E33012085,354,289,108,181,0,19,12,7,38,35,1,1,1,8
E33012086,311,254,72,182,3,13,11,2,36,32,0,4,0,5
E33012087,333,246,74,172,0,20,16,4,66,59,0,6,1,1
E33012088,817,649,200,449,1,42,31,11,117,111,0,5,1,8
E33012089,371,305,100,205,2,16,15,1,46,37,1,5,3,2
E33012090,256,203,68,135,0,6,4,2,45,40,0,5,0,2
E33012091,316,271,103,168,0,15,10,5,28,28,0,0,0,2
E33012092,453,371,127,244,2,24,20,4,53,45,0,8,0,3
E33012093,648,501,155,346,1,52,39,13,91,84,1,6,0,3
E33012094,593,476,162,314,4,25,15,10,79,72,1,6,0,9
E33012095,675,543,178,365,0,37,33,4,91,74,0,16,1,4
E33012096,368,280,82,198,1,23,21,2,55,49,0,5,1,9
E33012097,402,342,104,238,0,13,11,2,43,41,0,2,0,4
E33012098,314,241,82,159,1,26,24,2,42,41,0,0,1,4
E33012099,339,255,82,173,1,30,26,4,51,46,0,4,1,2
E33012100,337,298,71,227,4,3,2,1,31,31,0,0,0,1
E33012101,283,236,82,154,2,12,5,7,30,25,5,0,0,3
E33012102,360,293,84,209,0,15,10,5,50,42,1,6,1,2
E33012103,257,199,67,132,1,19,15,4,36,29,1,4,2,2
E33012104,645,511,176,335,0,28,24,4,99,88,4,5,2,7
E33012105,588,494,128,366,3,26,19,7,61,55,1,5,0,4
E33012106,310,261,79,182,0,14,10,4,31,24,5,2,0,4
E33012107,452,362,125,237,4,14,11,3,70,66,1,2,1,2
E33012108,868,705,218,487,1,37,28,9,122,115,0,5,2,3
E33012109,228,166,63,103,0,9,7,2,46,44,2,0,0,7
E33012110,752,595,177,418,3,61,52,9,91,81,1,5,4,2
E33012111,244,215,71,144,0,8,7,1,19,14,1,3,1,2
E33012112,373,295,107,188,3,16,12,4,55,53,0,2,0,4
E33012113,360,294,102,192,0,18,16,2,46,41,1,4,0,2
E33012114,284,237,74,163,0,10,8,2,33,26,0,7,0,4
E33012115,537,457,150,307,1,19,15,4,57,48,0,4,5,3
E33012116,328,278,110,168,0,7,6,1,36,26,1,8,1,7
E33012117,354,285,80,205,0,25,18,7,44,41,1,2,0,0
E33012118,252,221,86,135,1,6,5,1,24,20,4,0,0,0
E33012119,329,263,88,175,1,26,22,4,36,30,0,6,0,3
E33012120,335,279,104,175,0,8,7,1,44,27,7,5,5,4
E33012121,345,284,103,181,1,14,11,3,42,39,0,2,1,4
E33012122,477,383,153,230,1,24,21,3,61,57,0,4,0,8
E33012123,385,332,117,215,0,17,13,4,34,28,0,4,2,2
E33012124,265,235,79,156,2,2,2,0,20,16,0,2,2,6
E33012125,265,226,78,148,0,21,18,3,16,14,0,2,0,2
E33012126,286,241,73,168,2,20,17,3,21,17,1,3,0,2
E33012127,285,244,95,149,1,15,13,2,22,21,0,1,0,3
E33012128,269,237,93,144,2,7,5,2,18,18,0,0,0,5
E33012129,643,435,142,293,1,93,75,18,101,92,1,7,1,13
E33012130,558,420,115,305,2,28,17,11,103,89,8,5,1,5
E33012131,403,314,93,221,4,33,29,4,48,45,1,2,0,4
E33012132,1047,906,303,603,9,63,50,13,66,60,1,5,0,3
E33012133,1135,897,225,672,4,95,72,23,132,114,0,15,3,7
E33012134,351,257,80,177,2,26,20,6,56,51,0,5,0,10
E33012135,466,316,86,230,4,51,40,11,94,91,0,3,0,1
E33012136,911,706,185,521,3,52,46,6,141,129,2,9,1,9
E33012137,364,265,75,190,0,49,41,8,48,45,2,0,1,2
E33012138,454,354,110,244,3,28,24,4,64,61,0,1,2,5
E33012139,450,372,123,249,3,45,38,7,30,30,0,0,0,0
E33012140,276,203,65,138,0,37,33,4,34,30,0,4,0,2
E33012141,431,348,102,246,1,29,28,1,49,42,1,4,2,4
E33012142,536,393,148,245,1,54,44,10,83,73,0,10,0,5
E33012143,278,204,80,124,2,25,20,5,46,41,0,5,0,1
E33012144,295,231,86,145,1,34,27,7,27,27,0,0,0,2
E33012145,524,417,108,309,2,29,19,10,70,62,1,7,0,6
E33012146,282,241,83,158,0,8,4,4,30,24,2,4,0,3
E33012147,402,321,111,210,1,19,17,2,58,54,0,4,0,3
E33012148,600,472,144,328,3,45,38,7,75,63,7,4,1,5
E33012149,296,253,95,158,0,16,16,0,24,20,1,3,0,3
E33012150,286,250,111,139,0,18,16,2,16,13,1,1,1,2
E33012151,478,348,83,265,4,23,18,5,92,74,13,4,1,11
E33012152,576,442,142,300,0,46,37,9,84,70,8,5,1,4
E33012153,289,237,75,162,0,21,18,3,29,25,0,4,0,2
E33012154,305,240,70,170,0,25,15,10,35,28,0,6,1,5
E33012155,244,199,72,127,0,12,11,1,31,31,0,0,0,2
E33012156,260,218,84,134,1,8,7,1,29,25,2,1,1,4
E33012157,231,195,75,120,0,10,7,3,24,22,1,1,0,2
E33012158,572,423,129,294,3,39,28,11,90,82,2,4,2,17
E33012159,383,323,96,227,2,20,18,2,32,27,1,4,0,6
E33012160,298,254,95,159,0,17,15,2,22,19,0,3,0,5
E33012161,279,219,82,137,2,23,20,3,34,29,1,4,0,1
E33012162,353,263,95,168,7,29,23,6,51,46,0,3,2,3
E33012163,328,263,77,186,2,26,23,3,34,31,1,2,0,3
E33012164,340,268,126,142,3,19,14,5,45,41,1,1,2,5
E33012165,265,226,78,148,1,14,12,2,23,19,0,2,2,1
E33012166,441,329,89,240,2,33,26,7,71,61,2,7,1,6
E33012167,516,398,100,298,5,35,25,10,73,64,0,4,5,5
E33012168,552,438,127,311,7,27,10,17,75,66,0,8,1,5
E33012169,229,175,51,124,0,12,8,4,40,38,0,1,1,2
E33012170,418,346,99,247,2,27,21,6,40,38,0,2,0,3
E33012171,561,400,119,281,1,84,68,16,72,67,0,4,1,4
E33012172,279,236,67,169,3,22,17,5,13,12,0,1,0,5
E33012173,716,535,151,384,6,49,33,16,121,114,0,7,0,5
E33012174,374,271,63,208,4,38,29,9,59,57,0,1,1,2
E33012175,382,310,75,235,0,21,17,4,51,45,0,6,0,0
E33012176,284,187,58,129,3,66,53,13,24,22,0,1,1,4
E33012177,649,488,181,307,3,70,57,13,84,81,0,2,1,4
E33012178,665,521,133,388,6,41,32,9,95,86,0,8,1,2
E33012179,465,365,98,267,5,39,31,8,54,47,2,5,0,2
E33012180,451,362,102,260,2,27,24,3,60,56,0,4,0,0
E33012181,731,609,215,394,2,31,24,7,75,70,1,4,0,14
E33012182,485,420,143,277,0,11,10,1,53,52,1,0,0,1
E33012183,293,250,77,173,0,18,10,8,22,21,0,1,0,3
E33012184,359,221,62,159,0,61,49,12,70,57,3,9,1,7
E33012185,472,405,127,278,0,23,20,3,42,40,1,1,0,2
E33012186,310,266,64,202,1,10,9,1,32,27,0,5,0,1
E33012187,683,526,149,377,3,66,50,16,81,68,1,10,2,7
E33012188,515,397,113,284,2,45,37,8,65,54,0,9,2,6
E33012189,301,255,71,184,1,14,11,3,30,28,0,2,0,1
E33012190,291,233,72,161,0,14,11,3,36,36,0,0,0,8
E33012191,294,230,68,162,2,9,5,4,46,40,2,4,0,7
E33012192,502,404,125,279,2,22,18,4,71,67,0,3,1,3
E33012193,520,431,138,293,1,45,40,5,40,38,0,1,1,3
E33012194,345,276,88,188,1,27,24,3,41,38,0,3,0,0
E33012195,396,295,79,216,0,36,31,5,60,55,1,4,0,5
E33012196,382,282,84,198,0,40,33,7,55,51,0,4,0,5
E33012197,310,211,43,168,0,56,50,6,37,32,0,2,3,6
E33012198,306,233,54,179,1,46,41,5,25,23,0,1,1,1
E33012199,557,367,127,240,0,121,88,33,63,53,0,7,3,6
E33012200,662,421,136,285,3,131,107,24,99,93,0,6,0,8
E33012201,427,293,86,207,2,85,74,11,41,35,0,6,0,6
E33012202,415,299,96,203,0,63,55,8,49,46,1,2,0,4
E33012203,253,176,50,126,1,42,37,5,32,30,0,1,1,2
E33012204,283,194,43,151,0,51,46,5,34,28,0,6,0,4
E33012205,765,636,143,493,3,51,40,11,72,65,0,6,1,3
E33012206,362,212,52,160,0,94,84,10,55,49,0,6,0,1
E33012207,218,158,54,104,0,18,11,7,41,40,0,1,0,1
E33012208,286,217,63,154,1,30,9,21,32,30,0,2,0,6
E33012209,670,452,142,310,2,45,30,15,163,152,0,11,0,8
E33012210,644,509,165,344,3,26,18,8,101,92,0,5,4,5
E33012211,387,324,111,213,0,29,27,2,29,27,0,2,0,5
E33012212,664,457,110,347,5,49,33,16,146,132,0,12,2,7
E33012213,376,311,97,214,1,21,18,3,42,37,0,3,2,1
E33012214,554,370,80,290,4,39,26,13,138,130,2,4,2,3
E33012215,326,280,100,180,0,12,4,8,31,28,2,1,0,3
E33012216,409,313,69,244,0,32,27,5,62,59,0,2,1,2
E33012217,282,235,81,154,0,21,16,5,24,22,1,1,0,2
E33012218,378,200,53,147,0,76,54,22,101,99,0,2,0,1
E33012219,353,265,77,188,1,15,13,2,67,60,0,7,0,5
E33012220,471,356,84,272,1,33,25,8,78,71,2,5,0,3
E33012221,310,230,62,168,0,41,29,12,37,34,0,3,0,2
E33012222,681,532,144,388,3,60,44,16,83,76,1,5,1,3
E33012223,268,200,67,133,0,35,21,14,28,26,0,2,0,5
E33012224,273,212,60,152,1,19,10,9,37,34,0,2,1,4
E33012225,269,206,71,135,0,29,20,9,33,25,0,8,0,1
E33012226,294,226,67,159,2,14,13,1,49,43,1,5,0,3
E33012227,307,239,64,175,0,16,13,3,48,45,0,3,0,4
E33012228,250,144,43,101,4,61,44,17,38,36,0,2,0,3
E33012229,274,158,40,118,3,56,33,23,55,53,1,1,0,2
E33012230,635,449,138,311,2,81,55,26,96,89,1,6,0,7
E33012231,312,256,74,182,2,24,20,4,28,26,0,2,0,2
E33012232,231,173,51,122,0,26,19,7,27,23,0,4,0,5
E33012233,577,402,101,301,0,51,38,13,121,113,1,6,1,3
E33012234,405,317,87,230,2,17,12,5,57,43,3,11,0,12
E33012235,247,182,46,136,1,22,19,3,40,36,0,4,0,2
E33012236,497,390,134,256,3,47,34,13,52,45,1,5,1,5
E33012237,494,375,111,264,0,48,35,13,67,59,0,8,0,4
E33012238,288,242,75,167,1,9,8,1,36,36,0,0,0,0
E33012239,458,328,89,239,0,54,43,11,74,65,1,8,0,2
E33012240,301,233,65,168,1,23,20,3,42,40,0,2,0,2
E33012241,273,215,49,166,0,20,19,1,37,36,0,1,0,1
E33012242,434,320,68,252,0,54,48,6,59,54,0,5,0,1
E33012243,310,211,65,146,4,53,52,1,41,37,0,3,1,1
E33012244,320,234,50,184,1,54,49,5,30,28,0,2,0,1
E33012245,446,322,69,253,5,54,47,7,60,52,1,6,1,5
E33012246,309,236,57,179,0,45,31,14,21,18,0,3,0,7
E33012247,524,431,114,317,5,26,22,4,60,58,0,2,0,2
E33012248,292,213,64,149,1,35,23,12,40,28,4,6,2,3
E33012249,372,260,59,201,2,21,17,4,78,75,0,3,0,11
E33012250,551,411,95,316,2,54,40,14,84,75,2,7,0,0
E33012251,268,228,72,156,0,11,9,2,23,21,2,0,0,6
E33012252,251,205,77,128,1,19,17,2,23,22,0,1,0,3
E33012253,282,223,54,169,0,15,13,2,37,33,0,2,2,7
E33012254,262,138,38,100,1,75,43,32,47,43,1,3,0,1
E33012255,307,209,52,157,0,47,36,11,49,46,0,3,0,2
E33012256,291,213,58,155,0,32,21,11,41,38,0,2,1,5
E33012257,345,245,62,183,1,40,19,21,56,49,2,5,0,3
E33012258,703,506,152,354,2,115,101,14,77,71,0,5,1,3
E33012259,282,201,57,144,1,32,19,13,42,42,0,0,0,6
E33012260,395,292,70,222,0,29,22,7,72,70,0,2,0,2
E33012261,505,411,122,289,1,41,25,16,48,43,0,4,1,4
E33012262,530,330,94,236,2,125,115,10,67,59,0,8,0,6
E33012263,458,272,87,185,0,123,115,8,53,44,1,6,2,10
E33012264,261,182,62,120,2,19,14,5,51,46,0,5,0,7
E33012265,293,209,57,152,0,19,11,8,60,55,0,5,0,5
E33012266,228,163,42,121,0,20,12,8,42,37,0,5,0,3
E33012267,343,232,49,183,1,43,25,18,65,61,0,2,2,2
E33012268,572,434,82,352,2,33,26,7,100,95,0,5,0,3
E33012269,443,354,80,274,3,17,9,8,65,62,0,3,0,4
E33012270,1347,962,211,751,4,194,160,34,175,153,0,21,1,12
E33012271,758,516,91,425,3,141,111,30,95,85,1,7,2,3
E33012272,330,207,60,147,0,101,86,15,19,17,0,2,0,3
E33012273,587,338,77,261,1,179,164,15,67,59,1,6,1,2
E33012274,304,156,52,104,0,74,62,12,70,64,0,3,3,4
E33012275,240,159,54,105,0,25,10,15,49,45,0,4,0,7
E33012276,268,211,51,160,0,25,10,15,31,30,0,0,1,1
E33012277,513,355,132,223,1,60,38,22,91,83,1,6,1,6
E33012278,409,294,90,204,3,44,37,7,65,56,0,7,2,3
E33012279,523,301,77,224,2,128,111,17,89,82,2,5,0,3
E33012280,479,264,72,192,4,122,81,41,88,82,0,5,1,1
E33012281,247,207,50,157,0,11,10,1,29,27,0,1,1,0
E33012282,381,293,82,211,1,28,27,1,58,50,0,7,1,1
E33012283,538,416,108,308,3,43,30,13,70,65,1,4,0,6
E33012284,232,192,61,131,0,11,7,4,25,22,0,1,2,4
E33012285,627,482,117,365,2,35,23,12,106,94,1,11,0,2
E33012286,265,205,58,147,3,17,15,2,37,34,0,3,0,3
E33012287,528,349,123,226,3,95,87,8,76,69,0,3,4,5
E33012288,598,369,88,281,2,160,143,17,66,58,0,8,0,1
E33012289,312,197,34,163,1,79,66,13,29,26,1,2,0,6
E33012290,430,260,52,208,3,124,97,27,40,28,1,11,0,3
E33012291,699,443,124,319,4,140,81,59,110,102,0,7,1,2
E33012292,647,449,126,323,2,89,50,39,103,96,0,7,0,4
E33012293,383,237,75,162,3,68,41,27,72,60,0,12,0,3
E33012294,278,182,51,131,1,43,23,20,49,44,1,4,0,3
E33012295,830,553,148,405,3,135,96,39,134,132,1,1,0,5
E33012296,485,319,102,217,0,79,60,19,81,76,1,4,0,6
E33012297,687,312,69,243,5,58,27,31,298,281,2,13,2,14
E33012298,415,151,47,104,3,34,21,13,222,216,1,4,1,5
E33012299,642,397,89,308,3,37,20,17,203,194,0,9,0,2
E33012300,532,281,65,216,4,45,26,19,199,190,0,7,2,3
E33012301,281,135,41,94,4,30,17,13,108,102,0,6,0,4
E33012302,302,161,45,116,2,63,46,17,75,65,1,8,1,1
E33012303,366,238,74,164,3,57,43,14,67,64,0,3,0,1
E33012304,302,214,63,151,4,32,27,5,47,44,0,3,0,5
E33012305,408,230,51,179,1,116,100,16,60,54,0,2,4,1
E33012306,330,229,52,177,2,61,52,9,36,33,0,3,0,2
E33012307,289,164,41,123,2,89,75,14,32,29,0,3,0,2
E33012308,308,179,48,131,0,76,57,19,50,45,0,5,0,3
E33012309,327,243,91,152,0,45,36,9,36,32,1,3,0,3
E33012310,263,161,43,118,1,38,14,24,61,54,0,7,0,2
E33012311,245,145,50,95,6,51,25,26,40,37,0,2,1,3
E33012312,497,273,111,162,3,86,59,27,116,108,0,6,2,19
E33012313,552,360,108,252,2,88,39,49,95,94,0,1,0,7
E33012314,375,254,72,182,2,79,64,15,31,25,1,4,1,9
E33012315,749,573,92,481,3,103,92,11,66,61,0,3,2,4
E33012316,326,218,67,151,0,77,65,12,25,23,0,2,0,6
E33012317,265,195,52,143,0,27,24,3,37,33,0,3,1,6
E33012318,275,216,65,151,2,26,21,5,30,23,0,4,3,1
E33012319,297,210,54,156,1,40,35,5,42,40,0,2,0,4
E33012320,312,243,63,180,1,35,30,5,27,23,0,3,1,6
E33012321,543,399,121,278,4,74,53,21,65,63,0,1,1,1
E33012322,299,227,44,183,0,19,9,10,52,48,0,2,2,1
E33012323,315,240,59,181,3,27,23,4,39,31,0,6,2,6
E33012324,376,247,49,198,1,73,57,16,54,47,0,7,0,1
E33012325,293,185,61,124,1,38,25,13,64,61,0,3,0,5
E33012326,514,282,83,199,5,104,85,19,115,105,4,6,0,8
E33012327,536,276,76,200,3,119,97,22,124,116,2,5,1,14
E33012328,542,246,97,149,3,77,51,26,207,199,0,7,1,9
E33012329,358,141,72,69,3,24,12,12,189,180,2,5,2,1
E33012330,466,297,81,216,3,79,60,19,85,80,1,3,1,2
E33012331,576,383,93,290,5,94,74,20,83,75,3,4,1,11
E33012332,416,269,82,187,3,60,45,15,76,72,1,3,0,8
E33012333,367,145,33,112,4,98,68,30,116,108,1,2,5,4
E33012334,422,260,78,182,3,56,40,16,102,101,0,0,1,1
E33012335,617,398,105,293,3,97,67,30,116,109,0,6,1,3
E33012336,221,100,33,67,1,41,27,14,77,75,0,2,0,2
E33012337,319,214,61,153,1,25,23,2,78,74,0,4,0,1
E33012338,327,150,51,99,1,37,23,14,138,126,0,11,1,1
E33012339,604,403,111,292,3,87,73,14,108,105,0,1,2,3
E33012340,490,271,84,187,2,66,46,20,145,138,0,6,1,6
E33012341,322,271,79,192,1,18,16,2,30,28,0,2,0,2
E33012342,472,364,111,253,1,57,45,12,43,39,0,4,0,7
E33012343,313,244,67,177,1,19,15,4,47,44,0,3,0,2
E33012344,284,194,60,134,0,34,32,2,54,51,0,3,0,2
E33012345,537,381,89,292,1,82,65,17,71,62,2,7,0,2
E33012346,603,430,122,308,2,96,80,16,69,58,0,10,1,6
E33012347,494,372,84,288,1,43,32,11,70,64,0,6,0,8
E33012348,313,215,38,177,0,47,39,8,45,38,0,6,1,6
E33012349,682,459,100,359,3,100,70,30,117,110,0,6,1,3
E33012350,338,214,49,165,1,65,52,13,58,55,0,3,0,0
E33012351,340,260,73,187,1,26,19,7,49,44,0,5,0,4
E33012352,400,217,54,163,2,131,119,12,44,41,0,2,1,6
E33012353,284,150,26,124,0,103,84,19,28,25,0,3,0,3
E33012354,290,201,44,157,5,56,24,32,28,26,0,2,0,0
E33012355,262,192,36,156,1,40,35,5,28,24,0,4,0,1
E33012356,499,381,102,279,0,59,43,16,57,54,0,3,0,2
E33012357,237,158,46,112,4,40,33,7,34,30,0,4,0,1
E33012358,280,226,55,171,0,16,14,2,37,35,0,2,0,1
E33012359,349,252,52,200,1,47,45,2,46,39,1,6,0,3
E33012360,475,375,80,295,2,42,36,6,50,43,3,4,0,6
E33012361,294,208,48,160,0,23,14,9,59,55,0,4,0,4
E33012362,317,195,53,142,1,48,33,15,71,67,0,4,0,2
E33012363,778,597,189,408,4,60,40,20,108,101,0,5,2,9
E33012364,232,122,23,99,2,35,21,14,72,69,0,3,0,1
E33012365,630,394,105,289,3,34,25,9,191,184,1,6,0,8
E33012366,7252,5159,1197,3962,29,918,721,197,1111,1020,12,72,7,35
E33012367,369,198,56,142,2,117,108,9,48,45,0,3,0,4
E33012368,270,117,38,79,2,100,81,19,46,40,3,3,0,5
E33012369,287,129,37,92,0,118,102,16,38,35,1,2,0,2
E33012370,424,233,47,186,7,67,48,19,114,103,2,8,1,3
E33012371,310,152,53,99,2,53,18,35,100,88,0,9,3,3
E33012372,596,361,87,274,3,107,90,17,116,114,1,1,0,9
E33012373,1437,901,241,660,14,310,253,57,207,195,0,11,1,5
E33012374,1014,727,173,554,5,157,117,40,123,113,1,8,1,2
E33012375,281,230,73,157,2,24,18,6,25,25,0,0,0,0
E33012376,2089,1610,318,1292,10,111,77,34,339,312,1,25,1,19
E33012377,339,287,97,190,0,6,5,1,44,39,2,3,0,2
E33012378,625,406,96,310,0,80,67,13,132,126,1,5,0,7
E33012379,496,345,91,254,2,70,45,25,75,73,0,2,0,4
E33012380,273,194,56,138,0,25,19,6,52,46,0,6,0,2
E33012381,642,436,119,317,0,142,118,24,62,53,1,6,2,2
E33012382,1073,823,204,619,1,101,88,13,140,135,0,4,1,8
E33012383,350,241,65,176,1,75,67,8,32,26,0,6,0,1
E33012384,329,262,72,190,1,24,19,5,41,36,0,3,2,1
E33012385,358,295,65,230,0,41,31,10,22,19,0,3,0,0
E33012386,411,320,72,248,4,28,25,3,53,48,0,4,1,6
E33012387,329,260,79,181,2,40,30,10,26,23,0,3,0,1
E33012388,604,479,129,350,0,47,34,13,71,59,0,11,1,7
E33012389,371,307,83,224,0,25,20,5,37,34,2,0,1,2
E33012390,272,214,76,138,1,26,20,6,22,21,0,1,0,9
E33012391,444,306,89,217,2,64,51,13,71,61,0,10,0,1
E33012392,397,289,70,219,1,72,62,10,31,25,1,1,4,4
E33012393,881,471,115,356,8,122,109,13,269,249,0,15,5,11
E33012394,1030,802,150,652,2,94,73,21,127,116,0,8,3,5
E33012395,326,174,44,130,1,98,85,13,48,43,0,5,0,5
E33012396,520,364,106,258,5,88,65,23,60,51,2,5,2,3
E33012397,305,173,56,117,1,56,44,12,71,65,0,6,0,4
E33012398,364,212,54,158,1,75,57,18,69,65,0,3,1,7
E33012399,453,283,59,224,2,109,89,20,55,50,1,3,1,4
E33012400,324,170,60,110,1,125,103,22,26,23,1,1,1,2
E33012401,325,270,80,190,0,19,13,6,32,29,0,3,0,4
E33012402,368,297,61,236,0,24,17,7,42,39,0,2,1,5
E33012403,340,255,81,174,0,39,31,8,45,37,0,7,1,1
E33012404,583,438,116,322,2,54,48,6,85,78,0,7,0,4
E33012405,257,185,54,131,1,14,10,4,54,52,0,2,0,3
E33012406,388,295,83,212,1,43,40,3,42,40,0,2,0,7
E33012407,302,226,81,145,2,26,20,6,47,39,2,6,0,1
E33012408,379,301,98,203,1,22,21,1,49,44,1,2,2,6
E33012409,299,164,44,120,2,76,62,14,56,51,0,4,1,1
E33012410,245,145,30,115,2,54,39,15,42,41,0,1,0,2
E33012411,409,267,62,205,1,16,5,11,122,113,3,6,0,3
E33012412,285,181,48,133,0,54,47,7,45,40,1,3,1,5
E33012413,535,386,65,321,4,36,21,15,104,100,0,4,0,5
E33012414,377,244,64,180,1,66,50,16,60,51,1,6,2,6
E33012415,338,218,72,146,1,55,44,11,61,58,1,1,1,3
E33012416,259,185,48,137,0,31,26,5,41,36,0,4,1,2
E33012417,314,237,86,151,2,31,25,6,37,32,1,3,1,7
E33012418,355,274,73,201,0,25,21,4,52,46,0,6,0,4
E33012419,259,202,76,126,1,16,15,1,38,32,0,4,2,2
E33012420,510,326,93,233,3,35,15,20,143,136,0,6,1,3
E33012421,253,210,62,148,0,15,11,4,24,22,0,2,0,4
E33012422,330,294,75,219,0,19,18,1,17,17,0,0,0,0
E33012423,493,409,131,278,0,34,26,8,44,41,0,3,0,6
E33012424,283,243,64,179,0,19,14,5,19,18,0,1,0,2
E33012425,552,392,102,290,0,97,82,15,61,53,0,6,2,2
E33012426,519,343,92,251,5,78,68,10,88,76,0,7,5,5
E33012427,518,312,71,241,5,134,110,24,66,62,1,3,0,1
E33012428,276,215,60,155,1,31,28,3,28,26,0,2,0,1
E33012429,370,279,73,206,1,32,30,2,51,41,0,10,0,7
E33012430,334,270,69,201,1,26,24,2,34,31,0,3,0,3
E33012431,233,184,46,138,2,21,19,2,23,22,0,1,0,3
E33012432,352,275,69,206,1,38,35,3,36,33,0,3,0,2
E33012433,451,312,72,240,7,60,51,9,67,58,1,4,4,5
E33012434,487,354,97,257,4,65,56,9,55,49,0,4,2,9
E33012435,432,283,83,200,2,89,80,9,53,47,2,3,1,5
E33012436,300,218,58,160,0,43,43,0,38,33,0,5,0,1
E33012437,580,389,109,280,2,114,91,23,71,67,1,3,0,4
E33012438,467,364,81,283,2,40,30,10,60,59,0,1,0,1
E33012439,333,214,62,152,1,70,57,13,44,41,0,2,1,4
E33012440,236,173,46,127,0,34,22,12,29,28,0,1,0,0
E33012441,262,168,44,124,3,26,21,5,64,60,0,4,0,1
E33012442,985,641,125,516,2,57,41,16,277,260,0,16,1,8
E33012443,338,234,53,181,2,19,13,6,81,78,0,3,0,2
E33012444,363,270,55,215,1,37,28,9,51,42,0,8,1,4
E33012445,218,131,35,96,4,44,35,9,38,37,0,0,1,1
E33012446,964,746,161,585,4,79,52,27,129,119,0,9,1,6
E33012447,609,389,100,289,1,81,57,24,131,123,0,8,0,7
E33012448,716,513,119,394,2,78,64,14,119,112,1,6,0,4
E33012449,693,560,115,445,5,45,38,7,81,74,0,7,0,2
E33012450,864,599,148,451,4,54,41,13,201,184,1,14,2,6
E33012451,258,210,55,155,0,25,23,2,23,17,0,2,4,0
E33012452,396,298,65,233,2,28,23,5,64,59,1,4,0,4
E33012453,300,175,44,131,2,64,47,17,58,55,0,2,1,1
E33012454,481,319,67,252,5,95,78,17,59,55,0,4,0,3
E33012455,482,295,89,206,4,62,41,21,112,105,0,5,2,9
E33012456,307,198,52,146,0,43,31,12,64,59,0,5,0,2
E33012457,334,211,59,152,2,48,35,13,68,61,3,2,2,5
E33012458,609,458,113,345,3,72,56,16,73,70,0,3,0,3
E33012459,351,194,80,114,3,52,28,24,92,85,0,7,0,10
E33012460,318,202,54,148,1,61,42,19,50,45,0,5,0,4
E33012461,267,209,68,141,0,35,31,4,18,18,0,0,0,5
E33012462,470,395,97,298,5,21,18,3,45,41,3,1,0,4
E33012463,964,740,207,533,3,106,96,10,107,96,1,8,2,8
E33012464,558,449,120,329,1,54,43,11,46,41,0,5,0,8
E33012465,723,584,157,427,9,49,31,18,73,60,4,6,3,8
E33012466,317,244,44,200,2,37,31,6,32,27,1,3,1,2
E33012467,389,331,81,250,0,26,21,5,29,23,0,6,0,3
E33012468,422,336,87,249,5,30,26,4,46,36,2,8,0,5
E33012469,349,216,70,146,0,91,86,5,40,39,0,1,0,2
E33012470,540,376,106,270,5,57,48,9,94,88,0,6,0,8
E33012471,341,233,61,172,2,52,35,17,52,49,0,1,2,2
E33012472,1191,907,182,725,4,115,94,21,162,146,1,14,1,3
E33012473,354,255,64,191,2,21,13,8,73,69,0,4,0,3
E33012474,678,508,187,321,2,87,65,22,76,69,0,7,0,5
E33012475,359,255,71,184,2,34,26,8,59,52,0,7,0,9
E33012476,333,235,60,175,0,43,35,8,52,51,0,1,0,3
E33012477,493,311,70,241,2,134,98,36,42,40,0,2,0,4
E33012478,320,199,45,154,1,88,71,17,30,20,1,6,3,2
E33012479,253,206,70,136,0,11,8,3,32,27,0,5,0,4
E33012480,634,455,95,360,2,80,55,25,94,86,1,7,0,3
E33012481,319,191,51,140,2,91,78,13,33,29,0,3,1,2
E33012482,354,244,51,193,1,76,67,9,33,27,1,5,0,0
E33012483,385,318,70,248,3,27,21,6,35,31,0,3,1,2
E33012484,493,347,88,259,1,53,44,9,90,83,0,6,1,2
E33012485,483,356,101,255,1,40,35,5,82,75,0,6,1,4
E33012486,319,250,62,188,2,28,28,0,36,35,0,1,0,3
E33012487,459,363,75,288,0,35,29,6,58,51,0,7,0,3
E33012488,289,242,67,175,0,17,13,4,27,23,0,3,1,3
E33012489,510,396,98,298,2,34,28,6,70,65,0,3,2,8
E33012490,663,532,162,370,2,44,35,9,82,68,1,11,2,3
E33012491,384,296,60,236,2,33,31,2,48,47,0,1,0,5
E33012492,258,196,49,147,2,24,18,6,33,29,0,3,1,3
E33012493,508,358,97,261,1,55,40,15,85,74,1,5,5,9
E33012494,224,179,54,125,0,25,23,2,20,18,0,1,1,0
E33012495,248,195,38,157,0,31,28,3,19,17,0,2,0,3
E33012496,351,276,69,207,4,36,31,5,34,33,0,1,0,1
E33012497,363,293,75,218,0,33,24,9,35,27,2,3,3,2
E33012498,294,206,65,141,2,57,48,9,22,20,1,1,0,7
E33012499,433,302,93,209,1,69,62,7,59,52,2,2,3,2
E33012500,554,410,125,285,0,53,40,13,91,83,0,8,0,0
E33012501,248,194,54,140,1,29,21,8,21,19,0,2,0,3
E33012502,269,213,53,160,1,29,26,3,24,21,0,2,1,2
E33012503,325,240,73,167,6,30,25,5,47,44,0,1,2,2
E33012504,314,213,31,182,6,45,38,7,46,41,1,4,0,4
E33012505,380,277,62,215,10,56,53,3,32,30,0,2,0,5
E33012506,715,554,124,430,4,73,56,17,80,73,0,6,1,4
E33012507,293,224,31,193,0,19,13,6,48,42,4,1,1,2
E33012508,277,208,51,157,1,18,16,2,46,37,4,3,2,4
E33012509,299,222,47,175,0,52,38,14,24,23,0,1,0,1
E33012510,302,232,83,149,0,19,16,3,51,48,0,2,1,0
E33012511,413,255,51,204,0,104,89,15,49,41,1,6,1,5
E33012512,254,160,31,129,2,64,44,20,28,28,0,0,0,0
E33012513,347,217,34,183,0,91,88,3,36,28,2,6,0,3
E33012514,235,162,32,130,1,37,29,8,35,34,0,1,0,0
E33012515,348,281,58,223,0,23,18,5,40,38,0,2,0,4
E33012516,303,205,46,159,5,24,18,6,65,61,0,2,2,4
E33012517,769,540,140,400,7,80,61,19,138,134,0,4,0,4
E33012518,368,310,72,238,1,24,22,2,30,27,1,2,0,3
E33012519,298,242,60,182,1,19,12,7,36,33,0,1,2,0
E33012520,403,319,99,220,2,43,34,9,34,30,0,4,0,5
E33012521,337,252,69,183,2,41,34,7,40,40,0,0,0,2
E33012522,289,227,68,159,1,19,17,2,33,29,0,1,3,9
E33012523,444,304,79,225,5,45,34,11,87,83,1,3,0,3
E33012524,302,217,53,164,0,34,26,8,47,44,0,2,1,4
E33012525,262,201,59,142,0,26,19,7,33,28,2,3,0,2
E33012526,389,293,69,224,2,37,30,7,57,50,0,7,0,0
E33012527,417,310,76,234,0,40,36,4,65,60,0,5,0,2
E33012528,325,235,58,177,4,40,35,5,44,40,0,2,2,2
E33012529,504,394,77,317,3,41,36,5,63,55,0,6,2,3
E33012530,267,198,39,159,3,33,24,9,31,31,0,0,0,2
E33012531,368,285,50,235,10,34,27,7,36,31,0,3,2,3
E33012532,524,397,93,304,2,52,35,17,68,57,3,8,0,5
E33012533,259,203,57,146,0,14,9,5,34,30,0,3,1,8
E33012534,322,280,67,213,1,12,12,0,27,24,0,2,1,2
E33012535,476,407,103,304,0,24,20,4,41,39,0,2,0,4
E33012536,491,371,79,292,2,37,24,13,78,77,0,1,0,3
E33012537,369,288,72,216,0,27,19,8,52,47,0,5,0,2
E33012538,428,317,82,235,1,61,56,5,48,43,0,4,1,1
E33012539,245,207,53,154,1,12,5,7,24,23,0,1,0,1
E33012540,279,180,41,139,0,72,64,8,25,22,1,2,0,2
E33012541,327,249,70,179,0,40,32,8,36,34,0,2,0,2
E33012542,245,183,58,125,0,20,18,2,40,36,0,4,0,2
E33012543,275,206,57,149,0,33,15,18,31,29,0,2,0,5
E33012544,366,286,66,220,1,30,21,9,46,36,2,7,1,3
E33012545,283,245,55,190,2,8,6,2,25,21,0,4,0,3
E33012546,464,409,93,316,1,18,16,2,34,30,1,1,2,2
E33012547,266,210,62,148,1,28,21,7,27,22,2,2,1,0
E33012548,254,175,48,127,0,63,54,9,9,7,1,1,0,7
E33012549,307,210,49,161,1,69,53,16,23,20,0,3,0,4
E33012550,383,219,53,166,4,119,94,25,40,34,0,4,2,1
E33012551,1395,853,218,635,6,203,160,43,324,311,3,9,1,9
E33012552,735,596,163,433,6,65,55,10,62,49,2,9,2,6
E33012553,711,594,162,432,3,46,31,15,62,52,2,7,1,6
E33012554,322,227,61,166,1,36,25,11,54,50,0,4,0,4
E33012555,261,181,52,129,2,32,27,5,42,35,0,7,0,4
E33012556,303,225,42,183,0,58,47,11,18,15,0,2,1,2
E33012557,755,603,154,449,1,82,63,19,61,49,0,11,1,8
E33012558,287,230,65,165,0,33,24,9,21,19,0,2,0,3
E33012559,598,503,147,356,5,41,27,14,48,41,1,6,0,1
E33012560,404,283,78,205,4,72,60,12,44,37,0,2,5,1
E33012561,305,225,59,166,1,32,29,3,45,39,0,6,0,2
E33012562,251,173,36,137,0,35,26,9,39,33,2,4,0,4
E33012563,743,618,148,470,2,55,44,11,67,65,0,2,0,1
E33012564,372,295,86,209,5,30,23,7,35,32,1,1,1,7
E33012565,260,209,58,151,0,28,21,7,21,16,0,5,0,2
E33012566,316,248,49,199,0,25,20,5,43,42,0,1,0,0
E33012567,268,219,48,171,1,20,17,3,23,19,1,3,0,5
E33012568,402,348,85,263,1,29,20,9,22,20,0,2,0,2
E33012569,1517,1184,288,896,6,115,95,20,208,186,0,22,0,4
E33012570,388,290,85,205,0,48,43,5,50,43,2,4,1,0
E33012571,480,392,103,289,4,37,24,13,43,40,2,1,0,4
E33012572,295,232,62,170,0,26,21,5,33,30,0,3,0,4
E33012573,286,223,51,172,1,26,22,4,36,33,0,2,1,0
E33012574,469,336,93,243,5,46,40,6,75,60,1,14,0,7
E33012575,407,325,94,231,1,42,31,11,36,29,2,5,0,3
E33012576,332,259,72,187,1,37,28,9,31,31,0,0,0,4
E33012577,317,254,64,190,2,15,11,4,40,36,1,3,0,6
E33012578,295,178,44,134,2,56,41,15,54,51,0,3,0,5
E33012579,387,343,89,254,0,23,19,4,19,19,0,0,0,2
E33012580,325,251,69,182,0,24,13,11,48,39,2,7,0,2
E33012581,441,360,91,269,1,44,34,10,33,29,0,1,3,3
E33012582,451,308,79,229,5,87,69,18,49,43,0,5,1,2
E33012583,388,297,79,218,3,50,40,10,34,33,0,1,0,4
E33012584,384,299,81,218,0,46,38,8,39,38,0,1,0,0
E33012585,478,367,99,268,3,60,51,9,47,43,0,4,0,1
E33012586,521,366,106,260,2,70,59,11,78,71,0,6,1,5
E33012587,626,538,153,385,3,33,29,4,51,45,2,4,0,1
E33012588,250,187,57,130,1,41,35,6,19,17,0,2,0,2
E33012589,252,166,40,126,2,53,38,15,28,23,0,5,0,3
E33012590,702,536,137,399,1,106,80,26,55,49,0,5,1,4
E33012591,270,200,58,142,2,33,24,9,31,29,0,1,1,4
E33012592,271,207,59,148,2,34,30,4,28,23,3,2,0,0
E33012593,289,244,81,163,0,18,13,5,25,24,0,1,0,2
E33012594,403,320,68,252,2,43,20,23,36,33,0,3,0,2
E33012595,970,667,171,496,8,138,103,35,154,140,4,10,0,3
E33012596,471,359,86,273,1,48,35,13,58,50,1,6,1,5
E33012597,511,424,93,331,1,33,28,5,51,44,1,6,0,2
E33012598,368,304,102,202,0,27,23,4,29,24,0,5,0,8
E33012599,597,488,105,383,1,33,23,10,72,67,0,4,1,3
E33012600,312,264,89,175,3,12,11,1,32,29,0,3,0,1
E33012601,597,471,141,330,0,42,24,18,79,68,3,6,2,5
E33012602,328,242,74,168,2,44,33,11,37,34,2,1,0,3
E33012603,341,240,58,182,0,53,44,9,48,44,0,4,0,0
E33012604,258,172,50,122,1,55,39,16,29,25,0,2,2,1
E33012605,256,182,54,128,1,41,27,14,29,22,0,5,2,3
E33012606,803,650,199,451,3,79,66,13,68,60,1,7,0,3
E33012607,595,440,131,309,5,73,48,25,74,71,0,3,0,3
E33012608,370,288,86,202,3,35,31,4,40,38,0,1,1,4
E33012609,286,209,52,157,2,34,26,8,37,33,1,2,1,4
E33012610,322,208,34,174,0,73,68,5,39,31,1,6,1,2
E33012611,949,789,206,583,3,72,48,24,84,72,0,9,3,1
E33012612,378,308,55,253,0,25,16,9,42,35,0,6,1,3
E33012613,297,208,66,142,0,38,32,6,48,44,1,2,1,3
E33012614,391,300,90,210,2,49,40,9,36,34,1,1,0,4
E33012615,279,165,55,110,2,63,48,15,46,39,0,4,3,3
E33012616,825,560,174,386,4,140,107,33,115,102,0,11,2,6
E33012617,276,180,59,121,1,26,13,13,65,59,0,2,4,4
E33012618,4686,3623,875,2748,16,409,314,95,621,564,7,45,5,17
E33012619,510,360,107,253,3,60,48,12,83,77,0,5,1,4
E33012620,635,527,132,395,2,23,17,6,82,70,1,10,1,1
E33012621,978,660,176,484,2,191,146,45,120,108,1,9,2,5
E33012622,557,386,106,280,3,107,86,21,49,42,2,3,2,12
E33012623,456,347,83,264,3,60,48,12,42,38,0,4,0,4
E33012624,300,245,68,177,0,18,12,6,34,30,0,3,1,3
E33012625,690,578,160,418,6,53,39,14,48,43,0,5,0,5
E33012626,1088,854,214,640,7,80,55,25,144,129,1,14,0,3
E33012627,426,309,77,232,1,51,35,16,60,57,0,3,0,5
E33012628,774,645,222,423,0,50,34,16,77,72,1,4,0,2
E33012629,272,187,39,148,1,48,33,15,34,30,1,2,1,2
E33012630,396,280,61,219,2,56,33,23,56,51,1,4,0,2
E33012631,688,488,145,343,0,128,104,24,63,55,2,5,1,9
E33012632,463,359,94,265,0,47,34,13,55,49,0,4,2,2
E33012633,326,229,76,153,1,48,39,9,48,40,3,5,0,0
E33012634,294,237,60,177,1,20,14,6,35,33,0,2,0,1
E33012635,315,236,72,164,0,39,33,6,31,30,0,1,0,9
E33012636,403,319,88,231,1,34,26,8,44,38,0,5,1,5
E33012637,380,284,78,206,2,44,31,13,49,45,0,4,0,1
E33012638,504,348,81,267,1,75,56,19,79,72,0,7,0,1
E33012639,327,242,69,173,0,51,36,15,32,30,0,2,0,2
E33012640,426,345,95,250,2,34,27,7,39,36,0,1,2,6
E33012641,349,242,66,176,0,74,61,13,31,25,0,5,1,2
E33012642,233,186,73,113,1,27,17,10,16,14,0,2,0,3
E33012643,438,375,127,248,2,30,23,7,24,24,0,0,0,7
E33012644,310,230,56,174,2,34,27,7,42,39,0,2,1,2
E33012645,359,311,103,208,0,10,4,6,33,31,0,1,1,5
E33012646,377,292,67,225,0,53,41,12,25,25,0,0,0,7
E33012647,271,207,68,139,0,31,27,4,30,27,2,1,0,3
E33012648,648,522,144,378,0,45,34,11,71,59,3,8,1,10
E33012649,320,256,52,204,2,27,21,6,34,25,1,3,5,1
E33012650,366,257,69,188,4,42,30,12,63,59,0,3,1,0
E33012651,403,316,85,231,0,40,28,12,43,42,0,1,0,4
E33012652,434,349,91,258,0,31,24,7,51,46,1,2,2,3
E33012653,301,213,51,162,1,44,34,10,41,36,0,4,1,2
E33012654,255,160,47,113,2,70,59,11,21,16,0,3,2,2
E33012655,374,251,73,178,2,88,73,15,30,27,0,3,0,3
E33012656,357,215,48,167,0,100,75,25,40,34,0,3,3,2
E33012657,368,232,46,186,0,75,55,20,55,51,0,3,1,6
E33012658,290,228,69,159,0,31,24,7,30,27,1,2,0,1
E33012659,356,264,74,190,3,52,40,12,36,34,0,2,0,1
E33012660,300,214,47,167,2,50,36,14,31,26,0,4,1,3
E33012661,257,191,54,137,2,30,21,9,30,28,0,2,0,4
E33012662,540,394,97,297,1,61,48,13,80,74,0,5,1,4
E33012663,884,656,134,522,6,100,77,23,116,106,0,8,2,6
E33012664,746,508,127,381,2,138,100,38,91,78,1,11,1,7
E33012665,443,347,109,238,2,47,31,16,44,38,0,6,0,3
E33012666,338,264,73,191,1,35,21,14,33,29,1,3,0,5
E33012667,1119,861,199,662,1,122,75,47,132,117,0,13,2,3
E33012668,313,241,78,163,1,41,33,8,28,22,1,2,3,2
E33012669,249,191,41,150,0,17,10,7,38,36,0,2,0,3
E33012670,274,238,61,177,0,12,9,3,20,17,0,3,0,4
E33012671,502,361,108,253,2,76,66,10,58,53,0,5,0,5
E33012672,346,248,65,183,3,52,44,8,34,31,0,3,0,9
E33012673,476,287,94,193,3,130,103,27,54,52,0,1,1,2
E33012674,346,233,56,177,3,32,25,7,75,73,0,1,1,3
E33012675,311,203,75,128,0,32,20,12,66,60,0,6,0,10
E33012676,395,284,84,200,2,51,33,18,57,51,1,4,1,1
E33012677,355,251,59,192,0,62,52,10,41,39,0,2,0,1
E33012678,647,502,123,379,2,73,60,13,65,53,0,8,4,5
E33012679,556,411,126,285,2,65,50,15,71,61,0,6,4,7
E33012680,272,230,66,164,0,11,8,3,27,24,0,2,1,4
E33012681,286,246,78,168,0,21,18,3,19,18,0,1,0,0
E33012682,376,311,87,224,0,37,29,8,25,22,0,2,1,3
E33012683,285,223,77,146,0,22,15,7,35,26,1,7,1,5
E33012684,294,251,82,169,0,28,19,9,10,7,0,3,0,5
E33012685,246,214,65,149,0,11,10,1,21,19,0,1,1,0
E33012686,293,238,77,161,2,25,17,8,27,23,2,1,1,1
E33012687,363,322,130,192,0,16,12,4,23,23,0,0,0,2
E33012688,527,435,118,317,1,39,26,13,45,35,1,8,1,7
E33012689,332,267,88,179,1,27,21,6,25,19,3,2,1,12
E33012690,298,253,87,166,1,20,16,4,23,22,0,1,0,1
E33012691,253,197,68,129,0,14,14,0,39,36,3,0,0,3
E33012692,340,268,92,176,0,16,11,5,55,38,0,14,3,1
E33012693,292,247,111,136,0,17,11,6,23,16,0,7,0,5
E33012694,309,250,73,177,2,9,7,2,43,36,0,7,0,5
E33012695,235,170,59,111,3,24,20,4,38,32,3,3,0,0
E33012696,382,307,105,202,0,22,13,9,47,41,3,3,0,6
E33012697,324,267,97,170,0,26,19,7,28,23,0,3,2,3
E33012698,314,259,77,182,0,26,14,12,26,23,0,2,1,3
E33012699,312,263,90,173,0,20,17,3,27,23,0,4,0,2
E33012700,356,288,92,196,2,29,20,9,36,33,1,2,0,1
E33012701,354,308,87,221,1,18,14,4,23,20,1,2,0,4
E33012702,510,400,127,273,1,29,23,6,79,66,5,4,4,1
E33012703,355,245,74,171,2,69,57,12,38,32,0,6,0,1
E33012704,633,486,119,367,3,83,65,18,59,46,0,10,3,2
E33012705,367,286,79,207,1,44,34,10,34,28,0,6,0,2
E33012706,340,253,67,186,2,47,37,10,36,34,0,2,0,2
E33012707,430,352,131,221,3,29,18,11,45,31,6,7,1,1
E33012708,750,575,179,396,0,54,40,14,113,106,0,6,1,8
E33012709,317,256,89,167,1,30,21,9,29,22,0,6,1,1
E33012710,721,506,147,359,7,104,78,26,90,84,1,4,1,14
E33012711,540,381,105,276,1,92,65,27,60,54,1,5,0,6
E33012712,455,351,122,229,0,51,35,16,45,36,1,7,1,8
E33012713,444,334,91,243,0,55,44,11,50,45,0,4,1,5
E33012714,480,397,117,280,0,31,25,6,49,40,0,8,1,3
E33012715,370,301,94,207,0,22,11,11,44,42,0,2,0,3
E33012716,532,448,114,334,1,28,19,9,50,44,1,4,1,5
E33012717,387,304,107,197,1,38,29,9,41,33,0,5,3,3
E33012718,685,549,175,374,3,78,68,10,52,49,2,1,0,3
E33012719,336,247,80,167,0,51,42,9,37,30,0,3,4,1
E33012720,253,182,58,124,1,25,21,4,45,37,4,1,3,0
E33012721,314,244,59,185,0,28,17,11,38,33,2,3,0,4
E33012722,297,234,79,155,0,27,20,7,34,29,0,5,0,2
E33012723,214,160,44,116,0,17,9,8,35,32,0,3,0,2
E33012724,510,414,115,299,1,42,33,9,47,43,0,4,0,6
E33012725,297,199,47,152,0,53,41,12,41,38,0,3,0,4
E33012726,701,539,138,401,2,80,58,22,74,67,0,5,2,6
E33012727,395,305,73,232,1,58,47,11,30,21,1,8,0,1
E33012728,515,382,99,283,1,67,47,20,58,52,0,6,0,7
E33012729,478,324,56,268,0,61,50,11,90,81,0,9,0,3
E33012730,855,665,130,535,2,58,47,11,128,118,0,10,0,2
E33012731,1316,911,161,750,2,185,141,44,214,198,1,13,2,4
E33012732,583,403,91,312,2,121,43,78,55,48,1,5,1,2
E33012733,307,203,44,159,1,63,56,7,35,29,0,6,0,5
E33012734,255,168,33,135,1,60,57,3,26,23,0,2,1,0
E33012735,360,240,56,184,2,77,71,6,37,34,0,3,0,4
E33012736,750,456,111,345,0,212,175,37,70,64,0,5,1,12
E33012737,328,234,30,204,2,40,35,5,48,48,0,0,0,4
E33012738,407,318,69,249,1,42,41,1,44,39,0,4,1,2
E33012739,399,290,65,225,2,56,48,8,49,46,0,3,0,2
E33012740,446,271,47,224,0,103,94,9,69,63,1,4,1,3
E33012741,415,310,75,235,2,36,27,9,61,52,3,4,2,6
E33012742,524,389,123,266,1,60,46,14,71,66,0,3,2,3
E33012743,758,586,146,440,1,73,58,15,95,85,2,6,2,3
E33012744,390,309,70,239,0,31,26,5,48,39,1,4,4,2
E33012745,256,206,50,156,0,25,18,7,22,20,0,2,0,3
E33012746,409,317,77,240,1,32,25,7,57,47,2,6,2,2
E33012747,284,213,47,166,1,49,42,7,20,17,0,3,0,1
E33012748,316,177,50,127,0,90,65,25,44,41,0,3,0,5
E33012749,534,315,60,255,1,148,119,29,60,56,0,4,0,10
E33012750,600,456,139,317,3,86,76,10,53,49,0,4,0,2
E33012751,443,321,89,232,3,70,66,4,47,42,0,5,0,2
E33012752,462,333,73,260,1,89,76,13,33,31,0,2,0,6
E33012753,288,210,61,149,0,46,38,8,28,20,0,6,2,4
E33012754,574,385,88,297,1,115,107,8,67,59,2,4,2,6
E33012755,558,417,105,312,2,75,60,15,60,52,0,6,2,4
E33012756,602,420,113,307,3,91,77,14,83,77,1,4,1,5
E33012757,327,239,49,190,1,51,45,6,36,34,0,2,0,0
E33012758,419,330,100,230,3,22,17,5,61,56,0,5,0,3
E33012759,500,395,93,302,1,24,18,6,78,71,0,4,3,2
E33012760,314,182,52,130,1,27,15,12,99,90,0,7,2,5
E33012761,2659,1983,605,1378,2,104,68,36,558,524,0,27,7,12
E33012762,437,351,100,251,0,31,25,6,52,47,0,5,0,3
E33012763,396,353,99,254,2,6,5,1,33,29,0,3,1,2
E33012764,745,564,131,433,0,90,79,11,89,83,0,6,0,2
E33012765,567,414,71,343,4,63,52,11,85,80,1,4,0,1
E33012766,343,302,106,196,0,12,12,0,27,23,0,4,0,2
E33012767,398,329,91,238,0,20,18,2,48,45,1,2,0,1
E33012768,310,259,74,185,1,17,14,3,29,28,0,1,0,4
E33012769,302,210,50,160,0,24,16,8,67,58,0,7,2,1
E33012770,361,252,94,158,0,32,20,12,76,68,2,6,0,1
E33012771,278,187,49,138,1,38,31,7,47,43,0,3,1,5
E33012772,257,212,62,150,1,19,16,3,21,21,0,0,0,4
E33012773,275,164,48,116,3,29,26,3,78,72,3,2,1,1
E33012774,272,167,55,112,2,32,27,5,70,66,1,3,0,1
E33012775,258,106,22,84,1,38,24,14,111,103,3,2,3,2
E33012776,265,173,50,123,0,31,23,8,59,56,0,3,0,2
E33012777,275,172,43,129,1,33,27,6,68,62,1,5,0,1
E33012778,256,149,37,112,0,16,11,5,89,86,0,3,0,2
E33012779,238,154,43,111,0,15,11,4,68,60,0,6,2,1
E33012780,430,254,59,195,0,36,27,9,137,125,0,11,1,3
E33012781,268,192,54,138,1,18,13,5,57,53,2,2,0,0
E33012782,346,281,91,190,0,22,20,2,40,34,1,3,2,3
E33012783,397,315,82,233,1,30,26,4,44,42,1,1,0,7
E33012784,302,214,66,148,3,29,22,7,56,54,0,2,0,0
E33012785,541,309,70,239,1,146,119,27,79,73,0,6,0,6
E33012786,424,284,67,217,5,86,63,23,45,42,0,3,0,4
E33012787,287,171,50,121,2,16,9,7,97,92,0,5,0,1
E33012788,294,190,66,124,1,13,10,3,88,83,0,5,0,2
E33012789,256,157,51,106,2,17,13,4,78,69,0,6,3,2
E33012790,340,222,69,153,1,21,15,6,90,88,0,2,0,6
E33012791,731,539,132,407,2,104,93,11,81,71,1,9,0,5
E33012792,261,182,44,138,0,31,25,6,46,37,2,7,0,2
E33012793,633,514,121,393,2,46,34,12,70,63,0,7,0,1
E33012794,440,353,80,273,4,40,25,15,40,33,1,6,0,3
E33012795,254,168,55,113,1,49,33,16,34,32,0,2,0,2
E33012796,534,337,69,268,2,105,82,23,89,75,1,13,0,1
E33012797,309,193,35,158,0,78,73,5,36,31,1,4,0,2
E33012798,262,195,45,150,3,26,22,4,38,31,2,5,0,0
E33012799,341,221,59,162,1,55,38,17,61,60,0,1,0,3
E33012800,268,180,47,133,1,14,12,2,72,65,2,5,0,1
E33012801,324,196,54,142,1,41,31,10,84,80,0,3,1,2
E33012802,279,208,63,145,2,20,15,5,46,44,0,2,0,3
E33012803,408,297,69,228,1,28,24,4,74,67,0,7,0,8
E33012804,288,222,64,158,1,11,10,1,52,45,0,7,0,2
E33012805,307,150,53,97,2,51,36,15,103,98,2,0,3,1
E33012806,264,152,37,115,0,51,38,13,57,55,0,2,0,4
E33012807,527,380,92,288,0,56,43,13,89,81,1,6,1,2
E33012808,296,190,41,149,1,39,33,6,66,59,0,6,1,0
E33012809,248,180,57,123,1,35,31,4,30,29,0,1,0,2
E33012810,257,185,61,124,1,32,26,6,34,31,1,2,0,5
E33012811,300,183,50,133,1,41,27,14,73,70,1,2,0,2
E33012812,290,207,60,147,0,12,11,1,68,65,0,3,0,3
E33012813,526,405,121,284,0,27,20,7,89,81,0,8,0,5
E33012814,299,200,50,150,1,35,29,6,61,57,1,1,2,2
E33012815,321,242,75,167,0,26,18,8,52,48,0,4,0,1
E33012816,423,238,74,164,0,29,18,11,152,132,2,16,2,4
E33012817,319,233,50,183,1,42,30,12,43,41,0,2,0,0
E33012818,478,359,89,270,1,30,25,5,86,79,0,4,3,2
E33012819,463,324,66,258,0,69,50,19,67,62,0,5,0,3
E33012820,358,235,54,181,1,65,52,13,53,51,0,2,0,4
E33012821,671,421,89,332,2,111,89,22,132,122,1,9,0,5
E33012822,393,274,66,208,0,48,35,13,69,63,3,3,0,2
E33012823,275,168,21,147,2,40,32,8,62,59,0,3,0,3
E33012824,237,168,47,121,5,29,20,9,33,31,0,2,0,2
E33012825,463,352,82,270,0,25,17,8,82,78,0,3,1,4
E33012826,864,658,135,523,1,58,47,11,143,133,1,9,0,4
E33012827,453,319,73,246,1,33,28,5,96,92,0,1,3,4
E33012828,330,240,58,182,0,18,15,3,70,66,0,4,0,2
E33012829,346,213,63,150,0,26,13,13,103,96,1,4,2,4
E33012830,327,249,62,187,0,15,14,1,60,55,3,2,0,3
E33012831,338,273,88,185,1,22,19,3,38,31,0,7,0,4
E33012832,293,227,66,161,2,33,27,6,27,25,1,1,0,4
E33012833,297,240,62,178,1,17,13,4,37,35,0,1,1,2
E33012834,388,300,65,235,0,25,23,2,61,57,0,3,1,2
E33012835,853,606,182,424,7,94,61,33,144,128,0,13,3,2
E33012836,401,298,85,213,2,43,37,6,54,52,0,2,0,4
E33012837,622,426,102,324,1,106,78,28,85,77,0,6,2,4
E33012838,465,250,62,188,5,118,100,18,87,75,4,5,3,5
E33012839,1407,1044,281,763,6,112,81,31,239,219,0,17,3,6
E33012840,589,465,128,337,1,44,43,1,77,74,0,2,1,2
E33012841,250,153,39,114,0,48,32,16,49,46,1,1,1,0
E33012842,1156,789,142,647,3,127,103,24,233,222,0,7,4,4
E33012843,411,288,85,203,0,43,40,3,79,73,0,5,1,1
E33012844,256,182,38,144,1,26,22,4,47,43,0,2,2,0
E33012845,253,162,46,116,0,12,6,6,78,74,0,4,0,1
E33012846,284,156,58,98,4,46,30,16,75,66,0,8,1,3
E33012847,416,256,61,195,1,47,26,21,110,104,0,5,1,2
E33012848,259,174,59,115,0,28,19,9,56,53,0,2,1,1
E33012849,279,177,40,137,1,56,40,16,44,40,1,3,0,1
E33012850,307,216,50,166,2,58,46,12,31,25,0,5,1,0
E33012851,446,280,69,211,1,82,69,13,81,74,0,7,0,2
E33012852,240,205,101,104,1,9,7,2,22,20,0,2,0,3
E33012853,295,226,77,149,1,23,9,14,43,36,0,7,0,2
E33012854,366,302,109,193,0,16,11,5,43,38,1,3,1,5
E33012855,503,399,134,265,0,16,9,7,81,71,2,8,0,7
E33012856,246,183,59,124,1,25,21,4,36,34,0,2,0,1
E33012857,379,321,106,215,2,10,3,7,45,39,2,3,1,1
E33012858,433,355,153,202,1,20,17,3,52,44,1,5,2,5
E33012859,688,514,143,371,3,57,42,15,103,87,3,12,1,11
E33012860,249,188,90,98,0,10,6,4,45,39,0,6,0,6
E33012861,338,234,81,153,1,33,30,3,69,52,6,11,0,1
E33012862,824,619,208,411,3,57,47,10,138,129,1,8,0,7
E33012863,399,294,78,216,0,35,33,2,69,64,0,5,0,1
E33012864,303,213,88,125,0,37,30,7,46,40,0,5,1,7
E33012865,283,215,75,140,0,15,10,5,51,45,1,4,1,2
E33012866,565,400,146,254,1,30,22,8,128,117,2,8,1,6
E33012867,254,167,54,113,0,15,11,4,66,62,1,2,1,6
E33012868,582,463,136,327,1,17,11,6,94,81,0,13,0,7
E33012869,257,187,53,134,0,18,14,4,49,38,5,6,0,3
E33012870,243,165,61,104,2,15,12,3,58,51,2,5,0,3
E33012871,232,153,59,94,0,14,8,6,62,55,1,5,1,3
E33012872,810,569,158,411,3,54,33,21,176,156,1,19,0,8
E33012873,347,254,95,159,0,15,8,7,72,65,1,6,0,6
E33012874,447,331,115,216,0,19,9,10,95,88,1,6,0,2
E33012875,360,222,81,141,0,21,19,2,112,98,4,8,2,5
E33012876,412,244,120,124,2,24,17,7,117,103,7,6,1,25
E33012877,372,310,144,166,0,13,5,8,42,35,1,5,1,7
E33012878,270,194,101,93,3,11,6,5,42,34,2,5,1,20
E33012879,329,254,94,160,1,13,7,6,57,51,1,5,0,4
E33012880,351,256,112,144,0,24,16,8,68,57,7,2,2,3
E33012881,373,243,103,140,1,24,22,2,86,60,23,3,0,19
E33012882,369,294,97,197,0,13,10,3,54,47,4,3,0,8
E33012883,263,163,68,95,2,8,7,1,70,59,4,5,2,20
E33012884,273,208,68,140,0,16,12,4,41,35,2,1,3,8
E33012885,533,433,129,304,1,19,15,4,65,54,3,7,1,15
E33012886,296,241,89,152,0,9,6,3,41,33,3,2,3,5
E33012887,313,262,102,160,1,13,8,5,33,33,0,0,0,4
E33012888,581,424,156,268,3,40,25,15,107,95,2,8,2,7
E33012889,1078,878,190,688,5,48,24,24,145,136,1,5,3,2
E33012890,608,436,163,273,1,53,33,20,109,100,1,5,3,9
E33012891,289,249,81,168,0,9,3,6,25,19,0,2,4,6
E33012892,728,578,203,375,1,31,23,8,106,92,3,9,2,12
E33012893,288,221,84,137,0,19,14,5,45,39,1,5,0,3
E33012894,405,305,135,170,2,25,19,6,69,53,9,5,2,4
E33012895,410,327,95,232,1,19,16,3,59,44,2,8,5,4
E33012896,243,186,67,119,0,16,13,3,37,32,4,1,0,4
E33012897,334,288,123,165,0,8,4,4,32,24,4,1,3,6
E33012898,225,189,67,122,0,6,4,2,25,24,0,0,1,5
E33012899,326,255,70,185,0,1,1,0,60,53,5,1,1,10
E33012900,308,227,71,156,2,16,7,9,60,57,1,1,1,3
E33012901,564,465,131,334,2,30,21,9,65,64,0,1,0,2
E33012902,251,136,61,75,0,13,12,1,68,62,4,1,1,34
E33012903,258,215,96,119,1,3,3,0,36,35,0,1,0,3
E33012904,482,346,91,255,0,43,36,7,82,74,4,0,4,11
E33012905,237,142,59,83,1,7,5,2,52,49,2,1,0,35
E33012906,290,225,81,144,1,13,7,6,47,44,0,3,0,4
E33012907,451,362,102,260,1,20,14,6,65,62,0,3,0,3
E33012908,281,204,65,139,0,27,25,2,49,44,0,5,0,1
E33012909,262,197,71,126,0,12,9,3,52,48,2,2,0,1
E33012910,508,360,85,275,0,28,21,7,108,98,3,5,2,12
E33012911,252,195,78,117,1,16,13,3,36,34,1,1,0,4
E33012912,285,223,94,129,0,24,20,4,36,34,1,1,0,2
E33012913,370,302,100,202,1,10,8,2,55,50,0,2,3,2
E33012914,349,241,83,158,1,26,20,6,77,76,0,0,1,4
E33012915,231,191,69,122,0,8,7,1,29,24,0,2,3,3
E33012916,293,170,65,105,2,9,6,3,89,84,5,0,0,23
E33012917,1615,1207,309,898,2,90,57,33,301,202,57,8,34,15
E33012918,351,252,97,155,1,24,20,4,68,62,0,4,2,6
E33012919,324,252,81,171,3,8,5,3,49,42,2,4,1,12
E33012920,306,237,82,155,0,16,15,1,50,47,1,1,1,3
E33012921,441,348,124,224,0,29,21,8,60,45,0,5,10,4
E33012922,284,236,94,142,0,9,8,1,36,32,2,2,0,3
E33012923,297,257,91,166,1,5,5,0,33,25,1,5,2,1
E33012924,274,185,64,121,0,38,28,10,50,48,0,2,0,1
E33012925,296,238,87,151,1,8,3,5,46,38,3,4,1,3
E33012926,326,251,73,178,0,8,7,1,63,54,4,4,1,4
E33012927,410,329,85,244,1,24,16,8,55,47,0,3,5,1
E33012928,365,284,107,177,2,12,8,4,63,53,0,6,4,4
E33012929,534,401,134,267,1,40,26,14,84,77,0,3,4,8
E33012930,514,384,132,252,3,40,31,9,79,68,1,9,1,8
E33012931,389,307,94,213,1,14,12,2,61,52,4,5,0,6
E33012932,318,284,97,187,0,5,3,2,26,24,1,1,0,3
E33012933,401,306,73,233,2,30,22,8,60,52,0,4,4,3
E33012934,468,384,109,275,0,21,19,2,57,49,1,7,0,6
E33012935,497,427,137,290,2,11,8,3,53,47,1,4,1,4
E33012936,302,229,76,153,0,39,33,6,32,27,0,4,1,2
E33012937,572,447,141,306,4,40,32,8,80,73,0,6,1,1
E33012938,664,468,128,340,3,98,81,17,90,81,1,8,0,5
E33012939,326,250,71,179,0,48,47,1,26,21,1,4,0,2
E33012940,221,186,92,94,1,4,3,1,21,18,0,3,0,9
E33012941,235,186,72,114,2,12,6,6,32,24,5,3,0,3
E33012942,253,203,77,126,0,18,9,9,29,27,0,2,0,3
E33012943,307,254,119,135,2,11,9,2,31,27,1,3,0,9
E33012944,461,369,120,249,3,38,23,15,46,45,0,1,0,5
E33012945,284,243,107,136,0,10,8,2,26,25,0,1,0,5
E33012946,361,284,90,194,2,12,10,2,56,47,1,7,1,7
E33012947,299,221,81,140,0,16,13,3,51,44,2,4,1,11
E33012948,436,371,125,246,2,23,15,8,32,29,0,3,0,8
E33012949,397,316,90,226,2,17,12,5,60,53,0,6,1,2
E33012950,459,318,85,233,1,61,52,9,74,69,0,5,0,5
E33012951,318,251,68,183,0,21,15,6,42,38,1,2,1,4
E33012952,233,172,63,109,1,16,8,8,41,40,0,1,0,3
E33012953,319,254,73,181,0,17,16,1,48,45,1,2,0,0
E33012954,416,305,80,225,5,24,14,10,73,67,0,5,1,9
E33012955,348,304,112,192,2,15,9,6,26,24,0,2,0,1
E33012956,421,300,88,212,0,37,28,9,82,66,1,9,6,2
E33012957,274,186,52,134,0,28,23,5,55,50,3,2,0,5
E33012958,247,197,63,134,0,8,5,3,39,33,0,4,2,3
E33012959,333,244,55,189,1,27,21,6,59,54,0,5,0,2
E33012960,344,286,88,198,2,14,14,0,37,31,3,1,2,5
E33012961,477,368,118,250,1,25,19,6,70,57,7,6,0,13
E33012962,797,614,154,460,1,69,58,11,110,99,2,8,1,3
E33012963,507,389,123,266,1,49,26,23,64,50,1,10,3,4
E33012964,356,297,78,219,1,25,18,7,32,28,0,0,4,1
E33012965,720,444,132,312,9,58,49,9,199,187,1,11,0,10
E33012966,321,264,95,169,1,11,8,3,33,28,1,4,0,12
E33012967,256,201,81,120,0,11,7,4,37,30,0,3,4,7
E33012968,384,303,87,216,2,37,30,7,39,33,0,6,0,3
E33012969,271,211,69,142,0,17,12,5,39,32,1,4,2,4
E33012970,288,199,83,116,2,26,22,4,43,39,1,3,0,18
E33012971,640,504,157,347,0,47,38,9,81,77,2,1,1,8
E33012972,459,342,117,225,3,27,22,5,77,68,1,7,1,10
E33012973,325,266,92,174,0,18,15,3,41,38,0,3,0,0
E33012974,278,208,69,139,0,25,23,2,42,39,0,3,0,3
E33012975,294,238,65,173,0,19,11,8,36,34,0,2,0,1
E33012976,296,232,65,167,0,25,24,1,36,33,0,2,1,3
E33012977,963,827,121,706,2,32,25,7,101,97,0,2,2,1
E33012978,394,278,64,214,1,45,39,6,69,64,0,3,2,1
E33012979,269,214,87,127,2,18,18,0,32,27,3,2,0,3
E33012980,426,352,115,237,2,12,10,2,56,51,0,4,1,4
E33012981,316,243,82,161,0,21,13,8,44,39,1,3,1,8
E33012982,338,254,94,160,6,11,10,1,64,55,0,4,5,3
E33012983,264,217,61,156,0,8,6,2,37,30,6,1,0,2
E33012984,986,806,195,611,3,44,31,13,124,115,3,5,1,9
E33012985,320,263,74,189,1,29,26,3,26,22,1,3,0,1
E33012986,362,263,91,172,2,30,27,3,63,59,0,2,2,4
E33012987,640,474,127,347,0,57,48,9,102,93,1,7,1,7
E33012988,392,280,87,193,1,32,26,6,71,67,0,2,2,8
E33012989,221,185,65,120,0,11,7,4,23,21,0,2,0,2
E33012990,850,663,150,513,3,38,27,11,142,121,6,14,1,4
E33012991,336,248,76,172,1,25,14,11,60,57,2,1,0,2
E33012992,309,243,82,161,2,15,13,2,45,42,0,1,2,4
E33012993,265,229,69,160,1,10,7,3,21,17,2,2,0,4
E33012994,430,259,97,162,3,53,43,10,108,99,4,5,0,7
E33012995,393,326,112,214,0,23,12,11,40,36,0,4,0,4
E33012996,238,195,62,133,0,11,9,2,28,27,0,1,0,4
E33012997,432,356,79,277,1,22,19,3,53,49,0,4,0,0
E33012998,329,281,78,203,0,9,5,4,36,32,0,4,0,3
E33012999,301,252,84,168,0,18,17,1,28,28,0,0,0,3
E33013000,314,252,60,192,0,15,13,2,44,35,0,9,0,3
E33013001,441,369,116,253,0,25,22,3,44,37,1,4,2,3
E33013002,282,237,72,165,0,12,10,2,28,26,0,2,0,5
E33013003,470,400,153,247,0,26,22,4,37,35,0,2,0,7
E33013004,268,210,75,135,2,19,14,5,34,33,0,1,0,3
E33013005,468,403,129,274,1,15,14,1,46,40,3,3,0,3
E33013006,315,236,58,178,1,20,15,5,56,52,2,2,0,2
E33013007,1098,527,128,399,4,86,76,10,473,467,1,4,1,8
E33013008,640,503,147,356,1,38,28,10,88,87,0,1,0,10
E33013009,586,469,153,316,2,32,27,5,75,65,0,8,2,8
E33013010,544,453,127,326,4,24,21,3,56,52,0,4,0,7
E33013011,274,201,64,137,1,13,13,0,57,37,7,5,8,2
E33013012,615,500,142,358,1,25,24,1,85,73,2,9,1,4
E33013013,543,451,153,298,0,26,21,5,57,51,0,4,2,9
E33013014,447,338,109,229,1,21,20,1,83,79,1,0,3,4
E33013015,398,317,105,212,6,23,17,6,49,44,1,2,2,3
E33013016,299,235,90,145,1,13,13,0,40,36,0,3,1,10
E33013017,792,648,176,472,1,24,22,2,103,97,2,4,0,16
E33013018,301,242,72,170,2,11,7,4,45,38,0,5,2,1
E33013019,486,407,133,274,1,23,20,3,50,47,0,2,1,5
E33013020,523,420,91,329,8,18,12,6,76,74,0,1,1,1
E33013021,247,211,56,155,1,17,14,3,18,17,0,1,0,0
E33013022,1973,1746,382,1364,1,49,42,7,173,156,0,15,2,4
E33013023,483,399,83,316,0,20,19,1,61,57,0,4,0,3
E33013024,618,479,135,344,1,50,40,10,81,74,0,7,0,7
E33013025,391,308,77,231,1,13,4,9,64,57,1,6,0,5
E33013026,321,276,83,193,2,10,9,1,32,28,0,3,1,1
E33013027,322,249,88,161,1,26,16,10,39,34,0,3,2,7
E33013028,241,178,44,134,0,16,13,3,47,42,0,5,0,0
E33013029,527,401,116,285,1,45,41,4,79,74,2,3,0,1
E33013030,370,278,68,210,0,40,35,5,51,42,1,7,1,1
E33013031,322,244,70,174,1,25,20,5,52,49,0,3,0,0
E33013032,287,230,57,173,1,16,14,2,39,37,0,2,0,1
E33013033,228,174,43,131,1,14,13,1,37,32,2,3,0,2
E33013034,419,297,85,212,3,55,50,5,62,56,0,6,0,2
E33013035,320,275,84,191,0,6,4,2,37,36,0,0,1,2
E33013036,329,277,87,190,0,12,12,0,37,35,0,2,0,3
E33013037,263,222,71,151,0,6,4,2,32,25,0,7,0,3
E33013038,465,388,131,257,0,23,19,4,50,48,0,2,0,4
E33013039,299,252,74,178,2,12,10,2,28,23,0,5,0,5
E33013040,315,215,52,163,1,29,26,3,69,67,0,2,0,1
E33013041,268,214,50,164,0,12,12,0,42,39,0,3,0,0
E33013042,434,330,84,246,6,33,32,1,60,52,2,5,1,5
E33013043,306,240,58,182,0,13,9,4,53,51,0,1,1,0
E33013044,526,431,140,291,2,22,20,2,67,61,1,5,0,4
E33013045,408,345,83,262,0,18,14,4,40,37,0,3,0,5
E33013046,598,501,179,322,3,21,17,4,68,61,2,3,2,5
E33013047,452,386,116,270,0,20,16,4,45,34,1,6,4,1
E33013048,312,244,86,158,0,19,18,1,41,32,2,5,2,8
E33013049,899,589,165,424,1,52,42,10,247,232,2,12,1,10
E33013050,223,162,60,102,0,12,8,4,47,47,0,0,0,2
E33013051,451,370,129,241,0,22,19,3,55,51,0,2,2,4
E33013052,363,274,95,179,3,24,22,2,62,49,3,10,0,0
E33013053,633,449,144,305,3,45,44,1,130,120,2,6,2,6
E33013054,256,201,71,130,0,19,18,1,29,21,5,0,3,7
E33013055,355,233,67,166,0,46,44,2,69,60,1,8,0,7
E33013056,490,377,135,242,2,40,38,2,67,56,0,8,3,4
E33013057,436,327,90,237,2,28,19,9,79,72,0,6,1,0
E33013058,271,161,43,118,0,24,20,4,85,73,3,8,1,1
E33013059,553,363,85,278,3,45,38,7,141,132,2,7,0,1
E33013060,347,232,69,163,0,23,19,4,87,84,0,2,1,5
E33013061,763,545,167,378,0,56,44,12,157,148,1,7,1,5
E33013062,478,355,120,235,2,40,28,12,80,74,1,5,0,1
E33013063,255,228,88,140,1,8,8,0,18,16,0,2,0,0
E33013064,245,187,61,126,0,20,17,3,36,33,0,3,0,2
E33013065,1306,878,196,682,2,105,84,21,318,294,2,20,2,3
E33013066,326,225,62,163,0,13,11,2,86,81,1,3,1,2
E33013067,341,238,68,170,2,49,46,3,49,49,0,0,0,3
E33013068,263,192,64,128,0,27,18,9,40,39,0,1,0,4
E33013069,858,652,176,476,3,70,57,13,127,112,3,10,2,6
E33013070,241,193,59,134,0,17,14,3,30,26,1,1,2,1
E33013071,223,193,58,135,0,9,6,3,19,17,1,1,0,2
E33013072,290,235,75,160,1,12,9,3,32,29,0,2,1,10
E33013073,285,250,81,169,0,8,7,1,26,24,0,0,2,1
E33013074,259,227,75,152,1,12,9,3,19,18,0,1,0,0
E33013075,640,514,157,357,2,50,40,10,69,61,2,4,2,5
E33013076,360,266,91,175,1,46,38,8,44,39,0,5,0,3
E33013077,264,183,62,121,1,18,6,12,59,58,0,1,0,3
E33013078,349,262,73,189,2,26,12,14,53,47,2,2,2,6
E33013079,330,251,66,185,1,42,18,24,34,32,0,2,0,2
E33013080,357,243,58,185,0,64,28,36,49,42,0,7,0,1
E33013081,455,353,93,260,0,35,19,16,64,57,0,4,3,3
E33013082,401,318,71,247,1,18,7,11,62,50,4,7,1,2
E33013083,451,270,82,188,6,107,29,78,66,61,0,4,1,2
E33013084,602,450,111,339,0,55,28,27,92,83,1,8,0,5
E33013085,291,204,51,153,3,25,4,21,59,57,1,1,0,0
E33013086,262,194,59,135,0,15,3,12,53,46,0,7,0,0
E33013087,542,396,93,303,1,40,20,20,103,95,1,7,0,2
E33013088,318,229,64,165,2,15,11,4,70,58,0,10,2,2
E33013089,424,311,88,223,2,20,6,14,90,82,1,7,0,1
E33013090,315,286,87,199,0,4,1,3,23,20,0,1,2,2
E33013091,564,454,90,364,6,31,16,15,70,62,1,7,0,3
E33013092,388,284,65,219,3,9,3,6,88,82,0,6,0,4
E33013093,365,255,61,194,1,18,4,14,89,79,0,9,1,2
E33013094,521,386,93,293,3,26,10,16,102,93,0,9,0,4
E33013095,532,344,92,252,0,41,18,23,144,135,0,7,2,3
E33013096,837,664,148,516,3,43,17,26,121,103,2,14,2,6
E33013097,330,271,80,191,0,12,5,7,41,38,2,1,0,6
E33013098,332,291,85,206,1,5,2,3,32,30,0,2,0,3
E33013099,281,232,76,156,0,14,7,7,29,29,0,0,0,6
E33013100,264,211,56,155,1,10,4,6,42,41,0,1,0,0
E33013101,596,458,101,357,1,38,17,21,98,85,6,7,0,1
E33013102,337,239,54,185,0,16,5,11,70,62,1,7,0,12
E33013103,284,230,69,161,2,7,2,5,42,40,0,1,1,3
E33013104,451,326,94,232,0,44,15,29,77,69,2,6,0,4
E33013105,328,265,58,207,0,13,2,11,49,46,0,3,0,1
E33013106,489,373,82,291,4,24,5,19,84,78,3,3,0,4
E33013107,325,263,86,177,0,22,13,9,40,31,0,9,0,0
E33013108,303,193,44,149,3,33,16,17,70,64,0,5,1,4
E33013109,409,329,78,251,1,14,3,11,61,56,0,5,0,4
E33013110,480,335,89,246,2,22,12,10,114,104,2,7,1,7
E33013111,498,363,106,257,3,19,7,12,104,87,1,16,0,9
E33013112,444,340,103,237,1,16,10,6,83,76,0,7,0,4
E33013113,446,333,92,241,2,25,5,20,85,76,0,8,1,1
E33013114,392,290,82,208,0,13,3,10,86,79,2,4,1,3
E33013115,441,336,107,229,2,16,6,10,87,82,0,5,0,0
E33013116,687,543,135,408,2,29,9,20,107,87,3,10,7,6
E33013117,553,436,124,312,4,18,6,12,94,84,0,10,0,1
E33013118,722,584,163,421,4,40,22,18,91,82,1,8,0,3
E33013119,245,200,57,143,0,7,4,3,38,34,0,4,0,0
E33013120,376,294,80,214,0,16,5,11,64,60,0,4,0,2
E33013121,322,225,60,165,1,12,4,8,84,79,0,5,0,0
E33013122,436,329,83,246,2,50,22,28,52,50,0,2,0,3
E33013123,332,267,67,200,0,28,10,18,35,34,0,1,0,2
E33013124,606,513,156,357,6,22,7,15,63,61,0,2,0,2
E33013125,348,250,66,184,1,17,6,11,74,70,2,2,0,6
E33013126,553,447,103,344,2,18,8,10,85,75,2,7,1,1
E33013127,2989,2410,588,1822,7,92,33,59,460,363,56,25,16,20
E33013128,261,199,60,139,0,12,6,6,47,30,1,12,4,3
E33013129,608,495,125,370,2,41,14,27,63,52,1,7,3,7
E33013130,278,179,40,139,1,20,8,12,76,69,2,4,1,2
E33013131,534,429,136,293,0,14,5,9,89,78,4,6,1,2
E33013132,696,504,119,385,1,33,15,18,156,145,3,7,1,2
E33013133,358,242,69,173,0,18,8,10,96,87,1,8,0,2
E33013134,356,320,113,207,0,9,1,8,24,23,0,0,1,3
E33013135,550,450,127,323,0,25,9,16,73,70,0,3,0,2
E33013136,310,258,68,190,1,31,13,18,16,14,1,1,0,4
E33013137,264,172,45,127,0,58,28,30,33,30,0,3,0,1
E33013138,269,170,38,132,2,50,21,29,46,43,0,3,0,1
E33013139,375,270,62,208,2,56,23,33,46,44,0,2,0,1
E33013140,316,269,68,201,1,9,7,2,36,32,2,1,1,1
E33013141,495,342,115,227,2,32,15,17,113,91,10,7,5,6
E33013142,768,646,174,472,4,19,11,8,96,82,0,11,3,3
E33013143,322,263,50,213,4,9,4,5,46,43,0,3,0,0
E33013144,587,498,136,362,0,17,8,9,69,60,2,7,0,3
E33013145,431,369,96,273,2,11,2,9,47,43,1,3,0,2
E33013146,288,264,94,170,0,5,3,2,17,15,1,1,0,2
E33013147,376,320,86,234,1,8,3,5,44,39,4,1,0,3
E33013148,365,318,110,208,0,7,3,4,37,31,1,5,0,3
E33013149,261,211,76,135,2,9,6,3,37,31,3,2,1,2
E33013150,315,241,80,161,0,12,4,8,48,38,8,2,0,14
E33013151,275,197,46,151,1,13,3,10,64,56,0,6,2,0
E33013152,769,636,180,456,1,24,7,17,103,93,2,8,0,5
E33013153,425,341,107,234,1,13,7,6,64,62,1,1,0,6
E33013154,485,348,99,249,2,42,19,23,92,78,5,2,7,1
E33013155,378,310,87,223,1,29,11,18,33,30,1,2,0,5
E33013156,456,350,111,239,1,28,14,14,72,63,1,3,5,5
E33013157,347,274,108,166,2,18,12,6,42,38,2,2,0,11
E33013158,402,335,107,228,2,16,10,6,48,42,0,6,0,1
E33013159,235,191,41,150,0,10,2,8,30,23,1,6,0,4
E33013160,379,273,84,189,1,41,15,26,60,51,1,6,2,4
E33013161,599,455,116,339,1,43,24,19,96,90,0,5,1,4
E33013162,423,335,91,244,2,25,12,13,55,47,4,4,0,6
E33013163,308,243,88,155,0,12,4,8,46,44,0,2,0,7
E33013164,518,438,120,318,0,28,13,15,46,45,1,0,0,6
E33013165,445,333,84,249,2,33,13,20,74,61,3,10,0,3
E33013166,417,324,101,223,0,23,13,10,65,56,2,5,2,5
E33013167,454,371,120,251,2,28,17,11,46,40,1,5,0,7
E33013168,561,460,132,328,2,36,18,18,54,48,0,5,1,9
E33013169,350,292,81,211,1,5,4,1,48,38,1,7,2,4
E33013170,275,229,58,171,1,3,0,3,40,33,1,5,1,2
E33013171,793,672,168,504,5,36,17,19,76,67,0,8,1,4
E33013172,313,253,72,181,0,18,9,9,40,32,2,6,0,2
E33013173,258,199,51,148,0,13,7,6,45,35,6,2,2,1
E33013174,460,379,108,271,0,18,8,10,52,41,2,9,0,11
E33013175,448,372,92,280,0,23,11,12,51,45,0,4,2,2
E33013176,1125,872,209,663,3,91,33,58,153,140,3,10,0,6
E33013177,538,423,140,283,1,27,9,18,74,63,5,4,2,13
E33013178,391,260,70,190,0,54,21,33,73,65,2,4,2,4
E33013179,359,292,78,214,1,17,7,10,45,39,4,2,0,4
E33013180,404,312,113,199,0,33,22,11,53,47,0,4,2,6
E33013181,357,283,84,199,1,17,11,6,51,45,0,5,1,5
E33013182,764,591,163,428,5,62,40,22,98,83,5,9,1,8
E33013183,282,239,50,189,0,10,7,3,28,21,0,3,4,5
E33013184,422,350,109,241,3,37,17,20,32,28,0,4,0,0
E33013185,353,295,124,171,3,19,12,7,33,28,1,1,3,3
E33013186,582,405,86,319,0,58,29,29,116,112,1,2,1,3
E33013187,604,486,104,382,4,44,18,26,66,66,0,0,0,4
E33013188,353,268,63,205,0,25,13,12,58,51,4,3,0,2
E33013189,291,189,37,152,2,47,19,28,52,43,4,4,1,1
E33013190,694,488,131,357,2,89,41,48,115,103,1,9,2,0
E33013191,436,274,71,203,1,63,26,37,92,85,1,5,1,6
E33013192,831,586,177,409,2,117,57,60,114,97,2,10,5,12
E33013193,305,193,66,127,0,41,20,21,66,56,1,8,1,5
E33013194,293,239,73,166,1,11,7,4,40,39,0,1,0,2
E33013195,295,199,70,129,3,34,15,19,55,53,0,1,1,4
E33013196,321,261,72,189,0,20,6,14,37,35,0,2,0,3
E33013197,277,233,70,163,0,12,5,7,31,29,0,1,1,1
E33013198,277,229,76,153,1,16,6,10,31,24,0,7,0,0
E33013199,2683,2158,511,1647,5,173,73,100,338,307,11,19,1,9
E33013200,330,213,62,151,0,56,26,30,59,52,2,3,2,2
E33013201,353,293,63,230,1,20,9,11,37,33,1,3,0,2
E33013202,350,276,72,204,0,36,15,21,34,31,0,3,0,4
E33013203,564,479,152,327,1,33,18,15,48,45,1,2,0,3
E33013204,263,211,81,130,0,13,5,8,35,29,1,4,1,4
E33013205,761,646,186,460,1,38,12,26,70,61,1,8,0,6
E33013206,381,294,113,181,0,15,7,8,64,47,7,6,4,8
E33013207,565,473,169,304,4,18,9,9,64,57,0,6,1,6
E33013208,535,401,118,283,1,55,22,33,70,62,1,7,0,8
E33013209,293,253,73,180,0,13,8,5,23,19,2,2,0,4
E33013210,508,380,105,275,2,60,36,24,64,60,0,4,0,2
E33013211,382,289,90,199,3,25,8,17,63,55,0,5,3,2
E33013212,308,272,72,200,1,7,2,5,27,19,2,6,0,1
E33013213,358,268,73,195,2,12,9,3,71,63,5,3,0,5
E33013214,477,323,86,237,0,36,19,17,111,96,7,8,0,7
E33013215,397,328,93,235,3,33,17,16,28,25,0,2,1,5
E33013216,354,272,58,214,0,26,15,11,50,45,0,5,0,6
E33013217,356,261,66,195,0,44,24,20,50,45,0,4,1,1
E33013218,240,154,34,120,0,51,26,25,30,29,0,1,0,5
E33013219,323,242,80,162,1,38,20,18,41,34,0,7,0,1
E33013220,802,581,116,465,1,108,49,59,107,93,0,14,0,5
E33013221,396,307,85,222,0,32,10,22,52,47,1,4,0,5
E33013222,911,682,207,475,2,111,60,51,106,90,5,11,0,10
E33013223,312,223,67,156,1,52,39,13,33,30,2,0,1,3
E33013224,251,181,45,136,0,36,21,15,33,30,0,2,1,1
E33013225,594,429,135,294,0,70,34,36,91,79,2,8,2,4
E33013226,399,296,75,221,0,36,24,12,57,53,1,3,0,10
E33013227,330,269,71,198,0,35,24,11,25,23,0,2,0,1
E33013228,481,425,130,295,0,11,7,4,40,40,0,0,0,5
E33013229,290,207,53,154,0,46,21,25,34,29,0,4,1,3
E33013230,370,291,63,228,1,13,9,4,62,56,1,5,0,3
E33013231,418,338,93,245,3,21,7,14,53,43,1,9,0,3
E33013232,310,265,76,189,0,15,4,11,30,25,0,5,0,0
E33013233,378,315,78,237,4,15,4,11,44,41,0,3,0,0
E33013234,245,195,66,129,3,13,8,5,33,25,4,4,0,1
E33013235,311,269,71,198,1,18,7,11,20,18,0,2,0,3
E33013236,781,640,191,449,0,40,22,18,94,79,3,11,1,7
E33013237,429,366,126,240,0,23,13,10,30,22,1,3,4,10
E33013238,573,378,124,254,1,29,21,8,153,141,2,9,1,12
E33013239,327,264,83,181,1,17,14,3,39,25,2,9,3,6
E33013240,266,227,71,156,1,9,6,3,26,25,0,1,0,3
E33013241,267,224,70,154,1,10,6,4,27,23,1,2,1,5
E33013242,450,341,122,219,2,42,33,9,53,43,8,2,0,12
E33013243,308,258,96,162,4,7,4,3,33,25,3,4,1,6
E33013244,270,235,88,147,1,4,1,3,20,17,1,2,0,10
E33013245,567,426,130,296,2,33,10,23,98,76,13,4,5,8
E33013246,267,177,41,136,1,15,5,10,73,31,36,0,6,1
E33013247,345,241,68,173,1,17,12,5,80,69,5,6,0,6
E33013248,265,227,73,154,1,14,5,9,20,20,0,0,0,3
E33013249,443,340,105,235,2,32,13,19,68,54,9,5,0,1
E33013250,223,181,62,119,0,10,6,4,31,30,0,1,0,1
E33013251,374,276,97,179,1,28,14,14,63,59,0,4,0,6
E33013252,424,359,116,243,0,24,15,9,38,31,2,4,1,3
E33013253,269,237,85,152,1,10,7,3,18,12,0,6,0,3
E33013254,254,205,77,128,0,26,19,7,21,18,0,2,1,2
E33013255,335,298,132,166,2,14,9,5,19,15,0,4,0,2
E33013256,598,384,129,255,2,41,12,29,163,68,57,5,33,8
E33013257,316,242,80,162,1,14,5,9,56,35,8,1,12,3
E33013258,400,301,101,200,1,35,10,25,63,55,1,5,2,0
E33013259,274,217,53,164,1,19,4,15,35,28,3,2,2,2
E33013260,270,211,63,148,2,19,5,14,35,31,1,3,0,3
E33013261,545,420,140,280,2,39,16,23,79,68,1,7,3,5
E33013262,333,280,117,163,0,22,9,13,30,26,0,4,0,1
E33013263,374,299,94,205,0,23,6,17,45,40,1,2,2,7
E33013264,410,331,85,246,3,17,12,5,58,50,4,3,1,1
E33013265,384,346,104,242,0,5,2,3,32,27,1,4,0,1
E33013266,236,133,37,96,11,71,9,62,20,15,1,1,3,1
E33013267,330,252,82,170,4,29,12,17,42,38,0,3,1,3
E33013268,487,346,117,229,8,71,11,60,59,55,0,3,1,3
E33013269,252,148,48,100,5,72,5,67,23,22,0,1,0,4
E33013270,488,389,125,264,8,47,27,20,44,43,0,1,0,0
E33013271,274,225,74,151,1,20,7,13,26,20,3,2,1,2
E33013272,340,234,74,160,4,61,31,30,41,38,0,2,1,0
E33013273,287,248,75,173,0,20,10,10,19,18,0,1,0,0
E33013274,596,412,104,308,8,65,25,40,108,95,5,4,4,3
E33013275,268,200,64,136,0,33,11,22,31,28,1,2,0,4
E33013276,535,373,99,274,0,54,19,35,103,97,0,6,0,5
E33013277,536,401,117,284,6,30,16,14,93,78,2,10,3,6
E33013278,460,320,73,247,1,51,29,22,86,76,2,7,1,2
E33013279,551,399,137,262,1,48,39,9,92,85,1,6,0,11
E33013280,288,248,70,178,1,15,10,5,24,23,0,1,0,0
E33013281,418,287,91,196,1,46,29,17,79,72,0,7,0,5
E33013282,416,335,102,233,2,20,11,9,55,46,0,6,3,4
E33013283,211,126,33,93,0,18,12,6,62,61,0,1,0,5
E33013284,258,202,57,145,3,24,11,13,25,22,1,2,0,4
E33013285,308,258,111,147,2,6,3,3,33,30,1,2,0,9
E33013286,310,217,66,151,2,37,30,7,46,42,0,4,0,8
E33013287,267,209,64,145,1,17,11,6,38,35,1,2,0,2
E33013288,448,300,109,191,6,30,11,19,106,101,2,3,0,6
E33013289,409,287,105,182,2,25,19,6,93,90,1,1,1,2
E33013290,3932,2778,702,2076,25,285,163,122,817,758,5,46,8,27
E33013291,286,203,62,141,3,24,14,10,54,52,0,2,0,2
E33013292,299,161,49,112,6,78,69,9,54,46,0,8,0,0
E33013293,329,202,57,145,1,89,70,19,34,34,0,0,0,3
E33013294,251,167,61,106,2,25,13,12,52,49,0,3,0,5
E33013295,371,240,71,169,0,64,55,9,61,59,0,2,0,6
E33013296,443,318,98,220,5,51,34,17,69,65,1,2,1,0
E33013297,860,528,148,380,6,100,64,36,219,211,0,8,0,7
E33013298,243,140,31,109,1,15,11,4,83,80,0,3,0,4
E33013299,1933,1445,341,1104,21,178,120,58,280,262,4,12,2,9
E33013300,297,255,102,153,1,17,15,2,19,15,1,3,0,5
E33013301,269,210,69,141,2,22,16,6,33,26,2,5,0,2
E33013302,255,203,58,145,4,11,7,4,35,32,1,1,1,2
E33013303,689,499,156,343,6,55,38,17,117,103,0,14,0,12
E33013304,398,273,70,203,1,48,29,19,73,67,4,2,0,3
E33013305,477,365,90,275,4,54,47,7,53,48,0,2,3,1
E33013306,386,310,85,225,3,35,32,3,33,29,0,4,0,5
E33013307,406,272,62,210,6,40,24,16,84,78,0,5,1,4
E33013308,232,189,46,143,0,12,8,4,29,25,2,1,1,2
E33013309,601,311,94,217,4,83,54,29,201,188,4,8,1,2
E33013310,616,466,169,297,7,40,27,13,101,98,1,0,2,2
E33013311,261,163,48,115,1,29,23,6,62,59,1,2,0,6
E33013312,355,258,82,176,0,28,18,10,66,61,1,4,0,3
E33013313,250,127,48,79,1,38,20,18,82,79,0,2,1,2
E33013314,373,231,88,143,2,20,12,8,105,95,3,5,2,15
E33013315,467,346,69,277,0,33,25,8,86,84,0,2,0,2
E33013316,408,273,90,183,2,23,12,11,102,95,2,5,0,8
E33013317,327,182,50,132,1,29,16,13,112,98,2,8,4,3
E33013318,533,345,97,248,5,56,34,22,122,111,2,9,0,5
E33013319,1097,680,214,466,7,78,53,25,322,305,2,14,1,10
E33013320,281,226,65,161,0,16,9,7,38,33,0,2,3,1
E33013321,336,238,74,164,1,35,19,16,55,51,0,4,0,7
E33013322,432,289,88,201,0,22,15,7,115,109,2,3,1,6
E33013323,329,272,92,180,5,15,11,4,36,30,1,5,0,1
E33013324,348,162,48,114,1,90,83,7,91,81,2,8,0,4
E33013325,314,221,80,141,5,26,22,4,61,53,5,3,0,1
E33013326,259,149,57,92,1,27,22,5,81,74,1,4,2,1
E33013327,305,165,56,109,4,38,24,14,96,83,0,10,3,2
E33013328,1275,836,189,647,9,97,50,47,326,286,5,31,4,7
E33013329,370,271,87,184,3,53,42,11,39,36,0,3,0,4
E33013330,425,305,88,217,4,33,24,9,79,71,2,6,0,4
E33013331,441,300,87,213,2,68,51,17,66,61,0,5,0,5
E33013332,649,447,154,293,3,88,67,21,99,89,7,2,1,12
E33013333,321,264,85,179,4,20,12,8,32,29,2,1,0,1
E33013334,451,295,99,196,3,37,21,16,113,107,2,4,0,3
E33013335,520,335,92,243,6,31,16,15,143,135,1,5,2,5
E33013336,328,252,97,155,4,5,4,1,63,57,1,5,0,4
E33013337,292,228,54,174,1,15,9,6,45,41,0,4,0,3
E33013338,442,325,102,223,3,23,11,12,85,81,0,4,0,6
E33013339,223,160,43,117,1,12,7,5,49,45,0,4,0,1
E33013340,740,482,120,362,4,154,121,33,92,86,0,6,0,8
E33013341,559,386,90,296,1,119,95,24,50,44,0,6,0,3
E33013342,484,301,92,209,3,33,15,18,133,125,2,4,2,14
E33013343,512,303,96,207,2,46,28,18,154,146,2,5,1,7
E33013344,246,151,47,104,3,19,10,9,72,70,0,2,0,1
E33013345,309,239,75,164,0,17,13,4,51,47,2,0,2,2
E33013346,594,378,99,279,3,41,28,13,168,100,38,7,23,4
E33013347,269,180,68,112,1,8,6,2,77,71,3,2,1,3
E33013348,206,132,52,80,0,15,10,5,56,48,1,2,5,3
E33013349,435,350,127,223,2,27,17,10,51,43,0,5,3,5
E33013350,433,372,111,261,1,9,4,5,46,41,1,3,1,5
E33013351,475,347,106,241,1,24,10,14,99,82,1,14,2,4
E33013352,348,261,82,179,1,27,16,11,57,53,2,2,0,2
E33013353,213,159,47,112,0,12,9,3,42,37,0,5,0,0
E33013354,273,169,51,118,0,12,4,8,84,76,2,6,0,8
E33013355,274,213,61,152,0,18,13,5,42,37,3,2,0,1
E33013356,257,211,65,146,2,16,10,6,28,25,0,3,0,0
E33013357,337,301,67,234,0,10,6,4,24,23,0,1,0,2
E33013358,289,213,77,136,8,41,9,32,24,23,0,0,1,3
E33013359,404,278,77,201,1,62,53,9,59,51,1,7,0,4
E33013360,515,410,138,272,0,32,19,13,67,54,6,5,2,6
E33013361,444,365,94,271,1,24,20,4,51,45,2,1,3,3
E33013362,249,168,58,110,1,5,4,1,50,45,0,3,2,25
E33013363,242,196,56,140,0,16,11,5,29,27,0,0,2,1
E33013364,360,213,78,135,1,40,26,14,101,79,7,5,10,5
E33013365,265,239,93,146,0,10,4,6,15,13,1,1,0,1
E33013366,285,250,88,162,0,12,7,5,21,19,0,2,0,2
E33013367,557,441,150,291,2,38,21,17,65,57,2,2,4,11
E33013368,483,409,158,251,2,28,11,17,40,36,0,4,0,4
E33013369,313,235,75,160,4,13,5,8,54,49,0,3,2,7
E33013370,250,209,87,122,1,9,5,4,31,25,1,4,1,0
E33013371,312,242,98,144,2,16,8,8,46,43,1,2,0,6
E33013372,346,249,128,121,4,8,3,5,78,74,0,3,1,7
E33013373,265,209,97,112,1,11,7,4,37,26,1,10,0,7
E33013374,318,239,119,120,0,14,5,9,50,45,1,1,3,15
E33013375,583,448,189,259,0,29,12,17,97,91,0,6,0,9
E33013376,382,275,117,158,7,19,2,17,72,65,0,4,3,9
E33013377,223,171,84,87,3,5,0,5,39,28,6,0,5,5
E33013378,286,211,95,116,1,10,2,8,57,52,1,1,3,7
E33013379,244,180,67,113,0,20,1,19,40,35,3,1,1,4
E33013380,233,161,80,81,3,13,4,9,43,41,1,1,0,13
E33013381,311,202,97,105,4,17,6,11,79,58,12,8,1,9
E33013382,445,316,132,184,2,25,3,22,93,81,1,5,6,9
E33013383,1065,816,198,618,3,32,13,19,193,179,3,8,3,21
E33013384,250,161,83,78,2,18,2,16,56,45,3,3,5,13
E33013385,627,474,196,278,0,25,5,20,102,80,9,10,3,26
E33013386,527,431,173,258,0,21,8,13,67,58,2,7,0,8
E33013387,567,426,186,240,0,29,2,27,96,86,2,6,2,16
E33013388,217,178,92,86,2,5,3,2,30,26,1,3,0,2
E33013389,587,419,171,248,2,53,14,39,102,95,0,7,0,11
E33013390,216,159,81,78,2,7,4,3,43,34,5,4,0,5
E33013391,419,311,131,180,1,34,15,19,70,63,1,6,0,3
E33013392,387,313,110,203,0,16,5,11,55,45,2,3,5,3
E33013393,357,246,87,159,1,10,3,7,96,90,2,2,2,4
E33013394,261,149,73,76,0,3,2,1,94,85,2,2,5,15
E33013395,469,396,128,268,2,12,5,7,53,48,3,2,0,6
E33013396,307,226,107,119,2,6,2,4,70,60,5,5,0,3
E33013397,587,466,160,306,1,25,11,14,89,79,0,7,3,6
E33013398,290,218,76,142,3,28,12,16,39,33,1,5,0,2
E33013399,367,301,96,205,0,10,6,4,51,47,1,2,1,5
E33013400,312,258,85,173,0,9,4,5,43,35,3,4,1,2
E33013401,424,311,106,205,4,28,11,17,75,66,4,4,1,6
E33013402,1647,1209,351,858,6,115,42,73,309,287,2,16,4,8
E33013403,505,365,149,216,1,30,7,23,107,94,1,8,4,2
E33013404,277,191,71,120,0,40,14,26,44,35,0,7,2,2
E33013405,565,423,147,276,2,45,11,34,90,82,2,3,3,5
E33013406,542,399,149,250,2,26,8,18,110,101,1,8,0,5
E33013407,281,228,85,143,4,12,4,8,33,29,0,3,1,4
E33013408,355,277,106,171,0,22,5,17,50,37,3,5,5,6
E33013409,802,641,217,424,3,48,18,30,107,99,1,6,1,3
E33013410,331,207,63,144,2,19,6,13,96,87,2,7,0,7
E33013411,445,361,130,231,0,16,4,12,58,49,3,6,0,10
E33013412,668,537,154,383,4,24,4,20,100,88,0,8,4,3
E33013413,892,708,221,487,4,34,16,18,142,127,2,10,3,4
E33013414,354,269,85,184,0,22,8,14,58,54,0,4,0,5
E33013415,283,229,85,144,0,13,6,7,32,24,2,4,2,9
E33013416,389,255,93,162,1,28,8,20,104,97,1,6,0,1
E33013417,556,446,163,283,1,32,12,20,69,65,0,4,0,8
E33013418,859,655,178,477,3,34,18,16,157,134,4,17,2,10
E33013419,320,233,97,136,0,44,10,34,40,37,1,2,0,3
E33013420,346,250,95,155,1,37,3,34,53,51,1,1,0,5
E33013421,789,633,221,412,3,57,15,42,86,77,2,7,0,10
E33013422,695,554,190,364,2,72,10,62,59,54,1,4,0,8
E33013423,257,180,75,105,1,11,2,9,55,51,3,1,0,10
E33013424,363,291,134,157,2,32,13,19,29,25,2,2,0,9
E33013425,255,192,86,106,5,17,3,14,36,34,0,2,0,5
E33013426,259,213,82,131,1,13,2,11,25,23,0,2,0,7
E33013427,320,229,80,149,6,17,2,15,61,60,1,0,0,7
E33013428,598,478,162,316,2,53,21,32,58,49,4,5,0,7
E33013429,264,214,97,117,0,10,1,9,32,31,0,1,0,8
E33013430,549,420,238,182,2,18,5,13,92,73,2,13,4,17
E33013431,436,307,158,149,3,12,3,9,92,81,5,5,1,22
E33013432,267,205,106,99,0,13,5,8,45,36,2,5,2,4
E33013433,210,139,45,94,0,12,3,9,49,39,3,4,3,10
E33013434,364,269,126,143,2,38,1,37,52,48,2,1,1,3
E33013435,281,183,58,125,0,47,7,40,51,45,1,1,4,0
E33013436,345,299,96,203,1,11,1,10,33,29,3,0,1,1
E33013437,325,194,61,133,3,65,8,57,53,48,1,4,0,10
E33013438,511,363,114,249,1,51,3,48,90,82,2,6,0,6
E33013439,330,244,54,190,1,34,3,31,48,40,4,3,1,3
E33013440,423,317,95,222,7,35,9,26,60,53,2,3,2,4
E33013441,1700,1236,361,875,7,181,24,157,263,201,29,17,16,13
E33013442,215,179,96,83,1,7,2,5,23,21,2,0,0,5
E33013443,326,273,121,152,1,11,1,10,39,32,1,5,1,2
E33013444,286,211,96,115,1,8,1,7,57,46,2,9,0,9
E33013445,417,320,122,198,2,22,5,17,65,54,3,4,4,8
E33013446,285,222,72,150,0,28,1,27,29,25,2,1,1,6
E33013447,368,276,81,195,0,30,4,26,59,45,6,6,2,3
E33013448,322,243,94,149,0,21,1,20,57,51,2,2,2,1
E33013449,327,203,101,102,3,12,2,10,87,69,8,9,1,22
E33013450,402,320,129,191,1,15,2,13,58,49,6,2,1,8
E33013451,288,218,114,104,2,13,2,11,47,39,2,4,2,8
E33013452,1799,1031,234,797,2,95,30,65,662,213,314,16,119,9
E33013453,638,433,173,260,3,26,5,21,155,139,7,4,5,21
E33013454,312,182,79,103,2,33,7,26,80,59,14,6,1,15
E33013455,287,203,62,141,2,15,3,12,58,52,2,3,1,9
E33013456,328,229,87,142,1,19,6,13,70,45,17,5,3,9
E33013457,242,158,63,95,2,7,1,6,57,43,7,6,1,18
E33013458,257,180,52,128,1,24,2,22,44,37,0,5,2,8
E33013459,963,625,206,419,2,119,17,102,203,179,7,11,6,14
E33013460,482,314,107,207,2,52,9,43,103,90,4,6,3,11
E33013461,263,194,110,84,3,10,1,9,47,41,2,2,2,9
E33013462,272,192,78,114,0,11,3,8,64,59,0,5,0,5
E33013463,335,247,92,155,3,21,4,17,58,47,3,3,5,6
E33013464,347,254,121,133,1,21,4,17,57,41,9,5,2,14
E33013465,365,240,95,145,2,30,9,21,75,59,7,1,8,18
E33013466,273,196,104,92,3,16,3,13,48,42,5,1,0,10
E33013467,398,172,28,144,0,44,12,32,177,58,71,2,46,5
E33013468,314,222,112,110,2,17,3,14,63,62,0,1,0,10
E33013469,330,283,100,183,1,16,1,15,25,21,1,3,0,5
E33013470,945,664,194,470,5,89,13,76,181,165,6,8,2,6
E33013471,570,366,139,227,2,59,7,52,127,104,12,7,4,16
E33013472,382,302,86,216,7,11,1,10,60,51,3,6,0,2
E33013473,337,239,87,152,2,27,3,24,62,60,1,0,1,7
E33013474,575,392,126,266,9,37,16,21,124,101,12,7,4,13
E33013475,257,197,88,109,2,7,3,4,36,22,8,1,5,15
E33013476,617,439,143,296,1,48,12,36,120,111,2,4,3,9
E33013477,553,380,142,238,5,56,7,49,107,99,2,5,1,5
E33013478,383,277,105,172,1,39,7,32,64,56,2,4,2,2
E33013479,402,291,100,191,2,31,10,21,65,52,6,4,3,13
E33013480,230,156,60,96,1,14,3,11,56,41,6,6,3,3
E33013481,260,173,71,102,3,20,3,17,52,42,2,1,7,12
E33013482,399,281,120,161,4,39,13,26,64,55,2,5,2,11
E33013483,275,212,101,111,2,19,4,15,40,33,3,4,0,2
E33013484,856,580,160,420,3,47,23,24,221,87,76,4,54,5
E33013485,360,297,105,192,3,20,2,18,37,30,4,0,3,3
E33013486,308,170,76,94,6,12,6,6,115,94,9,9,3,5
E33013487,472,327,107,220,5,32,18,14,97,80,12,4,1,11
E33013488,244,134,66,68,0,17,10,7,76,63,5,7,1,17
E33013489,267,190,105,85,0,2,1,1,59,43,8,6,2,16
E33013490,428,303,133,170,7,20,7,13,83,74,4,3,2,15
E33013491,323,223,131,92,2,16,3,13,61,40,10,4,7,21
E33013492,447,288,99,189,2,31,11,20,111,99,6,3,3,15
E33013493,254,188,76,112,2,17,12,5,44,39,2,0,3,3
E33013494,774,399,111,288,6,66,25,41,299,92,123,6,78,4
E33013495,249,168,49,119,1,14,8,6,61,52,1,4,4,5
E33013496,255,177,57,120,0,19,11,8,54,49,2,3,0,5
E33013497,431,310,100,210,1,39,19,20,76,61,8,3,4,5
E33013498,570,377,141,236,2,32,18,14,151,126,8,12,5,8
E33013499,636,336,74,262,2,38,14,24,248,77,97,9,65,12
E33013500,416,307,135,172,4,18,6,12,75,62,5,4,4,12
E33013501,699,478,162,316,3,44,17,27,157,126,11,12,8,17
E33013502,451,314,117,197,2,26,17,9,85,70,9,3,3,24
E33013503,299,188,66,122,3,13,8,5,80,65,8,5,2,15
E33013504,705,479,151,328,4,58,30,28,149,131,5,8,5,15
E33013505,1144,826,264,562,3,86,48,38,212,182,21,7,2,17
E33013506,450,317,92,225,2,35,18,17,92,84,3,4,1,4
E33013507,324,186,50,136,1,62,43,19,69,58,5,3,3,6
E33013508,289,203,72,131,1,24,17,7,58,56,0,2,0,3
E33013509,263,220,86,134,0,9,4,5,29,23,1,5,0,5
E33013510,519,355,113,242,0,69,49,20,90,77,9,4,0,5
E33013511,325,240,108,132,2,21,12,9,52,48,1,1,2,10
E33013512,295,206,55,151,0,20,17,3,61,54,2,5,0,8
E33013513,279,216,55,161,1,20,10,10,38,35,1,2,0,4
E33013514,311,228,81,147,2,11,9,2,65,56,0,4,5,5
E33013515,243,159,69,90,0,10,5,5,54,43,5,1,5,20
E33013516,628,443,146,297,4,37,32,5,141,129,5,4,3,3
E33013517,473,339,97,242,5,37,20,17,90,79,5,5,1,2
E33013518,202,135,58,77,2,5,0,5,56,51,4,1,0,4
E33013519,371,300,166,134,1,18,6,12,43,39,2,2,0,9
E33013520,460,325,128,197,2,30,19,11,96,85,2,7,2,7
E33013521,363,293,147,146,1,6,4,2,58,47,1,5,5,5
E33013522,339,246,103,143,2,22,13,9,61,55,2,3,1,8
E33013523,427,341,126,215,1,18,11,7,57,49,4,4,0,10
E33013524,250,198,62,136,1,6,4,2,45,42,0,3,0,0
E33013525,376,306,91,215,6,22,12,10,36,32,1,3,0,6
E33013526,368,306,77,229,1,16,9,7,41,34,5,2,0,4
E33013527,465,360,98,262,2,22,14,8,77,63,3,8,3,4
E33013528,299,228,91,137,1,17,12,5,45,44,0,1,0,8
E33013529,254,172,62,110,3,9,4,5,62,49,5,3,5,8
E33013530,321,256,90,166,2,18,6,12,37,37,0,0,0,8
E33013531,443,367,136,231,3,15,8,7,53,43,2,2,6,5
E33013532,393,247,97,150,1,26,14,12,108,95,5,5,3,11
E33013533,376,300,84,216,2,13,7,6,58,53,0,5,0,3
E33013534,401,322,115,207,2,22,12,10,50,43,1,2,4,5
E33013535,348,260,87,173,4,23,9,14,60,55,0,4,1,1
E33013536,285,202,74,128,5,37,22,15,38,35,0,3,0,3
E33013537,239,187,47,140,2,17,9,8,28,22,1,5,0,5
E33013538,468,350,128,222,0,42,17,25,70,60,2,6,2,6
E33013539,309,235,80,155,3,10,7,3,54,49,0,5,0,7
E33013540,405,335,102,233,4,23,15,8,38,30,0,7,1,5
E33013541,365,293,85,208,1,22,11,11,47,42,1,3,1,2
E33013542,457,346,118,228,2,25,16,9,76,69,1,6,0,8
E33013543,375,283,93,190,0,17,10,7,70,67,1,2,0,5
E33013544,260,180,46,134,1,19,8,11,58,54,0,3,1,2
E33013545,364,294,63,231,2,16,12,4,50,44,0,5,1,2
E33013546,415,278,81,197,1,49,16,33,87,78,2,7,0,0
E33013547,299,205,55,150,1,24,16,8,68,65,0,2,1,1
E33013548,345,274,73,201,2,13,10,3,55,52,0,2,1,1
E33013549,323,283,85,198,0,4,1,3,34,32,1,1,0,2
E33013550,398,273,90,183,3,15,8,7,100,94,3,3,0,7
E33013551,556,389,141,248,5,38,17,21,119,110,1,4,4,5
E33013552,336,226,106,120,7,22,7,15,75,73,2,0,0,6
E33013553,321,235,75,160,4,14,7,7,63,56,0,7,0,5
E33013554,374,275,84,191,1,22,10,12,68,65,1,2,0,8
E33013555,253,170,52,118,1,37,27,10,41,31,1,9,0,4
E33013556,467,301,100,201,1,67,41,26,93,88,1,4,0,5
E33013557,575,320,79,241,7,90,50,40,154,135,4,11,4,4
E33013558,275,182,45,137,1,17,11,6,72,63,0,8,1,3
E33013559,447,332,87,245,1,49,24,25,59,50,5,3,1,6
E33013560,711,497,136,361,3,60,20,40,142,138,0,3,1,9
E33013561,453,312,98,214,3,52,15,37,82,70,0,10,2,4
E33013562,525,345,113,232,8,58,26,32,112,106,0,5,1,2
E33013563,373,286,98,188,3,24,12,12,53,39,4,7,3,7
E33013564,358,290,74,216,1,29,15,14,35,33,0,1,1,3
E33013565,423,286,66,220,3,18,8,10,114,108,2,4,0,2
E33013566,378,235,76,159,1,19,5,14,119,109,2,5,3,4
E33013567,482,318,94,224,2,21,8,13,136,123,2,8,3,5
E33013568,592,360,128,232,6,50,30,20,170,158,3,7,2,6
E33013569,463,352,119,233,3,12,8,4,96,91,1,4,0,0
E33013570,228,152,60,92,0,16,5,11,51,49,0,2,0,9
E33013571,433,259,81,178,5,25,12,13,141,134,1,6,0,3
E33013572,276,192,56,136,2,21,7,14,59,53,0,5,1,2
E33013573,219,170,63,107,0,12,7,5,33,30,1,2,0,4
E33013574,222,176,84,92,0,8,6,2,35,27,1,5,2,3
E33013575,447,308,92,216,3,21,12,9,105,89,8,7,1,10
E33013576,386,304,119,185,1,25,14,11,41,35,2,2,2,15
E33013577,259,201,76,125,0,17,10,7,39,36,2,1,0,2
E33013578,341,256,112,144,2,21,11,10,50,43,3,3,1,12
E33013579,262,171,82,89,1,17,10,7,61,53,4,3,1,12
E33013580,307,226,84,142,0,18,15,3,59,53,2,4,0,4
E33013581,361,234,64,170,1,29,22,7,86,72,5,7,2,11
E33013582,272,215,65,150,1,10,5,5,44,39,2,3,0,2
E33013583,349,293,76,217,3,6,6,0,47,41,0,6,0,0
E33013584,762,538,172,366,9,58,29,29,145,137,1,7,0,12
E33013585,338,247,67,180,0,23,15,8,63,59,1,2,1,5
E33013586,1214,860,266,594,7,92,44,48,252,233,3,16,0,3
E33013587,373,292,120,172,4,17,8,9,60,53,0,6,1,0
E33013588,3119,1664,383,1281,17,112,59,53,1253,1190,22,19,22,73
E33013589,276,199,89,110,2,15,13,2,51,43,2,4,2,9
E33013590,601,456,169,287,3,27,16,11,107,92,3,10,2,8
E33013591,254,195,82,113,1,10,6,4,45,36,3,4,2,3
E33013592,248,201,78,123,0,11,6,5,23,18,2,3,0,13
E33013593,393,284,106,178,2,30,12,18,70,61,4,0,5,7
E33013594,298,198,70,128,4,10,5,5,76,61,3,3,9,10
E33013595,250,192,66,126,0,10,5,5,45,40,2,2,1,3
E33013596,204,155,58,97,1,10,3,7,36,36,0,0,0,2
E33013597,310,257,86,171,1,8,3,5,41,38,0,3,0,3
E33013598,242,140,54,86,0,13,10,3,81,76,0,4,1,8
E33013599,345,275,66,209,1,3,1,2,63,58,2,2,1,3
E33013600,322,225,65,160,1,21,11,10,74,68,1,5,0,1
E33013601,631,495,164,331,5,25,13,12,100,95,2,3,0,6
E33013602,287,214,63,151,2,13,4,9,52,44,0,6,2,6
E33013603,563,419,155,264,2,15,8,7,121,108,6,7,0,6
E33013604,294,240,63,177,2,6,3,3,42,38,0,3,1,4
E33013605,259,208,80,128,5,14,4,10,30,30,0,0,0,2
E33013606,1135,907,256,651,4,31,17,14,185,167,3,14,1,8
E33013607,409,326,117,209,1,14,5,9,67,59,0,8,0,1
E33013608,319,227,79,148,3,19,8,11,65,58,0,2,5,5
E33013609,412,320,107,213,0,15,9,6,72,64,2,4,2,5
E33013610,326,252,103,149,3,18,11,7,44,39,2,3,0,9
E33013611,336,246,101,145,7,16,11,5,64,59,2,1,2,3
E33013612,231,161,53,108,5,22,12,10,37,36,0,1,0,6
E33013613,362,287,97,190,1,14,8,6,57,47,1,8,1,3
E33013614,376,276,109,167,1,21,13,8,64,57,2,4,1,14
E33013615,388,254,93,161,3,28,17,11,88,73,7,5,3,15
E33013616,328,240,95,145,3,14,9,5,63,48,6,4,5,8
E33013617,341,216,76,140,1,19,11,8,89,74,5,6,4,16
E33013618,239,161,61,100,2,10,5,5,58,41,10,3,4,8
E33013619,298,220,97,123,0,19,13,6,54,44,2,3,5,5
E33013620,359,257,93,164,0,18,12,6,69,63,3,2,1,15
E33013621,233,166,86,80,1,15,9,6,42,37,0,5,0,9
E33013622,390,310,104,206,2,19,12,7,58,44,7,0,7,1
E33013623,299,234,97,137,1,15,10,5,46,39,2,4,1,3
E33013624,343,258,56,202,0,29,16,13,53,45,1,5,2,3
E33013625,421,283,104,179,1,55,41,14,78,69,3,6,0,4
E33013626,212,151,58,93,3,14,9,5,37,33,4,0,0,7
E33013627,663,465,142,323,3,54,31,23,136,122,7,6,1,5
E33013628,340,231,74,157,2,40,17,23,61,36,15,7,3,6
E33013629,656,308,75,233,1,58,27,31,285,100,112,7,66,4
E33013630,338,244,68,176,0,30,11,19,56,22,15,7,12,8
E33013631,345,244,73,171,1,31,11,20,69,56,5,5,3,0
E33013632,293,139,16,123,1,17,9,8,132,49,52,1,30,4
E33013633,283,148,46,102,0,23,11,12,107,40,39,4,24,5
E33013634,813,352,50,302,2,77,24,53,379,109,157,4,109,3
E33013635,451,317,78,239,1,38,29,9,89,67,10,1,11,6
E33013636,378,201,51,150,0,36,20,16,139,46,51,2,40,2
E33013637,763,430,88,342,3,69,34,35,258,107,78,8,65,3
E33013638,1404,885,209,676,8,144,66,78,359,149,103,17,90,8
E33013639,440,285,75,210,2,68,50,18,81,51,12,9,9,4
E33013640,756,378,72,306,0,103,45,58,269,100,81,10,78,6
E33013641,319,195,114,81,5,14,9,5,81,67,6,3,5,24
E33013642,652,465,180,285,2,30,18,12,145,132,8,5,0,10
E33013643,354,232,137,95,1,24,11,13,79,70,0,8,1,18
E33013644,624,406,221,185,1,84,31,53,120,95,3,20,2,13
E33013645,220,155,100,55,3,6,4,2,46,37,5,4,0,10
E33013646,246,173,93,80,2,20,4,16,41,24,8,9,0,10
E33013647,455,339,178,161,5,25,12,13,79,61,3,9,6,7
E33013648,284,202,102,100,2,7,4,3,67,42,6,3,16,6
E33013649,356,207,111,96,2,9,6,3,110,87,13,5,5,28
E33013650,307,208,60,148,2,30,18,12,53,43,4,3,3,14
E33013651,402,281,117,164,8,19,12,7,83,72,3,6,2,11
E33013652,319,235,87,148,6,16,7,9,55,43,6,6,0,7
E33013653,388,222,99,123,1,36,15,21,122,93,19,6,4,7
E33013654,269,214,88,126,1,10,8,2,32,21,8,1,2,12
E33013655,317,237,96,141,2,20,14,6,52,47,1,2,2,6
E33013656,290,156,73,83,1,18,8,10,93,79,5,7,2,22
E33013657,269,189,101,88,0,9,4,5,58,44,1,6,7,13
E33013658,247,179,98,81,0,7,2,5,49,41,3,3,2,12
E33013659,594,441,183,258,6,29,2,27,111,102,5,4,0,7
E33013660,457,296,118,178,0,53,9,44,99,95,0,4,0,9
E33013661,394,296,132,164,1,37,4,33,53,49,1,3,0,7
E33013662,226,132,82,50,2,11,0,11,66,56,3,1,6,15
E33013663,229,174,68,106,0,19,5,14,23,23,0,0,0,13
E33013664,284,229,115,114,3,12,0,12,31,29,2,0,0,9
E33013665,396,300,137,163,5,24,3,21,59,51,2,5,1,8
E33013666,473,350,164,186,1,47,3,44,71,63,3,5,0,4
E33013667,341,264,105,159,0,20,2,18,53,48,2,3,0,4
E33013668,315,226,85,141,0,22,10,12,61,54,0,4,3,6
E33013669,318,233,113,120,0,25,5,20,52,45,0,3,4,8
E33013670,691,490,213,277,2,66,7,59,116,95,6,10,5,17
E33013671,383,288,118,170,0,15,4,11,69,64,1,3,1,11
E33013672,592,452,160,292,0,24,3,21,102,75,14,7,6,14
E33013673,471,332,120,212,1,47,4,43,87,76,3,7,1,4
E33013674,500,306,115,191,4,51,4,47,132,121,1,7,3,7
E33013675,263,189,87,102,2,22,4,18,42,36,2,3,1,8
E33013676,607,338,153,185,1,46,8,38,191,159,19,11,2,31
E33013677,435,240,102,138,9,54,15,39,110,100,4,3,3,22
E33013678,332,157,73,84,0,33,14,19,122,120,1,1,0,20
E33013679,403,247,110,137,0,23,9,14,117,77,31,3,6,16
E33013680,255,211,124,87,0,7,2,5,30,27,1,2,0,7
E33013681,219,154,85,69,0,12,2,10,40,34,3,3,0,13
E33013682,277,219,120,99,0,10,6,4,40,28,10,1,1,8
E33013683,308,204,80,124,3,25,2,23,65,55,4,3,3,11
E33013684,250,165,85,80,1,10,1,9,57,43,8,0,6,17
E33013685,260,194,76,118,1,6,2,4,47,42,2,3,0,12
E33013686,249,203,62,141,0,11,2,9,25,9,10,6,0,10
E33013687,338,205,91,114,0,22,8,14,97,86,7,3,1,14
E33013688,286,150,66,84,0,17,1,16,89,85,3,1,0,30
E33013689,284,178,90,88,0,25,2,23,62,51,10,0,1,19
E33013690,584,469,145,324,4,33,5,28,63,56,1,6,0,15
E33013691,391,265,85,180,3,16,3,13,87,71,12,2,2,20
E33013692,738,468,187,281,1,72,11,61,183,155,12,10,6,14
E33013693,320,247,95,152,4,19,7,12,44,38,2,2,2,6
E33013694,229,167,90,77,1,19,4,15,34,30,2,2,0,8
E33013695,255,168,74,94,3,23,9,14,56,48,4,1,3,5
E33013696,230,163,73,90,0,12,4,8,52,49,1,1,1,3
E33013697,315,197,83,114,0,27,6,21,78,50,23,2,3,13
E33013698,297,195,95,100,3,19,7,12,62,55,1,4,2,18
E33013699,528,396,145,251,4,37,7,30,79,64,10,5,0,12
E33013700,366,239,97,142,0,18,1,17,97,84,8,2,3,12
E33013701,234,186,106,80,3,5,0,5,32,27,0,5,0,8
E33013702,554,411,154,257,2,34,3,31,94,84,5,4,1,13
E33013703,217,134,64,70,4,2,1,1,57,44,13,0,0,20
E33013704,294,201,78,123,4,42,10,32,46,46,0,0,0,1
E33013705,438,303,133,170,1,50,10,40,74,65,1,4,4,10
E33013706,321,239,110,129,4,27,2,25,47,38,4,4,1,4
E33013707,285,175,57,118,2,37,4,33,70,68,1,1,0,1
E33013708,424,343,126,217,3,27,6,21,49,42,2,5,0,2
E33013709,205,133,46,87,0,16,5,11,56,51,1,4,0,0
E33013710,610,398,145,253,2,50,15,35,148,130,1,9,8,12
E33013711,387,211,114,97,4,96,7,89,67,60,3,4,0,9
E33013712,443,328,158,170,3,40,16,24,67,60,0,5,2,5
E33013713,233,163,82,81,0,22,5,17,43,36,1,3,3,5
E33013714,230,157,74,83,1,14,5,9,52,46,1,3,2,6
E33013715,295,203,104,99,4,15,8,7,66,55,2,7,2,7
E33013716,341,201,95,106,2,8,0,8,106,93,4,4,5,24
E33013717,309,215,100,115,4,15,0,15,69,61,3,1,4,6
E33013718,561,343,145,198,0,48,9,39,160,145,2,12,1,10
E33013719,411,337,141,196,4,20,4,16,50,39,2,8,1,0
E33013720,546,373,139,234,5,85,15,70,80,68,2,8,2,3
E33013721,622,457,180,277,2,58,12,46,100,91,1,7,1,5
E33013722,285,228,81,147,1,13,2,11,41,36,1,4,0,2
E33013723,356,262,127,135,1,14,7,7,62,53,2,1,6,17
E33013724,381,285,139,146,1,40,10,30,49,45,1,2,1,6
E33013725,309,241,113,128,0,10,2,8,49,39,2,5,3,9
E33013726,259,190,104,86,3,22,5,17,29,25,1,3,0,15
E33013727,440,349,183,166,0,24,7,17,53,39,5,7,2,14
E33013728,276,220,104,116,0,20,2,18,36,31,2,3,0,0
E33013729,601,419,155,264,2,56,13,43,116,103,5,8,0,8
E33013730,384,316,101,215,0,14,3,11,48,45,0,3,0,6
E33013731,319,260,105,155,2,8,4,4,43,37,0,3,3,6
E33013732,256,211,91,120,0,11,2,9,31,29,0,2,0,3
E33013733,479,380,154,226,3,18,3,15,69,60,0,6,3,9
E33013734,492,366,114,252,3,31,7,24,89,86,0,3,0,3
E33013735,234,172,59,113,0,7,4,3,54,49,1,4,0,1
E33013736,430,271,92,179,2,30,6,24,125,117,2,6,0,2
E33013737,451,254,115,139,3,42,10,32,143,128,8,6,1,9
E33013738,195,123,34,89,3,8,3,5,58,51,1,2,4,3
E33013739,288,202,71,131,0,18,4,14,60,52,0,6,2,8
E33013740,249,165,49,116,0,8,1,7,70,64,0,3,3,6
E33013741,244,145,46,99,2,14,6,8,68,62,0,4,2,15
E33013742,255,171,55,116,0,15,4,11,64,57,2,5,0,5
E33013743,377,258,51,207,0,24,7,17,90,82,2,6,0,5
E33013744,325,203,51,152,1,68,24,44,52,49,0,3,0,1
E33013745,254,172,54,118,1,19,6,13,60,57,1,2,0,2
E33013746,295,227,79,148,2,31,5,26,35,29,0,5,1,0
E33013747,485,354,109,245,3,12,0,12,111,105,0,5,1,5
E33013748,378,276,77,199,1,24,8,16,75,66,2,7,0,2
E33013749,250,163,53,110,2,15,3,12,65,58,2,5,0,5
E33013750,520,364,110,254,1,31,5,26,122,113,1,7,1,2
E33013751,383,284,99,185,1,14,2,12,82,78,1,2,1,2
E33013752,596,410,134,276,1,41,9,32,139,128,0,8,3,5
E33013753,253,190,72,118,1,11,2,9,50,46,1,3,0,1
E33013754,2093,1583,472,1111,12,79,18,61,409,363,14,23,9,10
E33013755,283,199,64,135,4,12,5,7,67,60,0,7,0,1
E33013756,245,197,79,118,0,14,4,10,27,25,1,1,0,7
E33013757,403,280,73,207,0,43,14,29,76,70,2,3,1,4
E33013758,411,277,92,185,1,22,10,12,106,97,2,4,3,5
E33013759,348,296,96,200,3,9,0,9,39,39,0,0,0,1
E33013760,348,294,106,188,1,15,3,12,37,33,0,4,0,1
E33013761,336,218,88,130,1,23,2,21,88,83,1,4,0,6
E33013762,387,212,79,133,1,23,4,19,147,133,1,13,0,4
E33013763,279,149,55,94,2,23,7,16,98,93,1,4,0,7
E33013764,306,191,62,129,2,21,7,14,89,82,0,2,5,3
E33013765,405,301,98,203,1,16,5,11,80,70,3,6,1,7
E33013766,244,136,44,92,3,12,1,11,90,86,1,3,0,3
E33013767,291,168,60,108,3,19,6,13,99,94,1,4,0,2
E33013768,239,183,63,120,0,12,3,9,42,34,4,4,0,2
E33013769,323,250,75,175,6,20,5,15,40,35,0,3,2,7
E33013770,250,170,69,101,0,20,9,11,58,50,2,4,2,2
E33013771,525,404,157,247,1,12,3,9,106,95,1,7,3,2
E33013772,299,183,54,129,2,73,19,54,40,36,0,3,1,1
E33013773,313,221,51,170,1,47,12,35,39,34,1,3,1,5
E33013774,415,329,85,244,7,22,10,12,53,44,0,9,0,4
E33013775,355,286,114,172,2,19,8,11,47,39,1,6,1,1
E33013776,257,204,85,119,2,15,4,11,34,31,0,1,2,2
E33013777,238,205,67,138,0,8,3,5,24,21,2,1,0,1
E33013778,496,390,170,220,0,24,3,21,69,55,5,5,4,13
E33013779,254,135,52,83,2,8,2,6,86,80,2,4,0,23
E33013780,470,290,104,186,4,61,19,42,109,93,6,8,2,6
E33013781,421,304,105,199,0,32,4,28,80,72,0,7,1,5
E33013782,327,257,84,173,2,26,8,18,37,35,0,2,0,5
E33013783,309,232,89,143,3,16,5,11,43,38,1,4,0,15
E33013784,240,173,66,107,1,26,5,21,38,34,0,4,0,2
E33013785,302,226,87,139,3,13,4,9,56,50,0,2,4,4
E33013786,620,469,198,271,5,22,5,17,117,106,1,8,2,7
E33013787,445,348,136,212,1,25,6,19,67,59,0,6,2,4
E33013788,610,477,149,328,2,42,34,8,74,63,5,5,1,15
E33013789,491,400,133,267,1,21,14,7,62,57,0,5,0,7
E33013790,300,238,66,172,0,14,12,2,38,32,4,0,2,10
E33013791,329,269,80,189,1,22,21,1,30,26,3,0,1,7
E33013792,278,210,76,134,0,14,12,2,37,31,3,3,0,17
E33013793,455,371,117,254,2,30,19,11,45,38,1,5,1,7
E33013794,347,258,84,174,2,41,32,9,45,41,1,3,0,1
E33013795,314,245,87,158,1,32,26,6,32,27,0,5,0,4
E33013796,267,224,101,123,3,7,7,0,31,28,1,1,1,2
E33013797,415,280,89,191,8,33,19,14,86,72,3,8,3,8
E33013798,403,306,84,222,4,19,13,6,65,57,3,3,2,9
E33013799,239,171,56,115,0,15,13,2,46,37,3,4,2,7
E33013800,425,324,129,195,1,25,20,5,70,66,1,1,2,5
E33013801,284,213,61,152,2,21,15,6,44,33,4,7,0,4
E33013802,349,271,82,189,0,25,6,19,47,44,0,1,2,6
E33013803,247,197,79,118,1,17,10,7,25,21,1,3,0,7
E33013804,494,359,104,255,1,41,27,14,91,82,3,5,1,2
E33013805,488,405,114,291,4,16,9,7,57,53,1,3,0,6
E33013806,314,256,72,184,2,9,4,5,43,33,2,5,3,4
E33013807,256,186,63,123,0,36,32,4,32,31,0,1,0,2
E33013808,337,262,95,167,0,20,17,3,53,50,1,2,0,2
E33013809,277,228,57,171,0,25,20,5,21,19,0,2,0,3
E33013810,325,266,71,195,2,18,13,5,36,31,1,3,1,3
E33013811,463,377,117,260,6,30,19,11,41,35,4,2,0,9
E33013812,445,355,98,257,0,48,39,9,41,37,1,3,0,1
E33013813,883,619,199,420,9,113,59,54,136,119,6,11,0,6
E33013814,291,190,37,153,2,54,36,18,42,40,0,2,0,3
E33013815,591,433,135,298,6,65,37,28,86,81,2,2,1,1
E33013816,431,306,92,214,4,55,40,15,65,61,1,3,0,1
E33013817,289,167,40,127,1,41,29,12,79,76,0,3,0,1
E33013818,1063,730,189,541,6,84,52,32,238,227,2,8,1,5
E33013819,337,248,80,168,0,51,32,19,37,34,0,3,0,1
E33013820,503,389,125,264,3,58,27,31,49,45,0,3,1,4
E33013821,551,445,137,308,3,45,29,16,57,50,2,4,1,1
E33013822,342,301,88,213,2,11,4,7,27,18,0,8,1,1
E33013823,572,467,138,329,2,36,25,11,64,58,0,5,1,3
E33013824,392,336,97,239,1,18,6,12,35,31,0,2,2,2
E33013825,327,270,102,168,1,22,10,12,26,23,0,3,0,8
E33013826,581,337,77,260,5,39,27,12,196,191,0,3,2,4
E33013827,266,220,78,142,0,15,12,3,24,24,0,0,0,7
E33013828,332,255,99,156,2,24,12,12,46,39,2,4,1,5
E33013829,338,245,70,175,2,10,8,2,80,76,0,2,2,1
E33013830,455,373,133,240,1,26,12,14,49,42,3,1,3,6
E33013831,623,533,140,393,1,23,10,13,63,57,0,4,2,3
E33013832,261,210,60,150,3,14,12,2,32,25,0,7,0,2
E33013833,292,227,73,154,2,15,13,2,44,40,0,4,0,4
E33013834,271,201,57,144,2,29,25,4,37,34,2,0,1,2
E33013835,413,339,111,228,2,29,22,7,38,32,1,5,0,5
E33013836,380,306,95,211,0,29,23,6,40,38,0,2,0,5
E33013837,261,220,81,139,1,10,7,3,28,23,0,5,0,2
E33013838,246,197,73,124,4,18,18,0,20,14,2,4,0,7
E33013839,264,215,77,138,0,18,13,5,29,26,0,2,1,2
E33013840,554,463,138,325,1,31,23,8,52,46,2,3,1,7
E33013841,799,720,260,460,2,41,37,4,35,31,0,1,3,1
E33013842,611,403,118,285,4,84,74,10,113,108,1,4,0,7
E33013843,438,328,91,237,0,38,30,8,65,55,1,4,5,7
E33013844,638,514,128,386,2,32,25,7,88,84,2,0,2,2
E33013845,424,345,80,265,2,29,22,7,47,40,0,6,1,1
E33013846,553,440,106,334,1,49,43,6,58,49,2,7,0,5
E33013847,394,324,71,253,0,18,14,4,50,35,2,9,4,2
E33013848,266,184,44,140,0,46,41,5,34,27,2,4,1,2
E33013849,700,520,143,377,2,86,72,14,89,84,0,4,1,3
E33013850,642,516,81,435,3,52,42,10,70,66,0,4,0,1
E33013851,496,377,99,278,1,44,35,9,74,64,1,9,0,0
E33013852,273,246,86,160,0,6,5,1,20,18,0,2,0,1
E33013853,314,249,74,175,1,24,22,2,36,31,0,2,3,4
E33013854,284,227,53,174,0,17,15,2,38,33,1,4,0,2
E33013855,1302,1025,237,788,7,108,87,21,157,149,0,8,0,5
E33013856,502,341,73,268,3,39,31,8,118,111,0,5,2,1
E33013857,242,160,51,109,1,23,13,10,58,54,0,3,1,0
E33013858,263,174,50,124,0,47,37,10,39,34,0,5,0,3
E33013859,679,461,123,338,4,103,75,28,109,103,0,6,0,2
E33013860,1667,1271,324,947,8,134,86,48,248,217,0,29,2,6
E33013861,608,450,114,336,1,32,25,7,124,113,0,6,5,1
E33013862,634,387,86,301,4,55,39,16,183,175,1,5,2,5
E33013863,1817,1344,306,1038,4,135,108,27,327,307,1,16,3,7
E33013864,903,501,103,398,2,78,59,19,316,297,0,19,0,6
E33013865,384,195,36,159,5,29,24,5,151,144,1,4,2,4
E33013866,314,180,64,116,0,30,17,13,103,91,1,11,0,1
E33013867,771,465,111,354,2,74,49,25,229,206,7,8,8,1
E33013868,316,164,36,128,4,34,22,12,110,106,0,3,1,4
E33013869,240,151,57,94,1,47,25,22,38,33,0,3,2,3
E33013870,656,404,120,284,0,54,31,23,193,182,0,10,1,5
E33013871,340,176,58,118,1,26,13,13,136,121,1,8,6,1
E33013872,323,207,72,135,2,38,30,8,75,74,0,0,1,1
E33013873,416,290,83,207,2,27,17,10,96,87,0,9,0,1
E33013874,295,207,81,126,3,21,15,6,60,52,2,3,3,4
E33013875,497,303,75,228,2,56,45,11,134,126,0,7,1,2
E33013876,568,348,101,247,1,59,43,16,155,144,5,5,1,5
E33013877,276,132,33,99,0,14,10,4,127,123,1,3,0,3
E33013878,255,171,49,122,0,16,14,2,63,62,0,1,0,5
E33013879,272,191,68,123,1,30,26,4,49,46,0,3,0,1
E33013880,278,181,60,121,0,20,16,4,74,71,0,3,0,3
E33013881,362,185,55,130,3,56,30,26,112,105,0,7,0,6
E33013882,715,516,135,381,2,66,43,23,127,115,0,10,2,4
E33013883,804,519,124,395,3,92,59,33,182,171,3,8,0,8
E33013884,249,157,58,99,2,23,16,7,60,58,1,1,0,7
E33013885,634,375,99,276,5,61,41,20,191,183,0,8,0,2
E33013886,265,124,35,89,2,32,14,18,107,101,0,6,0,0
E33013887,294,154,49,105,3,29,21,8,106,99,3,2,2,2
E33013888,280,175,54,121,4,42,29,13,53,31,0,2,20,6
E33013889,418,257,63,194,3,89,32,57,57,51,2,3,1,12
E33013890,1418,1084,284,800,2,229,134,95,102,92,0,7,3,1
E33013891,307,225,65,160,0,28,17,11,45,42,0,3,0,9
E33013892,678,223,76,147,2,52,29,23,82,72,0,8,2,319
E33013893,327,180,40,140,1,70,14,56,74,70,0,3,1,2
E33013894,417,276,59,217,0,40,25,15,96,92,0,4,0,5
E33013895,455,329,83,246,0,76,66,10,46,44,0,2,0,4
E33013896,440,356,99,257,3,56,42,14,24,23,0,1,0,1
E33013897,572,473,128,345,2,45,37,8,48,43,1,4,0,4
E33013898,271,216,55,161,2,33,29,4,16,16,0,0,0,4
E33013899,402,295,73,222,1,64,53,11,36,31,1,3,1,6
E33013900,360,287,90,197,2,32,4,28,36,33,1,2,0,3
E33013901,343,267,90,177,1,17,4,13,56,51,1,4,0,2
E33013902,736,382,113,269,6,64,30,34,274,260,1,11,2,10
E33013903,256,167,67,100,1,27,2,25,61,57,0,3,1,0
E33013904,592,439,149,290,1,55,9,46,88,73,6,8,1,9
E33013905,538,371,128,243,4,60,7,53,95,89,1,4,1,8
E33013906,356,274,95,179,0,25,4,21,51,46,3,2,0,6
E33013907,283,180,68,112,2,34,2,32,59,54,0,2,3,8
E33013908,236,163,57,106,2,19,2,17,51,43,6,2,0,1
E33013909,266,184,55,129,1,40,2,38,40,33,0,6,1,1
E33013910,374,244,94,150,6,48,7,41,74,70,1,2,1,2
E33013911,479,327,130,197,1,50,10,40,92,85,4,2,1,9
E33013912,494,314,70,244,1,37,27,10,138,129,1,6,2,4
E33013913,472,279,68,211,0,32,18,14,159,150,1,8,0,2
E33013914,488,290,58,232,2,33,22,11,156,153,0,3,0,7
E33013915,866,597,105,492,9,38,31,7,215,206,0,9,0,7
E33013916,471,288,65,223,3,80,66,14,97,90,2,4,1,3
E33013917,676,357,68,289,10,84,63,21,222,210,1,11,0,3
E33013918,598,375,97,278,4,133,119,14,81,74,0,6,1,5
E33013919,630,443,124,319,4,92,68,24,88,81,1,5,1,3
E33013920,244,171,35,136,1,34,26,8,30,30,0,0,0,8
E33013921,482,335,66,269,3,87,71,16,57,54,0,2,1,0
E33013922,498,291,63,228,2,146,121,25,54,48,2,2,2,5
E33013923,1084,780,155,625,4,43,27,16,252,238,1,13,0,5
E33013924,372,209,55,154,2,55,39,16,106,101,0,5,0,0
E33013925,293,235,77,158,1,9,9,0,45,40,1,4,0,3
E33013926,379,307,114,193,2,25,17,8,39,31,2,3,3,6
E33013927,229,167,53,114,2,13,10,3,44,36,4,4,0,3
E33013928,592,479,146,333,0,17,6,11,92,86,0,4,2,4
E33013929,400,320,94,226,2,15,6,9,59,50,1,8,0,4
E33013930,461,347,98,249,1,12,5,7,96,84,4,7,1,5
E33013931,193,152,52,100,0,11,11,0,27,25,0,2,0,3
E33013932,468,364,120,244,0,26,18,8,73,61,1,10,1,5
E33013933,529,391,114,277,3,19,12,7,111,98,4,7,2,5
E33013934,280,218,81,137,1,11,10,1,44,39,0,2,3,6
E33013935,1189,908,267,641,5,48,25,23,217,207,3,5,2,11
E33013936,525,379,99,280,5,65,44,21,72,69,0,3,0,4
E33013937,761,578,155,423,2,85,58,27,93,82,0,10,1,3
E33013938,719,482,130,352,6,88,57,31,139,127,2,10,0,4
E33013939,774,581,112,469,4,36,25,11,150,135,2,12,1,3
E33013940,277,158,36,122,3,36,25,11,78,76,0,2,0,2
E33013941,758,605,146,459,4,29,13,16,119,112,0,7,0,1
E33013942,518,365,89,276,6,36,17,19,108,101,0,5,2,3
E33013943,1883,1468,377,1091,13,117,72,45,279,251,2,24,2,6
E33013944,767,563,120,443,6,60,38,22,136,123,1,11,1,2
E33013945,332,245,58,187,2,26,16,10,56,52,2,2,0,3
E33013946,564,452,87,365,5,23,15,8,81,77,0,4,0,3
E33013947,898,739,230,509,2,45,18,27,108,105,0,3,0,4
E33013948,632,473,110,363,3,62,41,21,94,90,0,3,1,0
E33013949,2705,2180,552,1628,12,167,92,75,337,312,4,18,3,9
E33013950,228,185,69,116,0,17,11,6,26,22,1,2,1,0
E33013951,402,294,84,210,3,41,24,17,61,57,0,3,1,3
E33013952,243,143,38,105,2,26,17,9,67,60,2,5,0,5
E33013953,304,186,49,137,3,50,29,21,63,60,0,3,0,2
E33013954,628,437,124,313,0,84,66,18,102,99,0,2,1,5
E33013955,196,110,33,77,4,30,11,19,50,48,0,2,0,2
E33013956,352,213,80,133,4,58,32,26,75,65,0,8,2,2
E33013957,322,214,69,145,1,36,22,14,70,69,0,1,0,1
E33013958,122,112,21,91,0,1,0,1,8,7,0,1,0,1
E33013959,314,234,74,160,4,36,19,17,39,36,0,1,2,1
E33013960,453,343,101,242,2,22,8,14,84,75,1,7,1,2
E33013961,624,455,141,314,4,78,55,23,82,75,0,7,0,5
E33013962,511,307,88,219,2,84,49,35,116,107,0,9,0,2
E33013963,569,426,104,322,5,44,21,23,92,85,0,7,0,2
E33013964,2277,1398,363,1035,19,236,143,93,609,573,1,31,4,15
E33013965,272,156,42,114,3,40,28,12,71,65,1,5,0,2
E33013966,707,450,140,310,6,91,56,35,152,144,0,6,2,8
E33013967,242,182,41,141,3,22,15,7,34,30,1,3,0,1
E33013968,339,207,72,135,5,64,40,24,57,54,0,3,0,6
E33013969,1866,1363,396,967,8,162,102,60,325,291,5,25,4,8
E33013970,329,244,74,170,4,34,15,19,41,35,0,5,1,6
E33013971,1578,1160,280,880,11,117,68,49,284,267,0,17,0,6
E33013972,636,471,158,313,1,37,20,17,123,114,1,8,0,4
E33013973,211,158,39,119,1,12,6,6,32,30,0,1,1,8
E33013974,385,287,94,193,5,28,20,8,62,58,1,2,1,3
E33013975,329,231,52,179,3,31,21,10,64,63,0,1,0,0
E33013976,402,335,118,217,1,27,22,5,37,31,0,6,0,2
E33013977,524,382,95,287,3,43,22,21,92,85,0,6,1,4
E33013978,510,429,79,350,5,22,16,6,54,52,1,1,0,0
E33013979,1481,1196,320,876,14,93,55,38,174,159,0,13,2,4
E33013980,352,252,84,168,1,31,20,11,63,57,1,5,0,5
E33013981,284,222,68,154,2,22,15,7,36,32,2,0,2,2
E33013982,265,206,64,142,2,22,19,3,34,30,0,4,0,1
E33013983,360,270,72,198,6,34,23,11,50,43,0,7,0,0
E33013984,321,240,56,184,2,34,27,7,42,38,1,3,0,3
E33013985,305,228,57,171,4,17,12,5,56,50,0,6,0,0
E33013986,203,131,49,82,2,35,20,15,35,27,0,6,2,0
E33013987,419,353,95,258,1,17,10,7,48,46,1,1,0,0
E33013988,373,262,86,176,1,44,34,10,63,61,0,1,1,3
E33013989,751,549,150,399,7,85,61,24,109,98,0,9,2,1
E33013990,1235,919,252,667,12,110,79,31,190,177,0,13,0,4
E33013991,711,492,133,359,10,113,94,19,93,83,1,5,4,3
E33013992,904,664,210,454,4,113,84,29,115,110,0,4,1,8
E33013993,1023,778,207,571,11,74,44,30,152,140,2,9,1,8
E33013994,7425,5732,1448,4284,37,570,289,281,1061,977,19,56,9,25
E33013995,602,467,117,350,0,42,25,17,88,80,0,8,0,5
E33013996,295,237,61,176,5,13,3,10,40,36,0,2,2,0
E33013997,1960,1663,412,1251,13,100,68,32,178,166,1,8,3,6
E33013998,155,92,34,58,1,43,37,6,18,15,2,1,0,1
E33013999,512,340,78,262,2,68,51,17,99,97,0,2,0,3
E33014000,334,281,77,204,0,20,14,6,31,30,0,1,0,2
E33014001,925,683,173,510,8,85,57,28,146,130,2,13,1,3
E33014002,3253,1954,546,1408,22,453,310,143,809,763,2,31,13,15
E33014003,580,419,124,295,6,88,64,24,67,60,2,4,1,0
E33014004,430,320,104,216,3,56,32,24,50,44,1,3,2,1
E33014005,464,377,132,245,0,23,14,9,60,55,1,4,0,4
E33014006,390,202,53,149,2,57,37,20,127,123,0,2,2,2
E33014007,1019,728,199,529,11,96,63,33,171,164,1,5,1,13
E33014008,867,309,85,224,10,126,80,46,416,398,0,11,7,6
E33014009,253,173,49,124,2,21,8,13,53,52,0,1,0,4
E33014010,254,188,53,135,0,30,15,15,36,32,0,4,0,0
E33014011,254,202,42,160,1,7,5,2,43,38,0,4,1,1
E33014012,374,212,68,144,2,59,33,26,95,90,1,2,2,6
E33014013,352,245,84,161,1,42,21,21,56,52,0,4,0,8
E33014014,599,483,172,311,5,45,23,22,65,63,1,1,0,1
E33014015,521,271,69,202,1,61,39,22,182,171,1,8,2,6
E33014016,233,159,53,106,0,17,8,9,55,51,2,0,2,2
E33014017,356,225,79,146,2,35,23,12,92,87,0,3,2,2
E33014018,251,159,59,100,2,30,17,13,57,53,0,1,3,3
E33014019,363,255,71,184,2,38,27,11,67,60,1,5,1,1
E33014020,392,253,100,153,1,34,28,6,95,87,0,7,1,9
E33014021,693,521,149,372,6,52,31,21,110,104,0,4,2,4
E33014022,3414,2672,733,1939,20,266,166,100,444,355,51,21,17,12
E33014023,400,308,87,221,2,38,26,12,45,42,0,3,0,7
E33014024,244,183,83,100,1,20,15,5,40,38,1,1,0,0
E33014025,377,282,92,190,2,31,24,7,58,56,0,2,0,4
E33014026,358,265,86,179,2,30,21,9,59,56,0,3,0,2
E33014027,358,245,80,165,3,27,17,10,82,71,0,11,0,1
E33014028,902,589,154,435,3,95,43,52,213,204,0,9,0,2
E33014029,619,415,117,298,5,89,54,35,109,98,0,10,1,1
E33014030,1516,999,275,724,5,182,114,68,323,306,1,7,9,7
E33014031,204,154,42,112,1,7,6,1,42,39,0,3,0,0
E33014032,1258,883,242,641,2,168,100,68,200,180,1,17,2,5
E33014033,466,365,74,291,3,38,25,13,58,53,0,5,0,2
E33014034,259,196,75,121,1,22,15,7,39,38,0,1,0,1
E33014035,605,467,120,347,6,41,29,12,86,82,0,3,1,5
E33014036,1066,633,160,473,15,83,51,32,332,322,0,8,2,3
E33014037,643,482,154,328,6,71,54,17,83,78,1,4,0,1
E33014038,350,216,70,146,5,54,39,15,73,72,0,1,0,2
E33014039,398,285,106,179,0,51,38,13,60,54,0,5,1,2
E33014040,201,150,51,99,0,23,14,9,28,26,0,2,0,0
E33014041,698,562,193,369,5,64,40,24,62,56,1,5,0,5
E33014042,528,384,104,280,3,40,18,22,97,94,0,3,0,4
E33014043,319,268,72,196,3,22,19,3,26,25,0,1,0,0
E33014044,669,461,115,346,4,72,40,32,129,123,0,2,4,3
E33014045,299,223,68,155,2,32,18,14,42,37,0,5,0,0
E33014046,591,479,136,343,10,31,20,11,70,63,1,6,0,1
E33014047,1257,952,323,629,4,106,69,37,192,176,2,12,2,3
E33014048,384,276,74,202,6,39,27,12,62,53,3,4,2,1
E33014049,202,144,46,98,2,18,14,4,38,37,0,1,0,0
E33014050,381,232,76,156,2,76,63,13,67,64,0,2,1,4
E33014051,418,293,83,210,2,44,25,19,77,74,0,3,0,2
E33014052,245,181,78,103,3,18,9,9,41,36,1,3,1,2
E33014053,917,681,218,463,5,117,71,46,108,100,2,3,3,6
E33014054,236,174,53,121,3,16,13,3,42,42,0,0,0,1
E33014055,415,239,85,154,1,94,79,15,73,71,0,2,0,8
E33014056,303,221,81,140,4,18,7,11,50,44,1,1,4,10
E33014057,440,273,73,200,6,53,21,32,78,70,7,1,0,30
E33014058,278,198,55,143,4,18,7,11,53,48,1,3,1,5
E33014059,350,279,103,176,5,29,9,20,33,27,2,3,1,4
E33014060,1043,743,267,476,11,111,42,69,174,156,4,12,2,4
E33014061,378,294,97,197,6,27,8,19,48,45,0,2,1,3
E33014062,284,187,49,138,11,45,21,24,38,31,2,3,2,3
E33014063,2025,1511,419,1092,10,126,59,67,368,340,2,22,4,10
E33014064,177,121,40,81,0,11,7,4,44,42,0,2,0,1
E33014065,691,426,106,320,5,76,38,38,178,167,0,10,1,6
E33014066,236,180,58,122,1,28,21,7,22,21,0,1,0,5
E33014067,653,445,120,325,8,79,50,29,118,104,0,12,2,3
E33014068,547,404,112,292,1,33,23,10,99,92,0,4,3,10
E33014069,934,669,168,501,6,99,67,32,157,149,0,7,1,3
E33014070,398,255,72,183,3,53,34,19,85,80,2,3,0,2
E33014071,484,340,99,241,1,47,30,17,93,89,0,4,0,3
E33014072,499,343,78,265,6,41,26,15,107,105,0,1,1,2
E33014073,214,148,45,103,1,36,33,3,25,21,0,4,0,4
E33014074,490,331,66,265,3,48,37,11,106,91,0,14,1,2
E33014075,430,272,77,195,1,92,68,24,62,55,2,5,0,3
E33014076,939,674,194,480,12,113,83,30,140,133,0,7,0,0
E33014077,697,509,132,377,7,65,46,19,113,108,0,5,0,3
E33014078,1553,1258,242,1016,9,74,49,25,207,192,1,14,0,5
E33014079,368,226,58,168,2,59,31,28,77,70,1,6,0,4
E33014080,696,494,94,400,3,78,56,22,115,107,0,5,3,6
E33014081,430,272,59,213,2,43,28,15,110,102,1,7,0,3
E33014082,605,382,93,289,2,71,44,27,145,136,2,7,0,5
E33014083,807,511,126,385,3,145,113,32,147,146,0,1,0,1
E33014084,1059,637,146,491,12,137,87,50,271,250,2,17,2,2
E33014085,282,198,54,144,1,37,31,6,46,40,0,5,1,0
E33014086,540,412,91,321,5,32,20,12,87,79,0,8,0,4
E33014087,1059,790,195,595,7,116,90,26,140,127,0,13,0,6
E33014088,132,93,19,74,0,17,14,3,21,19,0,2,0,1
E33014089,343,228,58,170,0,71,55,16,42,37,0,4,1,2
E33014090,374,206,49,157,1,108,81,27,56,49,1,6,0,3
E33014091,210,148,46,102,1,36,27,9,24,19,1,3,1,1
E33014092,353,238,58,180,0,60,45,15,51,44,0,7,0,4
E33014093,966,669,147,522,4,88,63,25,204,179,0,25,0,1
E33014094,274,224,65,159,0,23,18,5,25,24,0,1,0,2
E33014095,700,494,132,362,8,57,36,21,141,115,0,26,0,0
E33014096,1078,705,180,525,15,117,70,47,240,229,0,9,2,1
E33014097,298,213,58,155,2,15,10,5,67,63,0,4,0,1
E33014098,288,186,32,154,1,15,5,10,83,78,1,3,1,3
E33014099,276,195,51,144,2,5,3,2,74,71,0,2,1,0
E33014100,853,704,137,567,2,48,31,17,98,91,3,4,0,1
E33014101,399,303,93,210,1,40,26,14,55,52,0,2,1,0
E33014102,705,459,104,355,7,64,37,27,170,159,0,9,2,5
E33014103,452,349,100,249,3,32,25,7,68,65,0,3,0,0
E33014104,1886,1338,327,1011,12,181,127,54,341,312,1,23,5,14
E33014105,509,352,102,250,1,67,50,17,87,83,0,3,1,2
E33014106,564,341,123,218,7,57,29,28,158,151,1,6,0,1
E33014107,7218,5355,1315,4040,39,504,310,194,1284,1206,13,57,8,36
E33014108,272,234,64,170,1,7,6,1,30,28,0,2,0,0
E33014109,726,502,145,357,7,76,55,21,140,131,1,7,1,1
E33014110,267,216,51,165,0,19,11,8,31,27,0,3,1,1
E33014111,304,211,45,166,0,6,5,1,87,83,0,4,0,0
E33014112,372,288,88,200,4,33,26,7,47,45,0,2,0,0
E33014113,822,572,119,453,8,60,37,23,179,162,1,16,0,3
E33014114,1224,842,253,589,8,150,91,59,213,200,0,12,1,11
E33014115,6698,5152,1336,3816,27,523,371,152,969,884,9,68,8,27
E33014116,415,301,81,220,2,16,12,4,95,90,1,4,0,1
E33014117,394,307,89,218,2,32,13,19,52,47,1,3,1,1
E33014118,240,179,51,128,1,20,15,5,38,34,1,3,0,2
E33014119,203,154,35,119,0,18,10,8,30,26,0,4,0,1
E33014120,547,450,150,300,2,40,24,16,52,47,0,4,1,3
E33014121,237,180,58,122,0,20,12,8,35,28,1,5,1,2
E33014122,979,704,223,481,3,145,105,40,114,106,3,5,0,13
E33014123,607,457,156,301,2,49,26,23,94,86,2,6,0,5
E33014124,622,471,140,331,2,49,26,23,99,91,1,7,0,1
E33014125,499,388,108,280,2,30,16,14,79,61,0,8,10,0
E33014126,215,155,55,100,0,15,6,9,41,39,1,0,1,4
E33014127,817,610,180,430,4,78,39,39,120,112,1,7,0,5
E33014128,494,367,127,240,3,47,29,18,73,66,2,5,0,4
E33014129,174,122,37,85,0,30,23,7,21,18,0,2,1,1
E33014130,321,248,82,166,0,41,27,14,30,29,0,1,0,2
E33014131,565,442,152,290,0,53,30,23,67,63,0,4,0,3
E33014132,242,178,70,108,2,21,12,9,41,39,0,2,0,0
E33014133,213,152,62,90,4,22,10,12,32,31,0,1,0,3
E33014134,219,164,51,113,1,16,11,5,35,35,0,0,0,3
E33014135,273,227,67,160,2,11,7,4,33,29,0,4,0,0
E33014136,671,550,159,391,1,53,20,33,60,52,0,7,1,7
E33014137,324,274,75,199,1,10,8,2,37,31,0,6,0,2
E33014138,682,480,145,335,0,66,40,26,132,121,0,10,1,4
E33014139,450,362,103,259,2,38,22,16,47,40,0,7,0,1
E33014140,525,418,110,308,2,42,30,12,61,55,2,3,1,2
E33014141,1142,892,268,624,1,117,71,46,129,116,0,11,2,3
E33014142,204,166,41,125,0,10,4,6,26,23,0,3,0,2
E33014143,833,635,177,458,3,85,55,30,107,92,1,14,0,3
E33014144,2033,1443,406,1037,8,243,162,81,332,303,1,22,6,7
E33014145,426,343,91,252,2,40,33,7,37,27,0,6,4,4
E33014146,1626,1110,248,862,2,229,198,31,275,244,4,26,1,10
E33014147,662,544,176,368,4,54,44,10,58,50,0,8,0,2
E33014148,925,716,207,509,3,83,66,17,120,111,1,8,0,3
E33014149,835,625,201,424,1,83,63,20,124,112,0,12,0,2
E33014150,1597,689,143,546,9,172,124,48,712,699,2,8,3,15
E33014151,319,267,81,186,1,19,16,3,31,30,0,1,0,1
E33014152,1674,1197,338,859,4,175,129,46,287,262,3,20,2,11
E33014153,447,369,97,272,3,15,13,2,55,50,0,5,0,5
E33014154,1561,1207,320,887,6,140,91,49,204,185,1,18,0,4
E33014155,255,190,64,126,0,21,15,6,37,28,1,3,5,7
E33014156,292,214,64,150,0,35,27,8,42,42,0,0,0,1
E33014157,370,270,82,188,1,42,35,7,56,53,0,2,1,1
E33014158,270,212,54,158,1,30,21,9,26,21,1,2,2,1
E33014159,319,264,85,179,0,18,16,2,37,27,0,10,0,0
E33014160,442,359,106,253,1,27,21,6,48,42,0,2,4,7
E33014161,837,686,191,495,0,84,77,7,64,62,0,1,1,3
E33014162,313,217,63,154,0,49,43,6,46,41,1,3,1,1
E33014163,258,211,62,149,2,15,14,1,30,25,0,5,0,0
E33014164,217,165,60,105,1,28,27,1,23,17,1,3,2,0
E33014165,916,484,124,360,5,143,105,38,275,267,0,6,2,9
E33014166,672,500,149,351,0,92,79,13,76,71,0,5,0,4
E33014167,1498,1112,298,814,3,179,151,28,197,182,1,14,0,7
E33014168,417,331,93,238,0,32,27,5,52,49,0,3,0,2
E33014169,364,293,76,217,1,33,27,6,36,31,1,4,0,1
E33014170,173,128,40,88,0,22,17,5,22,16,0,5,1,1
E33014171,832,649,203,446,1,76,62,14,98,92,2,3,1,8
E33014172,500,341,77,264,0,104,94,10,54,50,0,4,0,1
E33014173,456,297,93,204,1,125,106,19,31,29,0,2,0,2
E33014174,294,225,62,163,0,46,42,4,23,21,0,2,0,0
E33014175,166,110,22,88,1,31,26,5,22,19,0,3,0,2
E33014176,977,682,204,478,2,153,134,19,138,122,3,13,0,2
E33014177,200,136,34,102,0,37,27,10,23,21,0,1,1,4
E33014178,347,239,84,155,0,60,55,5,45,37,1,6,1,3
E33014179,207,166,45,121,0,10,10,0,31,27,0,4,0,0
E33014180,366,273,98,175,2,48,42,6,41,36,0,5,0,2
E33014181,649,479,139,340,1,92,79,13,76,70,0,6,0,1
E33014182,221,160,56,104,0,31,27,4,29,25,0,4,0,1
E33014183,499,386,122,264,1,57,52,5,52,44,0,8,0,3
E33014184,237,178,50,128,0,25,22,3,34,32,0,1,1,0
E33014185,389,313,93,220,2,39,34,5,33,32,0,1,0,2
E33014186,1146,870,234,636,3,153,133,20,117,108,0,9,0,3
E33014187,346,254,67,187,0,37,31,6,53,49,1,3,0,2
E33014188,609,467,117,350,2,38,31,7,96,89,1,5,1,6
E33014189,1257,990,335,655,1,105,93,12,159,135,1,21,2,2
E33014190,909,674,212,462,7,123,104,19,98,80,0,14,4,7
E33014191,300,215,66,149,2,39,32,7,43,39,1,3,0,1
E33014192,906,715,177,538,3,92,85,7,89,83,0,4,2,7
E33014193,781,635,210,425,3,86,79,7,56,48,0,5,3,1
E33014194,2044,1210,364,846,30,303,156,147,479,456,2,16,5,22
E33014195,594,417,138,279,8,60,21,39,102,91,1,8,2,7
E33014196,614,415,152,263,4,76,26,50,108,94,7,6,1,11
E33014197,343,251,91,160,2,14,7,7,73,61,5,5,2,3
E33014198,231,191,82,109,4,3,1,2,30,29,0,1,0,3
E33014199,218,155,56,99,2,25,10,15,33,29,2,2,0,3
E33014200,309,229,107,122,2,25,11,14,48,42,1,5,0,5
E33014201,532,424,184,240,2,50,37,13,51,44,1,3,3,5
E33014202,259,213,92,121,2,17,6,11,26,22,0,3,1,1
E33014203,608,485,185,300,3,41,14,27,73,65,1,7,0,6
E33014204,347,250,97,153,1,27,10,17,69,63,2,4,0,0
E33014205,331,251,88,163,1,28,15,13,46,38,2,5,1,5
E33014206,259,185,62,123,0,37,20,17,33,29,1,3,0,4
E33014207,268,195,81,114,0,20,10,10,50,48,0,2,0,3
E33014208,1065,849,233,616,3,79,41,38,133,123,0,9,1,1
E33014209,237,178,48,130,0,20,9,11,38,33,2,3,0,1
E33014210,530,430,119,311,2,29,13,16,69,66,0,2,1,0
E33014211,860,685,187,498,2,59,33,26,112,104,2,6,0,2
E33014212,1500,1195,320,875,9,118,58,60,175,160,3,11,1,3
E33014213,642,485,134,351,6,64,25,39,85,77,2,6,0,2
E33014214,570,419,108,311,1,57,30,27,85,77,0,7,1,8
E33014215,327,248,76,172,3,23,11,12,52,47,0,4,1,1
E33014216,271,231,70,161,2,10,4,6,26,26,0,0,0,2
E33014217,321,259,71,188,0,29,14,15,30,28,0,2,0,3
E33014218,219,180,53,127,1,19,13,6,18,17,0,1,0,1
E33014219,405,294,78,216,2,33,19,14,70,69,0,1,0,6
E33014220,402,346,99,247,4,21,12,9,28,24,0,3,1,3
E33014221,1014,700,206,494,3,79,50,29,231,222,1,8,0,1
E33014222,938,691,170,521,2,78,30,48,163,160,0,3,0,4
E33014223,218,160,38,122,0,13,7,6,44,42,0,2,0,1
E33014224,947,742,206,536,1,74,43,31,129,116,0,11,2,1
E33014225,965,759,235,524,4,81,31,50,117,108,0,8,1,4
E33014226,372,277,60,217,4,27,12,15,62,55,0,3,4,2
E33014227,426,294,91,203,2,56,21,35,71,67,0,3,1,3
E33014228,233,155,39,116,7,14,5,9,53,49,0,4,0,4
E33014229,922,758,251,507,7,36,24,12,119,111,2,3,3,2
E33014230,295,229,85,144,1,27,15,12,37,30,2,5,0,1
E33014231,225,146,46,100,1,16,13,3,55,49,0,5,1,7
E33014232,232,186,68,118,1,10,8,2,31,29,0,2,0,4
E33014233,220,167,58,109,3,9,7,2,40,34,2,4,0,1
E33014234,721,505,146,359,5,67,47,20,137,117,1,15,4,7
E33014235,214,152,50,102,2,14,11,3,38,35,0,2,1,8
E33014236,407,300,98,202,0,32,16,16,68,58,1,8,1,7
E33014237,679,569,185,384,7,40,30,10,57,55,0,1,1,6
E33014238,246,180,59,121,3,21,16,5,42,40,0,2,0,0
E33014239,610,433,143,290,7,32,22,10,132,120,0,11,1,6
E33014240,272,185,63,122,0,44,30,14,39,33,0,5,1,4
E33014241,479,382,123,259,2,29,19,10,59,49,2,5,3,7
E33014242,426,300,81,219,5,54,47,7,64,61,0,3,0,3
E33014243,393,315,74,241,0,26,17,9,48,45,0,3,0,4
E33014244,434,305,80,225,1,50,41,9,72,67,1,4,0,6
E33014245,287,223,57,166,0,23,18,5,40,36,0,2,2,1
E33014246,327,244,72,172,1,38,30,8,41,34,3,4,0,3
E33014247,669,546,175,371,3,31,23,8,80,69,0,10,1,9
E33014248,336,294,110,184,1,12,10,2,27,24,0,3,0,2
E33014249,753,537,180,357,5,92,71,21,116,105,0,8,3,3
E33014250,224,195,93,102,0,11,9,2,18,16,0,2,0,0
E33014251,200,162,51,111,0,24,19,5,12,12,0,0,0,2
E33014252,222,169,50,119,0,32,22,10,19,18,0,1,0,2
E33014253,224,195,56,139,0,15,11,4,13,11,0,2,0,1
E33014254,943,699,213,486,1,152,136,16,88,75,1,11,1,3
E33014255,341,262,101,161,0,45,34,11,33,28,0,5,0,1
E33014256,311,269,83,186,2,20,10,10,18,17,0,1,0,2
E33014257,235,180,47,133,2,23,20,3,28,26,0,1,1,2
E33014258,681,513,154,359,2,69,52,17,92,83,4,5,0,5
E33014259,322,248,70,178,0,46,44,2,27,22,0,5,0,1
E33014260,814,584,187,397,3,133,114,19,88,76,0,12,0,6
E33014261,262,206,78,128,0,22,18,4,34,31,0,3,0,0
E33014262,880,636,203,433,1,136,118,18,105,99,0,4,2,2
E33014263,705,565,169,396,1,40,32,8,94,85,1,8,0,5
E33014264,795,600,138,462,3,79,31,48,107,99,1,7,0,6
E33014265,330,191,50,141,4,30,21,9,104,97,0,4,3,1
E33014266,533,394,100,294,6,44,28,16,85,82,1,2,0,4
E33014267,323,222,42,180,3,30,16,14,62,58,1,3,0,6
E33014268,933,714,210,504,5,66,37,29,145,122,8,13,2,3
E33014269,392,265,81,184,3,37,17,20,83,75,2,5,1,4
E33014270,596,447,96,351,2,56,33,23,86,81,0,5,0,5
E33014271,1114,845,247,598,10,103,58,45,154,150,1,3,0,2
E33014272,478,362,102,260,2,44,25,19,68,60,0,8,0,2
E33014273,341,296,84,212,1,23,12,11,19,19,0,0,0,2
E33014274,683,531,147,384,4,48,32,16,95,89,0,6,0,5
E33014275,740,560,162,398,4,63,46,17,110,96,2,12,0,3
E33014276,755,616,164,452,1,42,26,16,86,85,0,1,0,10
E33014277,574,425,107,318,2,52,37,15,92,80,2,8,2,3
E33014278,776,611,139,472,7,56,35,21,98,93,0,4,1,4
E33014279,1148,928,298,630,12,67,36,31,137,131,0,6,0,4
E33014280,577,501,101,400,2,10,5,5,63,57,2,4,0,1
E33014281,625,461,141,320,7,50,24,26,105,95,1,7,2,2
E33014282,2506,2192,430,1762,16,81,45,36,205,186,0,18,1,12
E33014283,626,533,127,406,6,19,11,8,66,56,1,9,0,2
E33014284,1032,791,221,570,8,68,34,34,163,155,0,7,1,2
E33014285,629,445,139,306,3,71,48,23,105,95,0,8,2,5
E33014286,544,402,79,323,5,27,19,8,108,100,0,8,0,2
E33014287,2244,1581,357,1224,27,135,70,65,489,453,3,29,4,12
E33014288,851,611,148,463,6,45,27,18,186,175,0,10,1,3
E33014289,3302,2527,484,2043,28,186,101,85,548,485,4,53,6,13
E33014290,492,377,103,274,2,32,23,9,81,76,0,4,1,0
E33014291,289,239,57,182,2,22,16,6,25,25,0,0,0,1
E33014292,484,415,117,298,1,21,12,9,46,39,0,7,0,1
E33014293,363,314,71,243,4,16,12,4,27,23,1,3,0,2
E33014294,2475,2166,600,1566,13,89,53,36,202,183,5,14,0,5
E33014295,1161,620,132,488,10,95,64,31,422,407,5,8,2,14
E33014296,239,184,54,130,3,12,4,8,38,36,1,1,0,2
E33014297,1960,1643,396,1247,17,71,36,35,228,202,1,22,3,1
E33014298,694,493,125,368,5,73,48,25,120,112,0,8,0,3
E33014299,508,397,99,298,4,25,17,8,75,69,1,5,0,7
E33014300,307,258,60,198,1,10,7,3,38,37,0,1,0,0
E33014301,209,157,38,119,2,12,6,6,37,35,1,1,0,1
E33014302,1076,833,209,624,8,84,53,31,148,139,0,7,2,3
E33014303,328,274,75,199,3,11,4,7,39,38,0,1,0,1
E33014304,873,609,132,477,6,67,37,30,188,177,1,9,1,3
E33014305,215,176,46,130,1,12,7,5,25,22,0,3,0,1
E33014306,831,586,139,447,6,75,47,28,163,157,0,4,2,1
E33014307,378,290,66,224,4,22,16,6,60,56,0,2,2,2
E33014308,566,400,121,279,8,56,34,22,98,91,0,4,3,4
E33014309,151,116,38,78,1,16,9,7,14,12,0,2,0,4
E33014310,406,250,70,180,4,65,29,36,83,78,0,4,1,4
E33014311,286,234,68,166,2,16,9,7,33,33,0,0,0,1
E33014312,704,488,140,348,2,91,52,39,119,108,0,7,4,4
E33014313,114,86,24,62,1,10,9,1,16,16,0,0,0,1
E33014314,1196,1049,290,759,6,36,29,7,104,96,0,8,0,1
E33014315,445,340,104,236,1,41,22,19,62,56,1,5,0,1
E33014316,233,151,36,115,2,25,17,8,51,51,0,0,0,4
E33014317,789,578,132,446,3,67,43,24,138,136,1,1,0,3
E33014318,528,402,119,283,3,41,29,12,80,72,0,8,0,2
E33014319,349,255,70,185,2,25,14,11,65,64,0,1,0,2
E33014320,513,388,85,303,10,18,8,10,96,91,0,5,0,1
E33014321,440,349,97,252,2,13,9,4,72,67,1,4,0,4
E33014322,262,217,55,162,2,6,4,2,37,34,0,2,1,0
E33014323,676,532,148,384,5,43,24,19,92,83,1,5,3,4
E33014324,550,465,112,353,5,33,23,10,43,37,2,4,0,4
E33014325,558,371,101,270,6,57,35,22,119,112,2,5,0,5
E33014326,354,261,73,188,5,24,17,7,62,55,1,5,1,2
E33014327,311,233,62,171,5,22,15,7,49,48,0,1,0,2
E33014328,678,390,102,288,4,86,54,32,188,181,1,6,0,10
E33014329,978,775,270,505,4,59,33,26,133,121,2,9,1,7
E33014330,1126,824,231,593,11,111,60,51,175,151,3,19,2,5
E33014331,798,611,182,429,9,63,40,23,110,104,1,5,0,5
E33014332,291,240,58,182,0,13,8,5,37,32,0,5,0,1
E33014333,565,439,121,318,4,43,26,17,76,71,1,3,1,3
E33014334,951,701,220,481,5,96,45,51,140,130,2,8,0,9
E33014335,260,212,73,139,2,18,10,8,27,25,0,1,1,1
E33014336,872,721,200,521,8,45,27,18,93,83,1,8,1,5
E33014337,553,422,130,292,2,52,37,15,75,68,2,5,0,2
E33014338,1726,1212,296,916,16,160,89,71,332,317,0,11,4,6
E33014339,570,413,131,282,10,51,18,33,94,89,0,1,4,2
E33014340,506,393,100,293,6,23,8,15,80,76,0,3,1,4
E33014341,379,286,83,203,9,35,10,25,47,43,0,3,1,2
E33014342,311,224,66,158,4,26,6,20,56,47,0,8,1,1
E33014343,472,345,103,242,7,37,15,22,79,69,2,6,2,4
E33014344,438,341,99,242,3,41,13,28,50,43,0,7,0,3
E33014345,306,244,76,168,8,13,4,9,40,36,0,4,0,1
E33014346,368,272,76,196,4,26,8,18,56,48,0,6,2,10
E33014347,464,364,96,268,6,24,13,11,64,57,3,4,0,6
E33014348,878,651,198,453,17,76,27,49,130,113,2,15,0,4
E33014349,357,286,80,206,6,14,5,9,48,42,1,5,0,3
E33014350,455,287,86,201,6,43,11,32,119,117,0,2,0,0
E33014351,819,580,150,430,13,80,19,61,139,129,3,5,2,7
E33014352,252,195,49,146,5,13,4,9,36,33,2,1,0,3
E33014353,355,271,75,196,5,19,8,11,59,53,3,3,0,1
E33014354,355,259,85,174,2,40,9,31,52,48,1,3,0,2
E33014355,770,558,143,415,11,50,11,39,150,141,5,1,3,1
E33014356,200,140,50,90,3,19,8,11,38,36,2,0,0,0
E33014357,336,259,59,200,3,27,10,17,45,41,1,0,3,2
E33014358,7374,4826,1146,3680,78,793,462,331,1639,1555,13,63,8,38
E33014359,1034,836,237,599,6,61,26,35,125,111,0,11,3,6
E33014360,295,240,75,165,2,21,15,6,32,32,0,0,0,0
E33014361,741,618,186,432,4,41,26,15,78,72,1,3,2,0
E33014362,281,230,82,148,2,21,11,10,26,23,0,3,0,2
E33014363,354,285,89,196,2,19,13,6,45,42,1,2,0,3
E33014364,388,282,74,208,4,44,27,17,58,53,1,4,0,0
E33014365,460,351,97,254,1,53,30,23,55,51,0,3,1,0
E33014366,479,379,112,267,2,34,25,9,63,53,0,9,1,1
E33014367,402,338,105,233,3,15,6,9,44,39,2,3,0,2
E33014368,397,312,82,230,3,25,13,12,54,46,0,6,2,3
E33014369,1283,998,274,724,9,85,52,33,183,170,2,11,0,8
E33014370,698,516,120,396,9,57,49,8,112,99,2,11,0,4
E33014371,262,194,60,134,2,22,14,8,41,38,0,2,1,3
E33014372,268,202,52,150,4,19,13,6,42,38,0,3,1,1
E33014373,240,198,71,127,0,21,18,3,21,18,0,3,0,0
E33014374,386,317,76,241,6,17,13,4,46,43,0,3,0,0
E33014375,1604,964,265,699,11,143,96,47,481,458,0,21,2,5
E33014376,516,417,110,307,2,25,20,5,69,63,3,3,0,3
E33014377,706,517,190,327,5,70,44,26,105,96,2,7,0,9
E33014378,284,218,62,156,6,11,8,3,47,32,6,6,3,2
E33014379,268,204,52,152,1,21,16,5,40,35,0,4,1,2
E33014380,658,447,157,290,7,68,49,19,134,126,1,4,3,2
E33014381,864,631,201,430,12,82,59,23,137,129,0,8,0,2
E33014382,442,321,89,232,9,36,24,12,71,65,1,3,2,5
E33014383,239,174,76,98,3,22,16,6,35,30,0,4,1,5
E33014384,634,491,84,407,3,20,14,6,118,111,1,6,0,2
E33014385,282,225,74,151,1,24,14,10,30,26,0,1,3,2
E33014386,236,185,56,129,3,23,19,4,23,21,0,2,0,2
E33014387,287,228,63,165,1,14,10,4,39,35,1,3,0,5
E33014388,699,527,134,393,4,64,32,32,101,91,1,8,1,3
E33014389,200,158,57,101,2,16,9,7,21,21,0,0,0,3
E33014390,216,164,61,103,1,17,13,4,33,30,1,2,0,1
E33014391,540,385,118,267,6,62,41,21,78,64,1,12,1,9
E33014392,281,204,51,153,5,20,11,9,51,49,1,1,0,1
E33014393,426,309,96,213,2,49,33,16,64,62,0,2,0,2
E33014394,828,674,145,529,5,32,20,12,115,107,1,7,0,2
E33014395,228,193,54,139,0,12,7,5,21,19,0,2,0,2
E33014396,484,392,91,301,4,27,11,16,61,52,0,8,1,0
E33014397,1044,826,199,627,6,28,15,13,181,162,5,12,2,3
E33014398,1209,929,214,715,13,47,35,12,217,201,0,16,0,3
E33014399,876,651,189,462,8,77,44,33,138,128,0,9,1,2
E33014400,324,262,58,204,3,19,8,11,40,35,0,5,0,0
E33014401,310,240,57,183,5,15,10,5,50,47,0,0,3,0
E33014402,344,253,84,169,1,32,25,7,57,53,0,4,0,1
E33014403,412,270,71,199,5,50,39,11,84,79,3,2,0,3
E33014404,258,192,59,133,0,21,10,11,45,41,2,2,0,0
E33014405,740,602,152,450,9,38,25,13,90,81,1,6,2,1
E33014406,357,236,63,173,1,48,35,13,68,64,0,3,1,4
E33014407,217,165,47,118,2,19,9,10,28,24,0,3,1,3
E33014408,609,463,130,333,5,55,40,15,86,79,0,6,1,0
E33014409,434,345,106,239,5,28,20,8,56,51,0,5,0,0
E33014410,316,243,70,173,4,29,14,15,39,31,2,6,0,1
E33014411,772,574,180,394,2,91,63,28,101,91,1,8,1,4
E33014412,599,358,113,245,3,70,54,16,167,156,8,2,1,1
E33014413,269,208,74,134,2,31,23,8,27,24,0,3,0,1
E33014414,240,185,45,140,3,24,19,5,28,26,0,2,0,0
E33014415,886,666,176,490,6,92,60,32,119,108,1,10,0,3
E33014416,456,357,78,279,3,32,22,10,63,59,0,3,1,1
E33014417,601,386,91,295,5,78,56,22,130,126,0,3,1,2
E33014418,776,528,133,395,7,83,60,23,155,148,1,6,0,3
E33014419,529,372,82,290,6,58,34,24,92,86,0,6,0,1
E33014420,380,317,73,244,2,17,11,6,42,41,0,1,0,2
E33014421,685,492,143,349,9,61,34,27,120,116,0,4,0,3
E33014422,328,231,62,169,2,38,26,12,55,47,0,7,1,2
E33014423,546,446,120,326,4,43,26,17,52,49,0,1,2,1
E33014424,569,448,116,332,3,65,55,10,52,45,0,7,0,1
E33014425,753,535,148,387,4,93,77,16,120,110,0,10,0,1
E33014426,227,173,58,115,1,24,16,8,28,28,0,0,0,1
E33014427,456,336,78,258,4,30,22,8,84,77,0,6,1,2
E33014428,809,635,180,455,11,59,40,19,102,86,2,13,1,2
E33014429,218,172,38,134,3,18,12,6,25,22,1,2,0,0
E33014430,224,164,58,106,3,31,23,8,25,18,0,7,0,1
E33014431,348,268,87,181,1,39,19,20,38,36,0,2,0,2
E33014432,205,155,45,110,0,15,12,3,31,26,0,4,1,4
E33014433,1046,790,238,552,6,76,45,31,166,156,2,8,0,8
E33014434,655,537,162,375,8,40,29,11,69,62,0,7,0,1
E33014435,452,367,105,262,8,20,11,9,54,49,0,4,1,3
E33014436,747,562,164,398,3,68,46,22,107,98,4,5,0,7
E33014437,672,526,176,350,6,58,39,19,67,63,0,3,1,15
E33014438,858,620,186,434,6,61,42,19,167,163,0,3,1,4
E33014439,334,264,77,187,3,27,24,3,38,37,0,1,0,2
E33014440,533,409,98,311,1,51,39,12,72,62,2,7,1,0
E33014441,966,762,229,533,7,81,31,50,108,99,3,5,1,8
E33014442,362,226,82,144,7,37,10,27,85,80,0,5,0,7
E33014443,287,216,84,132,4,23,8,15,44,36,4,2,2,0
E33014444,329,183,52,131,3,35,15,20,107,98,0,7,2,1
E33014445,2660,2055,540,1515,23,182,64,118,387,347,12,25,3,13
E33014446,222,149,48,101,6,16,6,10,51,48,1,2,0,0
E33014447,696,491,149,342,7,85,35,50,110,97,2,9,2,3
E33014448,415,316,96,220,11,35,9,26,50,46,0,4,0,3
E33014449,449,228,66,162,4,40,24,16,174,159,4,8,3,3
E33014450,520,312,92,220,5,33,15,18,169,157,3,7,2,1
E33014451,259,132,35,97,4,27,13,14,91,85,1,4,1,5
E33014452,242,181,62,119,1,20,7,13,40,37,1,1,1,0
E33014453,372,207,35,172,2,26,9,17,137,132,1,4,0,0
E33014454,892,545,138,407,8,69,37,32,268,250,2,14,2,2
E33014455,231,178,41,137,2,11,5,6,38,32,0,5,1,2
E33014456,228,129,42,87,0,26,11,15,73,71,0,0,2,0
E33014457,274,198,79,119,0,16,9,7,58,51,0,3,4,2
E33014458,370,249,89,160,2,20,4,16,95,89,3,3,0,4
E33014459,384,289,86,203,3,29,13,16,62,57,3,2,0,1
E33014460,216,165,65,100,2,20,12,8,29,27,1,1,0,0
E33014461,434,252,73,179,8,80,30,50,92,84,2,2,4,2
E33014462,258,203,51,152,3,8,2,6,40,33,1,6,0,4
E33014463,850,569,178,391,14,99,42,57,167,155,0,11,1,1
E33014464,420,318,75,243,8,13,4,9,80,74,2,2,2,1
E33014465,731,584,191,393,6,30,6,24,108,99,1,8,0,3
E33014466,572,403,163,240,5,36,11,25,119,107,6,5,1,9
E33014467,951,533,207,326,23,95,27,68,286,265,6,15,0,14
E33014468,933,707,230,477,5,68,23,45,150,132,4,14,0,3
E33014469,456,327,89,238,1,31,9,22,92,87,0,5,0,5
E33014470,267,225,65,160,1,9,3,6,29,26,1,2,0,3
E33014471,289,235,52,183,2,14,1,13,38,35,0,3,0,0
E33014472,253,197,59,138,0,9,2,7,46,35,1,10,0,1
E33014473,358,252,99,153,4,29,12,17,69,61,1,7,0,4
E33014474,267,162,47,115,2,20,6,14,81,75,2,4,0,2
E33014475,303,216,70,146,1,20,5,15,64,60,1,1,2,2
E33014476,372,260,76,184,5,32,6,26,73,63,0,8,2,2
E33014477,236,192,62,130,0,13,3,10,31,27,0,3,1,0
E33014478,231,184,61,123,2,14,2,12,29,28,1,0,0,2
E33014479,293,211,72,139,4,18,6,12,60,56,1,3,0,0
E33014480,291,187,65,122,4,18,3,15,82,75,1,6,0,0
E33014481,286,177,57,120,3,16,5,11,88,80,3,5,0,2
E33014482,408,274,99,175,3,38,7,31,89,81,1,7,0,4
E33014483,265,192,58,134,4,11,2,9,55,51,1,3,0,3
E33014484,334,262,76,186,1,16,5,11,53,48,1,4,0,2
E33014485,904,716,201,515,14,24,12,12,145,131,2,12,0,5
E33014486,567,392,104,288,8,80,58,22,86,72,0,14,0,1
E33014487,423,309,100,209,2,46,34,12,64,58,1,5,0,2
E33014488,810,550,145,405,5,123,100,23,126,103,4,17,2,6
E33014489,1373,1154,309,845,7,55,39,16,153,137,3,10,3,4
E33014490,246,150,43,107,3,15,11,4,77,67,8,2,0,1
E33014491,222,170,33,137,5,9,8,1,37,34,0,1,2,1
E33014492,407,279,51,228,2,31,22,9,92,85,1,6,0,3
E33014493,252,134,44,90,3,25,19,6,90,88,0,2,0,0
E33014494,278,132,32,100,2,23,12,11,117,114,0,3,0,4
E33014495,540,411,133,278,3,44,27,17,79,72,3,3,1,3
E33014496,687,541,148,393,2,33,24,9,110,102,1,7,0,1
E33014497,487,308,83,225,1,52,44,8,123,109,3,7,4,3
E33014498,341,246,56,190,5,15,12,3,74,63,1,8,2,1
E33014499,766,614,156,458,11,42,29,13,94,82,1,10,1,5
E33014500,445,366,76,290,1,5,4,1,72,61,2,9,0,1
E33014501,528,344,94,250,2,35,28,7,138,133,1,3,1,9
E33014502,736,576,112,464,3,43,28,15,110,101,1,8,0,4
E33014503,818,627,174,453,10,80,58,22,96,93,0,3,0,5
E33014504,623,491,161,330,2,36,26,10,90,80,5,5,0,4
E33014505,416,313,68,245,4,22,14,8,76,67,1,6,2,1
E33014506,829,583,182,401,5,112,89,23,126,111,4,9,2,3
E33014507,335,196,41,155,5,21,12,9,112,103,3,2,4,1
E33014508,344,244,78,166,1,36,27,9,60,53,0,7,0,3
E33014509,853,654,151,503,11,37,29,8,149,132,5,12,0,2
E33014510,1634,1367,374,993,14,64,48,16,182,170,0,9,3,7
E33014511,315,202,46,156,5,29,19,10,79,74,1,4,0,0
E33014512,189,105,33,72,2,17,14,3,63,57,1,3,2,2
E33014513,893,660,139,521,12,46,31,15,170,151,2,14,3,5
E33014514,351,233,86,147,1,60,44,16,55,49,1,5,0,2
E33014515,498,340,91,249,2,68,45,23,83,78,0,3,2,5
E33014516,238,135,31,104,0,31,25,6,71,68,0,2,1,1
E33014517,762,543,142,401,7,61,38,23,143,128,4,10,1,8
E33014518,524,396,84,312,3,39,31,8,83,73,1,9,0,3
E33014519,201,166,50,116,0,9,9,0,21,16,2,3,0,5
E33014520,412,334,84,250,5,13,7,6,57,51,0,5,1,3
E33014521,423,288,82,206,5,38,29,9,90,84,0,6,0,2
E33014522,218,160,62,98,1,10,9,1,42,38,0,2,2,5
E33014523,2338,1773,465,1308,9,103,67,36,443,229,130,12,72,10
E33014524,1615,754,189,565,20,168,128,40,669,645,6,12,6,4
E33014525,781,572,145,427,8,54,41,13,141,127,5,9,0,6
E33014526,749,567,195,372,5,69,57,12,104,97,1,6,0,4
E33014527,247,192,56,136,0,12,7,5,42,36,1,5,0,1
E33014528,523,408,107,301,5,27,22,5,82,68,6,8,0,1
E33014529,857,568,125,443,11,62,38,24,210,194,5,11,0,6
E33014530,628,489,149,340,6,53,42,11,74,65,0,8,1,6
E33014531,426,324,69,255,2,23,17,6,72,62,4,5,1,5
E33014532,349,307,82,225,0,7,4,3,35,29,2,3,1,0
E33014533,896,690,254,436,6,77,55,22,121,116,1,4,0,2
E33014534,220,162,45,117,2,20,14,6,34,30,1,2,1,2
E33014535,393,289,83,206,5,21,12,9,73,61,4,8,0,5
E33014536,346,237,61,176,3,33,22,11,71,65,0,4,2,2
E33014537,262,202,45,157,0,16,12,4,43,41,0,2,0,1
E33014538,243,168,49,119,4,27,18,9,43,40,2,1,0,1
E33014539,489,379,62,317,4,21,13,8,78,73,2,2,1,7
E33014540,419,301,70,231,6,34,28,6,76,64,0,10,2,2
E33014541,479,386,107,279,1,15,11,4,75,63,3,9,0,2
E33014542,363,291,76,215,2,27,20,7,40,38,1,1,0,3
E33014543,803,613,166,447,3,72,48,24,109,97,0,11,1,6
E33014544,584,445,125,320,1,36,28,8,96,90,4,2,0,6
E33014545,263,175,60,115,0,28,18,10,57,43,8,4,2,3
E33014546,345,263,78,185,3,25,17,8,49,48,0,1,0,5
E33014547,672,530,174,356,3,46,27,19,88,78,2,7,1,5
E33014548,1081,751,192,559,6,75,62,13,247,243,1,2,1,2
E33014549,360,269,74,195,4,23,14,9,63,59,2,0,2,1
E33014550,443,269,76,193,6,32,22,10,134,128,1,2,3,2
E33014551,656,319,92,227,6,53,31,22,276,266,4,5,1,2
E33014552,207,150,32,118,3,12,9,3,41,37,1,3,0,1
E33014553,1385,942,278,664,22,97,70,27,315,293,5,14,3,9
E33014554,513,353,93,260,10,47,33,14,100,97,1,2,0,3
E33014555,254,199,65,134,4,13,10,3,37,30,2,4,1,1
E33014556,372,272,76,196,7,27,18,9,63,55,2,6,0,3
E33014557,242,195,54,141,3,19,13,6,25,22,1,1,1,0
E33014558,300,251,88,163,0,9,7,2,35,32,2,0,1,5
E33014559,263,176,46,130,1,13,10,3,68,64,0,3,1,5
E33014560,220,161,47,114,2,14,12,2,41,35,2,4,0,2
E33014561,387,312,113,199,4,21,14,7,48,45,1,2,0,2
E33014562,227,165,45,120,5,15,11,4,41,36,0,5,0,1
E33014563,227,160,50,110,0,26,16,10,39,35,0,2,2,2
E33014564,248,206,72,134,2,10,7,3,27,22,1,4,0,3
E33014565,390,242,88,154,6,33,28,5,105,98,0,6,1,4
E33014566,854,489,137,352,8,69,50,19,285,276,1,5,3,3
E33014567,338,223,45,178,0,34,21,13,79,76,0,2,1,2
E33014568,547,325,66,259,6,59,30,29,151,140,1,10,0,6
E33014569,356,214,68,146,1,28,20,8,108,98,7,3,0,5
E33014570,271,207,77,130,1,22,19,3,39,32,6,1,0,2
E33014571,287,211,57,154,3,19,14,5,52,50,0,2,0,2
E33014572,1283,681,180,501,30,135,81,54,426,404,9,10,3,11
E33014573,945,737,196,541,20,50,28,22,132,120,2,8,2,6
E33014574,1190,815,184,631,11,150,99,51,210,196,1,11,2,4
E33014575,1120,779,156,623,11,91,72,19,229,203,3,21,2,10
E33014576,284,182,45,137,3,29,21,8,68,62,0,6,0,2
E33014577,793,487,140,347,4,106,82,24,187,169,4,13,1,9
E33014578,283,210,52,158,3,21,15,6,45,41,0,3,1,4
E33014579,395,299,78,221,2,25,20,5,65,60,1,3,1,4
E33014580,128,89,23,66,2,11,7,4,26,23,1,2,0,0
E33014581,319,219,53,166,2,31,22,9,66,60,1,4,1,1
E33014582,874,653,181,472,9,60,44,16,149,137,3,7,2,3
E33014583,212,135,53,82,1,21,16,5,54,53,1,0,0,1
E33014584,697,465,122,343,8,84,66,18,138,127,4,6,1,2
E33014585,248,172,44,128,0,35,30,5,39,35,0,4,0,2
E33014586,237,163,50,113,0,25,22,3,47,38,3,4,2,2
E33014587,259,138,34,104,0,20,12,8,95,90,0,3,2,6
E33014588,307,214,77,137,0,19,16,3,70,56,11,3,0,4
E33014589,518,354,106,248,9,44,24,20,109,104,0,5,0,2
E33014590,299,229,69,160,3,32,17,15,35,32,0,3,0,0
E33014591,396,314,93,221,4,21,10,11,53,49,0,4,0,4
E33014592,1144,821,209,612,9,85,70,15,218,205,1,10,2,11
E33014593,636,530,152,378,2,31,24,7,68,59,2,6,1,5
E33014594,219,169,49,120,0,13,11,2,37,32,1,4,0,0
E33014595,340,253,96,157,3,19,13,6,53,47,2,3,1,12
E33014596,298,213,61,152,1,24,14,10,55,45,3,4,3,5
E33014597,478,336,76,260,5,41,30,11,92,78,3,7,4,4
E33014598,245,182,58,124,1,16,10,6,43,39,3,1,0,3
E33014599,247,166,40,126,4,27,18,9,45,36,4,5,0,5
E33014600,218,136,44,92,4,24,18,6,52,48,0,2,2,2
E33014601,244,172,62,110,4,17,12,5,50,45,2,3,0,1
E33014602,344,246,64,182,4,17,12,5,64,56,3,4,1,13
E33014603,361,265,100,165,1,38,27,11,52,45,0,2,5,5
E33014604,338,244,82,162,3,20,13,7,69,62,3,3,1,2
E33014605,756,485,146,339,16,126,90,36,126,116,3,3,4,3
E33014606,277,210,82,128,0,25,18,7,40,33,3,1,3,2
E33014607,302,258,112,146,2,22,14,8,18,14,3,0,1,2
E33014608,1361,1092,271,821,6,63,43,20,182,162,3,13,4,18
E33014609,498,371,100,271,4,37,29,8,84,74,3,7,0,2
E33014610,344,231,76,155,4,52,35,17,55,50,1,2,2,2
E33014611,416,256,67,189,11,76,25,51,70,66,0,3,1,3
E33014612,690,501,128,373,13,86,34,52,84,71,0,13,0,6
E33014613,344,241,69,172,8,35,10,25,57,49,1,7,0,3
E33014614,200,139,28,111,2,24,8,16,33,27,2,3,1,2
E33014615,197,137,44,93,0,14,8,6,42,33,2,7,0,4
E33014616,218,150,42,108,3,20,7,13,42,36,1,4,1,3
E33014617,205,152,26,126,2,12,3,9,37,28,8,1,0,2
E33014618,278,201,60,141,5,28,6,22,42,38,1,3,0,2
E33014619,1103,835,267,568,13,89,33,56,160,144,3,12,1,6
E33014620,671,501,148,353,1,47,32,15,112,98,8,5,1,10
E33014621,314,252,49,203,0,24,15,9,37,32,0,4,1,1
E33014622,632,399,69,330,6,123,98,25,98,90,0,8,0,6
E33014623,311,234,50,184,0,43,29,14,33,32,0,1,0,1
E33014624,329,263,76,187,6,31,22,9,29,29,0,0,0,0
E33014625,488,265,61,204,5,63,49,14,152,142,4,6,0,3
E33014626,337,198,44,154,2,67,54,13,68,60,1,7,0,2
E33014627,347,221,55,166,1,39,32,7,85,84,0,1,0,1
E33014628,366,271,52,219,2,40,31,9,51,46,0,5,0,2
E33014629,302,181,46,135,2,41,27,14,78,72,1,5,0,0
E33014630,293,193,43,150,3,40,35,5,55,51,0,4,0,2
E33014631,593,360,75,285,9,69,48,21,150,144,1,5,0,5
E33014632,478,338,79,259,4,41,28,13,93,89,0,2,2,2
E33014633,563,424,93,331,0,44,28,16,93,87,0,6,0,2
E33014634,628,432,89,343,6,62,42,20,125,119,0,5,1,3
E33014635,465,322,75,247,2,54,42,12,85,79,1,5,0,2
E33014636,787,600,141,459,2,66,45,21,115,109,0,4,2,4
E33014637,449,319,59,260,1,44,31,13,85,81,1,3,0,0
E33014638,292,172,31,141,3,29,23,6,88,76,4,6,2,0
E33014639,479,294,54,240,3,47,40,7,134,126,0,7,1,1
E33014640,384,236,59,177,3,47,29,18,98,94,0,4,0,0
E33014641,1357,941,192,749,6,198,156,42,198,181,0,17,0,14
E33014642,367,273,79,194,0,47,38,9,46,44,0,2,0,1
E33014643,656,453,96,357,12,75,22,53,112,108,0,2,2,4
E33014644,270,172,53,119,8,41,11,30,48,46,2,0,0,1
E33014645,199,152,54,98,2,22,5,17,22,21,0,1,0,1
E33014646,499,316,82,234,7,89,25,64,82,76,0,5,1,5
E33014647,266,180,38,142,3,43,23,20,37,35,0,1,1,3
E33014648,672,467,116,351,12,80,28,52,112,104,0,7,1,1
E33014649,1455,780,145,635,23,158,85,73,489,441,4,11,33,5
E33014650,363,267,67,200,4,27,15,12,63,59,0,3,1,2
E33014651,300,215,57,158,4,14,8,6,66,61,2,2,1,1
E33014652,999,799,179,620,7,39,18,21,151,145,2,4,0,3
E33014653,473,377,106,271,8,32,18,14,55,50,0,4,1,1
E33014654,1308,703,142,561,24,148,78,70,428,404,2,16,6,5
E33014655,717,470,135,335,9,56,25,31,178,170,0,8,0,4
E33014656,586,381,90,291,5,67,27,40,133,123,1,9,0,0
E33014657,121,82,22,60,0,7,3,4,31,29,1,0,1,1
E33014658,244,181,45,136,6,25,6,19,31,27,0,4,0,1
E33014659,307,206,54,152,5,35,9,26,60,54,2,4,0,1
E33014660,938,718,208,510,15,57,28,29,129,114,3,10,2,19
E33014661,469,346,95,251,1,54,16,38,64,59,3,1,1,4
E33014662,241,175,45,130,1,30,11,19,35,33,0,2,0,0
E33014663,383,265,61,204,1,34,8,26,82,77,0,4,1,1
E33014664,352,277,80,197,2,33,5,28,39,37,2,0,0,1
E33014665,554,372,90,282,8,80,16,64,91,78,0,13,0,3
E33014666,1168,791,190,601,17,123,32,91,230,213,2,13,2,7
E33014667,425,314,84,230,1,53,9,44,54,51,0,3,0,3
E33014668,339,250,65,185,1,44,15,29,42,37,0,5,0,2
E33014669,1045,512,116,396,7,103,45,58,416,404,0,12,0,7
E33014670,904,612,115,497,5,82,50,32,202,184,1,17,0,3
E33014671,224,173,49,124,0,11,7,4,38,30,4,4,0,2
E33014672,200,122,37,85,1,16,12,4,44,40,4,0,0,17
E33014673,223,161,36,125,2,12,9,3,43,36,1,4,2,5
E33014674,223,160,39,121,3,11,3,8,45,38,1,6,0,4
E33014675,301,204,61,143,1,17,8,9,77,73,0,3,1,2
E33014676,282,202,56,146,4,28,13,15,47,40,2,5,0,1
E33014677,699,468,107,361,7,77,42,35,144,128,1,14,1,3
E33014678,460,314,75,239,6,39,28,11,88,76,0,12,0,13
E33014679,1229,922,202,720,9,79,45,34,217,200,3,14,0,2
E33014680,281,216,47,169,6,20,11,9,37,34,0,3,0,2
E33014681,3425,2709,646,2063,28,228,120,108,448,415,3,27,3,12
E33014682,291,235,79,156,2,19,13,6,35,34,0,1,0,0
E33014683,1403,1035,235,800,12,115,64,51,234,217,1,12,4,7
E33014684,260,211,61,150,4,12,7,5,32,28,1,3,0,1
E33014685,313,235,63,172,1,12,7,5,65,63,0,2,0,0
E33014686,1230,830,174,656,14,101,48,53,282,267,2,12,1,3
E33014687,219,174,56,118,1,21,15,6,23,20,0,3,0,0
E33014688,697,489,114,375,2,76,45,31,128,119,0,9,0,2
E33014689,553,420,86,334,4,45,19,26,83,79,0,4,0,1
E33014690,578,443,91,352,5,22,11,11,102,91,2,9,0,6
E33014691,258,203,46,157,2,18,14,4,35,28,0,6,1,0
E33014692,320,234,67,167,5,28,20,8,52,49,0,3,0,1
E33014693,240,170,42,128,2,35,22,13,32,26,2,3,1,1
E33014694,361,230,52,178,5,37,23,14,87,83,0,4,0,2
E33014695,631,471,86,385,8,49,30,19,97,95,0,2,0,6
E33014696,452,332,77,255,9,39,27,12,70,61,0,8,1,2
E33014697,967,394,109,285,15,133,84,49,417,404,3,7,3,8
E33014698,231,168,46,122,3,23,16,7,35,32,0,3,0,2
E33014699,255,189,48,141,1,22,17,5,43,39,0,4,0,0
E33014700,690,565,140,425,3,43,22,21,77,69,0,7,1,2
E33014701,1239,855,223,632,21,160,122,38,199,192,1,6,0,4
E33014702,309,217,50,167,4,32,25,7,51,46,0,5,0,5
E33014703,404,312,57,255,5,35,24,11,49,46,0,3,0,3
E33014704,785,543,114,429,16,59,27,32,161,152,1,8,0,6
E33014705,778,546,138,408,14,69,38,31,147,141,0,5,1,2
E33014706,483,306,78,228,3,60,42,18,109,105,0,4,0,5
E33014707,1254,819,177,642,20,123,71,52,286,265,0,17,4,6
E33014708,787,518,122,396,20,81,44,37,166,154,3,9,0,2
E33014709,527,402,97,305,7,50,31,19,67,62,0,3,2,1
E33014710,856,579,148,431,14,84,50,34,172,165,2,5,0,7
E33014711,679,547,104,443,7,23,14,9,100,95,0,5,0,2
E33014712,435,317,50,267,10,11,4,7,96,88,0,7,1,1
E33014713,3968,3170,607,2563,49,173,100,73,563,517,2,40,4,13
E33014714,1045,781,171,610,17,70,44,26,175,165,0,10,0,2
E33014715,509,372,101,271,5,33,21,12,96,92,1,2,1,3
E33014716,450,326,78,248,4,41,27,14,78,73,0,4,1,1
E33014717,756,608,127,481,8,44,30,14,92,81,0,11,0,4
E33014718,1133,858,185,673,22,57,32,25,194,183,0,11,0,2
E33014719,450,358,82,276,6,25,15,10,59,55,0,4,0,2
E33014720,568,443,108,335,5,40,30,10,77,72,1,4,0,3
E33014721,2489,1992,352,1640,48,97,53,44,345,313,0,32,0,7
E33014722,475,355,90,265,7,18,13,5,92,86,0,6,0,3
E33014723,537,425,95,330,5,31,16,15,75,67,1,7,0,1
E33014724,1405,738,189,549,22,143,110,33,496,473,3,16,4,6
E33014725,302,209,76,133,2,34,21,13,56,49,1,6,0,1
E33014726,285,227,68,159,6,17,8,9,35,30,2,1,2,0
E33014727,417,274,64,210,5,37,19,18,100,93,0,7,0,1
E33014728,262,156,41,115,7,29,20,9,64,55,3,5,1,6
E33014729,516,402,101,301,4,39,23,16,70,61,1,7,1,1
E33014730,368,321,80,241,6,8,3,5,31,26,0,5,0,2
E33014731,870,694,169,525,13,50,32,18,106,101,1,4,0,7
E33014732,285,216,47,169,2,7,5,2,58,52,0,5,1,2
E33014733,964,555,128,427,12,151,90,61,243,226,1,14,2,3
E33014734,197,131,29,102,1,17,11,6,48,44,0,3,1,0
E33014735,345,242,56,186,7,25,17,8,71,64,4,3,0,0
E33014736,320,236,72,164,8,16,11,5,56,51,1,4,0,4
E33014737,682,463,126,337,12,77,58,19,125,115,0,10,0,5
E33014738,568,444,108,336,12,29,23,6,81,76,0,3,2,2
E33014739,420,204,46,158,5,38,27,11,173,167,0,3,3,0
E33014740,804,591,122,469,18,48,35,13,142,134,1,7,0,5
E33014741,1146,792,168,624,8,109,73,36,228,207,0,16,5,9
E33014742,482,328,90,238,4,73,49,24,73,65,5,3,0,4
E33014743,348,233,39,194,5,28,15,13,78,72,0,6,0,4
E33014744,398,281,71,210,3,35,26,9,78,69,0,9,0,1
E33014745,421,298,68,230,7,37,22,15,78,74,0,4,0,1
E33014746,387,238,61,177,4,38,29,9,107,104,0,3,0,0
E33014747,651,399,103,296,10,99,71,28,137,129,1,7,0,6
E33014748,1664,900,175,725,25,151,78,73,582,562,0,18,2,6
E33014749,942,637,184,453,30,117,62,55,153,146,0,6,1,5
E33014750,1751,1219,248,971,17,140,92,48,371,350,2,14,5,4
E33014751,1477,895,175,720,27,191,66,125,349,322,7,19,1,15
E33014752,576,453,71,382,3,30,16,14,84,81,0,3,0,6
E33014753,382,282,72,210,7,31,7,24,58,52,2,3,1,4
E33014754,501,389,82,307,8,27,5,22,75,68,0,6,1,2
E33014755,817,644,163,481,7,28,13,15,138,130,1,7,0,0
E33014756,762,277,77,200,4,33,4,29,325,287,19,4,15,123
E33014757,629,477,108,369,15,36,13,23,99,90,3,6,0,2
E33014758,451,369,106,263,7,24,7,17,47,44,0,3,0,4
E33014759,354,276,62,214,3,30,6,24,41,38,2,1,0,4
E33014760,682,530,145,385,9,51,20,31,80,68,5,7,0,12
E33014761,365,247,58,189,8,35,13,22,72,67,0,5,0,3
E33014762,532,371,92,279,6,74,22,52,74,68,0,6,0,7
E33014763,291,210,55,155,2,34,10,24,45,40,2,3,0,0
E33014764,405,303,87,216,9,40,22,18,53,46,0,7,0,0
E33014765,559,442,100,342,3,18,4,14,93,87,0,6,0,3
E33014766,345,229,64,165,3,47,17,30,65,58,0,7,0,1
E33014767,852,645,144,501,13,59,24,35,133,126,1,6,0,2
E33014768,270,180,44,136,1,33,19,14,56,56,0,0,0,0
E33014769,219,172,46,126,3,15,3,12,29,26,2,1,0,0
E33014770,294,216,57,159,2,35,15,20,40,37,0,3,0,1
E33014771,665,470,120,350,6,62,22,40,124,119,2,3,0,3
E33014772,361,267,61,206,3,30,13,17,60,56,0,4,0,1
E33014773,349,272,75,197,2,22,9,13,52,46,0,4,2,1
E33014774,1431,729,138,591,13,154,54,100,533,517,1,10,5,2
E33014775,492,292,62,230,5,42,13,29,151,144,0,4,3,2
E33014776,728,507,104,403,14,51,23,28,154,148,0,6,0,2
E33014777,1616,978,234,744,25,255,128,127,350,325,0,21,4,8
E33014778,393,292,45,247,9,13,5,8,75,66,2,7,0,4
E33014779,244,196,58,138,1,14,3,11,33,29,0,4,0,0
E33014780,313,242,64,178,2,19,8,11,48,39,0,9,0,2
E33014781,448,321,89,232,1,51,18,33,75,70,0,5,0,0
E33014782,280,214,59,155,0,12,6,6,51,49,0,2,0,3
E33014783,513,397,129,268,1,42,7,35,66,62,2,2,0,7
E33014784,474,353,94,259,6,38,9,29,70,58,2,10,0,7
E33014785,242,186,52,134,2,15,4,11,38,37,0,1,0,1
E33014786,565,379,102,277,8,87,26,61,86,80,0,6,0,5
E33014787,297,210,44,166,2,28,8,20,56,49,0,7,0,1
E33014788,329,254,67,187,3,18,4,14,53,44,2,6,1,1
E33014789,658,473,110,363,13,77,27,50,92,85,0,7,0,3
E33014790,230,149,29,120,4,30,11,19,46,45,0,1,0,1
E33014791,208,140,42,98,2,17,5,12,48,47,0,1,0,1
E33014792,299,185,48,137,5,43,22,21,63,61,0,2,0,3
E33014793,195,143,30,113,4,15,3,12,31,26,0,5,0,2
E33014794,333,262,71,191,1,29,22,7,38,30,0,7,1,3
E33014795,813,600,192,408,6,87,62,25,112,106,1,4,1,8
E33014796,1281,1101,251,850,3,52,30,22,119,107,0,10,2,6
E33014797,506,360,103,257,2,63,46,17,80,74,1,4,1,1
E33014798,271,199,45,154,0,36,30,6,35,30,0,4,1,1
E33014799,308,235,81,154,1,35,29,6,35,32,0,3,0,2
E33014800,703,547,146,401,3,60,48,12,89,78,0,11,0,4
E33014801,897,756,205,551,7,48,37,11,82,76,1,5,0,4
E33014802,321,201,55,146,2,34,29,5,84,82,1,1,0,0
E33014803,299,203,54,149,3,55,36,19,37,33,0,3,1,1
E33014804,464,376,112,264,1,31,22,9,54,49,0,4,1,2
E33014805,423,366,117,249,0,13,7,6,42,41,0,1,0,2
E33014806,317,249,54,195,1,30,22,8,36,31,1,4,0,1
E33014807,295,213,69,144,1,22,19,3,57,48,0,4,5,2
E33014808,637,476,147,329,3,62,51,11,96,87,0,9,0,0
E33014809,720,528,164,364,3,65,54,11,120,109,3,8,0,4
E33014810,502,402,117,285,1,37,32,5,57,48,3,5,1,5
E33014811,241,185,56,129,3,25,17,8,28,23,1,4,0,0
E33014812,3108,2473,634,1839,10,195,124,71,414,371,2,40,1,16
E33014813,1298,1003,262,741,12,96,74,22,179,158,0,20,1,8
E33014814,219,174,47,127,0,15,10,5,30,28,0,2,0,0
E33014815,2263,1714,411,1303,11,174,135,39,357,326,4,21,6,7
E33014816,4978,3946,883,3063,19,266,179,87,727,677,1,47,2,20
E33014817,217,159,32,127,0,19,16,3,38,36,0,2,0,1
E33014818,1380,1043,288,755,4,149,108,41,178,159,3,16,0,6
E33014819,509,391,95,296,5,21,12,9,89,87,1,1,0,3
E33014820,489,415,142,273,2,28,15,13,44,39,1,4,0,0
E33014821,666,506,145,361,5,55,45,10,96,84,3,9,0,4
E33014822,258,184,44,140,1,21,19,2,49,45,0,2,2,3
E33014823,575,410,139,271,2,63,53,10,90,84,1,5,0,10
E33014824,251,194,56,138,0,14,13,1,40,39,0,1,0,3
E33014825,545,415,114,301,3,59,48,11,67,55,1,9,2,1
E33014826,212,183,48,135,0,9,6,3,19,17,0,2,0,1
E33014827,232,166,64,102,1,28,15,13,37,30,1,6,0,0
E33014828,230,192,51,141,0,13,11,2,22,17,0,4,1,3
E33014829,278,204,63,141,1,28,16,12,42,37,3,1,1,3
E33014830,580,494,168,326,1,34,25,9,49,47,0,2,0,2
E33014831,615,478,141,337,6,52,39,13,72,62,3,6,1,7
E33014832,593,385,93,292,3,70,53,17,129,122,1,4,2,6
E33014833,247,136,41,95,0,23,13,10,60,55,3,1,1,28
E33014834,1344,1145,338,807,6,58,44,14,126,112,7,7,0,9
E33014835,590,479,150,329,3,48,42,6,56,54,0,1,1,4
E33014836,343,229,71,158,4,44,33,11,60,56,2,1,1,6
E33014837,327,253,85,168,0,27,20,7,44,37,2,5,0,3
E33014838,333,232,75,157,1,45,36,9,55,53,0,1,1,0
E33014839,726,566,159,407,5,54,36,18,98,91,0,7,0,3
E33014840,239,171,52,119,1,21,18,3,42,37,0,3,2,4
E33014841,215,150,29,121,1,17,14,3,47,46,0,1,0,0
E33014842,308,188,58,130,4,37,30,7,76,72,0,3,1,3
E33014843,326,257,77,180,1,18,13,5,46,45,0,1,0,4
E33014844,262,199,65,134,0,23,18,5,39,33,0,2,4,1
E33014845,836,707,244,463,0,56,47,9,69,63,1,5,0,4
E33014846,391,290,90,200,1,30,16,14,66,61,0,3,2,4
E33014847,719,497,146,351,2,92,63,29,122,116,0,4,2,6
E33014848,255,176,44,132,1,13,11,2,56,55,0,1,0,9
E33014849,1079,778,233,545,10,139,118,21,145,137,3,5,0,7
E33014850,1096,847,262,585,4,70,43,27,164,156,1,7,0,11
E33014851,400,308,88,220,5,26,25,1,57,51,1,4,1,4
E33014852,429,320,109,211,1,39,25,14,69,61,0,7,1,0
E33014853,246,190,60,130,2,9,4,5,41,37,0,4,0,4
E33014854,571,458,104,354,3,39,22,17,69,62,2,4,1,2
E33014855,544,428,121,307,2,48,33,15,59,52,1,5,1,7
E33014856,1367,1046,231,815,6,86,47,39,221,199,0,22,0,8
E33014857,717,533,115,418,8,46,38,8,123,111,1,10,1,7
E33014858,948,708,215,493,8,82,66,16,148,132,3,8,5,2
E33014859,1162,816,258,558,9,143,106,37,185,169,5,9,2,9
E33014860,155,122,33,89,0,13,9,4,20,18,0,1,1,0
E33014861,484,367,93,274,1,34,17,17,79,67,0,10,2,3
E33014862,503,342,76,266,4,64,47,17,87,80,1,6,0,6
E33014863,431,352,109,243,2,34,21,13,41,39,0,2,0,2
E33014864,417,303,103,200,4,39,26,13,69,60,0,8,1,2
E33014865,832,655,199,456,2,67,55,12,101,89,2,7,3,7
E33014866,623,467,133,334,3,61,32,29,91,87,0,3,1,1
E33014867,396,297,89,208,1,33,22,11,65,62,0,2,1,0
E33014868,301,228,75,153,2,34,20,14,35,31,0,4,0,2
E33014869,1825,1314,329,985,5,212,126,86,285,262,2,20,1,9
E33014870,431,300,91,209,0,58,35,23,73,63,0,9,1,0
E33014871,1139,784,205,579,5,100,61,39,241,222,0,16,3,9
E33014872,2339,2052,449,1603,13,60,41,19,205,182,4,18,1,9
E33014873,534,370,122,248,4,86,48,38,73,69,0,4,0,1
E33014874,280,226,67,159,2,24,12,12,27,22,0,5,0,1
E33014875,880,744,214,530,1,37,26,11,92,87,0,4,1,6
E33014876,239,171,58,113,1,19,10,9,48,46,0,2,0,0
E33014877,292,236,62,174,0,16,12,4,35,30,0,4,1,5
E33014878,312,226,68,158,1,42,19,23,39,36,1,2,0,4
E33014879,126,93,15,78,0,13,8,5,19,16,0,3,0,1
E33014880,336,259,90,169,1,35,26,9,41,34,1,3,3,0
E33014881,236,191,54,137,2,18,13,5,25,22,0,3,0,0
E33014882,488,390,95,295,7,22,17,5,69,64,0,5,0,0
E33014883,344,253,58,195,0,35,27,8,54,49,2,2,1,2
E33014884,644,446,112,334,1,61,51,10,130,122,0,7,1,6
E33014885,405,336,85,251,1,24,16,8,42,41,0,1,0,2
E33014886,244,179,56,123,0,23,18,5,41,38,0,3,0,1
E33014887,362,246,70,176,4,43,23,20,68,65,0,3,0,1
E33014888,332,277,91,186,2,20,15,5,32,29,0,3,0,1
E33014889,238,160,42,118,1,37,27,10,38,30,2,6,0,2
E33014890,268,187,59,128,1,27,20,7,52,46,1,5,0,1
E33014891,210,151,49,102,0,22,14,8,33,30,0,3,0,4
E33014892,608,355,65,290,5,68,52,16,174,163,0,11,0,6
E33014893,202,146,33,113,0,19,12,7,34,34,0,0,0,3
E33014894,834,711,189,522,1,33,20,13,81,72,1,5,3,8
E33014895,687,558,143,415,4,38,22,16,85,80,0,4,1,2
E33014896,323,241,52,189,2,26,17,9,53,50,0,3,0,1
E33014897,398,250,69,181,1,28,21,7,113,107,0,6,0,6
E33014898,1139,848,224,624,7,92,64,28,188,174,0,13,1,4
E33014899,774,640,170,470,2,62,47,15,68,64,0,4,0,2
E33014900,286,217,71,146,0,29,26,3,39,38,0,1,0,1
E33014901,942,752,235,517,3,84,59,25,100,93,0,4,3,3
E33014902,244,175,46,129,0,21,17,4,45,38,0,5,2,3
E33014903,515,386,134,252,2,43,28,15,79,67,0,12,0,5
E33014904,420,330,83,247,5,24,18,6,60,54,0,5,1,1
E33014905,316,217,79,138,2,29,20,9,65,54,1,10,0,3
E33014906,294,209,50,159,0,27,20,7,54,50,1,3,0,4
E33014907,222,171,48,123,2,15,7,8,34,28,0,6,0,0
E33014908,473,343,108,235,5,72,55,17,50,49,0,1,0,3
E33014909,274,194,45,149,4,28,20,8,47,45,0,2,0,1
E33014910,297,234,49,185,0,17,9,8,44,37,0,4,3,2
E33014911,882,627,158,469,4,97,64,33,151,137,0,11,3,3
E33014912,452,313,101,212,2,51,33,18,78,71,0,7,0,8
E33014913,380,303,99,204,3,32,19,13,41,37,0,4,0,1
E33014914,320,209,65,144,1,56,44,12,52,43,1,4,4,2
E33014915,355,297,91,206,1,18,16,2,34,32,0,2,0,5
E33014916,1275,973,284,689,10,98,61,37,178,155,7,14,2,16
E33014917,684,438,134,304,2,66,46,20,171,167,0,4,0,7
E33014918,294,226,49,177,1,21,16,5,44,38,2,4,0,2
E33014919,3812,2135,499,1636,27,440,338,102,1189,1134,8,39,8,21
E33014920,655,516,130,386,4,47,36,11,87,78,2,6,1,1
E33014921,445,340,82,258,3,23,16,7,76,72,0,4,0,3
E33014922,289,207,52,155,3,17,11,6,57,53,0,4,0,5
E33014923,683,483,147,336,4,65,48,17,126,117,1,8,0,5
E33014924,814,537,135,402,9,87,57,30,179,167,4,8,0,2
E33014925,515,382,106,276,2,40,30,10,85,73,4,8,0,6
E33014926,249,185,54,131,0,30,25,5,31,29,0,2,0,3
E33014927,277,188,63,125,0,41,26,15,47,44,1,2,0,1
E33014928,273,221,58,163,2,9,6,3,41,37,0,4,0,0
E33014929,201,147,46,101,2,11,8,3,37,36,0,1,0,4
E33014930,366,261,74,187,0,30,22,8,71,69,0,2,0,4
E33014931,272,205,51,154,0,18,14,4,47,42,0,4,1,2
E33014932,236,184,61,123,3,14,10,4,34,33,0,1,0,1
E33014933,558,445,133,312,4,45,24,21,61,53,2,5,1,3
E33014934,228,189,53,136,1,13,8,5,24,20,0,4,0,1
E33014935,425,329,98,231,2,50,43,7,41,31,1,9,0,3
E33014936,472,344,93,251,0,42,26,16,77,72,0,5,0,9
E33014937,668,553,166,387,3,42,37,5,67,62,0,4,1,3
E33014938,646,501,174,327,5,34,22,12,103,97,0,6,0,3
E33014939,240,183,56,127,0,15,9,6,39,34,0,4,1,3
E33014940,995,793,217,576,4,58,39,19,129,119,1,7,2,11
E33014941,558,435,110,325,3,42,21,21,76,66,0,8,2,2
E33014942,336,222,80,142,1,28,14,14,61,53,2,4,2,24
E33014943,641,504,157,347,0,28,18,10,94,86,3,5,0,15
E33014944,1416,813,233,580,15,125,99,26,455,434,3,17,1,8
E33014945,598,455,143,312,4,61,26,35,73,65,1,6,1,5
E33014946,446,309,84,225,2,52,25,27,82,77,0,4,1,1
E33014947,281,196,69,127,0,41,16,25,39,33,0,5,1,5
E33014948,595,458,102,356,3,30,15,15,101,93,0,7,1,3
E33014949,419,321,85,236,2,12,5,7,80,67,1,11,1,4
E33014950,825,695,212,483,3,24,9,15,94,87,0,7,0,9
E33014951,753,482,170,312,11,140,96,44,113,107,1,4,1,7
E33014952,1775,1336,267,1069,11,93,68,25,330,314,0,16,0,5
E33014953,252,175,64,111,3,14,7,7,55,47,2,5,1,5
E33014954,1462,1148,349,799,11,64,51,13,230,212,0,16,2,9
E33014955,214,159,59,100,2,12,5,7,39,37,0,0,2,2
E33014956,474,325,94,231,7,29,12,17,108,101,0,7,0,5
E33014957,526,390,124,266,10,32,20,12,91,87,0,4,0,3
E33014958,459,279,82,197,3,51,28,23,117,110,0,7,0,9
E33014959,611,442,99,343,2,43,27,16,120,117,0,2,1,4
E33014960,708,521,159,362,5,85,60,25,96,90,0,5,1,1
E33014961,617,526,157,369,5,17,13,4,65,59,0,6,0,4
E33014962,2157,1776,534,1242,10,127,85,42,236,217,2,17,0,8
E33014963,458,332,79,253,7,42,20,22,74,65,3,4,2,3
E33014964,776,572,155,417,4,54,32,22,145,138,1,6,0,1
E33014965,279,186,63,123,9,26,14,12,58,55,0,2,1,0
E33014966,229,146,45,101,1,18,8,10,61,55,2,3,1,3
E33014967,107,77,33,44,0,0,0,0,29,28,0,1,0,1
E33014968,597,284,64,220,4,48,35,13,257,251,1,5,0,4
E33014969,599,476,149,327,4,50,30,20,68,64,0,3,1,1
E33014970,534,404,126,278,4,24,12,12,97,92,1,4,0,5
E33014971,393,291,79,212,3,38,25,13,60,56,0,4,0,1
E33014972,438,334,98,236,3,47,29,18,52,46,0,6,0,2
E33014973,1130,898,235,663,10,68,44,24,145,132,4,8,1,9
E33014974,449,325,50,275,6,39,27,12,77,66,2,9,0,2
E33014975,254,192,28,164,1,19,10,9,42,40,0,1,1,0
E33014976,1712,1051,269,782,13,193,144,49,451,430,2,17,2,4
E33014977,365,241,58,183,5,41,29,12,76,71,0,5,0,2
E33014978,292,225,53,172,0,21,12,9,46,43,0,3,0,0
E33014979,244,181,35,146,1,27,19,8,35,30,0,5,0,0
E33014980,922,563,102,461,13,105,82,23,239,226,1,11,1,2
E33014981,1621,1218,250,968,6,175,139,36,220,208,1,9,2,2
E33014982,233,179,20,159,4,20,13,7,27,23,1,2,1,3
E33014983,413,307,41,266,4,18,11,7,81,74,0,7,0,3
E33014984,933,605,121,484,15,93,29,64,218,204,2,10,2,2
E33014985,219,126,30,96,3,30,14,16,59,55,0,4,0,1
E33014986,415,279,74,205,6,44,13,31,81,78,0,3,0,5
E33014987,337,267,53,214,7,20,7,13,42,41,0,1,0,1
E33014988,909,583,118,465,18,92,30,62,215,206,1,7,1,1
E33014989,814,504,133,371,9,69,38,31,222,209,1,12,0,10
E33014990,523,354,80,274,1,55,35,20,109,102,1,4,2,4
E33014991,602,428,116,312,8,50,29,21,109,98,0,10,1,7
E33014992,794,367,58,309,12,76,40,36,336,318,4,7,7,3
E33014993,917,642,163,479,17,72,40,32,183,173,1,9,0,3
E33014994,391,292,75,217,5,34,20,14,58,55,0,3,0,2
E33014995,470,293,51,242,10,44,31,13,119,112,0,6,1,4
E33014996,298,213,57,156,4,35,20,15,45,40,0,4,1,1
E33014997,305,191,41,150,2,34,20,14,69,65,0,4,0,9
E33014998,684,495,83,412,17,66,41,25,101,92,0,6,3,5
E33014999,812,628,139,489,10,50,26,24,119,108,0,10,1,5
E33015000,431,330,83,247,9,26,11,15,60,53,0,6,1,6
E33015001,313,181,39,142,1,38,23,15,92,86,0,4,2,1
E33015002,246,172,45,127,6,23,18,5,44,39,0,4,1,1
E33015003,208,123,26,97,2,34,25,9,48,46,0,2,0,1
E33015004,597,369,88,281,7,81,45,36,138,122,3,13,0,2
E33015005,232,140,24,116,1,33,15,18,57,53,0,2,2,1
E33015006,416,227,47,180,2,70,45,25,115,108,1,6,0,2
E33015007,200,154,47,107,0,15,7,8,29,28,0,1,0,2
E33015008,319,257,60,197,2,16,7,9,43,41,0,2,0,1
E33015009,376,254,60,194,3,29,19,10,88,84,0,3,1,2
E33015010,360,229,50,179,7,27,15,12,92,87,2,3,0,5
E33015011,215,132,27,105,2,23,20,3,57,53,0,1,3,1
E33015012,1373,1040,233,807,18,128,94,34,184,175,1,8,0,3
E33015013,300,173,36,137,5,22,11,11,96,93,1,2,0,4
E33015014,489,340,67,273,8,32,12,20,103,92,1,8,2,6
E33015015,3807,2877,651,2226,45,229,134,95,643,604,2,28,9,13
E33015016,341,252,51,201,6,28,12,16,54,52,0,2,0,1
E33015017,414,258,59,199,6,38,25,13,110,104,0,6,0,2
E33015018,516,369,91,278,21,42,25,17,81,72,0,9,0,3
E33015019,218,111,20,91,4,17,10,7,84,73,1,9,1,2
E33015020,612,354,86,268,5,96,60,36,156,147,1,6,2,1
E33015021,1488,1143,313,830,17,61,32,29,258,241,1,14,2,9
E33015022,667,499,119,380,9,51,23,28,107,92,2,11,2,1
E33015023,457,364,67,297,4,39,12,27,49,47,0,2,0,1
E33015024,943,677,175,502,11,96,29,67,155,138,2,15,0,4
E33015025,204,119,38,81,3,21,13,8,49,44,3,2,0,12
E33015026,555,339,68,271,7,48,31,17,157,152,1,4,0,4
E33015027,258,190,55,135,4,12,9,3,48,44,0,3,1,4
E33015028,661,556,164,392,1,26,11,15,77,71,0,6,0,1
E33015029,435,302,78,224,4,43,29,14,85,82,0,3,0,1
E33015030,1210,915,244,671,7,64,33,31,211,190,0,18,3,13
E33015031,583,372,116,256,5,98,59,39,105,100,1,4,0,3
E33015032,200,97,28,69,1,52,35,17,47,40,0,5,2,3
E33015033,765,530,166,364,5,92,58,34,135,128,0,4,3,3
E33015034,311,248,80,168,2,29,21,8,31,29,0,2,0,1
E33015035,259,178,54,124,5,21,13,8,51,49,1,1,0,4
E33015036,532,401,102,299,7,46,23,23,77,71,0,6,0,1
E33015037,408,252,82,170,2,60,40,20,91,87,1,3,0,3
E33015038,202,121,45,76,2,35,18,17,43,37,0,5,1,1
E33015039,222,160,55,105,0,29,17,12,31,28,1,1,1,2
E33015040,432,306,67,239,2,45,26,19,77,71,0,6,0,2
E33015041,777,505,139,366,6,66,33,33,197,181,2,14,0,3
E33015042,487,367,125,242,7,31,10,21,79,70,1,8,0,3
E33015043,2072,1739,540,1199,8,104,51,53,213,200,0,11,2,8
E33015044,385,267,66,201,2,26,18,8,87,80,2,4,1,3
E33015045,272,182,44,138,1,32,22,10,54,52,1,1,0,3
E33015046,352,289,93,196,5,17,9,8,40,38,0,2,0,1
E33015047,649,379,87,292,6,63,35,28,197,179,2,14,2,4
E33015048,197,154,49,105,2,5,2,3,33,30,1,2,0,3
E33015049,363,250,75,175,5,28,16,12,71,67,1,3,0,9
E33015050,224,144,45,99,1,15,10,5,59,56,0,2,1,5
E33015051,294,183,42,141,2,27,17,10,81,75,1,3,2,1
E33015052,824,609,173,436,13,46,21,25,155,146,0,8,1,1
E33015053,325,270,85,185,1,14,7,7,39,37,0,2,0,1
E33015054,751,537,150,387,9,71,37,34,131,125,0,6,0,3
E33015055,460,367,90,277,1,17,8,9,75,70,0,5,0,0
E33015056,318,216,55,161,3,34,22,12,62,59,2,1,0,3
E33015057,207,159,57,102,0,13,9,4,32,30,0,2,0,3
E33015058,606,459,160,299,5,52,43,9,89,79,1,6,3,1
E33015059,669,535,163,372,3,35,24,11,92,85,1,4,2,4
E33015060,444,326,99,227,4,27,13,14,85,74,1,10,0,2
E33015061,754,602,179,423,2,44,34,10,104,93,0,9,2,2
E33015062,253,162,43,119,0,34,19,15,56,54,0,0,2,1
E33015063,394,219,67,152,3,40,25,15,130,126,0,4,0,2
E33015064,843,692,248,444,4,61,32,29,82,73,0,8,1,4
E33015065,922,528,142,386,6,107,57,50,277,260,2,15,0,4
E33015066,367,271,77,194,5,36,24,12,55,50,0,5,0,0
E33015067,601,410,129,281,5,81,54,27,103,98,1,4,0,2
E33015068,598,453,121,332,6,49,29,20,88,82,0,6,0,2
E33015069,217,139,47,92,0,36,18,18,42,39,0,3,0,0
E33015070,192,120,32,88,1,15,10,5,55,53,0,1,1,1
E33015071,622,441,129,312,10,48,29,19,120,110,1,8,1,3
E33015072,343,193,46,147,2,37,19,18,108,102,0,6,0,3
E33015073,213,170,46,124,1,11,6,5,29,21,0,6,2,2
E33015074,1286,940,266,674,4,189,120,69,147,138,1,7,1,6
E33015075,909,606,191,415,2,83,37,46,212,198,0,12,2,6
E33015076,764,464,113,351,6,96,58,38,193,181,0,8,4,5
E33015077,324,204,39,165,0,26,16,10,91,89,0,2,0,3
E33015078,375,228,67,161,4,44,30,14,95,87,1,6,1,4
E33015079,263,195,50,145,1,17,11,6,46,44,0,2,0,4
E33015080,381,211,66,145,5,49,29,20,115,112,0,2,1,1
E33015081,448,364,109,255,4,21,9,12,56,54,0,2,0,3
E33015082,258,161,52,109,4,38,23,15,53,50,0,3,0,2
E33015083,718,434,156,278,8,125,81,44,143,136,0,7,0,8
E33015084,397,242,53,189,5,37,23,14,109,95,9,5,0,4
E33015085,646,431,90,341,4,65,41,24,141,128,1,10,2,5
E33015086,679,474,162,312,3,57,34,23,145,138,1,6,0,0
E33015087,670,412,144,268,5,102,55,47,147,143,0,4,0,4
E33015088,686,462,145,317,3,90,42,48,126,118,2,6,0,5
E33015089,696,563,176,387,2,42,28,14,86,79,0,6,1,3
E33015090,486,393,119,274,4,19,8,11,69,67,0,2,0,1
E33015091,1123,862,272,590,7,59,37,22,189,173,1,13,2,6
E33015092,922,719,212,507,5,77,59,18,117,110,0,5,2,4
E33015093,582,468,120,348,14,30,9,21,66,61,4,1,0,4
E33015094,1787,1384,319,1065,14,108,71,37,268,251,1,15,1,13
E33015095,213,168,49,119,0,14,9,5,28,23,1,4,0,3
E33015096,992,815,211,604,3,66,51,15,106,97,0,9,0,2
E33015097,458,374,101,273,4,31,22,9,49,46,0,3,0,0
E33015098,637,480,139,341,8,69,47,22,77,67,2,8,0,3
E33015099,497,400,85,315,5,21,13,8,69,67,1,0,1,2
E33015100,710,528,146,382,2,72,54,18,103,94,0,9,0,5
E33015101,816,680,206,474,1,43,23,20,89,86,0,2,1,3
E33015102,2118,1904,402,1502,2,53,35,18,149,127,2,20,0,10
E33015103,463,368,104,264,2,32,19,13,61,57,1,2,1,0
E33015104,440,354,117,237,1,31,13,18,50,49,0,1,0,4
E33015105,211,145,54,91,0,27,10,17,35,32,1,2,0,4
E33015106,448,371,92,279,2,31,14,17,43,40,0,3,0,1
E33015107,868,673,215,458,5,90,43,47,93,87,0,6,0,7
E33015108,123,71,19,52,0,30,14,16,22,21,0,1,0,0
E33015109,168,149,35,114,2,4,3,1,13,13,0,0,0,0
E33015110,572,431,125,306,3,45,28,17,91,87,0,3,1,2
E33015111,248,138,50,88,4,54,37,17,50,48,0,2,0,2
E33015112,420,344,62,282,2,17,10,7,56,55,1,0,0,1
E33015113,303,172,44,128,5,52,28,24,70,68,2,0,0,4
E33015114,242,150,40,110,1,22,12,10,66,61,0,5,0,3
E33015115,511,301,77,224,6,67,45,22,134,125,2,6,1,3
E33015116,306,234,75,159,0,24,13,11,42,39,0,3,0,6
E33015117,272,185,51,134,1,18,11,7,67,59,1,7,0,1
E33015118,240,170,46,124,2,18,9,9,47,45,0,2,0,3
E33015119,423,253,70,183,10,42,21,21,113,103,1,7,2,5
E33015120,421,325,103,222,1,42,24,18,52,48,1,3,0,1
E33015121,234,157,56,101,2,41,27,14,31,26,0,2,3,3
E33015122,604,357,98,259,5,63,33,30,173,157,2,12,2,6
E33015123,527,450,158,292,4,38,23,15,33,30,0,2,1,2
E33015124,398,258,65,193,1,42,20,22,94,88,1,4,1,3
E33015125,227,160,46,114,2,11,5,6,52,48,0,4,0,2
E33015126,206,126,36,90,1,18,6,12,58,56,0,2,0,3
E33015127,295,218,70,148,5,18,11,7,54,51,0,3,0,0
E33015128,204,153,37,116,0,10,6,4,40,33,0,7,0,1
E33015129,299,206,61,145,5,22,15,7,65,60,1,3,1,1
E33015130,920,767,228,539,8,62,28,34,80,74,0,4,2,3
E33015131,473,372,105,267,4,14,2,12,82,77,2,2,1,1
E33015132,352,277,66,211,1,15,8,7,57,54,2,1,0,2
E33015133,820,562,187,375,5,101,66,35,146,129,1,13,3,6
E33015134,886,648,197,451,2,70,41,29,160,145,2,11,2,6
E33015135,522,360,89,271,2,56,33,23,97,91,0,6,0,7
E33015136,275,184,60,124,1,31,13,18,57,55,1,0,1,2
E33015137,246,215,59,156,1,14,10,4,16,15,0,1,0,0
E33015138,198,145,46,99,2,13,4,9,37,37,0,0,0,1
E33015139,1106,807,182,625,7,111,61,50,177,161,0,10,6,4
E33015140,273,225,58,167,1,20,12,8,27,24,0,3,0,0
E33015141,540,421,85,336,2,31,16,15,84,80,0,3,1,2
E33015142,1441,1210,326,884,6,51,29,22,171,163,0,7,1,3
E33015143,304,195,62,133,3,19,6,13,76,34,40,2,0,11
E33015144,546,409,94,315,10,37,18,19,88,84,1,3,0,2
E33015145,857,689,192,497,12,44,29,15,108,100,1,7,0,4
E33015146,729,588,116,472,7,53,25,28,76,73,0,3,0,5
E33015147,297,243,76,167,3,11,3,8,37,34,0,2,1,3
E33015148,269,171,49,122,4,38,23,15,56,49,1,2,4,0
E33015149,217,157,52,105,0,17,12,5,41,37,1,3,0,2
E33015150,256,182,46,136,0,26,20,6,48,43,1,3,1,0
E33015151,199,156,50,106,1,16,11,5,23,20,1,2,0,3
E33015152,394,278,78,200,6,24,18,6,86,82,2,2,0,0
E33015153,291,182,42,140,1,48,43,5,57,51,1,5,0,3
E33015154,268,178,71,107,0,55,48,7,32,28,1,3,0,3
E33015155,419,314,104,210,1,58,53,5,43,38,0,5,0,3
E33015156,458,308,94,214,1,73,67,6,72,69,0,2,1,4
E33015157,251,211,45,166,0,18,12,6,21,20,0,1,0,1
E33015158,450,379,82,297,0,29,23,6,41,37,0,3,1,1
E33015159,454,333,98,235,2,54,46,8,62,61,1,0,0,3
E33015160,608,412,139,273,1,118,104,14,72,65,0,3,4,5
E33015161,585,423,139,284,3,79,72,7,76,67,1,8,0,4
E33015162,361,237,75,162,1,73,65,8,49,46,0,2,1,1
E33015163,167,98,25,73,1,23,16,7,40,36,1,2,1,5
E33015164,503,413,123,290,3,42,36,6,44,39,0,5,0,1
E33015165,306,202,63,139,1,58,49,9,44,36,0,6,2,1
E33015166,223,144,44,100,0,34,30,4,43,40,0,3,0,2
E33015167,294,245,92,153,1,25,23,2,23,21,0,1,1,0
E33015168,301,223,79,144,0,32,30,2,43,37,0,4,2,3
E33015169,376,268,91,177,2,58,54,4,43,40,0,3,0,5
E33015170,388,240,71,169,0,64,55,9,78,72,0,6,0,6
E33015171,199,137,51,86,0,14,5,9,31,24,0,3,4,17
E33015172,441,351,88,263,3,43,27,16,40,39,0,1,0,4
E33015173,316,252,63,189,3,17,10,7,42,39,0,3,0,2
E33015174,667,449,98,351,2,80,61,19,134,121,2,9,2,2
E33015175,469,313,100,213,2,52,29,23,102,99,0,3,0,0
E33015176,158,98,30,68,1,14,9,5,39,35,0,1,3,6
E33015177,651,469,110,359,4,32,14,18,141,132,0,7,2,5
E33015178,608,457,92,365,2,42,26,16,103,94,0,9,0,4
E33015179,293,193,48,145,4,28,14,14,66,59,0,3,4,2
E33015180,574,440,87,353,4,40,24,16,87,82,1,4,0,3
E33015181,502,324,65,259,2,41,20,21,135,121,0,13,1,0
E33015182,268,193,49,144,3,14,6,8,54,50,0,4,0,4
E33015183,587,457,140,317,2,54,35,19,74,68,0,5,1,0
E33015184,311,203,63,140,4,39,22,17,63,59,0,3,1,2
E33015185,434,293,74,219,2,75,55,20,61,55,1,4,1,3
E33015186,314,238,49,189,2,23,17,6,48,47,0,1,0,3
E33015187,665,467,155,312,4,61,36,25,130,115,2,12,1,3
E33015188,567,310,60,250,2,60,30,30,193,187,1,5,0,2
E33015189,273,171,42,129,1,17,14,3,82,69,11,1,1,2
E33015190,579,273,63,210,4,96,54,42,205,192,2,11,0,1
E33015191,616,345,85,260,4,82,54,28,182,170,0,12,0,3
E33015192,309,214,49,165,0,18,10,8,74,67,0,6,1,3
E33015193,445,265,58,207,2,48,22,26,128,118,1,7,2,2
E33015194,562,323,88,235,3,53,32,21,177,165,0,10,2,6
E33015195,551,436,114,322,1,30,14,16,82,74,0,8,0,2
E33015196,209,152,50,102,2,12,6,6,43,40,0,3,0,0
E33015197,326,201,57,144,1,54,43,11,67,66,0,1,0,3
E33015198,206,127,27,100,0,19,14,5,59,54,2,2,1,1
E33015199,488,344,77,267,6,50,28,22,86,84,0,2,0,2
E33015200,409,235,74,161,4,85,70,15,83,71,2,7,3,2
E33015201,2194,1740,447,1293,10,137,87,50,300,273,1,24,2,7
E33015202,160,99,26,73,0,23,19,4,38,38,0,0,0,0
E33015203,646,449,132,317,3,56,38,18,135,130,0,5,0,3
E33015204,406,303,83,220,3,43,22,21,53,47,0,5,1,4
E33015205,629,348,83,265,3,113,71,42,162,157,0,5,0,3
E33015206,634,337,85,252,0,46,29,17,248,238,1,8,1,3
E33015207,293,133,29,104,0,32,22,10,127,122,0,4,1,1
E33015208,265,160,43,117,1,18,8,10,84,81,0,3,0,2
E33015209,380,230,71,159,2,46,36,10,100,94,0,6,0,2
E33015210,408,296,70,226,4,35,23,12,73,68,0,4,1,0
E33015211,173,105,27,78,1,16,9,7,51,47,1,3,0,0
E33015212,587,329,80,249,6,47,31,16,204,194,0,9,1,1
E33015213,362,227,49,178,2,30,21,9,98,91,1,5,1,5
E33015214,539,362,108,254,2,60,42,18,110,105,0,4,1,5
E33015215,343,224,45,179,3,36,23,13,79,76,0,2,1,1
E33015216,592,428,105,323,6,24,13,11,127,124,0,3,0,7
E33015217,502,364,101,263,5,22,18,4,110,103,1,6,0,1
E33015218,194,73,26,47,1,15,9,6,102,94,2,1,5,3
E33015219,887,618,176,442,4,53,33,20,209,192,1,13,3,3
E33015220,392,268,70,198,3,35,25,10,84,77,0,4,3,2
E33015221,241,132,40,92,3,24,9,15,81,78,0,3,0,1
E33015222,672,382,83,299,5,97,63,34,181,176,1,4,0,7
E33015223,1207,906,219,687,9,59,39,20,220,210,1,9,0,13
E33015224,394,226,61,165,6,21,11,10,139,132,0,7,0,2
E33015225,139,75,17,58,1,11,8,3,51,46,0,5,0,1
E33015226,210,121,29,92,0,19,15,4,70,64,0,5,1,0
E33015227,199,112,25,87,1,13,3,10,69,68,0,1,0,4
E33015228,316,193,35,158,2,23,15,8,87,82,0,3,2,11
E33015229,876,511,100,411,8,89,54,35,260,244,0,12,4,8
E33015230,125,96,29,67,3,2,2,0,23,22,1,0,0,1
E33015231,270,212,56,156,2,8,5,3,47,44,0,3,0,1
E33015232,638,510,131,379,4,25,18,7,97,95,0,2,0,2
E33015233,317,245,56,189,1,12,4,8,58,55,0,3,0,1
E33015234,300,233,62,171,2,12,4,8,51,47,1,3,0,2
E33015235,429,226,68,158,2,49,37,12,150,139,0,10,1,2
E33015236,700,461,113,348,5,63,38,25,168,150,0,14,4,3
E33015237,1344,945,182,763,10,99,64,35,286,262,1,17,6,4
E33015238,206,114,27,87,1,42,21,21,49,45,0,4,0,0
E33015239,365,195,67,128,4,55,29,26,109,99,0,9,1,2
E33015240,104,64,19,45,1,11,7,4,28,26,0,1,1,0
E33015241,798,541,152,389,0,42,26,16,201,192,3,4,2,14
E33015242,347,244,59,185,1,21,14,7,78,75,0,2,1,3
E33015243,241,174,47,127,0,30,14,16,35,33,0,1,1,2
E33015244,523,292,75,217,1,40,23,17,186,178,0,7,1,4
E33015245,4662,3011,935,2076,17,186,121,65,1411,1302,33,50,26,37
E33015246,480,324,74,250,2,25,15,10,127,122,0,5,0,2
E33015247,267,205,51,154,2,21,15,6,37,35,0,2,0,2
E33015248,629,232,50,182,5,84,46,38,302,292,0,9,1,6
E33015249,288,149,39,110,4,39,19,20,96,92,1,3,0,0
E33015250,514,275,71,204,3,93,67,26,138,129,3,5,1,5
E33015251,661,448,125,323,2,117,91,26,89,87,0,2,0,5
E33015252,244,162,42,120,1,41,30,11,38,36,0,2,0,2
E33015253,820,503,141,362,3,123,92,31,184,168,1,15,0,7
E33015254,287,177,42,135,1,48,33,15,59,57,0,2,0,2
E33015255,302,217,82,135,0,27,24,3,55,52,1,2,0,3
E33015256,269,210,56,154,4,17,7,10,37,35,0,2,0,1
E33015257,696,522,92,430,5,28,17,11,136,129,0,6,1,5
E33015258,612,448,146,302,3,14,7,7,141,126,10,1,4,6
E33015259,706,430,113,317,6,80,60,20,187,174,2,11,0,3
E33015260,411,237,61,176,3,44,34,10,125,107,1,15,2,2
E33015261,299,182,35,147,1,25,14,11,89,80,1,8,0,2
E33015262,1178,832,226,606,8,47,32,15,284,266,2,13,3,7
E33015263,369,265,83,182,1,17,12,5,85,80,1,4,0,1
E33015264,202,127,25,102,0,20,10,10,55,47,3,5,0,0
E33015265,608,388,80,308,6,49,37,12,161,150,2,8,1,4
E33015266,223,145,31,114,2,27,18,9,49,43,1,5,0,0
E33015267,426,292,83,209,3,57,44,13,73,64,0,8,1,1
E33015268,403,302,88,214,3,34,23,11,63,62,0,1,0,1
E33015269,267,167,46,121,2,24,20,4,72,68,1,3,0,2
E33015270,215,164,53,111,0,9,6,3,41,36,0,3,2,1
E33015271,216,139,28,111,1,29,25,4,45,43,2,0,0,2
E33015272,197,104,15,89,0,9,3,6,84,69,1,14,0,0
E33015273,210,142,42,100,0,11,5,6,54,47,0,7,0,3
E33015274,453,304,68,236,7,24,15,9,112,99,1,12,0,6
E33015275,411,236,48,188,4,53,34,19,113,103,3,7,0,5
E33015276,778,617,198,419,2,40,31,9,115,103,2,9,1,4
E33015277,127,98,35,63,1,6,5,1,21,19,0,2,0,1
E33015278,946,577,140,437,6,91,63,28,264,246,3,13,2,8
E33015279,467,375,98,277,3,32,29,3,56,48,2,6,0,1
E33015280,316,271,98,173,2,12,8,4,30,24,0,5,1,1
E33015281,277,233,80,153,0,19,14,5,23,23,0,0,0,2
E33015282,259,226,60,166,0,8,7,1,23,19,0,4,0,2
E33015283,255,208,84,124,1,9,8,1,34,32,1,1,0,3
E33015284,343,306,88,218,3,5,2,3,25,25,0,0,0,4
E33015285,727,592,199,393,0,44,26,18,83,75,1,7,0,8
E33015286,428,364,109,255,1,6,6,0,54,52,0,2,0,3
E33015287,429,329,82,247,0,23,16,7,73,65,0,7,1,4
E33015288,422,358,70,288,2,11,7,4,47,42,0,5,0,4
E33015289,328,245,73,172,0,50,41,9,33,28,1,3,1,0
E33015290,404,344,82,262,2,19,15,4,38,34,1,2,1,1
E33015291,356,270,61,209,1,53,46,7,32,30,0,2,0,0
E33015292,251,200,57,143,2,10,5,5,39,34,0,5,0,0
E33015293,521,428,119,309,2,18,12,6,67,62,1,4,0,6
E33015294,248,196,51,145,1,26,15,11,24,23,0,1,0,1
E33015295,521,382,108,274,4,40,24,16,94,88,0,3,3,1
E33015296,278,237,72,165,1,12,8,4,23,19,0,4,0,5
E33015297,291,240,67,173,2,19,16,3,25,22,0,3,0,5
E33015298,410,324,77,247,0,43,31,12,40,38,0,1,1,3
E33015299,375,302,72,230,1,34,31,3,37,33,0,4,0,1
E33015300,347,235,62,173,2,65,56,9,42,40,0,2,0,3
E33015301,325,250,54,196,3,32,27,5,40,34,0,6,0,0
E33015302,631,399,103,296,4,131,119,12,92,84,1,4,3,5
E33015303,493,327,91,236,6,67,47,20,91,88,0,2,1,2
E33015304,233,132,32,100,5,23,15,8,66,64,1,1,0,7
E33015305,435,287,93,194,1,51,31,20,92,80,0,9,3,4
E33015306,231,158,48,110,2,29,17,12,41,38,1,2,0,1
E33015307,684,508,130,378,5,50,30,20,116,103,0,12,1,5
E33015308,238,176,52,124,4,17,11,6,40,39,0,0,1,1
E33015309,519,397,113,284,3,66,51,15,49,47,0,2,0,4
E33015310,359,237,69,168,0,67,51,16,52,45,0,6,1,3
E33015311,518,417,125,292,3,32,24,8,63,56,1,6,0,3
E33015312,509,414,131,283,3,28,15,13,61,57,1,3,0,3
E33015313,287,153,35,118,2,54,39,15,75,67,3,4,1,3
E33015314,289,205,53,152,2,15,9,6,66,64,0,2,0,1
E33015315,270,136,38,98,2,34,10,24,95,92,0,3,0,3
E33015316,665,515,138,377,3,28,12,16,116,104,0,12,0,3
E33015317,1000,736,196,540,8,110,82,28,144,132,1,10,1,2
E33015318,438,350,100,250,2,46,37,9,39,32,0,7,0,1
E33015319,596,472,142,330,3,50,43,7,67,63,1,2,1,4
E33015320,468,312,98,214,7,48,29,19,99,84,3,7,5,2
E33015321,1051,682,178,504,14,142,86,56,202,186,3,12,1,11
E33015322,241,118,44,74,4,43,21,22,76,74,0,1,1,0
E33015323,386,270,76,194,5,39,29,10,71,65,1,5,0,1
E33015324,275,151,44,107,4,36,13,23,80,77,0,3,0,4
E33015325,353,219,47,172,1,50,27,23,80,74,0,5,1,3
E33015326,670,506,181,325,7,59,34,25,95,85,1,9,0,3
E33015327,311,216,59,157,3,29,24,5,62,61,0,1,0,1
E33015328,389,263,92,171,4,60,31,29,61,59,0,2,0,1
E33015329,250,142,47,95,3,23,16,7,77,73,0,3,1,5
E33015330,356,224,52,172,4,30,19,11,98,82,6,8,2,0
E33015331,500,399,94,305,4,33,22,11,62,61,0,1,0,2
E33015332,264,220,54,166,1,17,17,0,24,21,0,3,0,2
E33015333,288,230,79,151,1,29,25,4,24,22,0,2,0,4
E33015334,1005,726,231,495,9,148,108,40,121,114,0,5,2,1
E33015335,909,648,141,507,12,109,74,35,136,126,2,7,1,4
E33015336,343,261,73,188,6,26,17,9,44,42,0,2,0,6
E33015337,300,259,82,177,3,8,3,5,29,23,0,3,3,1
E33015338,465,387,111,276,3,37,19,18,36,34,0,2,0,2
E33015339,359,303,87,216,2,10,5,5,41,38,0,3,0,3
E33015340,259,188,59,129,0,16,6,10,52,48,0,3,1,3
E33015341,546,364,115,249,1,89,53,36,87,79,1,7,0,5
E33015342,357,202,59,143,3,44,23,21,104,98,2,1,3,4
E33015343,325,244,98,146,1,26,14,12,52,46,0,1,5,2
E33015344,294,186,68,118,2,26,12,14,79,73,0,5,1,1
E33015345,439,279,103,176,3,37,16,21,111,97,0,8,6,9
E33015346,291,214,66,148,0,30,19,11,45,42,1,2,0,2
E33015347,647,516,143,373,0,39,23,16,86,79,1,5,1,6
E33015348,247,170,51,119,0,32,19,13,43,39,0,4,0,2
E33015349,396,309,96,213,0,38,23,15,43,41,0,2,0,6
E33015350,252,193,81,112,3,20,8,12,28,28,0,0,0,8
E33015351,394,271,104,167,6,41,20,21,70,66,0,4,0,6
E33015352,356,255,83,172,3,29,20,9,58,51,0,5,2,11
E33015353,275,193,86,107,1,33,12,21,45,42,0,1,2,3
E33015354,908,621,197,424,8,123,80,43,149,139,0,8,2,7
E33015355,250,161,67,94,0,37,25,12,50,49,0,1,0,2
E33015356,294,217,88,129,3,32,10,22,36,35,0,0,1,6
E33015357,292,252,85,167,3,9,4,5,28,25,1,2,0,0
E33015358,363,303,102,201,2,22,15,7,35,33,0,2,0,1
E33015359,307,245,81,164,3,19,9,10,37,33,3,1,0,3
E33015360,224,163,57,106,3,28,17,11,27,24,1,2,0,3
E33015361,231,180,59,121,2,11,7,4,35,30,3,1,1,3
E33015362,407,331,101,230,5,21,12,9,48,40,0,5,3,2
E33015363,265,191,80,111,2,15,3,12,56,50,0,4,2,1
E33015364,327,221,68,153,3,34,13,21,66,63,0,2,1,3
E33015365,403,290,105,185,3,24,13,11,84,73,1,6,4,2
E33015366,451,392,125,267,2,22,14,8,34,29,1,4,0,1
E33015367,343,304,82,222,1,8,1,7,29,27,0,2,0,1
E33015368,476,408,144,264,4,17,14,3,43,39,0,2,2,4
E33015369,389,318,80,238,4,14,6,8,45,43,0,2,0,8
E33015370,384,300,80,220,8,21,5,16,51,50,0,1,0,4
E33015371,493,388,127,261,1,35,28,7,67,59,1,6,1,2
E33015372,414,341,116,225,0,18,10,8,53,46,0,7,0,2
E33015373,447,260,78,182,3,96,74,22,85,75,1,8,1,3
E33015374,477,268,84,184,3,86,53,33,111,100,0,9,2,9
E33015375,399,288,114,174,1,48,36,12,57,52,0,5,0,5
E33015376,2730,2128,532,1596,19,108,69,39,465,437,3,25,0,10
E33015377,407,294,71,223,1,41,26,15,71,69,0,2,0,0
E33015378,393,287,73,214,2,51,34,17,47,40,1,6,0,6
E33015379,1284,832,240,592,6,180,123,57,261,248,0,12,1,5
E33015380,339,253,62,191,1,41,29,12,44,41,0,3,0,0
E33015381,358,284,80,204,3,27,17,10,44,40,0,3,1,0
E33015382,506,342,82,260,4,47,26,21,107,97,1,6,3,6
E33015383,266,193,50,143,0,44,35,9,28,27,0,1,0,1
E33015384,478,384,95,289,2,40,31,9,46,42,0,4,0,6
E33015385,487,341,87,254,2,58,42,16,81,71,1,9,0,5
E33015386,424,295,83,212,0,68,41,27,59,53,2,4,0,2
E33015387,278,193,43,150,2,46,34,12,35,29,1,3,2,2
E33015388,253,172,36,136,1,40,32,8,40,35,0,5,0,0
E33015389,367,281,75,206,4,26,17,9,55,51,0,4,0,1
E33015390,1648,1285,347,938,6,131,97,34,220,205,0,12,3,6
E33015391,258,144,44,100,4,70,58,12,39,37,0,2,0,1
E33015392,238,171,55,116,1,30,15,15,35,33,0,2,0,1
E33015393,255,167,39,128,0,47,40,7,40,36,0,4,0,1
E33015394,303,196,47,149,1,47,37,10,55,50,0,4,1,4
E33015395,267,214,78,136,0,23,12,11,29,28,0,1,0,1
E33015396,505,364,119,245,7,75,44,31,55,52,0,2,1,4
E33015397,449,372,87,285,3,35,28,7,35,31,0,4,0,4
E33015398,489,358,90,268,5,71,40,31,55,46,0,4,5,0
E33015399,531,359,101,258,5,93,47,46,73,60,0,7,6,1
E33015400,320,212,50,162,2,61,33,28,41,37,0,4,0,4
E33015401,2250,1725,437,1288,10,218,141,77,284,261,1,19,3,13
E33015402,377,315,97,218,2,25,16,9,34,30,1,3,0,1
E33015403,430,372,102,270,0,13,8,5,42,41,0,1,0,3
E33015404,284,215,61,154,3,32,20,12,28,28,0,0,0,6
E33015405,408,338,82,256,2,21,14,7,44,43,0,1,0,3
E33015406,360,277,68,209,13,16,11,5,53,51,0,1,1,1
E33015407,314,194,69,125,2,44,29,15,69,63,1,5,0,5
E33015408,555,450,112,338,7,44,18,26,53,50,0,3,0,1
E33015409,437,317,83,234,5,49,29,20,62,54,3,4,1,4
E33015410,408,321,71,250,3,46,28,18,35,30,1,4,0,3
E33015411,266,176,39,137,2,43,32,11,44,41,0,3,0,1
E33015412,1051,757,187,570,5,122,92,30,164,151,1,11,1,3
E33015413,506,358,156,202,0,29,15,14,107,101,0,5,1,12
E33015414,814,653,206,447,3,64,35,29,89,79,4,5,1,5
E33015415,248,146,43,103,1,49,34,15,50,45,1,4,0,2
E33015416,275,164,50,114,3,67,55,12,41,35,1,3,2,0
E33015417,320,210,60,150,4,41,13,28,64,60,0,2,2,1
E33015418,301,197,46,151,0,75,70,5,27,23,0,4,0,2
E33015419,537,360,104,256,2,88,75,13,83,76,0,6,1,4
E33015420,1263,836,215,621,7,246,169,77,170,161,0,9,0,4
E33015421,978,666,187,479,7,111,74,37,190,178,1,9,2,4
E33015422,1365,959,237,722,10,132,97,35,259,240,2,13,4,5
E33015423,370,230,68,162,5,97,71,26,34,26,0,5,3,4
E33015424,3404,2695,678,2017,29,257,170,87,403,360,20,19,4,20
E33015425,246,148,38,110,2,68,50,18,25,24,0,1,0,3
E33015426,735,567,153,414,7,65,42,23,92,85,4,3,0,4
E33015427,325,231,62,169,3,51,24,27,38,34,1,3,0,2
E33015428,564,401,128,273,4,45,25,20,108,101,0,7,0,6
E33015429,258,179,72,107,1,30,11,19,46,46,0,0,0,2
E33015430,303,241,78,163,2,21,14,7,38,38,0,0,0,1
E33015431,405,320,96,224,2,21,13,8,60,57,0,2,1,2
E33015432,560,388,148,240,3,61,25,36,100,92,1,4,3,8
E33015433,541,367,143,224,8,62,29,33,98,85,2,6,5,6
E33015434,663,454,148,306,2,79,34,45,115,111,1,3,0,13
E33015435,488,381,121,260,7,33,24,9,61,52,3,4,2,6
E33015436,991,789,282,507,6,61,39,22,126,121,0,4,1,9
E33015437,294,222,88,134,0,18,3,15,53,49,1,3,0,1
E33015438,284,189,58,131,2,31,16,15,53,51,0,2,0,9
E33015439,388,272,103,169,2,50,14,36,57,49,0,7,1,7
E33015440,311,210,97,113,1,35,9,26,58,57,0,1,0,7
E33015441,394,299,114,185,3,26,10,16,63,55,0,6,2,3
E33015442,251,149,45,104,2,26,15,11,72,62,3,6,1,2
E33015443,767,522,158,364,5,78,50,28,158,148,1,8,1,4
E33015444,368,281,96,185,2,40,36,4,45,43,0,2,0,0
E33015445,298,205,58,147,5,32,13,19,55,49,2,3,1,1
E33015446,373,284,74,210,5,25,17,8,58,58,0,0,0,1
E33015447,408,330,104,226,4,32,20,12,39,35,0,4,0,3
E33015448,693,537,171,366,3,65,45,20,85,80,1,4,0,3
E33015449,389,294,56,238,3,19,7,12,72,70,0,2,0,1
E33015450,303,232,37,195,1,19,6,13,47,43,1,3,0,4
E33015451,567,402,102,300,8,55,27,28,98,92,1,3,2,4
E33015452,653,487,121,366,0,78,53,25,84,77,0,6,1,4
E33015453,523,389,126,263,3,56,34,22,73,66,1,4,2,2
E33015454,394,291,106,185,3,43,23,20,53,50,0,2,1,4
E33015455,520,374,141,233,6,54,25,29,79,77,0,1,1,7
E33015456,315,212,87,125,1,31,19,12,66,56,1,8,1,5
E33015457,596,437,163,274,4,47,23,24,104,99,0,5,0,4
E33015458,298,228,87,141,1,22,5,17,46,36,0,7,3,1
E33015459,325,220,75,145,2,64,56,8,37,34,1,1,1,2
E33015460,581,399,149,250,4,89,64,25,82,73,0,9,0,7
E33015461,547,380,131,249,3,73,54,19,89,81,0,7,1,2
E33015462,267,169,60,109,0,33,25,8,63,57,1,5,0,2
E33015463,331,228,53,175,3,56,44,12,40,39,0,1,0,4
E33015464,274,188,52,136,1,51,45,6,32,31,0,1,0,2
E33015465,573,418,121,297,5,87,67,20,56,54,0,2,0,7
E33015466,370,263,73,190,5,62,53,9,38,36,0,2,0,2
E33015467,433,353,98,255,4,34,30,4,42,32,0,8,2,0
E33015468,550,403,121,282,5,63,40,23,78,67,1,5,5,1
E33015469,312,206,72,134,3,37,23,14,64,60,0,4,0,2
E33015470,303,189,73,116,2,28,18,10,83,78,1,4,0,1
E33015471,291,154,45,109,2,40,27,13,90,87,0,3,0,5
E33015472,641,425,139,286,4,86,48,38,124,115,2,7,0,2
E33015473,377,232,88,144,3,48,27,21,92,87,0,2,3,2
E33015474,301,207,86,121,2,32,18,14,58,55,0,2,1,2
E33015475,227,155,69,86,1,27,15,12,41,36,0,2,3,3
E33015476,331,207,72,135,1,38,20,18,79,73,5,1,0,6
E33015477,278,174,81,93,1,32,15,17,67,64,1,2,0,4
E33015478,393,224,86,138,1,55,36,19,108,97,1,5,5,5
E33015479,301,193,101,92,0,54,23,31,51,44,1,5,1,3
E33015480,369,247,78,169,2,64,33,31,50,45,0,4,1,6
E33015481,382,253,93,160,2,67,37,30,58,54,0,3,1,2
E33015482,281,110,37,73,1,105,88,17,61,59,0,2,0,4
E33015483,337,179,54,125,1,100,80,20,55,53,1,0,1,2
E33015484,658,437,164,273,7,87,50,37,117,113,0,3,1,10
E33015485,319,188,96,92,4,69,48,21,54,45,5,2,2,4
E33015486,288,180,54,126,4,68,59,9,33,33,0,0,0,3
E33015487,264,153,47,106,5,57,28,29,47,42,1,3,1,2
E33015488,478,356,133,223,1,34,25,9,82,81,0,1,0,5
E33015489,623,449,156,293,1,54,29,25,116,108,2,6,0,3
E33015490,354,237,53,184,1,35,25,10,79,76,0,3,0,2
E33015491,321,230,84,146,7,32,24,8,51,43,4,2,2,1
E33015492,426,334,118,216,3,41,33,8,47,43,0,3,1,1
E33015493,271,219,85,134,6,4,3,1,41,39,1,1,0,1
E33015494,309,241,86,155,3,17,14,3,48,44,0,4,0,0
E33015495,266,190,48,142,1,38,31,7,36,34,0,2,0,1
E33015496,402,317,98,219,2,37,23,14,42,37,0,5,0,4
E33015497,336,221,85,136,2,33,20,13,73,71,0,2,0,7
E33015498,305,208,69,139,0,28,17,11,68,60,0,8,0,1
E33015499,571,395,131,264,3,56,35,21,111,106,0,4,1,6
E33015500,312,227,85,142,3,17,13,4,63,57,1,4,1,2
E33015501,266,199,87,112,0,7,7,0,58,53,0,4,1,2
E33015502,922,652,203,449,6,63,36,27,196,177,6,9,4,5
E33015503,282,157,59,98,2,40,10,30,78,76,0,2,0,5
E33015504,310,207,100,107,0,32,16,16,68,66,0,1,1,3
E33015505,398,199,63,136,8,53,24,29,132,113,12,5,2,6
E33015506,288,191,85,106,5,38,18,20,53,49,0,4,0,1
E33015507,304,200,74,126,1,47,22,25,51,50,0,1,0,5
E33015508,388,248,72,176,4,57,36,21,75,75,0,0,0,4
E33015509,406,292,104,188,1,31,21,10,76,69,0,6,1,6
E33015510,381,220,67,153,4,37,28,9,113,109,0,2,2,7
E33015511,447,251,100,151,3,29,14,15,157,147,2,5,3,7
E33015512,446,241,75,166,1,63,40,23,139,134,1,4,0,2
E33015513,309,173,52,121,0,30,19,11,102,96,1,5,0,4
E33015514,329,202,58,144,1,52,31,21,70,62,0,5,3,4
E33015515,500,343,96,247,5,56,22,34,92,89,1,2,0,4
E33015516,302,221,69,152,1,38,32,6,37,36,0,1,0,5
E33015517,901,726,237,489,4,56,42,14,108,102,0,5,1,7
E33015518,358,287,103,184,4,25,21,4,37,36,0,1,0,5
E33015519,270,154,44,110,1,72,51,21,39,34,0,5,0,4
E33015520,424,273,59,214,6,95,85,10,50,45,0,5,0,0
E33015521,667,427,99,328,2,118,82,36,115,112,0,3,0,5
E33015522,383,270,97,173,3,19,10,9,86,82,1,1,2,5
E33015523,335,266,126,140,4,20,11,9,37,35,2,0,0,8
E33015524,358,301,125,176,0,7,7,0,48,44,0,4,0,2
E33015525,287,233,88,145,1,14,7,7,30,28,0,2,0,9
E33015526,474,310,108,202,1,46,20,26,115,102,2,3,8,2
E33015527,259,143,34,109,1,43,16,27,68,65,0,2,1,4
E33015528,261,175,27,148,2,55,40,15,28,27,1,0,0,1
E33015529,244,150,36,114,1,53,41,12,40,40,0,0,0,0
E33015530,449,329,80,249,3,65,38,27,49,42,0,7,0,3
E33015531,278,177,40,137,0,62,47,15,38,36,0,2,0,1
E33015532,455,286,82,204,1,60,48,12,105,99,0,6,0,3
E33015533,278,178,59,119,3,25,15,10,65,54,0,3,8,7
E33015534,237,141,46,95,1,14,10,4,77,72,1,3,1,4
E33015535,282,153,55,98,4,32,18,14,89,83,0,4,2,4
E33015536,508,346,102,244,4,52,35,17,101,95,2,3,1,5
E33015537,255,186,75,111,1,23,14,9,41,36,0,4,1,4
E33015538,365,245,80,165,1,47,29,18,68,64,2,1,1,4
E33015539,3618,2432,749,1683,21,138,67,71,1013,961,8,36,8,14
E33015540,435,329,85,244,2,32,20,12,70,66,1,1,2,2
E33015541,313,222,64,158,3,15,10,5,66,64,0,2,0,7
E33015542,339,242,82,160,0,17,9,8,76,68,0,8,0,4
E33015543,290,190,50,140,0,15,6,9,83,80,0,3,0,2
E33015544,308,221,85,136,1,23,14,9,57,55,0,2,0,6
E33015545,490,318,101,217,5,26,11,15,138,132,0,4,2,3
E33015546,290,203,62,141,0,25,17,8,57,57,0,0,0,5
E33015547,453,349,114,235,3,46,31,15,54,45,1,8,0,1
E33015548,243,165,53,112,0,25,20,5,47,45,1,1,0,6
E33015549,271,207,67,140,0,34,28,6,29,29,0,0,0,1
E33015550,377,257,84,173,3,48,34,14,65,53,1,10,1,4
E33015551,246,150,52,98,0,29,20,9,66,63,0,2,1,1
E33015552,432,268,69,199,0,59,36,23,103,99,1,3,0,2
E33015553,257,205,79,126,2,14,4,10,34,32,1,1,0,2
E33015554,259,196,71,125,1,11,6,5,49,44,1,4,0,2
E33015555,293,217,89,128,1,34,25,9,39,37,0,2,0,2
E33015556,322,274,81,193,1,14,7,7,31,29,0,2,0,2
E33015557,293,210,77,133,0,23,17,6,55,50,2,3,0,5
E33015558,356,237,66,171,4,55,40,15,60,49,6,5,0,0
E33015559,321,236,74,162,4,40,31,9,37,34,2,1,0,4
E33015560,452,352,83,269,3,28,19,9,68,64,1,3,0,1
E33015561,398,295,84,211,1,30,22,8,68,58,3,7,0,4
E33015562,285,226,72,154,2,18,15,3,38,31,2,5,0,1
E33015563,398,260,61,199,2,70,57,13,65,60,1,3,1,1
E33015564,319,196,57,139,2,71,66,5,49,46,0,1,2,1
E33015565,390,222,57,165,4,127,103,24,35,31,0,4,0,2
E33015566,494,313,77,236,0,125,116,9,54,50,0,4,0,2
E33015567,374,279,77,202,1,47,42,5,41,40,0,1,0,6
E33015568,655,332,77,255,4,74,23,51,239,77,99,5,58,6
E33015569,1336,855,185,670,12,96,27,69,369,132,151,16,70,4
E33015570,244,155,48,107,1,19,8,11,61,56,3,1,1,8
E33015571,342,256,89,167,5,18,5,13,55,51,3,1,0,8
E33015572,513,354,127,227,2,21,10,11,125,110,11,2,2,11
E33015573,273,218,74,144,2,7,1,6,41,31,5,3,2,5
E33015574,641,480,145,335,6,47,23,24,99,77,7,6,9,9
E33015575,657,453,121,332,13,44,15,29,138,126,5,4,3,9
E33015576,303,241,107,134,2,18,1,17,39,34,0,3,2,3
E33015577,270,195,87,108,7,19,7,12,44,37,7,0,0,5
E33015578,388,281,72,209,7,44,11,33,55,48,2,5,0,1
E33015579,290,228,74,154,4,15,6,9,42,34,2,2,4,1
E33015580,543,381,104,277,8,53,21,32,95,90,0,4,1,6
E33015581,787,582,174,408,14,53,15,38,131,112,4,7,8,7
E33015582,285,246,94,152,1,15,6,9,21,18,2,1,0,2
E33015583,297,214,69,145,3,25,6,19,53,45,1,4,3,2
E33015584,816,554,177,377,8,76,31,45,173,143,7,9,14,5
E33015585,303,213,80,133,1,25,14,11,61,44,6,8,3,3
E33015586,647,430,168,262,9,52,27,25,149,134,7,6,2,7
E33015587,229,147,57,90,2,7,3,4,73,34,19,3,17,0
E33015588,261,214,66,148,2,14,5,9,28,25,1,1,1,3
E33015589,572,446,115,331,2,34,16,18,88,78,5,4,1,2
E33015590,331,231,62,169,5,36,19,17,56,52,1,3,0,3
E33015591,362,269,79,190,4,26,12,14,57,49,6,2,0,6
E33015592,393,270,70,200,6,36,12,24,73,64,2,6,1,8
E33015593,402,303,105,198,2,28,8,20,61,48,6,7,0,8
E33015594,573,400,151,249,5,43,19,24,109,88,18,2,1,16
E33015595,378,294,111,183,3,16,8,8,60,51,5,4,0,5
E33015596,340,240,104,136,1,23,9,14,64,54,3,4,3,12
E33015597,282,208,77,131,1,18,4,14,50,42,2,5,1,5
E33015598,581,469,131,338,1,38,26,12,70,66,0,4,0,3
E33015599,811,576,131,445,11,126,94,32,95,85,1,9,0,3
E33015600,249,176,47,129,0,41,32,9,28,28,0,0,0,4
E33015601,364,253,67,186,2,44,34,10,64,62,0,2,0,1
E33015602,259,181,47,134,0,37,25,12,40,33,1,5,1,1
E33015603,710,494,109,385,6,105,83,22,104,96,0,7,1,1
E33015604,607,409,89,320,1,100,83,17,95,86,0,7,2,2
E33015605,316,219,48,171,4,51,42,9,41,36,1,4,0,1
E33015606,410,269,68,201,1,61,42,19,77,71,0,6,0,2
E33015607,365,281,69,212,1,26,20,6,53,49,1,3,0,4
E33015608,582,432,111,321,3,55,40,15,87,75,1,9,2,5
E33015609,393,295,79,216,4,48,41,7,45,42,0,3,0,1
E33015610,658,448,130,318,2,122,98,24,85,77,0,7,1,1
E33015611,394,277,72,205,3,53,46,7,60,57,0,3,0,1
E33015612,371,238,62,176,1,76,54,22,51,48,0,2,1,5
E33015613,340,191,38,153,2,50,48,2,93,91,1,1,0,4
E33015614,606,398,95,303,2,126,106,20,78,69,0,7,2,2
E33015615,390,263,77,186,0,57,46,11,64,59,2,3,0,6
E33015616,427,299,83,216,1,59,54,5,67,61,0,6,0,1
E33015617,926,698,165,533,2,72,50,22,148,137,1,9,1,6
E33015618,251,183,41,142,10,21,21,0,35,31,1,3,0,2
E33015619,441,322,86,236,3,43,27,16,71,67,0,4,0,2
E33015620,265,153,41,112,0,62,43,19,46,43,0,3,0,4
E33015621,573,403,86,317,3,77,61,16,87,82,1,2,2,3
E33015622,270,178,43,135,2,41,34,7,47,45,1,1,0,2
E33015623,441,326,74,252,4,41,28,13,66,64,0,2,0,4
E33015624,295,217,59,158,0,32,24,8,43,37,1,5,0,3
E33015625,525,351,102,249,3,70,44,26,92,81,1,10,0,9
E33015626,290,206,45,161,1,38,30,8,42,40,0,1,1,3
E33015627,549,415,122,293,5,54,39,15,70,69,0,1,0,5
E33015628,421,317,80,237,1,44,35,9,59,57,1,1,0,0
E33015629,734,597,162,435,5,34,24,10,94,83,2,8,1,4
E33015630,481,318,93,225,3,55,35,20,97,89,1,7,0,8
E33015631,274,167,61,106,1,42,35,7,59,57,0,2,0,5
E33015632,246,202,71,131,1,18,10,8,23,21,0,2,0,2
E33015633,368,243,81,162,1,42,23,19,79,79,0,0,0,3
E33015634,323,237,86,151,0,29,19,10,52,47,2,2,1,5
E33015635,303,203,66,137,2,44,20,24,51,45,0,6,0,3
E33015636,372,255,85,170,0,33,24,9,80,72,0,8,0,4
E33015637,295,145,33,112,0,108,99,9,41,38,0,2,1,1
E33015638,385,198,53,145,0,135,127,8,51,49,0,1,1,1
E33015639,253,163,50,113,3,54,48,6,32,31,0,1,0,1
E33015640,376,234,65,169,0,47,22,25,92,87,1,3,1,3
E33015641,330,241,71,170,2,13,11,2,72,65,0,7,0,2
E33015642,431,322,87,235,2,24,18,6,83,76,0,7,0,0
E33015643,556,380,114,266,4,57,39,18,111,107,0,4,0,4
E33015644,544,372,94,278,2,56,38,18,109,103,1,5,0,5
E33015645,553,420,111,309,2,52,38,14,78,74,0,3,1,1
E33015646,334,184,68,116,3,58,25,33,88,82,0,5,1,1
E33015647,675,404,91,313,1,168,150,18,101,91,0,10,0,1
E33015648,263,175,40,135,2,50,42,8,35,32,0,3,0,1
E33015649,1018,762,184,578,6,139,113,26,106,91,0,15,0,5
E33015650,310,222,45,177,1,53,44,9,32,26,2,4,0,2
E33015651,266,169,53,116,5,36,22,14,51,46,2,3,0,5
E33015652,244,143,47,96,1,32,17,15,66,63,0,1,2,2
E33015653,457,298,98,200,2,53,27,26,102,100,2,0,0,2
E33015654,325,215,60,155,0,32,17,15,77,74,0,3,0,1
E33015655,434,279,80,199,0,49,37,12,100,84,6,9,1,6
E33015656,220,168,59,109,0,13,13,0,37,33,0,4,0,2
E33015657,234,153,44,109,1,20,15,5,58,55,0,3,0,2
E33015658,643,478,115,363,3,34,16,18,127,115,1,11,0,1
E33015659,365,179,40,139,3,101,43,58,78,76,0,1,1,4
E33015660,381,242,54,188,1,69,40,29,64,57,2,3,2,5
E33015661,282,205,61,144,3,27,17,10,42,37,0,3,2,5
E33015662,304,160,51,109,2,44,22,22,94,91,1,1,1,4
E33015663,257,164,48,116,4,34,20,14,55,51,0,4,0,0
E33015664,318,196,54,142,2,60,47,13,58,54,1,3,0,2
E33015665,453,311,91,220,5,45,28,17,91,87,1,3,0,1
E33015666,691,421,112,309,3,102,61,41,160,146,1,10,3,5
E33015667,657,327,119,208,4,155,106,49,165,156,0,7,2,6
E33015668,535,357,95,262,5,68,40,28,103,96,0,3,4,2
E33015669,470,274,70,204,1,63,45,18,125,116,3,6,0,7
E33015670,349,183,41,142,3,65,38,27,96,86,0,10,0,2
E33015671,429,325,84,241,2,48,43,5,52,45,0,5,2,2
E33015672,821,725,210,515,2,24,11,13,60,55,0,5,0,10
E33015673,303,233,56,177,1,32,24,8,35,31,0,4,0,2
E33015674,426,240,71,169,2,98,61,37,80,76,0,2,2,6
E33015675,307,203,51,152,0,43,29,14,60,50,1,5,4,1
E33015676,330,215,59,156,4,56,42,14,55,53,1,1,0,0
E33015677,577,439,115,324,0,62,42,20,73,66,1,6,0,3
E33015678,223,120,28,92,1,71,67,4,31,31,0,0,0,0
E33015679,597,458,133,325,4,50,34,16,83,76,0,7,0,2
E33015680,350,279,66,213,2,46,41,5,22,18,1,3,0,1
E33015681,588,422,103,319,2,94,77,17,67,62,2,1,2,3
E33015682,408,258,57,201,0,91,75,16,54,51,0,3,0,5
E33015683,256,150,50,100,1,73,60,13,29,27,0,1,1,3
E33015684,274,174,39,135,1,61,53,8,37,35,0,2,0,1
E33015685,255,158,36,122,0,38,32,6,56,49,0,7,0,3
E33015686,398,268,78,190,2,56,43,13,72,67,0,5,0,0
E33015687,359,197,56,141,1,70,41,29,90,84,3,2,1,1
E33015688,581,435,154,281,1,43,25,18,101,86,5,9,1,1
E33015689,487,302,73,229,6,59,20,39,113,104,1,7,1,7
E33015690,493,301,91,210,5,71,51,20,113,106,0,6,1,3
E33015691,311,127,46,81,3,43,11,32,136,131,0,3,2,2
E33015692,205,116,27,89,1,37,31,6,51,48,0,3,0,0
E33015693,330,178,48,130,3,81,46,35,66,59,0,6,1,2
E33015694,397,218,65,153,3,68,47,21,106,99,1,6,0,2
E33015695,1068,581,162,419,4,194,131,63,278,267,0,10,1,11
E33015696,317,212,62,150,2,39,27,12,63,57,0,5,1,1
E33015697,304,150,42,108,2,89,71,18,55,51,0,4,0,8
E33015698,300,150,36,114,0,31,23,8,115,109,0,6,0,4
E33015699,379,297,93,204,1,35,27,8,44,37,3,3,1,2
E33015700,388,297,87,210,2,36,29,7,47,43,0,4,0,6
E33015701,270,194,47,147,1,26,18,8,48,43,0,5,0,1
E33015702,427,319,81,238,2,41,31,10,62,60,0,2,0,3
E33015703,249,184,51,133,0,34,29,5,30,24,0,6,0,1
E33015704,351,261,80,181,0,37,29,8,53,50,0,3,0,0
E33015705,514,396,113,283,2,54,42,12,60,55,1,4,0,2
E33015706,266,144,52,92,4,53,38,15,59,57,0,1,1,6
E33015707,217,153,44,109,1,31,18,13,32,31,0,1,0,0
E33015708,513,297,70,227,6,92,62,30,110,102,0,8,0,8
E33015709,716,461,119,342,6,90,66,24,156,136,0,19,1,3
E33015710,389,233,72,161,2,58,39,19,93,84,0,9,0,3
E33015711,508,285,77,208,2,108,63,45,107,97,0,6,4,6
E33015712,622,363,93,270,4,118,80,38,134,128,0,6,0,3
E33015713,242,145,44,101,5,24,18,6,67,64,0,3,0,1
E33015714,306,195,60,135,4,44,23,21,61,58,0,2,1,2
E33015715,333,264,85,179,0,20,17,3,45,43,0,2,0,4
E33015716,583,444,135,309,0,49,42,7,83,75,1,7,0,7
E33015717,769,584,149,435,2,56,30,26,123,111,1,11,0,4
E33015718,393,276,69,207,0,29,18,11,88,81,1,6,0,0
E33015719,526,307,100,207,0,55,25,30,160,153,1,6,0,4
E33015720,477,333,93,240,1,25,10,15,116,110,0,6,0,2
E33015721,434,313,92,221,2,20,13,7,99,90,1,7,1,0
E33015722,436,334,103,231,2,22,11,11,72,65,2,3,2,6
E33015723,333,154,52,102,0,50,31,19,126,120,0,6,0,3
E33015724,295,166,63,103,2,29,15,14,94,86,0,7,1,4
E33015725,2000,1405,344,1061,10,265,180,85,305,285,2,17,1,15
E33015726,365,212,40,172,6,39,28,11,99,83,1,15,0,9
E33015727,594,335,95,240,2,108,70,38,143,131,1,11,0,6
E33015728,359,218,48,170,2,40,16,24,96,90,0,6,0,3
E33015729,820,559,125,434,9,117,82,35,130,115,1,13,1,5
E33015730,288,175,46,129,1,38,25,13,70,61,2,7,0,4
E33015731,308,260,87,173,1,17,8,9,29,28,0,1,0,1
E33015732,432,372,136,236,1,26,19,7,31,29,0,2,0,2
E33015733,439,334,125,209,1,41,31,10,59,51,5,3,0,4
E33015734,269,186,80,106,2,44,22,22,34,32,0,2,0,3
E33015735,302,169,47,122,1,36,23,13,90,85,0,5,0,6
E33015736,613,404,116,288,1,65,51,14,141,133,0,5,3,2
E33015737,344,153,44,109,0,51,46,5,140,137,0,3,0,0
E33015738,286,126,36,90,0,36,25,11,123,119,0,4,0,1
E33015739,245,141,36,105,0,40,27,13,64,63,0,1,0,0
E33015740,315,159,42,117,2,62,50,12,86,80,0,6,0,6
E33015741,978,716,229,487,3,52,31,21,200,185,4,8,3,7
E33015742,215,141,26,115,0,48,34,14,26,25,1,0,0,0
E33015743,441,365,114,251,2,23,15,8,49,44,2,3,0,2
E33015744,308,221,78,143,1,43,32,11,43,42,0,1,0,0
E33015745,513,420,110,310,4,32,25,7,54,48,0,6,0,3
E33015746,624,397,99,298,2,138,115,23,82,69,1,11,1,5
E33015747,991,730,208,522,1,59,37,22,195,186,1,7,1,6
E33015748,310,211,46,165,0,61,60,1,35,32,1,2,0,3
E33015749,532,413,103,310,2,63,51,12,52,47,0,5,0,2
E33015750,644,434,122,312,4,134,109,25,66,56,0,10,0,6
E33015751,328,230,71,159,2,57,49,8,37,34,1,2,0,2
E33015752,422,318,84,234,1,56,53,3,44,39,0,4,1,3
E33015753,319,243,80,163,1,37,25,12,33,26,0,7,0,5
E33015754,862,657,204,453,4,85,53,32,112,101,0,8,3,4
E33015755,722,574,180,394,1,63,38,25,82,73,0,9,0,2
E33015756,540,439,158,281,1,49,29,20,50,47,0,3,0,1
E33015757,306,254,119,135,3,17,10,7,26,18,4,3,1,6
E33015758,284,230,98,132,0,18,9,9,34,30,1,3,0,2
E33015759,673,556,200,356,3,41,21,20,69,53,0,13,3,4
E33015760,345,270,116,154,0,32,16,16,39,30,1,6,2,4
E33015761,1898,1375,415,960,3,208,133,75,302,282,0,19,1,10
E33015762,291,218,70,148,1,30,15,15,34,30,0,3,1,8
E33015763,410,307,98,209,0,49,28,21,51,48,0,1,2,3
E33015764,342,273,75,198,0,29,12,17,39,34,2,3,0,1
E33015765,262,181,47,134,1,42,15,27,34,26,1,4,3,4
E33015766,631,471,155,316,4,64,46,18,90,83,0,7,0,2
E33015767,495,392,120,272,0,38,27,11,61,56,0,5,0,4
E33015768,374,337,108,229,1,13,9,4,20,18,0,2,0,3
E33015769,765,622,210,412,5,43,25,18,82,77,0,5,0,13
E33015770,281,217,84,133,1,26,9,17,36,32,1,1,2,1
E33015771,531,386,122,264,4,43,23,20,97,86,2,7,2,1
E33015772,784,614,199,415,1,59,33,26,103,93,0,9,1,7
E33015773,433,367,128,239,3,18,6,12,44,38,1,5,0,1
E33015774,263,208,63,145,1,17,11,6,34,30,1,3,0,3
E33015775,260,225,81,144,1,15,4,11,18,17,0,1,0,1
E33015776,768,646,222,424,2,43,25,18,74,67,0,7,0,3
E33015777,375,322,109,213,0,20,10,10,31,28,0,0,3,2
E33015778,981,819,269,550,1,48,26,22,110,100,0,8,2,3
E33015779,307,238,103,135,1,18,13,5,48,42,1,2,3,2
E33015780,271,186,102,84,1,6,3,3,72,63,0,3,6,6
E33015781,488,411,143,268,0,15,6,9,58,56,0,0,2,4
E33015782,485,384,149,235,1,33,18,15,64,51,5,5,3,3
E33015783,571,477,185,292,2,34,24,10,58,52,0,4,2,0
E33015784,443,369,97,272,3,33,12,21,36,35,0,1,0,2
E33015785,504,359,131,228,3,64,35,29,73,68,0,3,2,5
E33015786,380,331,119,212,0,20,13,7,28,24,1,3,0,1
E33015787,332,264,85,179,2,36,20,16,28,26,1,1,0,2
E33015788,607,456,126,330,2,48,28,20,98,84,1,12,1,3
E33015789,445,384,116,268,0,19,11,8,41,39,0,2,0,1
E33015790,441,379,92,287,6,17,4,13,37,37,0,0,0,2
E33015791,573,441,149,292,3,36,24,12,90,81,0,9,0,3
E33015792,255,193,56,137,2,18,8,10,40,35,2,3,0,2
E33015793,320,240,73,167,3,29,15,14,45,35,1,8,1,3
E33015794,281,194,47,147,2,21,9,12,57,49,2,3,3,7
E33015795,867,709,220,489,2,56,27,29,97,87,1,7,2,3
E33015796,254,202,68,134,2,12,9,3,38,32,1,5,0,0
E33015797,447,347,111,236,1,30,15,15,66,64,1,1,0,3
E33015798,352,307,106,201,0,17,10,7,28,22,0,3,3,0
E33015799,336,297,78,219,0,4,1,3,34,32,1,0,1,1
E33015800,453,376,111,265,2,17,10,7,57,53,0,4,0,1
E33015801,318,256,63,193,2,20,10,10,36,32,2,2,0,4
E33015802,259,220,68,152,0,8,2,6,30,28,1,1,0,1
E33015803,242,190,64,126,0,21,15,6,27,22,0,5,0,4
E33015804,477,396,105,291,3,21,9,12,56,52,2,2,0,1
E33015805,306,231,74,157,1,29,15,14,45,39,1,4,1,0
E33015806,662,524,174,350,3,49,29,20,85,76,0,9,0,1
E33015807,390,342,88,254,1,11,4,7,34,30,1,3,0,2
E33015808,388,313,98,215,2,24,13,11,45,39,1,4,1,4
E33015809,534,414,128,286,3,41,15,26,71,63,1,7,0,5
E33015810,469,388,117,271,2,26,10,16,51,48,0,3,0,2
E33015811,472,368,129,239,2,52,27,25,47,39,2,4,2,3
E33015812,614,517,190,327,2,40,13,27,48,41,0,7,0,7
E33015813,616,511,155,356,3,40,16,24,58,50,2,6,0,4
E33015814,340,273,98,175,0,22,12,10,39,37,0,2,0,6
E33015815,1066,831,260,571,4,72,37,35,156,142,1,13,0,3
E33015816,250,183,61,122,4,11,5,6,48,43,0,2,3,4
E33015817,824,550,165,385,9,55,26,29,194,179,0,10,5,16
E33015818,363,325,107,218,1,13,3,10,19,15,0,4,0,5
E33015819,257,209,66,143,1,13,8,5,31,29,0,2,0,3
E33015820,356,295,98,197,2,12,7,5,39,36,2,1,0,8
E33015821,222,184,62,122,0,6,3,3,30,26,0,1,3,2
E33015822,285,239,96,143,0,12,6,6,33,30,2,1,0,1
E33015823,795,638,156,482,5,61,49,12,86,82,0,4,0,5
E33015824,625,489,164,325,2,59,52,7,68,57,0,10,1,7
E33015825,349,289,73,216,0,23,22,1,36,35,0,0,1,1
E33015826,431,306,94,212,0,44,39,5,78,69,0,9,0,3
E33015827,319,251,73,178,1,27,24,3,39,34,0,5,0,1
E33015828,833,674,191,483,0,52,46,6,100,92,0,8,0,7
E33015829,218,169,49,120,0,14,12,2,34,30,0,4,0,1
E33015830,388,295,83,212,1,37,34,3,52,42,0,5,5,3
E33015831,368,298,111,187,0,27,22,5,40,37,3,0,0,3
E33015832,252,176,45,131,0,33,28,5,41,38,0,2,1,2
E33015833,244,185,48,137,1,28,22,6,30,27,0,3,0,0
E33015834,579,425,137,288,0,53,34,19,95,77,3,13,2,6
E33015835,516,354,118,236,1,57,50,7,98,86,7,3,2,6
E33015836,278,189,57,132,0,30,30,0,55,46,4,5,0,4
E33015837,291,227,65,162,0,19,16,3,43,37,1,4,1,2
E33015838,459,341,109,232,1,49,41,8,65,59,0,6,0,3
E33015839,255,179,47,132,0,40,33,7,32,29,0,2,1,4
E33015840,419,323,105,218,0,42,37,5,54,47,0,5,2,0
E33015841,307,252,79,173,1,25,21,4,29,27,1,1,0,0
E33015842,358,281,97,184,0,38,36,2,39,36,1,2,0,0
E33015843,310,248,75,173,1,30,24,6,29,20,0,6,3,2
E33015844,311,249,89,160,0,29,25,4,28,23,1,4,0,5
E33015845,392,297,95,202,2,42,36,6,49,42,0,4,3,2
E33015846,529,393,131,262,0,79,63,16,53,47,0,6,0,4
E33015847,224,177,70,107,0,22,21,1,23,20,0,3,0,2
E33015848,617,453,139,314,0,81,63,18,76,60,0,16,0,7
E33015849,464,322,105,217,4,55,33,22,79,75,0,4,0,4
E33015850,320,255,71,184,0,29,22,7,33,30,0,3,0,3
E33015851,535,400,124,276,5,40,32,8,88,77,1,8,2,2
E33015852,472,339,118,221,0,50,35,15,75,64,0,10,1,8
E33015853,270,221,64,157,0,19,11,8,27,26,0,0,1,3
E33015854,551,452,139,313,3,38,34,4,55,51,1,2,1,3
E33015855,400,329,110,219,0,33,30,3,36,33,1,1,1,2
E33015856,665,536,167,369,2,66,54,12,58,49,1,8,0,3
E33015857,374,287,70,217,1,49,47,2,33,23,0,10,0,4
E33015858,395,304,82,222,5,55,47,8,25,19,2,4,0,6
E33015859,432,326,121,205,0,42,33,9,58,51,0,7,0,6
E33015860,299,225,62,163,0,37,30,7,30,28,0,2,0,7
E33015861,282,240,87,153,0,11,7,4,30,29,0,1,0,1
E33015862,320,266,69,197,0,17,14,3,37,33,0,2,2,0
E33015863,290,240,55,185,1,17,10,7,31,31,0,0,0,1
E33015864,536,399,121,278,4,47,37,10,82,76,0,6,0,4
E33015865,703,534,145,389,0,39,25,14,125,115,0,6,4,5
E33015866,601,460,125,335,4,60,42,18,72,67,0,4,1,5
E33015867,386,317,98,219,1,13,11,2,50,42,0,8,0,5
E33015868,303,187,54,133,2,77,65,12,32,29,1,2,0,5
E33015869,401,306,108,198,3,39,39,0,52,44,0,5,3,1
E33015870,519,405,110,295,1,68,61,7,43,34,1,8,0,2
E33015871,523,365,130,235,1,100,90,10,52,48,0,4,0,5
E33015872,263,186,68,118,0,44,42,2,33,27,0,6,0,0
E33015873,194,138,39,99,0,35,30,5,21,21,0,0,0,0
E33015874,465,354,108,246,1,60,55,5,48,46,0,2,0,2
E33015875,518,366,113,253,1,100,97,3,48,43,1,4,0,3
E33015876,377,281,58,223,1,38,23,15,52,47,0,5,0,5
E33015877,342,246,81,165,0,45,40,5,46,40,0,6,0,5
E33015878,412,288,81,207,0,57,37,20,62,60,0,0,2,5
E33015879,357,241,76,165,0,63,57,6,49,45,2,2,0,4
E33015880,328,228,58,170,0,70,68,2,25,22,0,3,0,5
E33015881,901,724,191,533,3,63,54,9,108,103,0,5,0,3
E33015882,449,279,75,204,2,90,87,3,76,67,1,5,3,2
E33015883,631,453,132,321,2,119,112,7,54,43,5,2,4,3
E33015884,468,369,132,237,2,42,39,3,52,48,0,4,0,3
E33015885,272,209,62,147,2,31,28,3,28,24,0,3,1,2
E33015886,265,179,59,120,0,51,41,10,31,26,1,4,0,4
E33015887,306,236,92,144,1,37,30,7,29,24,0,5,0,3
E33015888,292,245,67,178,0,34,26,8,12,9,0,2,1,1
E33015889,477,349,113,236,3,81,60,21,42,37,0,5,0,2
E33015890,565,398,112,286,2,86,79,7,76,67,0,9,0,3
E33015891,376,241,67,174,0,86,75,11,48,44,0,4,0,1
E33015892,335,269,87,182,1,27,25,2,36,27,2,5,2,2
E33015893,338,229,66,163,1,53,46,7,53,49,0,3,1,2
E33015894,404,294,93,201,4,56,51,5,48,42,1,5,0,2
E33015895,349,279,81,198,2,37,36,1,22,19,0,1,2,9
E33015896,579,389,125,264,1,122,119,3,62,55,0,4,3,5
E33015897,1180,937,263,674,1,70,61,9,167,159,0,8,0,5
E33015898,256,202,64,138,1,23,19,4,28,24,1,1,2,2
E33015899,347,279,97,182,1,33,31,2,32,29,2,1,0,2
E33015900,245,208,78,130,0,11,11,0,24,23,0,1,0,2
E33015901,701,488,158,330,3,94,87,7,109,97,1,9,2,7
E33015902,608,471,147,324,2,52,42,10,80,72,0,7,1,3
E33015903,338,193,61,132,1,53,44,9,87,76,0,8,3,4
E33015904,383,259,95,164,1,58,51,7,61,50,0,7,4,4
E33015905,438,326,108,218,2,61,56,5,48,45,0,3,0,1
E33015906,286,181,48,133,3,32,27,5,69,65,0,4,0,1
E33015907,433,313,100,213,0,40,30,10,78,63,0,6,9,2
E33015908,370,314,110,204,0,19,16,3,34,31,0,2,1,3
E33015909,375,324,120,204,0,27,21,6,20,18,0,0,2,4
E33015910,509,427,159,268,2,29,24,5,46,43,0,2,1,5
E33015911,3547,2755,814,1941,5,353,302,51,420,366,17,35,2,14
E33015912,294,223,75,148,1,33,28,5,30,29,0,1,0,7
E33015913,239,166,41,125,0,37,32,5,33,31,0,2,0,3
E33015914,336,262,72,190,0,31,26,5,41,37,1,0,3,2
E33015915,244,204,68,136,0,12,10,2,28,22,0,6,0,0
E33015916,241,164,42,122,2,18,17,1,53,49,2,2,0,4
E33015917,326,242,68,174,1,53,44,9,30,26,0,4,0,0
E33015918,561,436,146,290,1,71,58,13,51,47,0,4,0,2
E33015919,312,198,69,129,1,87,82,5,23,20,1,2,0,3
E33015920,448,302,89,213,1,99,98,1,42,38,0,3,1,4
E33015921,454,337,146,191,9,41,15,26,64,53,0,11,0,3
E33015922,250,173,79,94,3,16,5,11,49,41,0,7,1,9
E33015923,395,282,110,172,1,44,24,20,65,49,1,14,1,3
E33015924,359,248,112,136,3,35,13,22,68,57,3,7,1,5
E33015925,289,196,82,114,3,49,25,24,40,35,1,4,0,1
E33015926,270,198,87,111,2,16,3,13,44,39,0,3,2,10
E33015927,246,185,71,114,2,14,6,8,42,39,0,3,0,3
E33015928,319,251,123,128,4,16,6,10,41,35,0,6,0,7
E33015929,419,327,131,196,1,36,22,14,51,43,1,4,3,4
E33015930,241,174,72,102,3,17,9,8,33,26,2,2,3,14
E33015931,308,198,71,127,1,17,8,9,57,47,4,3,3,35
E33015932,714,479,197,282,5,85,31,54,123,102,2,10,9,22
E33015933,335,253,108,145,1,24,12,12,49,47,0,1,1,8
E33015934,347,257,120,137,5,26,14,12,57,42,11,3,1,2
E33015935,288,229,114,115,0,9,3,6,48,40,0,2,6,2
E33015936,529,314,148,166,7,24,10,14,122,96,18,4,4,62
E33015937,209,148,63,85,2,14,4,10,37,32,2,1,2,8
E33015938,495,358,200,158,5,31,12,19,90,71,3,10,6,11
E33015939,387,286,163,123,2,24,13,11,59,45,4,8,2,16
E33015940,285,234,137,97,0,9,4,5,35,28,0,7,0,7
E33015941,307,202,94,108,1,48,28,20,53,51,0,2,0,3
E33015942,408,308,125,183,4,47,18,29,45,38,2,5,0,4
E33015943,858,673,244,429,3,35,19,16,136,114,3,7,12,11
E33015944,462,374,159,215,1,40,24,16,47,44,1,2,0,0
E33015945,274,202,70,132,1,26,16,10,39,32,1,4,2,6
E33015946,367,302,134,168,2,24,9,15,33,29,0,4,0,6
E33015947,552,392,153,239,2,39,23,16,109,88,16,3,2,10
E33015948,364,275,111,164,0,37,9,28,49,40,3,4,2,3
E33015949,508,403,136,267,3,41,24,17,56,51,2,3,0,5
E33015950,700,526,205,321,2,63,30,33,98,73,4,12,9,11
E33015951,581,468,188,280,4,43,20,23,58,51,3,4,0,8
E33015952,612,537,216,321,1,24,17,7,47,40,0,6,1,3
E33015953,539,443,138,305,1,19,8,11,72,67,1,3,1,4
E33015954,378,283,121,162,4,38,17,21,42,41,1,0,0,11
E33015955,333,245,83,162,1,31,9,22,54,51,0,2,1,2
E33015956,463,387,153,234,2,29,17,12,39,33,3,3,0,6
E33015957,2597,2123,699,1424,7,175,117,58,275,234,3,31,7,17
E33015958,505,434,161,273,1,26,18,8,42,34,1,7,0,2
E33015959,324,266,115,151,3,17,8,9,37,28,3,3,3,1
E33015960,257,169,57,112,1,53,24,29,32,23,4,4,1,2
E33015961,283,225,111,114,0,17,9,8,39,27,0,7,5,2
E33015962,266,220,128,92,0,16,8,8,24,18,1,4,1,6
E33015963,471,351,148,203,1,32,17,15,77,65,4,8,0,10
E33015964,239,192,92,100,0,14,4,10,31,29,0,2,0,2
E33015965,288,224,97,127,2,25,14,11,33,30,0,2,1,4
E33015966,311,263,115,148,1,20,6,14,22,22,0,0,0,5
E33015967,480,380,149,231,2,53,29,24,38,36,0,2,0,7
E33015968,320,240,83,157,1,26,9,17,51,49,0,1,1,2
E33015969,382,323,113,210,2,16,8,8,40,36,0,4,0,1
E33015970,299,238,87,151,6,19,8,11,30,26,0,2,2,6
E33015971,567,450,186,264,1,44,24,20,65,58,0,6,1,7
E33015972,716,521,199,322,5,52,20,32,127,121,1,3,2,11
E33015973,719,567,197,370,12,48,33,15,82,74,0,8,0,10
E33015974,241,174,91,83,1,11,0,11,49,41,4,2,2,6
E33015975,336,242,132,110,1,24,11,13,48,44,0,4,0,21
E33015976,254,188,96,92,3,14,8,6,39,32,1,2,4,10
E33015977,476,380,148,232,5,21,13,8,66,60,0,5,1,4
E33015978,547,394,137,257,8,57,21,36,81,73,0,7,1,7
E33015979,316,239,88,151,1,38,23,15,35,34,0,1,0,3
E33015980,277,186,53,133,3,48,26,22,35,34,0,1,0,5
E33015981,466,361,123,238,3,17,5,12,67,60,4,3,0,18
E33015982,315,206,84,122,2,15,6,9,86,75,1,5,5,6
E33015983,285,233,97,136,3,8,6,2,39,35,0,3,1,2
E33015984,262,188,86,102,1,12,6,6,52,46,0,2,4,9
E33015985,407,304,114,190,4,23,10,13,62,58,1,3,0,14
E33015986,348,288,150,138,0,10,3,7,44,41,3,0,0,6
E33015987,237,164,68,96,1,9,6,3,53,42,6,4,1,10
E33015988,332,248,96,152,2,23,14,9,36,29,3,4,0,23
E33015989,273,180,63,117,0,66,16,50,25,23,0,2,0,2
E33015990,451,352,106,246,0,47,22,25,49,40,0,7,2,3
E33015991,271,194,63,131,1,30,10,20,43,37,0,4,2,3
E33015992,422,297,91,206,2,52,33,19,69,66,0,3,0,2
E33015993,298,256,68,188,0,13,10,3,27,24,0,3,0,2
E33015994,687,555,179,376,1,57,32,25,72,65,0,7,0,2
E33015995,411,338,92,246,1,19,4,15,51,50,0,1,0,2
E33015996,549,443,136,307,1,32,16,16,64,58,0,5,1,9
E33015997,431,346,120,226,2,28,12,16,54,44,2,6,2,1
E33015998,294,227,53,174,0,23,13,10,39,34,0,5,0,5
E33015999,688,582,161,421,3,23,11,12,75,73,0,2,0,5
E33016000,274,215,75,140,2,27,10,17,28,26,0,2,0,2
E33016001,567,440,165,275,1,34,20,14,85,79,1,4,1,7
E33016002,402,343,125,218,2,24,12,12,32,30,0,2,0,1
E33016003,225,180,66,114,0,11,5,6,30,28,0,2,0,4
E33016004,320,280,99,181,1,12,7,5,26,25,0,1,0,1
E33016005,690,575,201,374,4,37,14,23,71,63,0,5,3,3
E33016006,245,188,57,131,0,22,10,12,33,29,0,4,0,2
E33016007,304,254,70,184,0,16,8,8,33,30,0,3,0,1
E33016008,357,296,102,194,0,20,9,11,40,36,0,2,2,1
E33016009,936,693,244,449,0,87,44,43,152,139,0,12,1,4
E33016010,332,288,95,193,1,20,11,9,22,21,0,1,0,1
E33016011,288,238,56,182,0,20,7,13,30,26,0,4,0,0
E33016012,263,214,66,148,1,24,12,12,21,20,0,1,0,3
E33016013,251,202,68,134,1,26,11,15,20,17,0,3,0,2
E33016014,286,237,62,175,1,27,5,22,19,17,0,2,0,2
E33016015,635,533,136,397,2,27,13,14,70,57,0,13,0,3
E33016016,550,449,115,334,0,30,20,10,63,57,0,5,1,8
E33016017,360,258,73,185,3,29,17,12,70,67,0,3,0,0
E33016018,626,496,159,337,4,53,28,25,72,62,3,3,4,1
E33016019,644,522,163,359,2,44,29,15,73,69,0,4,0,3
E33016020,348,295,79,216,3,24,7,17,24,22,0,2,0,2
E33016021,400,302,86,216,4,32,14,18,58,55,0,3,0,4
E33016022,309,225,55,170,7,34,12,22,41,36,1,4,0,2
E33016023,377,306,82,224,0,22,13,9,46,43,1,2,0,3
E33016024,443,351,116,235,5,25,15,10,58,53,0,4,1,4
E33016025,387,342,82,260,1,13,8,5,31,26,0,5,0,0
E33016026,346,284,100,184,2,20,10,10,34,29,0,5,0,6
E33016027,290,214,60,154,1,30,13,17,43,40,0,3,0,2
E33016028,231,165,43,122,0,33,11,22,29,29,0,0,0,4
E33016029,264,189,48,141,0,24,15,9,49,47,0,2,0,2
E33016030,546,407,143,264,0,47,25,22,91,87,0,4,0,1
E33016031,315,212,59,153,7,41,20,21,53,46,1,6,0,2
E33016032,486,422,122,300,1,21,7,14,36,35,0,1,0,6
E33016033,368,303,103,200,6,17,14,3,31,28,1,2,0,11
E33016034,699,539,171,368,3,33,17,16,101,88,4,9,0,23
E33016035,322,260,57,203,2,13,3,10,47,43,0,4,0,0
E33016036,430,328,98,230,0,35,16,19,63,61,0,2,0,4
E33016037,416,304,80,224,4,34,15,19,74,63,1,10,0,0
E33016038,560,446,109,337,5,37,16,21,70,62,2,6,0,2
E33016039,244,201,56,145,3,10,5,5,28,27,0,1,0,2
E33016040,369,255,69,186,0,40,16,24,69,64,0,5,0,5
E33016041,551,443,126,317,2,31,16,15,73,64,0,9,0,2
E33016042,228,187,58,129,0,14,8,6,27,25,0,2,0,0
E33016043,265,207,64,143,3,23,10,13,31,28,0,1,2,1
E33016044,229,194,64,130,1,13,5,8,17,13,1,3,0,4
E33016045,402,319,103,216,4,26,11,15,52,40,1,8,3,1
E33016046,322,236,69,167,2,25,18,7,55,52,0,3,0,4
E33016047,392,272,75,197,4,19,8,11,93,88,2,1,2,4
E33016048,388,323,77,246,0,16,9,7,48,44,0,4,0,1
E33016049,387,294,87,207,3,23,14,9,62,57,1,4,0,5
E33016050,423,352,111,241,3,15,6,9,47,39,5,3,0,6
E33016051,273,227,55,172,0,14,2,12,29,28,0,1,0,3
E33016052,468,395,117,278,3,21,11,10,47,44,0,3,0,2
E33016053,302,233,61,172,1,21,8,13,40,39,0,0,1,7
E33016054,264,224,62,162,3,12,4,8,24,16,0,7,1,1
E33016055,474,377,104,273,2,32,12,20,62,58,1,3,0,1
E33016056,287,229,47,182,1,23,7,16,32,28,1,1,2,2
E33016057,286,237,66,171,0,16,10,6,33,28,0,5,0,0
E33016058,465,355,89,266,4,45,22,23,56,49,0,7,0,5
E33016059,552,407,118,289,5,65,44,21,71,55,0,8,8,4
E33016060,341,270,81,189,0,36,28,8,34,32,0,2,0,1
E33016061,292,183,44,139,0,86,78,8,19,18,0,1,0,4
E33016062,594,410,124,286,3,87,70,17,89,80,1,6,2,5
E33016063,614,492,114,378,1,70,50,20,47,43,0,2,2,4
E33016064,497,383,92,291,1,55,36,19,52,49,0,2,1,6
E33016065,560,420,93,327,2,45,41,4,85,80,0,4,1,8
E33016066,248,202,61,141,0,12,8,4,33,29,0,4,0,1
E33016067,340,279,68,211,0,14,11,3,41,36,0,5,0,6
E33016068,246,182,57,125,1,14,12,2,43,32,0,11,0,6
E33016069,390,316,83,233,3,32,25,7,36,32,0,2,2,3
E33016070,271,187,51,136,2,40,35,5,33,33,0,0,0,9
E33016071,409,314,82,232,4,35,19,16,53,50,2,0,1,3
E33016072,432,364,90,274,0,16,10,6,52,47,0,3,2,0
E33016073,389,320,113,207,0,25,23,2,40,37,0,3,0,4
E33016074,290,226,80,146,3,22,18,4,37,30,0,6,1,2
E33016075,317,262,77,185,0,16,14,2,32,22,0,5,5,7
E33016076,309,232,57,175,1,44,35,9,30,27,1,2,0,2
E33016077,411,350,91,259,0,13,13,0,45,40,1,3,1,3
E33016078,515,450,143,307,4,18,13,5,40,34,0,4,2,3
E33016079,466,403,135,268,1,25,16,9,36,31,0,5,0,1
E33016080,293,248,88,160,0,11,9,2,31,29,0,2,0,3
E33016081,484,370,124,246,0,37,29,8,75,59,0,9,7,2
E33016082,237,195,87,108,0,9,4,5,30,25,0,3,2,3
E33016083,276,213,60,153,1,10,5,5,52,44,0,6,2,0
E33016084,280,204,72,132,3,34,25,9,39,38,0,1,0,0
E33016085,452,377,141,236,4,25,18,7,40,35,1,3,1,6
E33016086,486,372,119,253,5,42,30,12,60,48,3,9,0,7
E33016087,471,341,108,233,5,57,42,15,60,53,0,6,1,8
E33016088,254,211,90,121,1,9,8,1,25,22,0,2,1,8
E33016089,328,270,91,179,4,13,11,2,40,37,1,1,1,1
E33016090,390,304,119,185,1,28,19,9,55,45,1,8,1,2
E33016091,297,264,96,168,1,8,7,1,22,18,0,4,0,2
E33016092,260,217,83,134,4,21,16,5,15,13,0,2,0,3
E33016093,559,449,146,303,2,42,30,12,63,57,0,6,0,3
E33016094,387,317,104,213,3,25,21,4,40,36,0,3,1,2
E33016095,311,261,101,160,2,15,12,3,30,22,0,4,4,3
E33016096,572,392,151,241,2,40,28,12,132,122,1,9,0,6
E33016097,417,294,88,206,2,20,15,5,98,88,2,8,0,3
E33016098,285,236,90,146,2,5,3,2,34,30,0,4,0,8
E33016099,311,227,96,131,2,27,14,13,51,43,3,5,0,4
E33016100,260,180,60,120,0,20,14,6,56,52,1,3,0,4
E33016101,364,288,110,178,0,20,14,6,51,40,0,11,0,5
E33016102,585,429,136,293,3,58,36,22,88,75,0,13,0,7
E33016103,606,426,153,273,5,94,61,33,81,73,0,4,4,0
E33016104,409,322,108,214,3,27,19,8,54,46,0,7,1,3
E33016105,228,184,59,125,1,11,8,3,31,26,0,5,0,1
E33016106,262,233,78,155,0,7,4,3,22,16,1,4,1,0
E33016107,333,269,81,188,2,21,19,2,40,37,2,1,0,1
E33016108,822,631,200,431,3,55,37,18,129,111,3,15,0,4
E33016109,264,209,55,154,1,14,8,6,38,36,1,1,0,2
E33016110,469,394,146,248,0,20,17,3,48,45,0,3,0,7
E33016111,612,486,166,320,4,71,56,15,51,43,0,7,1,0
E33016112,341,273,75,198,0,43,42,1,20,18,0,0,2,5
E33016113,617,503,145,358,1,38,32,6,73,65,0,5,3,2
E33016114,638,518,138,380,3,64,55,9,53,39,5,3,6,0
E33016115,265,224,72,152,0,16,13,3,24,18,0,3,3,1
E33016116,505,407,155,252,0,38,32,6,56,52,2,1,1,4
E33016117,435,363,109,254,0,32,25,7,37,33,0,4,0,3
E33016118,748,581,201,380,0,77,60,17,84,74,0,8,2,6
E33016119,265,219,56,163,0,25,15,10,19,19,0,0,0,2
E33016120,319,255,70,185,2,36,30,6,25,19,0,2,4,1
E33016121,304,222,82,140,1,42,38,4,35,33,1,1,0,4
E33016122,766,585,167,418,2,84,61,23,92,77,4,9,2,3
E33016123,310,229,68,161,0,66,47,19,13,12,0,1,0,2
E33016124,600,468,219,249,1,63,48,15,57,48,0,6,3,11
E33016125,319,243,70,173,4,26,19,7,42,39,0,3,0,4
E33016126,425,377,136,241,0,24,21,3,20,15,2,2,1,4
E33016127,299,278,81,197,0,10,9,1,11,9,0,2,0,0
E33016128,1540,935,295,640,3,311,259,52,269,258,0,8,3,22
E33016129,317,286,82,204,2,10,7,3,19,14,0,2,3,0
E33016130,356,284,88,196,1,32,24,8,38,35,0,2,1,1
E33016131,278,182,46,136,0,39,37,2,51,50,0,0,1,6
E33016132,306,220,86,134,1,44,27,17,40,35,0,4,1,1
E33016133,288,223,76,147,0,34,27,7,29,27,0,2,0,2
E33016134,258,211,86,125,0,20,17,3,26,23,0,3,0,1
E33016135,251,173,68,105,1,37,32,5,39,34,0,4,1,1
E33016136,370,309,133,176,1,21,19,2,34,31,2,1,0,5
E33016137,310,245,109,136,2,15,12,3,44,42,0,2,0,4
E33016138,401,337,144,193,1,26,25,1,36,29,0,5,2,1
E33016139,535,436,148,288,1,41,33,8,55,45,2,2,6,2
E33016140,290,190,62,128,2,64,57,7,33,27,0,3,3,1
E33016141,255,178,53,125,0,32,28,4,43,37,0,2,4,2
E33016142,444,323,107,216,3,85,80,5,29,26,1,2,0,4
E33016143,330,205,67,138,0,97,92,5,24,24,0,0,0,4
E33016144,279,200,69,131,1,50,45,5,27,27,0,0,0,1
E33016145,625,510,178,332,1,60,51,9,50,43,0,6,1,4
E33016146,264,213,113,100,1,22,12,10,25,20,2,3,0,3
E33016147,346,295,120,175,0,13,11,2,34,28,0,5,1,4
E33016148,380,299,137,162,0,37,36,1,35,31,1,3,0,9
E33016149,332,249,97,152,0,39,32,7,39,33,1,5,0,5
E33016150,374,267,80,187,3,57,54,3,46,40,0,4,2,1
E33016151,339,277,81,196,1,19,15,4,40,37,1,2,0,2
E33016152,561,470,127,343,3,42,41,1,45,38,0,7,0,1
E33016153,384,302,95,207,1,46,43,3,31,24,0,7,0,4
E33016154,289,208,54,154,3,54,50,4,24,23,0,1,0,0
E33016155,583,407,134,273,0,108,94,14,67,65,0,2,0,1
E33016156,382,263,85,178,2,78,74,4,34,25,0,7,2,5
E33016157,951,625,228,397,7,178,167,11,133,115,4,10,4,8
E33016158,440,326,90,236,2,58,57,1,54,53,0,1,0,0
E33016159,768,560,181,379,5,127,115,12,70,63,1,5,1,6
E33016160,390,308,107,201,1,40,36,4,39,34,0,5,0,2
E33016161,326,248,92,156,1,54,48,6,19,16,0,3,0,4
E33016162,310,185,64,121,0,56,49,7,66,55,11,0,0,3
E33016163,332,266,121,145,0,28,15,13,33,28,0,4,1,5
E33016164,452,366,147,219,1,44,38,6,37,36,0,1,0,4
E33016165,262,202,103,99,0,26,22,4,29,23,0,2,4,5
E33016166,3133,2583,413,2170,20,147,84,63,371,331,11,26,3,12
E33016167,707,520,119,401,1,57,28,29,123,115,1,5,2,6
E33016168,452,309,126,183,0,21,10,11,111,100,7,3,1,11
E33016169,778,445,118,327,3,75,42,33,250,236,1,8,5,5
E33016170,286,227,62,165,0,26,22,4,32,29,0,3,0,1
E33016171,421,333,107,226,3,24,18,6,52,46,1,2,3,9
E33016172,222,161,66,95,1,9,6,3,50,46,0,3,1,1
E33016173,258,215,61,154,0,8,4,4,35,29,0,6,0,0
E33016174,542,459,130,329,0,27,23,4,51,45,0,6,0,5
E33016175,336,283,60,223,0,11,6,5,40,34,0,3,3,2
E33016176,658,523,155,368,4,39,23,16,89,81,1,7,0,3
E33016177,398,298,67,231,1,18,12,6,80,72,6,2,0,1
E33016178,411,316,67,249,3,30,12,18,60,54,1,5,0,2
E33016179,266,215,76,139,3,19,7,12,29,25,1,3,0,0
E33016180,302,216,62,154,2,37,27,10,45,43,1,1,0,2
E33016181,290,238,78,160,1,11,7,4,35,32,0,3,0,5
E33016182,223,174,61,113,1,14,5,9,32,27,0,5,0,2
E33016183,387,311,100,211,2,18,9,9,49,45,0,4,0,7
E33016184,227,177,51,126,0,15,8,7,33,29,2,2,0,2
E33016185,266,215,64,151,1,25,18,7,23,21,1,1,0,2
E33016186,380,338,116,222,1,8,7,1,29,28,0,1,0,4
E33016187,545,439,152,287,1,28,17,11,73,65,3,5,0,4
E33016188,236,198,69,129,1,12,11,1,21,16,2,3,0,4
E33016189,477,330,104,226,0,20,14,6,87,38,45,2,2,40
E33016190,458,352,138,214,2,19,10,9,72,60,4,5,3,13
E33016191,442,326,110,216,2,25,13,12,72,63,3,6,0,17
E33016192,261,191,73,118,0,21,14,7,45,35,9,1,0,4
E33016193,273,210,74,136,2,18,8,10,41,39,0,1,1,2
E33016194,603,475,174,301,4,39,24,15,78,73,1,4,0,7
E33016195,508,377,138,239,4,31,23,8,87,78,7,1,1,9
E33016196,229,185,70,115,0,5,5,0,37,35,0,2,0,2
E33016197,308,216,88,128,1,27,14,13,52,49,0,1,2,12
E33016198,761,593,198,395,1,92,71,21,74,67,1,5,1,1
E33016199,372,299,82,217,1,28,24,4,43,39,2,2,0,1
E33016200,341,271,95,176,0,27,18,9,38,33,0,5,0,5
E33016201,315,274,74,200,2,12,11,1,26,19,1,6,0,1
E33016202,339,250,70,180,3,44,30,14,41,33,2,4,2,1
E33016203,547,412,136,276,2,54,42,12,78,73,0,4,1,1
E33016204,513,375,118,257,4,34,16,18,95,85,1,8,1,5
E33016205,200,160,44,116,0,15,12,3,24,22,0,2,0,1
E33016206,285,228,69,159,0,9,6,3,40,37,1,2,0,8
E33016207,332,273,97,176,1,20,18,2,36,31,0,5,0,2
E33016208,431,366,133,233,2,26,20,6,30,27,0,1,2,7
E33016209,371,309,99,210,1,27,25,2,34,29,3,2,0,0
E33016210,397,285,103,182,7,48,33,15,51,42,1,7,1,6
E33016211,321,272,78,194,2,20,16,4,26,20,0,6,0,1
E33016212,444,351,99,252,0,41,31,10,49,45,0,3,1,3
E33016213,332,295,86,209,0,5,1,4,30,28,0,2,0,2
E33016214,252,202,63,139,2,21,16,5,27,23,0,4,0,0
E33016215,315,279,87,192,1,12,6,6,21,19,0,0,2,2
E33016216,265,200,74,126,2,28,19,9,31,30,0,1,0,4
E33016217,289,228,63,165,2,21,13,8,34,29,2,1,2,4
E33016218,306,232,83,149,0,19,13,6,54,50,0,4,0,1
E33016219,298,244,84,160,1,20,10,10,32,31,0,1,0,1
E33016220,368,308,85,223,1,19,12,7,39,32,1,6,0,1
E33016221,487,353,50,303,0,25,11,14,107,103,0,3,1,2
E33016222,356,291,96,195,0,18,12,6,43,39,1,3,0,4
E33016223,451,358,109,249,9,18,9,9,64,62,0,2,0,2
E33016224,412,286,96,190,0,38,24,14,87,83,0,4,0,1
E33016225,403,313,86,227,3,25,11,14,58,54,3,1,0,4
E33016226,431,304,80,224,1,47,24,23,73,68,0,4,1,6
E33016227,413,320,83,237,3,31,15,16,56,43,3,5,5,3
E33016228,365,283,92,191,3,29,20,9,50,37,6,5,2,0
E33016229,268,209,40,169,0,16,4,12,41,41,0,0,0,2
E33016230,404,329,81,248,2,20,6,14,51,48,1,1,1,2
E33016231,308,256,65,191,0,31,21,10,20,17,0,3,0,1
E33016232,466,361,97,264,4,40,19,21,61,54,0,5,2,0
E33016233,330,237,55,182,1,29,21,8,63,60,0,2,1,0
E33016234,573,483,108,375,1,23,13,10,60,57,1,2,0,6
E33016235,461,372,105,267,4,40,23,17,43,41,1,1,0,2
E33016236,353,296,71,225,1,14,4,10,42,34,1,5,2,0
E33016237,367,334,95,239,0,6,3,3,27,24,0,3,0,0
E33016238,417,326,89,237,1,30,21,9,59,54,0,4,1,1
E33016239,241,203,73,130,2,21,7,14,15,13,0,2,0,0
E33016240,492,376,105,271,4,51,26,25,56,48,0,8,0,5
E33016241,590,455,131,324,3,36,14,22,92,83,2,5,2,4
E33016242,765,622,123,499,8,40,22,18,93,88,0,4,1,2
E33016243,719,577,139,438,7,50,23,27,78,65,0,12,1,7
E33016244,609,472,115,357,7,50,12,38,77,73,0,4,0,3
E33016245,470,363,99,264,5,35,23,12,62,56,1,5,0,5
E33016246,320,294,78,216,0,9,4,5,17,16,0,1,0,0
E33016247,248,226,45,181,1,6,1,5,14,12,1,1,0,1
E33016248,352,280,96,184,2,19,14,5,45,40,0,3,2,6
E33016249,311,261,90,171,1,11,3,8,36,31,0,3,2,2
E33016250,717,579,151,428,8,52,24,28,76,67,0,6,3,2
E33016251,259,205,82,123,1,22,13,9,27,24,0,2,1,4
E33016252,400,334,87,247,1,21,14,7,41,39,0,2,0,3
E33016253,338,282,86,196,1,27,10,17,27,25,0,2,0,1
E33016254,332,286,96,190,2,17,11,6,26,23,0,3,0,1
E33016255,289,232,73,159,1,22,12,10,32,32,0,0,0,2
E33016256,351,285,76,209,2,24,16,8,33,25,0,6,2,7
E33016257,618,548,160,388,3,18,8,10,48,42,0,6,0,1
E33016258,311,269,104,165,2,21,11,10,17,17,0,0,0,2
E33016259,321,264,69,195,2,14,7,7,39,31,0,6,2,2
E33016260,529,428,133,295,4,32,18,14,61,46,10,5,0,4
E33016261,418,352,95,257,1,23,9,14,41,38,1,2,0,1
E33016262,295,229,75,154,1,28,15,13,35,28,1,6,0,2
E33016263,267,226,82,144,0,25,16,9,15,14,1,0,0,1
E33016264,260,211,79,132,1,15,10,5,32,23,3,6,0,1
E33016265,433,318,110,208,5,55,21,34,54,49,1,3,1,1
E33016266,376,289,64,225,2,23,17,6,59,54,2,3,0,3
E33016267,323,258,89,169,0,23,6,17,42,38,0,1,3,0
E33016268,623,474,151,323,7,49,30,19,91,79,0,10,2,2
E33016269,235,153,54,99,2,30,20,10,47,47,0,0,0,3
E33016270,447,316,100,216,4,45,26,19,79,71,0,5,3,3
E33016271,368,246,77,169,3,53,22,31,63,58,2,2,1,3
E33016272,374,287,71,216,2,35,22,13,47,45,0,2,0,3
E33016273,437,278,91,187,6,50,34,16,100,86,2,8,4,3
E33016274,834,660,244,416,4,62,41,21,103,90,3,7,3,5
E33016275,416,318,86,232,5,33,21,12,58,54,0,2,2,2
E33016276,1113,849,233,616,9,79,53,26,171,163,0,6,2,5
E33016277,589,402,145,257,5,50,23,27,127,120,1,5,1,5
E33016278,285,196,76,120,2,44,37,7,42,41,0,1,0,1
E33016279,840,668,207,461,4,48,28,20,118,102,3,12,1,2
E33016280,296,155,50,105,1,24,14,10,110,104,1,4,1,6
E33016281,934,677,204,473,10,65,38,27,179,158,5,16,0,3
E33016282,1068,849,278,571,4,59,43,16,149,138,3,7,1,7
E33016283,272,220,71,149,1,12,8,4,37,35,0,0,2,2
E33016284,482,384,122,262,0,40,29,11,54,52,0,2,0,4
E33016285,318,266,93,173,1,21,16,5,28,28,0,0,0,2
E33016286,297,240,68,172,4,27,16,11,26,22,0,2,2,0
E33016287,848,692,210,482,10,57,36,21,87,71,1,13,2,2
E33016288,336,256,76,180,4,30,24,6,42,38,0,2,2,4
E33016289,321,268,77,191,1,22,11,11,28,27,0,1,0,2
E33016290,272,233,68,165,2,10,8,2,25,23,1,1,0,2
E33016291,334,280,80,200,4,12,8,4,37,31,1,5,0,1
E33016292,549,395,115,280,2,52,31,21,98,88,1,6,3,2
E33016293,406,185,57,128,2,64,35,29,154,145,0,9,0,1
E33016294,2889,2117,692,1425,16,77,52,25,658,616,7,30,5,21
E33016295,744,492,166,326,5,77,56,21,163,156,1,4,2,7
E33016296,583,461,147,314,5,25,18,7,90,82,0,6,2,2
E33016297,600,477,141,336,4,37,25,12,67,60,2,5,0,15
E33016298,304,250,102,148,0,14,9,5,37,30,1,5,1,3
E33016299,393,311,119,192,1,20,11,9,55,47,2,6,0,6
E33016300,328,262,98,164,1,22,19,3,37,30,0,6,1,6
E33016301,502,421,171,250,2,24,16,8,46,42,2,1,1,9
E33016302,295,216,62,154,2,26,18,8,47,44,0,3,0,4
E33016303,638,429,112,317,8,80,54,26,109,100,1,7,1,12
E33016304,307,230,51,179,2,47,40,7,27,22,0,5,0,1
E33016305,829,676,196,480,4,55,38,17,83,70,3,7,3,11
E33016306,387,249,58,191,4,63,47,16,68,63,0,3,2,3
E33016307,293,174,50,124,1,28,16,12,86,81,1,2,2,4
E33016308,476,382,156,226,3,30,25,5,57,49,2,5,1,4
E33016309,332,266,70,196,3,14,3,11,43,41,0,2,0,6
E33016310,264,237,98,139,2,2,2,0,22,17,0,5,0,1
E33016311,279,221,67,154,1,16,11,5,39,30,2,5,2,2
E33016312,711,541,150,391,12,57,41,16,98,87,0,7,4,3
E33016313,314,265,88,177,4,10,6,4,34,26,7,1,0,1
E33016314,334,267,85,182,1,15,10,5,48,47,0,1,0,3
E33016315,282,211,62,149,1,26,15,11,38,33,1,4,0,6
E33016316,371,278,82,196,8,37,27,10,48,47,0,1,0,0
E33016317,217,186,58,128,0,6,1,5,24,20,1,3,0,1
E33016318,293,230,77,153,1,14,10,4,38,32,1,3,2,10
E33016319,438,322,103,219,5,37,21,16,71,63,0,6,2,3
E33016320,368,307,108,199,3,13,11,2,42,35,1,6,0,3
E33016321,593,446,130,316,3,56,38,18,83,80,0,3,0,5
E33016322,479,395,109,286,1,21,16,5,62,58,0,4,0,0
E33016323,268,224,59,165,1,13,10,3,30,24,3,3,0,0
E33016324,413,337,97,240,3,22,18,4,47,38,4,1,4,4
E33016325,358,295,94,201,1,17,13,4,44,37,1,6,0,1
E33016326,280,216,62,154,0,20,16,4,44,39,1,4,0,0
E33016327,518,378,104,274,3,53,43,10,78,65,12,1,0,6
E33016328,281,215,63,152,2,26,22,4,36,32,0,1,3,2
E33016329,552,442,102,340,5,42,35,7,58,50,1,7,0,5
E33016330,450,346,93,253,0,61,53,8,42,35,0,7,0,1
E33016331,385,306,87,219,3,30,23,7,43,36,1,5,1,3
E33016332,387,310,112,198,3,31,25,6,40,36,0,3,1,3
E33016333,324,241,87,154,1,13,10,3,57,51,0,6,0,12
E33016334,876,739,239,500,4,40,28,12,88,76,2,10,0,5
E33016335,252,222,69,153,0,9,8,1,19,18,0,1,0,2
E33016336,258,202,76,126,3,18,14,4,32,31,0,1,0,3
E33016337,276,212,85,127,1,18,11,7,42,39,0,3,0,3
E33016338,363,282,120,162,4,19,16,3,50,45,3,0,2,8
E33016339,281,243,83,160,2,10,7,3,23,20,0,2,1,3
E33016340,288,214,81,133,1,22,18,4,45,38,2,4,1,6
E33016341,376,291,115,176,1,22,15,7,56,47,6,2,1,6
E33016342,265,187,68,119,2,16,8,8,44,29,11,1,3,16
E33016343,776,591,153,438,3,71,46,25,110,104,1,4,1,1
E33016344,266,199,64,135,5,14,8,6,42,38,3,1,0,6
E33016345,443,376,117,259,2,13,7,6,50,45,0,4,1,2
E33016346,422,340,133,207,2,30,19,11,46,37,1,5,3,4
E33016347,643,471,111,360,8,58,39,19,103,91,3,9,0,3
E33016348,645,514,143,371,7,33,20,13,83,71,2,10,0,8
E33016349,296,254,81,173,3,8,4,4,31,25,2,3,1,0
E33016350,282,229,61,168,0,24,11,13,29,26,0,3,0,0
E33016351,329,263,87,176,1,25,15,10,39,34,0,5,0,1
E33016352,439,397,126,271,1,4,3,1,36,30,2,4,0,1
E33016353,340,275,104,171,4,23,18,5,32,28,0,3,1,6
E33016354,688,557,161,396,4,38,21,17,84,77,1,5,1,5
E33016355,275,241,80,161,1,11,6,5,22,18,3,1,0,0
E33016356,471,386,109,277,2,23,14,9,59,57,0,2,0,1
E33016357,379,286,84,202,2,35,18,17,54,50,0,3,1,2
E33016358,319,246,87,159,7,27,17,10,36,31,1,4,0,3
E33016359,463,382,136,246,0,23,12,11,57,54,1,1,1,1
E33016360,331,240,81,159,3,30,14,16,57,53,1,3,0,1
E33016361,327,270,85,185,0,32,19,13,25,20,0,5,0,0
E33016362,318,257,96,161,1,23,15,8,36,35,0,0,1,1
E33016363,519,411,139,272,3,53,39,14,50,47,0,3,0,2
E33016364,226,197,62,135,1,5,5,0,22,19,0,3,0,1
E33016365,277,219,68,151,3,22,19,3,30,26,1,3,0,3
E33016366,537,420,113,307,1,42,26,16,65,61,0,4,0,9
E33016367,476,380,99,281,3,19,15,4,73,64,1,5,3,1
E33016368,703,557,210,347,3,19,4,15,97,79,8,6,4,27
E33016369,289,198,90,108,1,9,1,8,68,61,3,3,1,13
E33016370,494,371,128,243,7,32,19,13,75,65,4,4,2,9
E33016371,343,233,124,109,0,15,8,7,77,66,8,2,1,18
E33016372,375,287,85,202,3,37,7,30,46,40,0,5,1,2
E33016373,622,527,187,340,4,22,13,9,61,52,6,3,0,8
E33016374,492,395,150,245,3,52,37,15,39,36,0,3,0,3
E33016375,784,628,191,437,6,46,11,35,98,90,1,6,1,6
E33016376,271,229,88,141,1,11,4,7,29,26,0,2,1,1
E33016377,258,207,77,130,2,14,6,8,33,28,2,3,0,2
E33016378,288,228,81,147,3,13,3,10,42,40,0,1,1,2
E33016379,383,322,95,227,5,20,8,12,33,27,1,5,0,3
E33016380,331,287,65,222,2,8,2,6,31,27,0,4,0,3
E33016381,499,413,106,307,8,18,9,9,57,53,2,2,0,3
E33016382,316,250,70,180,2,18,6,12,45,37,0,2,6,1
E33016383,396,326,98,228,3,24,12,12,42,34,3,3,2,1
E33016384,374,339,89,250,3,6,0,6,24,24,0,0,0,2
E33016385,740,573,164,409,6,59,19,40,96,89,0,7,0,6
E33016386,443,363,130,233,0,18,6,12,58,52,2,4,0,4
E33016387,206,166,64,102,1,16,6,10,20,14,1,4,1,3
E33016388,362,260,78,182,4,23,10,13,70,59,6,4,1,5
E33016389,346,263,93,170,8,16,5,11,54,51,0,2,1,5
E33016390,239,185,54,131,3,11,1,10,37,30,2,5,0,3
E33016391,276,205,67,138,3,20,5,15,46,41,4,1,0,2
E33016392,293,223,103,120,1,18,9,9,46,43,1,1,1,5
E33016393,288,246,74,172,1,7,0,7,31,26,0,5,0,3
E33016394,409,339,108,231,4,16,7,9,45,44,0,1,0,5
E33016395,534,423,119,304,2,43,28,15,62,50,2,7,3,4
E33016396,266,220,76,144,1,21,6,15,20,17,0,3,0,4
E33016397,300,239,74,165,1,20,5,15,33,28,0,4,1,7
E33016398,342,285,98,187,3,14,2,12,35,26,5,3,1,5
E33016399,253,193,78,115,1,28,17,11,27,22,0,5,0,4
E33016400,232,193,74,119,1,13,6,7,20,19,0,1,0,5
E33016401,283,223,69,154,1,23,19,4,29,24,0,4,1,7
E33016402,358,285,113,172,1,23,10,13,33,27,2,3,1,16
E33016403,282,227,68,159,2,19,6,13,32,30,0,2,0,2
E33016404,334,264,101,163,1,20,12,8,42,37,0,1,4,7
E33016405,251,203,68,135,3,15,5,10,29,26,0,3,0,1
E33016406,351,288,75,213,1,13,5,8,46,41,1,4,0,3
E33016407,464,389,109,280,6,17,7,10,50,47,0,3,0,2
E33016408,245,153,54,99,1,14,7,7,70,56,13,1,0,7
E33016409,347,305,99,206,1,10,2,8,31,23,3,2,3,0
E33016410,436,356,112,244,1,22,3,19,52,43,0,9,0,5
E33016411,286,233,90,143,4,19,7,12,26,25,0,1,0,4
E33016412,462,347,96,251,8,47,13,34,56,46,0,10,0,4
E33016413,437,353,102,251,4,20,8,12,57,47,4,6,0,3
E33016414,666,494,142,352,11,46,8,38,108,99,2,7,0,7
E33016415,295,240,65,175,5,10,2,8,39,36,0,3,0,1
E33016416,262,214,68,146,3,9,1,8,34,32,0,2,0,2
E33016417,391,281,77,204,4,27,5,22,75,67,1,6,1,4
E33016418,1126,889,211,678,15,40,13,27,181,165,2,11,3,1
E33016419,475,382,67,315,11,29,9,20,53,50,0,3,0,0
E33016420,408,335,88,247,8,22,8,14,39,33,0,6,0,4
E33016421,235,189,53,136,3,14,3,11,25,24,0,1,0,4
E33016422,273,209,64,145,2,24,10,14,34,29,0,3,2,4
E33016423,276,198,60,138,4,39,11,28,33,29,1,3,0,2
E33016424,629,548,147,401,4,22,6,16,55,53,0,2,0,0
E33016425,291,231,72,159,0,25,19,6,33,28,0,2,3,2
E33016426,826,670,201,469,3,56,36,20,86,78,0,6,2,11
E33016427,309,271,79,192,2,17,12,5,19,17,0,1,1,0
E33016428,457,375,126,249,2,17,11,6,63,54,2,6,1,0
E33016429,786,600,180,420,4,80,56,24,98,92,1,5,0,4
E33016430,492,446,125,321,2,12,6,6,31,29,1,1,0,1
E33016431,1135,948,295,653,6,62,38,24,115,105,1,8,1,4
E33016432,405,345,105,240,3,15,10,5,41,36,1,4,0,1
E33016433,437,385,109,276,1,17,9,8,32,27,0,5,0,2
E33016434,483,376,121,255,0,45,26,19,57,51,0,4,2,5
E33016435,773,498,154,344,7,50,29,21,204,153,26,5,20,14
E33016436,662,514,184,330,7,56,45,11,72,65,0,6,1,13
E33016437,256,189,61,128,1,28,23,5,37,34,0,3,0,1
E33016438,346,277,78,199,3,24,11,13,41,36,0,3,2,1
E33016439,296,251,94,157,0,19,16,3,23,22,0,0,1,3
E33016440,435,374,165,209,2,18,11,7,37,30,3,2,2,4
E33016441,299,238,76,162,1,20,13,7,40,35,0,1,4,0
E33016442,1374,1078,331,747,9,93,65,28,185,172,0,12,1,9
E33016443,530,443,136,307,1,43,32,11,41,38,1,1,1,2
E33016444,269,206,86,120,0,26,21,5,33,29,2,1,1,4
E33016445,322,269,94,175,0,19,15,4,29,23,0,6,0,5
E33016446,456,369,141,228,1,33,23,10,50,41,0,6,3,3
E33016447,835,632,163,469,4,84,60,24,112,98,0,11,3,3
E33016448,307,220,67,153,4,45,20,25,33,32,0,1,0,5
E33016449,235,201,63,138,0,12,7,5,18,17,0,1,0,4
E33016450,324,262,82,180,1,11,8,3,48,42,4,2,0,2
E33016451,464,341,106,235,4,51,36,15,67,62,1,4,0,1
E33016452,288,229,70,159,2,28,14,14,28,24,3,1,0,1
E33016453,640,487,164,323,6,63,40,23,81,72,1,5,3,3
E33016454,640,496,144,352,2,53,26,27,84,78,0,6,0,5
E33016455,309,240,65,175,3,36,30,6,27,26,0,1,0,3
E33016456,1104,842,277,565,2,102,64,38,154,136,0,17,1,4
E33016457,313,239,82,157,4,34,23,11,34,32,0,2,0,2
E33016458,351,285,90,195,2,33,14,19,31,29,0,2,0,0
E33016459,896,715,159,556,4,66,34,32,101,91,0,10,0,10
E33016460,391,293,122,171,4,10,7,3,70,66,0,0,4,14
E33016461,342,295,106,189,3,9,6,3,33,25,0,5,3,2
E33016462,341,274,96,178,2,15,10,5,42,38,2,1,1,8
E33016463,895,757,254,503,1,33,20,13,99,90,2,7,0,5
E33016464,535,441,146,295,3,37,25,12,53,49,0,3,1,1
E33016465,550,464,169,295,4,12,7,5,62,55,2,5,0,8
E33016466,240,207,54,153,3,9,6,3,20,20,0,0,0,1
E33016467,335,293,86,207,2,7,5,2,31,29,0,0,2,2
E33016468,458,309,83,226,2,45,25,20,98,86,5,6,1,4
E33016469,289,228,44,184,6,9,6,3,46,43,0,3,0,0
E33016470,265,214,63,151,4,14,6,8,32,32,0,0,0,1
E33016471,317,223,67,156,3,29,20,9,62,51,2,5,4,0
E33016472,310,229,63,166,0,41,33,8,39,36,0,3,0,1
E33016473,925,718,201,517,4,65,45,20,133,117,4,12,0,5
E33016474,349,290,85,205,1,27,17,10,30,24,1,3,2,1
E33016475,374,311,87,224,1,32,26,6,30,28,0,2,0,0
E33016476,379,296,60,236,4,19,10,9,56,51,0,2,3,4
E33016477,1000,786,177,609,13,67,35,32,132,110,2,16,4,2
E33016478,1512,1127,286,841,17,83,48,35,277,254,1,21,1,8
E33016479,702,539,150,389,7,47,30,17,101,93,0,8,0,8
E33016480,475,378,114,264,4,35,11,24,50,47,0,3,0,8
E33016481,296,226,64,162,0,42,31,11,26,20,0,6,0,2
E33016482,277,239,79,160,0,15,11,4,23,23,0,0,0,0
E33016483,319,292,100,192,0,8,6,2,19,17,0,0,2,0
E33016484,259,216,68,148,0,6,3,3,35,33,0,0,2,2
E33016485,284,251,88,163,1,12,7,5,18,17,0,1,0,2
E33016486,336,287,87,200,4,13,6,7,31,31,0,0,0,1
E33016487,291,254,70,184,0,10,6,4,24,22,0,2,0,3
E33016488,684,465,124,341,5,69,48,21,144,133,0,7,4,1
E33016489,405,293,70,223,2,16,6,10,92,87,4,1,0,2
E33016490,349,272,71,201,1,16,10,6,58,48,0,3,7,2
E33016491,259,203,92,111,0,11,10,1,42,40,1,0,1,3
E33016492,392,267,91,176,0,20,13,7,96,75,8,9,4,9
E33016493,595,399,134,265,6,51,38,13,132,122,3,7,0,7
E33016494,307,246,76,170,1,12,10,2,45,41,1,3,0,3
E33016495,461,347,133,214,10,24,21,3,79,71,0,4,4,1
E33016496,400,325,151,174,3,14,11,3,52,42,3,4,3,6
E33016497,268,159,71,88,0,14,9,5,71,66,4,1,0,24
E33016498,263,163,61,102,0,21,17,4,68,61,1,2,4,11
E33016499,264,225,79,146,1,11,10,1,26,24,0,2,0,1
E33016500,521,391,108,283,7,31,19,12,88,66,11,2,9,4
E33016501,466,398,121,277,0,19,13,6,46,42,3,1,0,3
E33016502,655,513,155,358,6,46,34,12,87,81,1,3,2,3
E33016503,382,333,119,214,1,10,7,3,36,35,0,1,0,2
E33016504,622,503,158,345,5,41,28,13,66,63,0,3,0,7
E33016505,354,283,96,187,6,24,14,10,39,36,1,0,2,2
E33016506,676,515,177,338,8,43,21,22,108,91,5,6,6,2
E33016507,433,353,128,225,1,16,13,3,48,44,1,1,2,15
E33016508,694,516,137,379,2,61,47,14,108,96,5,4,3,7
E33016509,564,429,140,289,9,44,20,24,76,73,0,3,0,6
E33016510,464,320,97,223,8,73,53,20,60,43,6,9,2,3
E33016511,238,173,42,131,3,31,24,7,28,27,0,1,0,3
E33016512,738,502,127,375,11,63,46,17,148,137,3,6,2,14
E33016513,339,272,100,172,3,21,15,6,40,39,0,1,0,3
E33016514,312,247,63,184,1,21,12,9,42,40,0,2,0,1
E33016515,402,350,99,251,2,13,7,6,36,29,2,5,0,1
E33016516,332,226,57,169,0,50,40,10,54,49,1,1,3,2
E33016517,335,275,116,159,5,9,5,4,40,33,3,4,0,6
E33016518,445,270,96,174,3,33,18,15,127,107,15,3,2,12
E33016519,313,167,71,96,2,29,16,13,98,90,6,2,0,17
E33016520,257,207,65,142,0,11,9,2,35,31,0,2,2,4
E33016521,238,187,67,120,1,13,6,7,33,27,1,3,2,4
E33016522,303,228,96,132,1,27,20,7,40,36,1,1,2,7
E33016523,344,253,89,164,3,21,9,12,58,52,2,3,1,9
E33016524,328,244,93,151,3,22,17,5,53,47,2,4,0,6
E33016525,4268,3225,791,2434,33,288,191,97,700,650,4,42,4,22
E33016526,267,195,65,130,1,26,18,8,42,40,0,2,0,3
E33016527,712,519,133,386,4,63,54,9,124,115,0,6,3,2
E33016528,574,459,144,315,2,31,25,6,80,74,1,3,2,2
E33016529,312,220,61,159,3,20,14,6,67,63,1,3,0,2
E33016530,1175,918,215,703,10,90,57,33,154,145,4,5,0,3
E33016531,275,220,83,137,1,19,15,4,30,26,1,3,0,5
E33016532,923,738,196,542,14,34,21,13,128,117,1,10,0,9
E33016533,511,368,118,250,5,45,34,11,86,78,3,5,0,7
E33016534,516,407,122,285,2,27,19,8,75,70,0,5,0,5
E33016535,611,454,125,329,3,53,39,14,93,84,2,7,0,8
E33016536,481,409,128,281,0,22,18,4,47,41,1,4,1,3
E33016537,301,243,85,158,1,18,5,13,36,34,0,1,1,3
E33016538,487,356,133,223,10,58,36,22,60,51,2,6,1,3
E33016539,655,545,193,352,5,40,25,15,61,52,2,7,0,4
E33016540,448,354,124,230,2,37,29,8,52,49,1,2,0,3
E33016541,491,401,125,276,4,26,18,8,57,52,1,2,2,3
E33016542,397,324,113,211,0,27,17,10,42,34,4,3,1,4
E33016543,354,298,99,199,1,15,9,6,38,31,4,2,1,2
E33016544,776,541,145,396,12,64,50,14,150,133,0,16,1,9
E33016545,318,267,93,174,1,21,17,4,24,24,0,0,0,5
E33016546,369,272,93,179,2,45,39,6,47,43,0,4,0,3
E33016547,246,219,71,148,1,14,10,4,10,7,0,2,1,2
E33016548,356,265,80,185,6,43,34,9,38,35,0,3,0,4
E33016549,354,289,81,208,3,20,16,4,38,35,0,3,0,4
E33016550,384,316,98,218,3,32,24,8,30,25,0,2,3,3
E33016551,495,396,92,304,3,26,19,7,66,60,0,5,1,4
E33016552,293,232,67,165,3,28,27,1,29,27,1,1,0,1
E33016553,261,213,73,140,0,31,29,2,15,15,0,0,0,2
E33016554,325,263,85,178,0,28,21,7,34,33,0,1,0,0
E33016555,524,354,106,248,2,70,54,16,94,88,0,6,0,4
E33016556,339,288,72,216,2,20,15,5,27,26,1,0,0,2
E33016557,659,481,136,345,6,113,93,20,52,49,0,3,0,7
E33016558,490,409,103,306,3,35,24,11,40,36,0,4,0,3
E33016559,283,194,63,131,4,53,15,38,26,22,0,1,3,6
E33016560,267,201,56,145,2,21,10,11,37,33,0,3,1,6
E33016561,268,214,59,155,0,29,21,8,19,17,0,2,0,6
E33016562,391,298,109,189,3,34,27,7,54,44,3,7,0,2
E33016563,302,252,64,188,2,14,5,9,33,33,0,0,0,1
E33016564,331,282,74,208,2,13,9,4,33,29,0,3,1,1
E33016565,328,282,73,209,1,6,6,0,38,35,0,2,1,1
E33016566,377,305,88,217,7,24,21,3,37,36,0,1,0,4
E33016567,707,557,145,412,6,43,24,19,99,91,0,8,0,2
E33016568,455,368,114,254,6,28,19,9,45,36,0,9,0,8
E33016569,566,462,166,296,2,39,28,11,53,39,3,10,1,10
E33016570,236,192,67,125,0,19,16,3,19,17,0,1,1,6
E33016571,419,344,114,230,2,32,27,5,40,36,2,2,0,1
E33016572,466,358,116,242,1,46,39,7,58,54,2,2,0,3
E33016573,399,316,84,232,2,34,23,11,42,39,0,3,0,5
E33016574,584,453,131,322,5,57,43,14,64,58,2,2,2,5
E33016575,478,377,92,285,0,40,33,7,57,51,2,3,1,4
E33016576,311,251,76,175,1,19,14,5,39,32,0,7,0,1
E33016577,458,385,137,248,6,29,25,4,38,33,0,3,2,0
E33016578,434,359,127,232,1,26,17,9,45,39,0,6,0,3
E33016579,671,519,152,367,3,60,41,19,80,71,0,8,1,9
E33016580,651,538,165,373,4,21,14,7,83,78,0,4,1,5
E33016581,274,192,57,135,3,21,13,8,55,55,0,0,0,3
E33016582,394,293,84,209,4,29,23,6,64,58,3,3,0,4
E33016583,220,172,49,123,4,22,11,11,20,18,0,2,0,2
E33016584,305,235,80,155,2,20,15,5,44,37,2,5,0,4
E33016585,320,270,89,181,0,8,6,2,40,39,0,1,0,2
E33016586,308,246,92,154,5,26,20,6,30,25,0,3,2,1
E33016587,542,417,114,303,7,49,38,11,64,61,0,0,3,5
E33016588,719,535,149,386,7,63,44,19,109,104,0,2,3,5
E33016589,543,409,108,301,3,61,52,9,67,64,0,3,0,3
E33016590,303,236,87,149,4,31,27,4,32,31,0,1,0,0
E33016591,473,386,120,266,2,41,31,10,42,37,0,2,3,2
E33016592,981,729,230,499,8,99,66,33,137,125,3,3,6,8
E33016593,307,241,71,170,2,20,11,9,39,36,0,3,0,5
E33016594,511,364,108,256,5,60,43,17,80,72,0,7,1,2
E33016595,586,457,166,291,1,49,25,24,75,63,2,9,1,4
E33016596,389,286,82,204,4,40,26,14,58,54,0,2,2,1
E33016597,1252,930,282,648,6,124,71,53,190,181,0,6,3,2
E33016598,725,564,162,402,0,68,42,26,89,77,0,12,0,4
E33016599,304,260,92,168,3,5,2,3,35,30,0,5,0,1
E33016600,562,500,163,337,8,19,13,6,33,32,0,1,0,2
E33016601,333,295,107,188,4,4,2,2,28,28,0,0,0,2
E33016602,350,285,85,200,1,21,10,11,38,33,2,0,3,5
E33016603,710,350,125,225,3,41,18,23,305,278,17,7,3,11
E33016604,294,222,95,127,3,17,6,11,49,39,3,4,3,3
E33016605,270,202,77,125,1,20,7,13,44,31,6,6,1,3
E33016606,334,216,69,147,3,23,9,14,90,86,2,2,0,2
E33016607,230,173,75,98,0,16,3,13,25,15,6,2,2,16
E33016608,730,466,132,334,2,34,10,24,220,206,2,8,4,8
E33016609,376,300,101,199,3,33,5,28,33,32,1,0,0,7
E33016610,326,177,58,119,2,48,21,27,98,84,0,9,5,1
E33016611,305,207,69,138,3,33,13,20,62,60,0,2,0,0
E33016612,500,152,35,117,9,47,19,28,290,275,5,3,7,2
E33016613,382,243,64,179,9,41,18,23,88,82,3,3,0,1
E33016614,464,248,77,171,11,69,40,29,136,132,1,3,0,0
E33016615,453,272,85,187,4,79,38,41,88,85,0,2,1,10
E33016616,417,266,87,179,6,34,13,21,108,100,0,5,3,3
E33016617,633,520,153,367,6,30,12,18,75,70,3,1,1,2
E33016618,302,183,49,134,6,33,7,26,72,63,2,1,6,8
E33016619,297,202,80,122,1,17,5,12,75,72,1,0,2,2
E33016620,648,424,119,305,2,46,18,28,169,159,4,4,2,7
E33016621,604,432,92,340,6,36,13,23,128,118,0,6,4,2
E33016622,574,404,135,269,4,46,21,25,114,107,2,5,0,6
E33016623,351,193,68,125,3,54,18,36,100,82,4,9,5,1
E33016624,550,380,103,277,10,72,28,44,83,76,0,7,0,5
E33016625,253,205,70,135,0,14,3,11,32,27,3,2,0,2
E33016626,227,170,54,116,1,19,6,13,32,29,2,1,0,5
E33016627,526,357,88,269,7,50,23,27,109,105,0,4,0,3
E33016628,244,185,85,100,0,13,6,7,43,33,6,4,0,3
E33016629,308,239,67,172,0,19,11,8,49,46,1,1,1,1
E33016630,325,225,85,140,1,29,16,13,64,53,2,5,4,6
E33016631,361,248,97,151,2,41,14,27,68,63,2,2,1,2
E33016632,303,234,67,167,1,32,16,16,34,31,1,0,2,2
E33016633,251,166,45,121,1,31,14,17,52,50,1,0,1,1
E33016634,568,370,118,252,8,62,21,41,119,111,4,3,1,9
E33016635,316,219,91,128,4,43,14,29,49,42,2,3,2,1
E33016636,264,194,78,116,0,33,18,15,30,24,4,0,2,7
E33016637,263,168,52,116,1,54,16,38,39,32,1,6,0,1
E33016638,314,253,84,169,3,6,2,4,46,32,10,4,0,6
E33016639,275,244,89,155,1,4,1,3,23,21,0,2,0,3
E33016640,234,197,81,116,1,5,1,4,26,24,1,1,0,5
E33016641,242,207,70,137,0,6,2,4,27,21,0,6,0,2
E33016642,405,356,98,258,1,9,4,5,38,28,3,5,2,1
E33016643,236,168,73,95,2,10,5,5,48,39,5,3,1,8
E33016644,441,358,174,184,2,17,8,9,57,43,3,8,3,7
E33016645,553,425,183,242,8,24,7,17,89,76,9,2,2,7
E33016646,242,207,74,133,0,11,3,8,19,17,1,0,1,5
E33016647,582,471,162,309,3,34,11,23,70,62,0,6,2,4
E33016648,270,226,80,146,2,7,1,6,33,28,0,5,0,2
E33016649,433,300,111,189,0,35,11,24,96,87,1,8,0,2
E33016650,336,254,71,183,8,39,13,26,34,31,0,3,0,1
E33016651,597,455,156,299,2,48,15,33,89,86,0,3,0,3
E33016652,744,563,201,362,4,54,21,33,120,111,1,6,2,3
E33016653,285,193,69,124,2,16,6,10,67,60,2,5,0,7
E33016654,325,257,95,162,3,18,7,11,43,38,0,3,2,4
E33016655,231,162,68,94,0,15,3,12,50,45,2,3,0,4
E33016656,512,361,132,229,2,37,12,25,105,97,3,4,1,7
E33016657,518,381,110,271,2,52,15,37,77,74,0,3,0,6
E33016658,423,307,91,216,4,32,10,22,77,65,3,5,4,3
E33016659,278,205,78,127,3,16,3,13,50,45,0,5,0,4
E33016660,489,318,134,184,2,48,14,34,110,100,1,8,1,11
E33016661,271,221,93,128,3,9,2,7,36,26,0,10,0,2
E33016662,345,283,122,161,2,13,3,10,38,33,3,2,0,9
E33016663,449,316,120,196,7,30,4,26,92,90,0,2,0,4
E33016664,318,224,91,133,4,22,12,10,66,55,3,8,0,2
E33016665,249,157,64,93,1,33,7,26,56,49,3,4,0,2
E33016666,297,242,96,146,4,19,2,17,29,27,1,1,0,3
E33016667,453,302,153,149,3,26,4,22,108,98,3,6,1,14
E33016668,346,249,108,141,5,19,5,14,69,59,5,5,0,4
E33016669,246,195,83,112,1,17,6,11,32,26,1,3,2,1
E33016670,272,207,117,90,0,12,3,9,33,27,3,1,2,20
E33016671,239,197,116,81,0,12,4,8,24,19,2,1,2,6
E33016672,254,173,87,86,3,6,2,4,64,59,1,3,1,8
E33016673,324,244,101,143,3,20,2,18,52,41,6,5,0,5
E33016674,310,225,111,114,3,30,15,15,47,42,1,2,2,5
E33016675,250,189,74,115,5,4,2,2,43,27,11,4,1,9
E33016676,532,376,158,218,1,34,6,28,113,94,4,11,4,8
E33016677,373,284,129,155,2,14,6,8,66,50,5,9,2,7
E33016678,249,177,85,92,1,22,8,14,42,36,4,2,0,7
E33016679,289,208,96,112,0,12,4,8,61,49,9,3,0,8
E33016680,519,402,122,280,6,46,11,35,64,55,0,8,1,1
E33016681,388,296,115,181,7,17,5,12,65,59,2,2,2,3
E33016682,381,283,132,151,5,17,8,9,67,54,8,5,0,9
E33016683,389,300,111,189,1,14,2,12,64,55,1,6,2,10
E33016684,320,247,127,120,4,10,6,4,45,39,3,3,0,14
E33016685,299,221,103,118,0,14,6,8,50,39,9,2,0,14
E33016686,319,218,91,127,2,9,1,8,72,55,10,6,1,18
E33016687,263,167,85,82,0,6,3,3,68,53,7,3,5,22
E33016688,329,219,96,123,2,17,4,13,79,71,6,0,2,12
E33016689,356,253,81,172,0,22,8,14,70,60,6,2,2,11
E33016690,321,237,99,138,0,7,5,2,75,69,2,4,0,2
E33016691,263,179,79,100,1,16,6,10,62,58,0,4,0,5
E33016692,570,380,161,219,6,34,6,28,144,122,13,9,0,6
E33016693,290,234,107,127,2,6,3,3,45,40,0,5,0,3
E33016694,292,234,96,138,2,23,8,15,32,27,1,4,0,1
E33016695,448,340,115,225,5,28,12,16,74,66,3,4,1,1
E33016696,310,211,89,122,6,29,5,24,59,50,4,4,1,5
E33016697,308,227,91,136,3,15,5,10,60,55,2,2,1,3
E33016698,249,199,59,140,1,10,3,7,38,30,2,3,3,1
E33016699,332,249,94,155,1,9,3,6,69,55,1,9,4,4
E33016700,276,211,80,131,3,14,6,8,45,38,2,5,0,3
E33016701,223,178,55,123,1,8,1,7,34,33,1,0,0,2
E33016702,319,251,102,149,3,19,2,17,43,35,1,5,2,3
E33016703,482,374,115,259,4,26,8,18,78,69,1,7,1,0
E33016704,220,119,47,72,2,31,11,20,67,63,1,3,0,1
E33016705,274,200,73,127,0,16,6,10,55,50,2,3,0,3
E33016706,265,190,61,129,4,19,5,14,48,44,1,3,0,4
E33016707,288,216,65,151,3,18,5,13,51,41,5,4,1,0
E33016708,672,445,139,306,10,50,17,33,166,150,2,14,0,1
E33016709,716,476,154,322,6,92,32,60,134,122,2,10,0,8
E33016710,564,411,165,246,7,41,10,31,101,86,3,11,1,4
E33016711,630,493,199,294,3,29,13,16,102,94,3,5,0,3
E33016712,396,286,90,196,5,30,8,22,72,59,1,11,1,3
E33016713,609,447,190,257,7,24,6,18,119,104,1,10,4,12
E33016714,881,590,186,404,14,64,16,48,209,191,3,15,0,4
E33016715,204,117,35,82,8,14,3,11,62,61,1,0,0,3
E33016716,303,197,74,123,3,13,5,8,90,81,2,6,1,0
E33016717,583,417,154,263,6,43,14,29,113,101,2,9,1,4
E33016718,219,151,43,108,2,24,6,18,42,38,0,4,0,0
E33016719,613,428,151,277,9,53,11,42,120,113,2,4,1,3
E33016720,891,545,195,350,12,83,22,61,245,235,1,9,0,6
E33016721,234,175,62,113,2,21,7,14,36,35,1,0,0,0
E33016722,343,200,59,141,5,60,15,45,75,72,3,0,0,3
E33016723,284,208,78,130,7,9,4,5,57,52,2,3,0,3
E33016724,286,209,69,140,3,14,6,8,54,42,8,1,3,6
E33016725,456,340,122,218,5,19,8,11,85,74,6,3,2,7
E33016726,445,278,81,197,3,32,14,18,120,74,30,4,12,12
E33016727,317,228,41,187,1,22,14,8,64,41,8,4,11,2
E33016728,505,406,144,262,10,18,10,8,59,47,3,8,1,12
E33016729,313,232,86,146,1,18,5,13,54,44,4,4,2,8
E33016730,2760,1938,352,1586,18,109,42,67,687,330,220,20,117,8
E33016731,275,221,81,140,1,5,5,0,41,31,7,2,1,7
E33016732,235,157,53,104,3,18,8,10,50,40,5,5,0,7
E33016733,303,233,87,146,2,21,5,16,42,32,5,5,0,5
E33016734,274,196,78,118,3,18,14,4,52,41,2,9,0,5
E33016735,303,222,103,119,1,26,15,11,48,36,12,0,0,6
E33016736,243,161,74,87,2,20,8,12,47,32,8,6,1,13
E33016737,336,204,83,121,4,28,12,16,91,81,6,3,1,9
E33016738,389,304,110,194,6,19,9,10,46,40,5,1,0,14
E33016739,347,252,109,143,0,11,4,7,71,61,7,3,0,13
E33016740,302,233,95,138,1,27,6,21,35,26,8,1,0,6
E33016741,419,319,126,193,2,27,15,12,61,54,1,3,3,10
E33016742,510,420,161,259,4,30,9,21,48,43,3,2,0,8
E33016743,766,481,122,359,9,189,172,17,79,71,1,5,2,8
E33016744,237,184,58,126,1,27,25,2,22,19,1,2,0,3
E33016745,415,250,65,185,3,53,41,12,106,95,2,8,1,3
E33016746,290,190,44,146,2,24,20,4,71,63,0,8,0,3
E33016747,263,202,54,148,1,17,13,4,41,36,1,4,0,2
E33016748,331,264,95,169,3,28,22,6,34,32,0,1,1,2
E33016749,274,168,40,128,0,51,44,7,55,51,0,4,0,0
E33016750,375,260,71,189,0,23,19,4,89,83,3,2,1,3
E33016751,458,307,101,206,1,48,40,8,94,84,3,6,1,8
E33016752,336,229,63,166,1,28,23,5,76,66,0,8,2,2
E33016753,502,392,114,278,7,21,14,7,79,71,2,6,0,3
E33016754,219,155,63,92,0,26,20,6,30,27,0,2,1,8
E33016755,575,461,114,347,5,30,24,6,75,68,3,4,0,4
E33016756,570,391,127,264,0,34,23,11,126,116,2,5,3,19
E33016757,530,407,139,268,6,32,24,8,83,78,1,4,0,2
E33016758,4472,3386,812,2574,42,303,200,103,721,641,19,46,15,20
E33016759,456,263,73,190,3,59,45,14,124,117,0,6,1,7
E33016760,512,380,102,278,5,41,37,4,80,73,2,5,0,6
E33016761,593,407,106,301,2,62,53,9,118,107,1,8,2,4
E33016762,300,192,58,134,1,70,68,2,33,22,3,7,1,4
E33016763,495,357,99,258,2,41,26,15,90,79,2,9,0,5
E33016764,535,394,93,301,9,35,27,8,93,84,3,6,0,4
E33016765,402,310,65,245,1,50,43,7,40,36,1,3,0,1
E33016766,320,181,49,132,1,50,42,8,88,82,1,4,1,0
E33016767,229,133,52,81,2,18,13,5,73,69,1,3,0,3
E33016768,254,177,45,132,0,10,9,1,63,53,0,10,0,4
E33016769,626,483,122,361,5,21,17,4,112,107,2,3,0,5
E33016770,906,690,216,474,4,72,57,15,130,120,1,8,1,10
E33016771,263,147,47,100,2,24,18,6,86,83,0,3,0,4
E33016772,461,336,96,240,1,45,39,6,78,66,4,6,2,1
E33016773,255,164,40,124,2,28,26,2,61,56,0,4,1,0
E33016774,295,148,40,108,2,40,32,8,100,94,1,5,0,5
E33016775,358,232,80,152,3,41,24,17,75,69,1,4,1,7
E33016776,334,218,70,148,2,24,18,6,88,86,0,2,0,2
E33016777,362,220,71,149,0,47,34,13,94,86,2,6,0,1
E33016778,305,197,42,155,1,57,52,5,45,39,1,4,1,5
E33016779,356,272,56,216,6,31,25,6,44,39,1,4,0,3
E33016780,355,207,44,163,1,97,73,24,48,42,1,4,1,2
E33016781,459,357,93,264,3,25,19,6,71,64,1,4,2,3
E33016782,270,216,47,169,1,19,14,5,33,28,1,4,0,1
E33016783,357,281,64,217,1,30,28,2,41,39,0,2,0,4
E33016784,285,219,50,169,4,15,12,3,44,39,2,3,0,3
E33016785,515,330,102,228,7,42,28,14,131,121,3,7,0,5
E33016786,345,273,64,209,4,19,15,4,45,42,0,3,0,4
E33016787,414,320,81,239,4,31,17,14,58,52,0,5,1,1
E33016788,445,367,123,244,1,9,8,1,66,56,2,8,0,2
E33016789,484,325,82,243,2,102,89,13,53,48,1,4,0,2
E33016790,617,412,100,312,6,95,80,15,101,91,2,7,1,3
E33016791,779,512,104,408,0,110,80,30,149,130,3,15,1,8
E33016792,276,188,58,130,4,57,49,8,27,22,2,3,0,0
E33016793,321,262,65,197,0,23,11,12,36,27,2,7,0,0
E33016794,393,324,104,220,1,21,18,3,45,40,1,4,0,2
E33016795,403,319,64,255,3,27,23,4,49,47,0,2,0,5
E33016796,436,349,104,245,2,35,32,3,47,39,1,5,2,3
E33016797,418,361,101,260,1,8,8,0,43,40,0,1,2,5
E33016798,249,206,54,152,0,11,7,4,26,16,4,5,1,6
E33016799,299,243,63,180,1,6,4,2,44,39,1,4,0,5
E33016800,283,226,78,148,0,14,9,5,39,24,9,6,0,4
E33016801,440,307,85,222,3,36,21,15,88,73,7,4,4,6
E33016802,248,189,54,135,2,12,11,1,40,33,0,6,1,5
E33016803,305,234,85,149,0,14,12,2,52,48,1,3,0,5
E33016804,375,260,77,183,3,23,14,9,82,58,10,9,5,7
E33016805,361,285,93,192,0,17,16,1,57,49,4,4,0,2
E33016806,508,386,112,274,10,37,27,10,72,61,2,8,1,3
E33016807,245,190,65,125,2,18,13,5,35,34,0,1,0,0
E33016808,573,378,108,270,4,46,38,8,136,127,4,1,4,9
E33016809,428,318,95,223,4,32,27,5,65,49,5,11,0,9
E33016810,1002,769,180,589,11,49,37,12,164,144,5,14,1,9
E33016811,401,304,86,218,3,24,19,5,68,62,0,6,0,2
E33016812,451,362,98,264,3,21,11,10,60,53,4,2,1,5
E33016813,282,216,61,155,0,21,16,5,44,37,3,3,1,1
E33016814,268,228,70,158,4,13,10,3,23,21,1,0,1,0
E33016815,290,217,69,148,1,17,13,4,52,44,3,2,3,3
E33016816,3750,2684,460,2224,20,146,63,83,888,343,366,22,157,12
E33016817,834,578,164,414,4,83,55,28,157,130,10,12,5,12
E33016818,360,293,95,198,1,30,21,9,33,32,0,1,0,3
E33016819,300,240,82,158,0,11,7,4,45,36,5,4,0,4
E33016820,270,197,67,130,0,34,27,7,34,29,3,0,2,5
E33016821,534,420,134,286,4,42,28,14,64,57,3,3,1,4
E33016822,258,200,72,128,4,14,12,2,36,32,3,0,1,4
E33016823,205,151,47,104,2,13,12,1,38,33,1,2,2,1
E33016824,261,194,68,126,0,19,15,4,40,33,2,4,1,8
E33016825,601,465,134,331,4,45,32,13,82,65,3,13,1,5
E33016826,251,197,58,139,2,9,9,0,31,27,0,1,3,12
E33016827,439,326,110,216,3,30,16,14,70,62,3,2,3,10
E33016828,355,274,90,184,2,27,26,1,46,32,3,8,3,6
E33016829,349,214,74,140,5,38,32,6,88,76,8,3,1,4
E33016830,237,184,81,103,2,15,13,2,20,15,3,2,0,16
E33016831,436,337,118,219,1,38,32,6,57,46,0,8,3,3
E33016832,466,327,132,195,1,34,31,3,74,63,5,6,0,30
E33016833,558,431,133,298,4,62,56,6,57,50,2,3,2,4
E33016834,1112,708,151,557,7,54,34,20,325,130,141,9,45,18
E33016835,313,252,69,183,0,15,9,6,39,33,1,2,3,7
E33016836,431,324,87,237,0,39,32,7,65,57,3,1,4,3
E33016837,778,490,149,341,3,60,51,9,222,195,13,12,2,3
E33016838,263,177,46,131,2,35,31,4,37,31,3,2,1,12
E33016839,477,345,121,224,4,19,11,8,86,68,3,5,10,23
E33016840,289,214,52,162,0,23,15,8,47,40,2,5,0,5
E33016841,304,223,72,151,4,43,33,10,33,26,2,2,3,1
E33016842,458,325,95,230,4,44,29,15,83,78,0,3,2,2
E33016843,299,204,54,150,2,24,14,10,65,60,0,5,0,4
E33016844,562,413,93,320,5,68,56,12,70,61,3,6,0,6
E33016845,251,181,38,143,0,20,12,8,46,40,1,4,1,4
E33016846,404,318,79,239,2,14,9,5,65,59,2,2,2,5
E33016847,345,282,77,205,0,14,6,8,46,41,1,4,0,3
E33016848,347,283,58,225,7,16,8,8,41,40,0,1,0,0
E33016849,352,237,75,162,2,43,25,18,69,60,1,5,3,1
E33016850,578,433,138,295,0,42,31,11,99,85,8,4,2,4
E33016851,427,341,72,269,1,32,20,12,41,31,5,4,1,12
E33016852,387,296,83,213,2,24,20,4,61,58,0,2,1,4
E33016853,277,192,67,125,1,16,13,3,60,50,4,2,4,8
E33016854,261,140,40,100,1,8,7,1,101,91,3,3,4,11
E33016855,270,197,72,125,0,23,19,4,47,38,2,4,3,3
E33016856,241,184,79,105,1,23,17,6,31,28,1,2,0,2
E33016857,286,211,65,146,2,39,32,7,31,28,0,3,0,3
E33016858,338,262,81,181,2,25,19,6,49,43,1,5,0,0
E33016859,256,219,81,138,3,17,14,3,17,15,0,2,0,0
E33016860,372,280,111,169,1,21,19,2,64,51,6,4,3,6
E33016861,292,258,124,134,1,14,12,2,18,15,1,2,0,1
E33016862,447,358,122,236,5,30,18,12,51,49,1,1,0,3
E33016863,222,164,49,115,1,23,12,11,34,29,4,1,0,0
E33016864,236,162,60,102,0,27,23,4,46,32,8,2,4,1
E33016865,326,278,85,193,0,22,20,2,21,18,0,3,0,5
E33016866,276,222,95,127,3,16,12,4,32,27,1,4,0,3
E33016867,1947,1005,221,784,29,128,75,53,764,725,15,10,14,21
E33016868,347,275,95,180,3,26,17,9,41,37,0,2,2,2
E33016869,257,199,59,140,1,22,18,4,35,28,3,3,1,0
E33016870,331,264,77,187,1,23,18,5,39,35,2,1,1,4
E33016871,492,396,135,261,3,37,21,16,51,46,3,0,2,5
E33016872,491,382,128,254,4,35,29,6,62,51,4,6,1,8
E33016873,299,239,85,154,1,19,12,7,39,33,2,2,2,1
E33016874,369,306,104,202,2,38,34,4,21,14,5,2,0,2
E33016875,474,289,123,166,3,37,22,15,138,131,4,3,0,7
E33016876,552,324,124,200,3,35,29,6,177,125,42,8,2,13
E33016877,428,284,101,183,3,39,27,12,100,97,0,3,0,2
E33016878,237,164,53,111,2,31,30,1,37,30,3,4,0,3
E33016879,260,135,33,102,0,4,1,3,120,50,68,2,0,1
E33016880,394,331,119,212,3,20,17,3,33,29,0,4,0,7
E33016881,480,370,124,246,8,25,20,5,73,63,5,4,1,4
E33016882,283,221,84,137,1,21,15,6,34,27,1,3,3,6
E33016883,732,458,130,328,12,49,35,14,207,183,12,9,3,6
E33016884,595,433,147,286,7,52,33,19,102,92,1,9,0,1
E33016885,289,237,68,169,4,11,2,9,35,30,0,4,1,2
E33016886,322,243,63,180,3,19,16,3,55,52,0,3,0,2
E33016887,2962,1729,369,1360,36,253,160,93,928,877,15,33,3,16
E33016888,275,204,53,151,2,6,5,1,61,54,2,5,0,2
E33016889,664,543,178,365,6,38,26,12,74,69,1,3,1,3
E33016890,766,511,145,366,9,68,43,25,171,151,2,13,5,7
E33016891,480,268,84,184,5,16,9,7,188,182,3,2,1,3
E33016892,435,252,80,172,2,70,53,17,104,87,6,6,5,7
E33016893,397,277,79,198,3,36,25,11,72,64,1,5,2,9
E33016894,332,228,87,141,0,17,14,3,81,74,2,2,3,6
E33016895,277,221,79,142,2,26,15,11,26,26,0,0,0,2
E33016896,314,237,90,147,1,34,24,10,40,33,1,4,2,2
E33016897,329,246,103,143,1,39,27,12,39,35,3,1,0,4
E33016898,305,225,66,159,0,25,14,11,52,50,0,1,1,3
E33016899,395,275,85,190,1,43,33,10,69,59,4,6,0,7
E33016900,267,176,68,108,3,24,16,8,60,51,0,1,8,4
E33016901,245,183,58,125,1,26,20,6,35,30,0,5,0,0
E33016902,1204,887,230,657,12,89,53,36,202,185,5,11,1,14
E33016903,247,200,75,125,4,21,14,7,20,18,0,1,1,2
E33016904,300,237,78,159,3,16,12,4,42,36,0,4,2,2
E33016905,253,184,53,131,3,13,4,9,51,46,0,5,0,2
E33016906,287,194,67,127,10,21,10,11,60,55,0,4,1,2
E33016907,260,185,65,120,3,17,11,6,54,50,0,4,0,1
E33016908,493,389,137,252,9,25,17,8,65,55,7,3,0,5
E33016909,304,235,100,135,1,19,18,1,45,41,2,1,1,4
E33016910,280,206,91,115,1,20,18,2,48,37,8,3,0,5
E33016911,899,565,175,390,9,76,47,29,244,228,5,8,3,5
E33016912,312,260,111,149,2,19,16,3,26,23,1,2,0,5
E33016913,294,261,113,148,1,12,10,2,17,13,2,1,1,3
E33016914,357,294,94,200,4,18,11,7,39,33,0,5,1,2
E33016915,520,412,146,266,1,45,37,8,57,47,0,10,0,5
E33016916,324,271,116,155,3,25,19,6,24,24,0,0,0,1
E33016917,239,191,56,135,2,13,12,1,32,27,0,3,2,1
E33016918,343,311,90,221,1,10,8,2,20,20,0,0,0,1
E33016919,250,201,58,143,1,17,11,6,30,26,1,2,1,1
E33016920,784,547,163,384,7,66,54,12,154,144,2,7,1,10
E33016921,292,223,81,142,3,15,12,3,46,30,6,5,5,5
E33016922,440,284,91,193,3,47,32,15,100,89,4,5,2,6
E33016923,311,235,67,168,3,27,19,8,43,40,0,2,1,3
E33016924,564,462,132,330,10,32,25,7,56,46,3,5,2,4
E33016925,497,396,135,261,4,27,24,3,59,51,2,6,0,11
E33016926,239,175,65,110,2,15,8,7,41,37,3,0,1,6
E33016927,322,272,95,177,3,9,5,4,34,32,0,2,0,4
E33016928,333,250,79,171,3,28,16,12,49,47,2,0,0,3
E33016929,359,296,120,176,1,23,18,5,39,37,0,1,1,0
E33016930,476,331,95,236,3,40,30,10,99,88,6,2,3,3
E33016931,275,219,54,165,2,28,26,2,21,20,0,1,0,5
E33016932,535,359,96,263,2,88,81,7,78,65,1,11,1,8
E33016933,441,340,93,247,4,19,17,2,73,66,2,2,3,5
E33016934,1583,1028,262,766,10,141,106,35,394,380,2,11,1,10
E33016935,489,318,81,237,5,109,92,17,56,46,3,5,2,1
E33016936,355,247,69,178,2,36,21,15,66,62,0,3,1,4
E33016937,434,309,83,226,2,54,48,6,68,64,1,3,0,1
E33016938,576,402,76,326,10,63,52,11,100,89,3,8,0,1
E33016939,564,346,81,265,2,70,45,25,139,124,5,6,4,7
E33016940,336,243,56,187,1,30,24,6,59,59,0,0,0,3
E33016941,322,221,64,157,3,20,14,6,76,71,0,5,0,2
E33016942,325,253,59,194,1,25,18,7,43,38,0,5,0,3
E33016943,273,201,62,139,1,25,17,8,44,43,1,0,0,2
E33016944,251,169,53,116,5,16,9,7,54,51,1,0,2,7
E33016945,329,224,57,167,1,26,13,13,73,66,2,3,2,5
E33016946,382,285,94,191,1,36,27,9,56,50,3,2,1,4
E33016947,659,457,148,309,6,53,36,17,137,124,2,6,5,6
E33016948,478,303,87,216,2,52,39,13,117,111,1,3,2,4
E33016949,266,142,47,95,1,38,7,31,56,50,2,3,1,29
E33016950,699,522,148,374,4,46,38,8,123,88,24,1,10,4
E33016951,425,327,79,248,3,22,12,10,68,62,1,5,0,5
E33016952,424,320,124,196,2,20,15,5,65,55,6,0,4,17
E33016953,230,162,72,90,3,14,11,3,32,28,3,0,1,19
E33016954,365,271,87,184,3,20,18,2,49,38,5,1,5,22
E33016955,1246,865,203,662,11,105,81,24,258,240,5,12,1,7
E33016956,373,283,103,180,2,22,16,6,59,43,5,4,7,7
E33016957,421,313,124,189,2,38,34,4,63,53,4,4,2,5
E33016958,232,159,44,115,2,31,26,5,39,35,0,2,2,1
E33016959,456,371,116,255,2,23,17,6,53,40,7,4,2,7
E33016960,360,242,86,156,2,43,28,15,69,58,2,3,6,4
E33016961,726,521,162,359,1,83,53,30,112,104,1,5,2,9
E33016962,356,254,70,184,1,47,25,22,46,38,0,7,1,8
E33016963,231,175,76,99,1,15,11,4,29,23,2,3,1,11
E33016964,248,157,67,90,0,17,10,7,65,64,0,1,0,9
E33016965,337,227,72,155,1,17,10,7,78,74,1,3,0,14
E33016966,349,291,77,214,1,21,17,4,35,28,0,6,1,1
E33016967,290,253,78,175,2,3,2,1,30,26,0,4,0,2
E33016968,699,505,123,382,9,63,50,13,116,105,5,6,0,6
E33016969,370,320,87,233,3,20,18,2,25,21,0,3,1,2
E33016970,382,267,74,193,4,43,27,16,62,55,1,4,2,6
E33016971,440,315,68,247,5,35,26,9,84,79,0,5,0,1
E33016972,279,201,49,152,4,18,9,9,54,50,2,2,0,2
E33016973,365,297,64,233,11,15,11,4,42,36,2,4,0,0
E33016974,666,481,132,349,10,71,48,23,98,90,4,3,1,6
E33016975,271,244,77,167,2,9,6,3,13,11,0,0,2,3
E33016976,213,161,63,98,0,16,11,5,27,26,1,0,0,9
E33016977,613,507,152,355,8,38,27,11,56,45,2,9,0,4
E33016978,306,237,82,155,2,23,19,4,36,29,3,2,2,8
E33016979,262,205,89,116,0,9,3,6,34,28,6,0,0,14
E33016980,417,342,127,215,4,18,12,6,46,38,3,4,1,7
E33016981,249,192,72,120,1,29,17,12,25,24,0,1,0,2
E33016982,315,272,68,204,2,16,10,6,23,20,0,3,0,2
E33016983,317,232,82,150,1,34,13,21,47,45,1,1,0,3
E33016984,615,476,143,333,7,45,23,22,83,71,5,7,0,4
E33016985,267,205,65,140,2,10,4,6,48,34,12,2,0,2
E33016986,677,534,155,379,4,65,30,35,73,67,2,4,0,1
E33016987,331,279,84,195,2,16,9,7,33,32,1,0,0,1
E33016988,363,292,83,209,2,12,5,7,51,43,0,8,0,6
E33016989,362,291,86,205,10,13,11,2,48,45,1,2,0,0
E33016990,561,483,129,354,4,29,19,10,41,34,2,4,1,4
E33016991,306,233,63,170,3,29,23,6,40,37,0,3,0,1
E33016992,405,286,73,213,5,43,27,16,69,66,1,1,1,2
E33016993,354,245,68,177,2,45,39,6,59,53,1,3,2,3
E33016994,580,416,123,293,10,59,40,19,85,77,1,7,0,10
E33016995,342,222,59,163,4,70,63,7,46,39,2,3,2,0
E33016996,525,364,119,245,2,63,51,12,95,87,2,3,3,1
E33016997,227,157,40,117,1,25,18,7,42,40,0,1,1,2
E33016998,252,174,67,107,2,34,21,13,41,37,0,2,2,1
E33016999,292,249,74,175,0,3,2,1,34,31,0,2,1,6
E33017000,931,699,156,543,7,60,34,26,154,146,0,5,3,11
E33017001,305,180,53,127,2,19,15,4,89,77,5,7,0,15
E33017002,322,268,68,200,2,13,11,2,38,36,0,1,1,1
E33017003,672,484,149,335,2,70,31,39,109,103,0,6,0,7
E33017004,361,290,105,185,1,18,6,12,45,43,1,1,0,7
E33017005,305,220,96,124,3,22,7,15,48,42,1,5,0,12
E33017006,377,309,100,209,0,14,5,9,49,43,2,3,1,5
E33017007,638,512,175,337,0,36,6,30,82,71,1,10,0,8
E33017008,264,212,94,118,0,14,6,8,30,26,1,2,1,8
E33017009,279,169,57,112,1,21,7,14,54,46,1,6,1,34
E33017010,416,238,90,148,2,44,18,26,107,90,11,6,0,25
E33017011,255,203,75,128,4,14,2,12,26,20,1,4,1,8
E33017012,342,255,85,170,7,19,6,13,54,45,1,5,3,7
E33017013,315,264,94,170,3,7,2,5,36,30,2,1,3,5
E33017014,478,372,122,250,1,43,14,29,59,54,3,1,1,3
E33017015,315,266,81,185,1,11,3,8,32,25,1,3,3,5
E33017016,615,446,106,340,3,59,24,35,103,97,1,2,3,4
E33017017,254,202,91,111,0,20,2,18,24,24,0,0,0,8
E33017018,282,211,107,104,3,24,9,15,35,28,3,4,0,9
E33017019,250,185,69,116,3,15,3,12,43,39,1,3,0,4
E33017020,759,523,142,381,4,50,16,34,167,154,1,10,2,15
E33017021,313,250,108,142,0,13,4,9,47,42,1,2,2,3
E33017022,267,221,85,136,0,13,3,10,27,21,1,3,2,6
E33017023,263,162,53,109,2,11,4,7,68,60,2,6,0,20
E33017024,386,305,119,186,5,14,9,5,53,42,1,7,3,9
E33017025,676,480,148,332,5,65,18,47,113,103,3,7,0,13
E33017026,474,347,96,251,4,35,14,21,85,75,4,6,0,3
E33017027,520,398,111,287,8,32,9,23,75,66,3,5,1,7
E33017028,424,345,100,245,4,25,8,17,47,41,2,4,0,3
E33017029,357,260,55,205,4,22,10,12,70,64,0,6,0,1
E33017030,304,222,54,168,2,26,8,18,53,48,1,2,2,1
E33017031,290,215,63,152,2,25,9,16,48,42,2,4,0,0
E33017032,340,270,93,177,3,31,5,26,32,31,0,1,0,4
E33017033,268,201,65,136,2,14,7,7,49,45,1,3,0,2
E33017034,232,163,76,87,3,6,0,6,53,46,2,3,2,7
E33017035,300,220,96,124,2,17,2,15,52,44,7,0,1,9
E33017036,449,331,120,211,5,20,8,12,85,59,19,7,0,8
E33017037,555,393,119,274,6,34,15,19,112,97,10,4,1,10
E33017038,426,298,88,210,1,23,10,13,92,86,2,2,2,12
E33017039,256,154,64,90,2,9,3,6,76,60,14,2,0,15
E33017040,292,187,51,136,4,67,21,46,32,26,3,2,1,2
E33017041,709,515,142,373,5,97,34,63,89,80,1,8,0,3
E33017042,315,227,58,169,10,34,10,24,38,33,0,5,0,6
E33017043,242,175,55,120,3,34,10,24,29,23,1,4,1,1
E33017044,294,258,101,157,0,9,0,9,25,18,2,5,0,2
E33017045,324,251,103,148,3,19,10,9,45,29,10,6,0,6
E33017046,301,227,89,138,2,17,11,6,44,39,2,3,0,11
E33017047,266,204,76,128,2,19,2,17,39,34,2,1,2,2
E33017048,251,206,80,126,2,12,4,8,27,21,2,3,1,4
E33017049,280,192,67,125,4,25,6,19,52,44,1,6,1,7
E33017050,592,500,173,327,3,29,11,18,55,47,1,5,2,5
E33017051,575,471,153,318,5,41,13,28,52,47,1,3,1,6
E33017052,413,285,89,196,7,23,9,14,89,71,10,7,1,9
E33017053,492,377,147,230,6,17,10,7,78,67,3,8,0,14
E33017054,557,410,131,279,5,41,22,19,97,91,1,3,2,4
E33017055,481,375,112,263,6,23,14,9,71,60,2,7,2,6
E33017056,384,268,83,185,0,17,9,8,85,70,6,9,0,14
E33017057,345,258,78,180,7,29,9,20,46,41,3,2,0,5
E33017058,549,374,49,325,4,15,3,12,155,59,65,3,28,1
E33017059,304,233,92,141,1,13,8,5,51,46,1,4,0,6
E33017060,255,230,91,139,3,5,3,2,12,11,1,0,0,5
E33017061,245,218,77,141,3,2,1,1,20,18,0,2,0,2
E33017062,258,204,70,134,7,12,6,6,26,20,4,0,2,9
E33017063,359,279,100,179,2,11,8,3,61,55,1,1,4,6
E33017064,1268,1066,212,854,7,39,27,12,152,133,3,11,5,4
E33017065,434,325,131,194,0,30,10,20,69,57,2,7,3,10
E33017066,258,205,57,148,2,14,5,9,32,28,0,4,0,5
E33017067,235,185,63,122,0,18,11,7,31,30,0,0,1,1
E33017068,356,283,93,190,2,23,8,15,46,36,4,6,0,2
E33017069,333,260,87,173,2,28,13,15,37,32,2,1,2,6
E33017070,331,276,101,175,1,14,6,8,36,35,1,0,0,4
E33017071,1024,544,100,444,3,147,111,36,326,315,3,5,3,4
E33017072,291,247,79,168,1,15,8,7,28,24,0,4,0,0
E33017073,432,317,96,221,1,33,25,8,74,61,6,5,2,7
E33017074,497,378,97,281,3,58,47,11,54,53,0,1,0,4
E33017075,254,201,38,163,1,22,19,3,29,24,2,2,1,1
E33017076,309,225,56,169,0,38,37,1,43,39,0,4,0,3
E33017077,376,274,45,229,6,39,29,10,55,52,1,2,0,2
E33017078,429,276,63,213,4,54,46,8,95,85,4,5,1,0
E33017079,493,369,85,284,6,54,32,22,62,59,0,3,0,2
E33017080,356,268,52,216,0,29,24,5,57,55,0,2,0,2
E33017081,839,638,171,467,5,85,64,21,110,102,0,8,0,1
E33017082,254,170,44,126,1,28,24,4,55,54,0,0,1,0
E33017083,219,150,26,124,0,21,15,6,46,43,2,1,0,2
E33017084,1011,597,115,482,5,137,101,36,271,257,2,9,3,1
E33017085,291,227,63,164,1,27,24,3,35,33,0,1,1,1
E33017086,706,544,143,401,2,79,68,11,76,63,2,11,0,5
E33017087,293,222,48,174,4,35,26,9,31,26,0,4,1,1
E33017088,533,415,79,336,1,55,46,9,60,53,1,6,0,2
E33017089,402,277,64,213,4,53,41,12,66,61,0,5,0,2
E33017090,402,290,51,239,3,50,45,5,55,48,2,5,0,4
E33017091,556,434,122,312,1,45,36,9,69,57,2,10,0,7
E33017092,359,246,71,175,0,50,42,8,63,57,0,6,0,0
E33017093,315,219,45,174,1,46,44,2,47,41,0,4,2,2
E33017094,406,266,61,205,7,73,64,9,58,54,0,3,1,2
E33017095,333,253,92,161,4,21,4,17,48,45,3,0,0,7
E33017096,347,258,95,163,3,26,8,18,52,43,3,4,2,8
E33017097,266,202,63,139,0,22,13,9,38,30,3,3,2,4
E33017098,271,178,64,114,0,20,6,14,67,59,2,4,2,6
E33017099,266,226,77,149,1,14,3,11,20,19,0,1,0,5
E33017100,338,262,99,163,4,24,12,12,44,40,3,1,0,4
E33017101,329,241,66,175,2,22,8,14,51,39,4,2,6,13
E33017102,438,366,96,270,2,12,5,7,54,48,1,5,0,4
E33017103,334,289,82,207,0,21,11,10,22,20,1,0,1,2
E33017104,409,296,88,208,1,31,13,18,61,55,0,5,1,20
E33017105,385,293,97,196,1,33,14,19,50,48,1,0,1,8
E33017106,403,335,104,231,1,25,9,16,34,31,1,2,0,8
E33017107,463,353,109,244,9,38,10,28,58,47,4,0,7,5
E33017108,1314,985,229,756,31,102,39,63,191,165,1,23,2,5
E33017109,1034,748,180,568,17,99,46,53,158,148,0,8,2,12
E33017110,255,214,69,145,1,19,5,14,17,17,0,0,0,4
E33017111,260,208,65,143,2,18,3,15,26,22,0,4,0,6
E33017112,397,301,99,202,3,24,10,14,61,50,4,5,2,8
E33017113,576,350,87,263,9,51,21,30,162,153,4,5,0,4
E33017114,480,387,104,283,2,28,13,15,56,50,1,5,0,7
E33017115,480,383,109,274,3,30,10,20,59,49,3,7,0,5
E33017116,289,250,91,159,1,9,3,6,26,24,1,1,0,3
E33017117,496,392,121,271,2,36,12,24,63,58,0,3,2,3
E33017118,270,177,63,114,1,17,7,10,65,58,4,1,2,10
E33017119,312,235,70,165,2,19,10,9,52,42,4,4,2,4
E33017120,388,285,82,203,3,29,23,6,63,60,1,2,0,8
E33017121,308,242,77,165,2,18,12,6,42,40,0,2,0,4
E33017122,327,246,73,173,2,29,12,17,45,36,4,5,0,5
E33017123,359,278,88,190,3,34,17,17,41,31,2,6,2,3
E33017124,390,306,106,200,4,32,20,12,48,43,0,5,0,0
E33017125,265,202,75,127,2,24,12,12,30,26,0,4,0,7
E33017126,342,250,55,195,4,45,7,38,42,38,0,4,0,1
E33017127,317,227,35,192,6,25,5,20,56,54,0,2,0,3
E33017128,361,259,59,200,4,41,7,34,55,50,0,5,0,2
E33017129,422,341,85,256,6,29,11,18,45,38,1,6,0,1
E33017130,318,231,59,172,4,35,11,24,46,43,0,3,0,2
E33017131,276,205,57,148,3,28,9,19,36,33,1,2,0,4
E33017132,225,142,44,98,2,33,9,24,46,43,2,1,0,2
E33017133,711,507,140,367,9,92,34,58,100,93,2,5,0,3
E33017134,384,263,70,193,1,69,32,37,51,50,0,1,0,0
E33017135,410,298,53,245,4,36,20,16,71,68,0,1,2,1
E33017136,516,364,104,260,8,77,19,58,64,54,0,7,3,3
E33017137,1975,1452,353,1099,32,195,77,118,289,274,2,13,0,7
E33017138,667,440,121,319,13,77,17,60,135,116,0,9,10,2
E33017139,380,257,63,194,5,73,36,37,44,41,0,3,0,1
E33017140,408,290,73,217,7,54,25,29,54,44,0,7,3,3
E33017141,792,511,137,374,6,108,48,60,161,152,0,6,3,6
E33017142,319,242,112,130,2,19,3,16,53,51,0,2,0,3
E33017143,256,197,61,136,0,19,5,14,36,33,0,2,1,4
E33017144,384,302,98,204,3,24,8,16,48,44,0,4,0,7
E33017145,279,229,66,163,0,18,9,9,31,28,0,3,0,1
E33017146,379,270,78,192,0,46,21,25,57,53,0,3,1,6
E33017147,310,219,66,153,5,23,9,14,60,56,1,3,0,3
E33017148,381,260,84,176,4,33,11,22,83,71,8,4,0,1
E33017149,237,182,79,103,0,22,6,16,29,23,1,5,0,4
E33017150,391,294,123,171,3,41,10,31,49,46,0,3,0,4
E33017151,294,242,71,171,1,22,8,14,27,22,0,2,3,2
E33017152,310,224,76,148,2,30,13,17,48,44,1,3,0,6
E33017153,354,283,76,207,0,17,5,12,53,53,0,0,0,1
E33017154,379,279,97,182,12,23,2,21,59,55,3,1,0,6
E33017155,419,291,102,189,6,66,17,49,49,37,3,7,2,7
E33017156,443,312,106,206,4,52,12,40,71,68,1,1,1,4
E33017157,262,164,59,105,0,13,8,5,68,60,4,2,2,17
E33017158,337,237,71,166,3,29,7,22,62,50,4,5,3,6
E33017159,254,183,90,93,0,17,4,13,44,38,2,4,0,10
E33017160,677,467,160,307,5,65,19,46,132,99,24,6,3,8
E33017161,655,481,109,372,5,58,17,41,99,90,6,3,0,12
E33017162,184,121,50,71,2,9,0,9,43,35,3,4,1,9
E33017163,341,238,96,142,3,41,14,27,54,40,7,7,0,5
E33017164,698,553,140,413,8,51,20,31,79,74,0,5,0,7
E33017165,282,197,74,123,5,17,2,15,49,46,2,1,0,14
E33017166,312,258,97,161,1,10,1,9,38,37,1,0,0,5
E33017167,274,167,68,99,5,26,7,19,65,62,0,3,0,11
E33017168,277,223,64,159,1,22,9,13,30,25,1,2,2,1
E33017169,233,160,61,99,6,24,8,16,37,34,3,0,0,6
E33017170,276,197,79,118,1,15,1,14,48,44,2,2,0,15
E33017171,624,462,145,317,6,54,12,42,95,88,0,7,0,7
E33017172,526,409,108,301,4,37,13,24,73,68,0,3,2,3
E33017173,324,244,58,186,3,30,9,21,47,41,1,3,2,0
E33017174,241,162,57,105,5,15,5,10,47,39,1,5,2,12
E33017175,297,229,63,166,0,20,6,14,43,40,0,1,2,5
E33017176,415,362,101,261,0,7,3,4,46,44,1,1,0,0
E33017177,317,249,61,188,2,15,4,11,50,48,0,1,1,1
E33017178,376,286,77,209,3,35,15,20,50,48,0,2,0,2
E33017179,343,273,67,206,1,41,11,30,28,24,2,1,1,0
E33017180,316,270,91,179,0,18,4,14,25,20,0,3,2,3
E33017181,370,278,85,193,3,40,15,25,45,39,1,5,0,4
E33017182,269,217,68,149,1,21,3,18,30,29,0,1,0,0
E33017183,364,293,86,207,0,25,7,18,44,36,2,5,1,2
E33017184,288,247,69,178,0,9,2,7,31,28,0,3,0,1
E33017185,548,359,70,289,4,57,18,39,128,118,0,9,1,0
E33017186,290,229,50,179,3,21,4,17,31,28,1,2,0,6
E33017187,507,373,118,255,1,60,12,48,68,62,0,6,0,5
E33017188,318,229,62,167,0,47,9,38,42,40,0,2,0,0
E33017189,369,288,79,209,3,30,3,27,47,38,3,6,0,1
E33017190,269,224,40,184,0,14,4,10,31,29,0,2,0,0
E33017191,429,319,101,218,1,55,13,42,53,48,1,4,0,1
E33017192,534,348,96,252,4,40,9,31,140,132,0,8,0,2
E33017193,341,269,55,214,5,29,8,21,37,34,0,3,0,1
E33017194,448,342,82,260,6,42,8,34,57,49,5,3,0,1
E33017195,573,413,117,296,5,66,19,47,86,74,1,11,0,3
E33017196,666,534,144,390,1,49,9,40,79,70,5,4,0,3
E33017197,689,537,142,395,6,57,15,42,81,72,6,3,0,8
E33017198,287,208,53,155,1,19,4,15,52,43,4,2,3,7
E33017199,321,245,53,192,0,22,7,15,50,47,0,3,0,4
E33017200,462,385,52,333,2,16,4,12,56,52,0,4,0,3
E33017201,291,202,67,135,1,63,13,50,24,21,0,3,0,1
E33017202,885,633,167,466,6,83,31,52,155,141,1,8,5,8
E33017203,276,214,45,169,2,8,5,3,52,51,0,1,0,0
E33017204,383,297,86,211,3,38,7,31,43,40,0,3,0,2
E33017205,1304,1040,286,754,11,78,20,58,169,153,0,15,1,6
E33017206,368,292,76,216,2,44,7,37,28,25,2,1,0,2
E33017207,379,288,46,242,1,42,10,32,42,38,0,4,0,6
E33017208,317,235,54,181,1,20,4,16,57,52,1,4,0,4
E33017209,254,171,48,123,5,32,5,27,43,37,0,5,1,3
E33017210,294,217,75,142,4,36,9,27,34,28,0,6,0,3
E33017211,286,212,66,146,2,28,2,26,41,36,0,5,0,3
E33017212,354,266,72,194,4,44,7,37,40,35,0,4,1,0
E33017213,378,285,79,206,2,39,8,31,50,46,1,3,0,2
E33017214,341,290,44,246,1,7,3,4,42,37,2,3,0,1
E33017215,381,299,77,222,2,23,9,14,53,50,0,2,1,4
E33017216,754,658,210,448,3,21,7,14,65,56,2,5,2,7
E33017217,303,214,68,146,1,20,12,8,63,61,0,2,0,5
E33017218,243,181,65,116,1,11,10,1,39,36,2,1,0,11
E33017219,350,259,93,166,2,24,15,9,61,50,1,10,0,4
E33017220,246,208,67,141,0,11,5,6,25,23,0,2,0,2
E33017221,446,347,79,268,8,41,24,17,49,47,0,2,0,1
E33017222,437,351,88,263,12,24,12,12,47,43,0,3,1,3
E33017223,298,241,81,160,1,19,9,10,33,29,0,4,0,4
E33017224,260,192,63,129,1,29,20,9,35,29,1,5,0,3
E33017225,290,229,63,166,0,17,12,5,43,39,0,4,0,1
E33017226,477,371,91,280,5,39,20,19,61,60,0,1,0,1
E33017227,482,356,105,251,1,44,26,18,77,72,4,1,0,4
E33017228,538,448,109,339,2,23,11,12,61,57,2,2,0,4
E33017229,279,209,59,150,1,16,9,7,53,49,2,2,0,0
E33017230,340,297,82,215,0,18,12,6,25,25,0,0,0,0
E33017231,306,225,63,162,2,27,18,9,49,44,0,5,0,3
E33017232,351,288,66,222,3,12,7,5,48,45,0,3,0,0
E33017233,343,288,77,211,0,13,5,8,42,40,0,1,1,0
E33017234,290,237,74,163,5,10,6,4,37,36,0,1,0,1
E33017235,263,196,55,141,0,22,15,7,45,39,1,4,1,0
E33017236,480,360,101,259,4,33,14,19,81,75,2,3,1,2
E33017237,549,399,87,312,3,80,62,18,63,59,0,4,0,4
E33017238,299,195,42,153,2,52,40,12,49,41,0,7,1,1
E33017239,402,286,59,227,2,51,42,9,62,57,0,5,0,1
E33017240,262,186,54,132,2,24,12,12,43,40,0,3,0,7
E33017241,503,401,122,279,4,31,21,10,62,56,1,5,0,5
E33017242,377,271,97,174,2,35,22,13,68,63,0,5,0,1
E33017243,438,296,98,198,6,48,33,15,82,78,0,4,0,6
E33017244,286,190,49,141,4,27,22,5,64,56,2,6,0,1
E33017245,287,193,44,149,4,27,15,12,60,57,0,3,0,3
E33017246,552,396,113,283,3,46,22,24,105,99,0,4,2,2
E33017247,354,243,58,185,4,33,20,13,71,60,5,6,0,3
E33017248,421,304,87,217,5,45,25,20,62,55,2,5,0,5
E33017249,258,224,63,161,1,10,6,4,23,19,0,4,0,0
E33017250,344,243,73,170,2,37,23,14,59,55,0,4,0,3
E33017251,560,420,83,337,6,48,25,23,84,75,1,8,0,2
E33017252,489,365,88,277,7,33,25,8,79,76,1,2,0,5
E33017253,297,216,54,162,2,35,27,8,43,39,2,2,0,1
E33017254,207,148,30,118,1,24,18,6,31,28,0,3,0,3
E33017255,252,197,36,161,2,10,5,5,33,29,0,4,0,10
E33017256,503,368,83,285,4,37,22,15,89,81,1,7,0,5
E33017257,340,295,72,223,1,6,3,3,37,33,0,4,0,1
E33017258,927,785,237,548,5,35,19,16,100,86,0,6,8,2
E33017259,1020,838,155,683,8,53,26,27,117,106,0,10,1,4
E33017260,401,331,90,241,0,28,25,3,39,35,1,2,1,3
E33017261,1116,895,259,636,4,53,28,25,157,143,1,12,1,7
E33017262,1169,861,211,650,8,117,68,49,179,167,0,12,0,4
E33017263,369,291,76,215,2,19,11,8,55,49,1,4,1,2
E33017264,466,309,55,254,6,56,26,30,93,87,1,5,0,2
E33017265,344,310,91,219,2,5,5,0,25,24,0,1,0,2
E33017266,487,413,115,298,2,30,22,8,40,38,0,0,2,2
E33017267,571,423,123,300,5,30,13,17,110,102,3,2,3,3
E33017268,409,302,72,230,1,39,20,19,64,56,1,7,0,3
E33017269,574,391,95,296,6,27,10,17,144,138,1,5,0,6
E33017270,373,291,70,221,2,13,9,4,62,57,1,3,1,5
E33017271,707,502,136,366,2,70,45,25,128,116,0,11,1,5
E33017272,978,578,114,464,14,81,46,35,299,295,0,4,0,6
E33017273,287,229,63,166,5,14,7,7,36,32,2,2,0,3
E33017274,295,247,51,196,2,13,9,4,31,27,0,4,0,2
E33017275,315,261,103,158,3,15,6,9,32,32,0,0,0,4
E33017276,390,316,43,273,14,14,3,11,45,41,0,4,0,1
E33017277,759,611,175,436,5,34,25,9,105,99,0,6,0,4
E33017278,498,423,111,312,6,21,18,3,46,40,0,6,0,2
E33017279,706,581,130,451,6,37,25,12,79,68,3,8,0,3
E33017280,311,236,48,188,8,14,11,3,49,46,0,3,0,4
E33017281,366,283,81,202,6,16,11,5,59,54,2,3,0,2
E33017282,290,242,76,166,1,20,5,15,24,23,0,1,0,3
E33017283,424,283,87,196,2,58,46,12,69,62,0,7,0,12
E33017284,372,296,91,205,7,18,12,6,48,43,0,5,0,3
E33017285,276,202,48,154,0,21,12,9,53,49,1,3,0,0
E33017286,302,208,51,157,2,40,31,9,51,45,0,6,0,1
E33017287,311,221,40,181,5,31,26,5,52,48,0,4,0,2
E33017288,373,253,63,190,2,56,46,10,60,52,0,3,5,2
E33017289,769,500,114,386,16,127,110,17,122,112,0,6,4,4
E33017290,485,388,96,292,6,25,22,3,62,57,0,4,1,4
E33017291,460,367,81,286,5,29,22,7,53,49,1,2,1,6
E33017292,989,780,199,581,12,76,57,19,117,103,1,12,1,4
E33017293,284,187,47,140,2,30,26,4,63,57,1,4,1,2
E33017294,319,218,51,167,1,62,52,10,37,29,0,6,2,1
E33017295,656,469,144,325,4,57,39,18,123,112,2,7,2,3
E33017296,621,421,117,304,18,70,45,25,109,106,0,3,0,3
E33017297,282,209,54,155,0,26,15,11,42,40,0,1,1,5
E33017298,372,324,106,218,3,8,6,2,36,34,0,1,1,1
E33017299,361,243,67,176,4,50,41,9,61,50,1,10,0,3
E33017300,369,248,79,169,2,33,29,4,83,73,0,6,4,3
E33017301,273,186,33,153,2,50,41,9,35,32,0,3,0,0
E33017302,567,450,114,336,1,44,35,9,69,63,0,4,2,3
E33017303,333,246,61,185,4,42,35,7,41,37,0,4,0,0
E33017304,366,263,48,215,2,47,43,4,47,43,0,4,0,7
E33017305,608,473,132,341,7,36,27,9,91,79,1,8,3,1
E33017306,340,242,52,190,0,59,50,9,38,36,1,1,0,1
E33017307,392,267,66,201,3,16,9,7,102,87,5,10,0,4
E33017308,449,333,83,250,3,23,18,5,87,78,0,6,3,3
E33017309,303,211,43,168,1,43,36,7,46,44,0,2,0,2
E33017310,638,467,139,328,5,82,61,21,80,72,1,6,1,4
E33017311,668,549,148,401,3,18,11,7,92,77,1,12,2,6
E33017312,544,378,100,278,3,43,25,18,117,105,1,7,4,3
E33017313,348,254,68,186,2,23,19,4,67,57,1,7,2,2
E33017314,494,331,92,239,2,34,20,14,122,111,1,5,5,5
E33017315,450,291,79,212,13,50,29,21,92,87,2,1,2,4
E33017316,452,310,64,246,3,48,35,13,90,86,0,4,0,1
E33017317,322,240,53,187,4,22,10,12,54,49,0,5,0,2
E33017318,484,405,81,324,5,19,13,6,48,44,1,3,0,7
E33017319,446,333,63,270,3,26,17,9,84,77,0,6,1,0
E33017320,328,189,36,153,1,101,91,10,35,33,0,2,0,2
E33017321,382,231,62,169,8,65,45,20,74,68,1,5,0,4
E33017322,1028,679,153,526,11,139,93,46,192,180,2,10,0,7
E33017323,297,192,54,138,3,51,40,11,49,46,0,3,0,2
E33017324,726,553,138,415,6,72,45,27,87,78,0,9,0,8
E33017325,337,271,70,201,6,19,15,4,39,31,0,8,0,2
E33017326,334,297,77,220,1,12,8,4,24,24,0,0,0,0
E33017327,235,200,51,149,0,9,6,3,23,20,0,3,0,3
E33017328,368,289,76,213,4,24,13,11,48,43,0,4,1,3
E33017329,403,326,103,223,3,28,22,6,39,33,1,5,0,7
E33017330,418,361,118,243,2,7,4,3,46,44,0,2,0,2
E33017331,284,192,71,121,2,18,10,8,67,58,1,8,0,5
E33017332,322,204,63,141,2,58,38,20,56,53,0,3,0,2
E33017333,347,201,59,142,4,34,12,22,106,95,1,5,5,2
E33017334,1092,732,170,562,11,154,102,52,188,176,0,10,2,7
E33017335,630,336,71,265,14,78,54,24,200,187,0,12,1,2
E33017336,529,310,80,230,5,74,39,35,136,127,0,7,2,4
E33017337,405,227,53,174,16,81,55,26,78,75,0,2,1,3
E33017338,235,161,48,113,3,22,18,4,48,43,1,3,1,1
E33017339,497,371,100,271,2,27,20,7,94,82,1,8,3,3
E33017340,386,286,75,211,4,26,22,4,69,63,4,2,0,1
E33017341,350,239,62,177,2,15,6,9,93,88,0,5,0,1
E33017342,497,345,105,240,4,63,45,18,82,77,1,4,0,3
E33017343,254,194,42,152,2,17,11,6,40,38,0,2,0,1
E33017344,402,252,63,189,3,25,17,8,121,113,0,7,1,1
E33017345,315,198,41,157,4,34,16,18,74,70,2,2,0,5
E33017346,648,486,122,364,5,38,26,12,119,109,0,9,1,0
E33017347,422,242,56,186,10,24,9,15,141,127,5,7,2,5
E33017348,450,283,67,216,8,42,17,25,113,100,0,8,5,4
E33017349,322,196,47,149,7,23,9,14,93,85,2,4,2,3
E33017350,227,131,31,100,2,20,13,7,72,71,0,0,1,2
E33017351,723,488,129,359,5,70,43,27,154,136,3,14,1,6
E33017352,357,248,50,198,7,32,24,8,63,60,0,3,0,7
E33017353,1093,742,190,552,17,109,72,37,212,201,2,7,2,13
E33017354,303,171,43,128,1,33,19,14,97,86,0,10,1,1
E33017355,341,291,89,202,2,16,8,8,29,28,0,1,0,3
E33017356,294,192,51,141,3,22,20,2,75,72,1,2,0,2
E33017357,276,150,41,109,5,25,15,10,88,81,1,6,0,8
E33017358,336,216,60,156,2,52,35,17,65,61,0,4,0,1
E33017359,808,507,109,398,18,77,50,27,202,179,2,18,3,4
E33017360,269,175,50,125,2,27,13,14,65,63,0,1,1,0
E33017361,613,471,155,316,10,42,17,25,90,79,0,9,2,0
E33017362,404,306,79,227,5,37,14,23,53,49,0,3,1,3
E33017363,328,214,45,169,9,56,40,16,46,44,0,1,1,3
E33017364,859,652,116,536,18,50,33,17,137,120,4,13,0,2
E33017365,353,250,61,189,3,40,28,12,57,49,0,5,3,3
E33017366,350,235,43,192,4,54,34,20,55,48,0,7,0,2
E33017367,316,237,55,182,0,37,30,7,41,38,0,3,0,1
E33017368,504,384,73,311,6,53,39,14,60,59,0,1,0,1
E33017369,1569,1000,191,809,14,243,142,101,301,270,0,28,3,11
E33017370,494,394,88,306,9,19,12,7,66,61,3,2,0,6
E33017371,409,302,59,243,7,30,19,11,70,65,1,4,0,0
E33017372,979,719,133,586,6,44,21,23,207,199,0,8,0,3
E33017373,1646,1298,319,979,37,83,47,36,218,190,5,17,6,10
E33017374,227,166,47,119,2,19,15,4,37,32,1,2,2,3
E33017375,365,242,49,193,8,45,28,17,68,66,1,1,0,2
E33017376,1962,1227,258,969,32,226,143,83,471,448,0,20,3,6
E33017377,816,500,155,345,1,97,73,24,210,201,2,4,3,8
E33017378,805,600,127,473,10,37,16,21,156,146,0,10,0,2
E33017379,890,680,141,539,20,74,46,28,112,105,1,6,0,4
E33017380,420,302,70,232,7,26,16,10,83,77,0,5,1,2
E33017381,549,476,111,365,7,6,3,3,56,55,1,0,0,4
E33017382,314,219,27,192,15,23,9,14,55,51,0,4,0,2
E33017383,393,333,72,261,2,6,2,4,50,43,0,7,0,2
E33017384,439,326,73,253,2,32,20,12,77,73,0,3,1,2
E33017385,390,310,70,240,0,6,3,3,73,65,1,7,0,1
E33017386,1491,1238,172,1066,20,47,20,27,181,165,0,14,2,5
E33017387,679,506,98,408,11,52,30,22,104,95,1,7,1,6
E33017388,384,280,78,202,2,25,16,9,74,67,0,7,0,3
E33017389,491,385,51,334,2,20,8,12,81,80,0,1,0,3
E33017390,367,307,49,258,2,28,9,19,30,29,0,1,0,0
E33017391,295,247,55,192,2,11,10,1,29,29,0,0,0,6
E33017392,391,314,80,234,5,32,16,16,38,35,0,3,0,2
E33017393,527,426,120,306,6,32,12,20,53,46,2,3,2,10
E33017394,673,466,140,326,10,79,40,39,111,103,0,2,6,7
E33017395,329,275,99,176,3,20,8,12,30,23,3,2,2,1
E33017396,454,343,108,235,8,36,9,27,61,53,2,5,1,6
E33017397,329,261,84,177,1,24,6,18,39,33,3,1,2,4
E33017398,354,292,110,182,2,25,12,13,28,28,0,0,0,7
E33017399,477,307,81,226,0,32,9,23,127,110,4,4,9,11
E33017400,367,277,89,188,2,27,12,15,50,47,2,1,0,11
E33017401,408,318,91,227,2,30,16,14,49,43,3,1,2,9
E33017402,453,386,96,290,1,20,12,8,42,40,0,2,0,4
E33017403,299,240,69,171,1,21,8,13,33,31,1,0,1,4
E33017404,342,284,73,211,3,24,6,18,29,24,0,5,0,2
E33017405,529,419,66,353,3,24,7,17,77,70,1,6,0,6
E33017406,322,246,74,172,5,19,9,10,45,39,2,3,1,7
E33017407,630,467,66,401,16,38,20,18,104,94,3,7,0,5
E33017408,292,235,64,171,2,24,11,13,28,27,0,1,0,3
E33017409,290,237,66,171,5,11,4,7,32,30,0,2,0,5
E33017410,322,263,81,182,6,14,6,8,35,25,5,2,3,4
E33017411,434,329,79,250,5,28,9,19,69,61,0,7,1,3
E33017412,664,433,66,367,9,55,23,32,166,162,0,4,0,1
E33017413,536,438,139,299,15,32,12,20,48,39,5,4,0,3
E33017414,347,254,81,173,9,39,11,28,44,40,2,2,0,1
E33017415,311,246,57,189,7,21,11,10,35,34,1,0,0,2
E33017416,342,269,107,162,2,20,7,13,42,32,2,7,1,9
E33017417,684,551,160,391,5,38,12,26,83,71,1,6,5,7
E33017418,403,337,118,219,1,17,5,12,41,36,0,2,3,7
E33017419,321,258,104,154,1,32,8,24,26,26,0,0,0,4
E33017420,358,241,71,170,7,40,21,19,65,59,0,6,0,5
E33017421,601,475,135,340,19,26,4,22,76,69,2,5,0,5
E33017422,618,459,119,340,21,52,16,36,81,76,0,5,0,5
E33017423,545,398,127,271,9,79,31,48,53,49,1,2,1,6
E33017424,816,646,177,469,15,38,13,25,104,92,3,5,4,13
E33017425,326,231,58,173,6,26,6,20,57,52,2,2,1,6
E33017426,398,328,106,222,3,17,5,12,45,38,3,0,4,5
E33017427,264,189,61,128,2,22,5,17,47,40,3,3,1,4
E33017428,568,437,119,318,6,35,8,27,84,76,3,5,0,6
E33017429,653,473,140,333,7,60,20,40,108,99,1,6,2,5
E33017430,374,266,82,184,1,41,13,28,61,56,1,4,0,5
E33017431,742,476,141,335,13,65,21,44,181,167,3,8,3,7
E33017432,320,204,67,137,1,18,4,14,66,55,4,4,3,31
E33017433,297,243,80,163,2,13,8,5,36,32,1,2,1,3
E33017434,328,233,94,139,0,28,10,18,55,48,2,2,3,12
E33017435,397,298,103,195,5,39,11,28,53,42,4,6,1,2
E33017436,369,286,66,220,1,14,5,9,66,57,0,7,2,2
E33017437,395,317,136,181,1,18,8,10,45,31,6,6,2,14
E33017438,467,315,91,224,13,26,10,16,109,108,0,1,0,4
E33017439,370,298,85,213,10,15,5,10,43,33,0,3,7,4
E33017440,464,388,112,276,11,22,8,14,37,35,0,2,0,6
E33017441,459,346,94,252,14,36,9,27,60,55,0,4,1,3
E33017442,289,206,51,155,3,20,7,13,57,55,0,1,1,3
E33017443,289,225,84,141,1,11,4,7,36,30,0,0,6,16
E33017444,276,213,46,167,4,29,14,15,30,25,0,5,0,0
E33017445,489,430,90,340,0,12,0,12,46,45,0,1,0,1
E33017446,680,493,140,353,10,75,23,52,98,91,1,6,0,4
E33017447,422,372,102,270,1,14,0,14,33,32,0,0,1,2
E33017448,319,264,56,208,0,22,5,17,32,29,1,1,1,1
E33017449,454,326,89,237,3,42,13,29,78,70,3,4,1,5
E33017450,637,503,109,394,10,43,12,31,72,61,2,9,0,9
E33017451,416,313,75,238,7,42,9,33,51,43,5,3,0,3
E33017452,277,225,92,133,1,13,5,8,32,27,1,3,1,6
E33017453,389,239,66,173,5,42,15,27,80,72,4,2,2,23
E33017454,288,221,67,154,1,26,9,17,32,29,2,1,0,8
E33017455,301,214,62,152,6,12,4,8,65,59,3,1,2,4
E33017456,474,368,122,246,4,29,6,23,60,53,2,5,0,13
E33017457,285,182,56,126,0,24,7,17,50,44,4,0,2,29
E33017458,444,359,108,251,2,29,15,14,50,43,3,4,0,4
E33017459,236,187,53,134,1,15,6,9,22,17,1,3,1,11
E33017460,255,205,62,143,4,19,7,12,27,26,0,1,0,0
E33017461,358,277,92,185,4,33,11,22,41,38,0,2,1,3
E33017462,317,223,61,162,3,42,17,25,47,42,1,4,0,2
E33017463,294,225,54,171,1,32,10,22,33,31,0,2,0,3
E33017464,396,295,65,230,9,33,9,24,56,55,0,1,0,3
E33017465,421,299,88,211,3,72,27,45,44,43,0,1,0,3
E33017466,330,289,79,210,1,7,4,3,33,28,1,4,0,0
E33017467,288,236,83,153,2,14,4,10,32,30,0,2,0,4
E33017468,344,292,82,210,3,12,5,7,35,29,1,4,1,2
E33017469,291,183,56,127,1,23,9,14,81,70,3,8,0,3
E33017470,641,497,93,404,9,39,15,24,93,88,1,3,1,3
E33017471,266,164,55,109,2,25,9,16,72,58,1,12,1,3
E33017472,296,219,58,161,0,20,4,16,53,46,0,7,0,4
E33017473,356,285,72,213,4,23,6,17,40,38,0,2,0,4
E33017474,224,162,34,128,5,36,7,29,20,17,1,2,0,1
E33017475,287,164,28,136,5,75,17,58,41,37,0,4,0,2
E33017476,245,168,56,112,1,36,20,16,38,32,0,5,1,2
E33017477,359,263,70,193,6,41,15,26,48,42,0,5,1,1
E33017478,374,229,65,164,4,53,15,38,85,72,1,9,3,3
E33017479,627,483,125,358,5,61,13,48,77,68,0,5,4,1
E33017480,464,357,94,263,6,39,8,31,58,52,1,5,0,4
E33017481,441,336,91,245,2,51,17,34,51,45,0,6,0,1
E33017482,479,353,91,262,4,75,33,42,45,42,1,2,0,2
E33017483,325,231,41,190,3,44,13,31,45,43,1,1,0,2
E33017484,336,267,55,212,3,18,10,8,44,39,0,5,0,4
E33017485,348,205,59,146,2,57,18,39,83,76,0,7,0,1
E33017486,260,202,60,142,3,15,4,11,38,31,2,3,2,2
E33017487,697,525,146,379,3,47,23,24,117,106,4,6,1,5
E33017488,336,271,98,173,1,27,12,15,31,28,0,1,2,6
E33017489,272,232,72,160,0,14,3,11,26,24,0,2,0,0
E33017490,397,283,86,197,3,37,19,18,69,63,0,5,1,5
E33017491,259,188,68,120,1,23,11,12,36,32,1,3,0,11
E33017492,293,237,55,182,2,19,10,9,35,31,0,4,0,0
E33017493,348,267,77,190,5,20,8,12,52,44,1,5,2,4
E33017494,252,188,49,139,3,12,4,8,47,44,2,1,0,2
E33017495,424,339,83,256,6,21,6,15,54,45,1,6,2,4
E33017496,581,424,109,315,5,54,23,31,91,77,5,8,1,7
E33017497,298,250,84,166,4,8,2,6,30,26,1,3,0,6
E33017498,288,239,65,174,1,10,4,6,33,28,0,4,1,5
E33017499,363,272,92,180,1,32,13,19,53,50,1,2,0,5
E33017500,350,286,90,196,0,19,7,12,41,39,0,2,0,4
E33017501,605,511,138,373,3,30,9,21,58,52,1,5,0,3
E33017502,299,233,53,180,1,29,24,5,35,35,0,0,0,1
E33017503,685,506,185,321,2,70,51,19,99,85,4,7,3,8
E33017504,299,254,106,148,0,16,14,2,24,20,0,4,0,5
E33017505,321,244,79,165,0,21,18,3,49,44,0,5,0,7
E33017506,325,243,66,177,4,35,28,7,42,40,0,2,0,1
E33017507,352,258,72,186,3,37,32,5,51,45,0,4,2,3
E33017508,603,429,143,286,2,67,43,24,101,89,0,12,0,4
E33017509,410,309,88,221,3,52,34,18,42,37,0,5,0,4
E33017510,838,697,232,465,1,63,51,12,73,68,0,5,0,4
E33017511,1010,766,239,527,2,101,68,33,132,115,2,14,1,9
E33017512,470,395,131,264,4,31,25,6,38,35,0,3,0,2
E33017513,406,313,100,213,1,31,21,10,60,57,0,3,0,1
E33017514,297,194,59,135,3,28,19,9,69,59,3,7,0,3
E33017515,1887,1497,401,1096,8,166,115,51,208,182,0,26,0,8
E33017516,298,219,65,154,1,42,33,9,34,29,1,4,0,2
E33017517,481,325,98,227,1,45,34,11,99,84,2,10,3,11
E33017518,572,389,111,278,3,105,92,13,74,62,0,12,0,1
E33017519,228,168,40,128,2,25,21,4,30,24,1,5,0,3
E33017520,695,507,136,371,2,79,59,20,104,92,0,10,2,3
E33017521,370,281,78,203,2,49,37,12,35,29,1,4,1,3
E33017522,408,303,76,227,2,45,33,12,55,46,3,6,0,3
E33017523,502,382,102,280,7,50,39,11,61,55,0,6,0,2
E33017524,491,376,122,254,4,53,45,8,56,50,0,5,1,2
E33017525,285,232,77,155,3,16,13,3,29,26,0,2,1,5
E33017526,716,591,166,425,0,45,35,10,78,68,1,7,2,2
E33017527,620,505,157,348,0,41,33,8,71,67,0,4,0,3
E33017528,792,614,176,438,5,68,47,21,101,89,3,8,1,4
E33017529,518,422,116,306,0,38,27,11,54,52,0,2,0,4
E33017530,529,404,113,291,0,73,60,13,52,47,2,3,0,0
E33017531,752,541,157,384,5,109,78,31,90,83,0,7,0,7
E33017532,404,318,95,223,0,36,23,13,48,38,0,10,0,2
E33017533,263,206,50,156,1,27,23,4,28,22,0,4,2,1
E33017534,687,514,183,331,4,75,62,13,90,81,0,8,1,4
E33017535,267,192,64,128,1,32,24,8,40,38,0,2,0,2
E33017536,514,428,127,301,0,26,19,7,58,54,1,3,0,2
E33017537,650,528,122,406,4,30,24,6,82,77,0,5,0,6
E33017538,294,234,89,145,0,20,18,2,35,31,0,2,2,5
E33017539,347,277,61,216,0,33,23,10,35,32,0,1,2,2
E33017540,321,263,91,172,0,19,17,2,38,32,3,1,2,1
E33017541,300,228,80,148,0,27,15,12,43,34,0,5,4,2
E33017542,306,213,64,149,2,29,23,6,61,60,0,1,0,1
E33017543,383,338,106,232,0,19,18,1,25,20,4,0,1,1
E33017544,258,224,90,134,0,7,6,1,24,18,0,6,0,3
E33017545,447,331,106,225,0,58,48,10,57,50,0,7,0,1
E33017546,493,399,127,272,2,29,23,6,54,46,3,4,1,9
E33017547,374,308,111,197,0,26,20,6,38,33,0,3,2,2
E33017548,349,297,108,189,2,13,9,4,30,24,0,6,0,7
E33017549,406,296,71,225,4,42,36,6,62,56,0,6,0,2
E33017550,506,335,84,251,3,72,59,13,93,88,0,4,1,3
E33017551,296,255,64,191,0,13,9,4,26,23,1,2,0,2
E33017552,569,451,129,322,0,46,32,14,67,64,0,2,1,5
E33017553,309,238,80,158,1,29,20,9,41,38,0,3,0,0
E33017554,290,219,57,162,0,24,18,6,40,38,0,2,0,7
E33017555,253,185,60,125,1,22,13,9,41,36,3,2,0,4
E33017556,572,414,114,300,2,55,42,13,100,90,0,8,2,1
E33017557,384,282,74,208,3,27,18,9,69,62,0,7,0,3
E33017558,419,315,82,233,1,39,26,13,61,54,2,5,0,3
E33017559,373,272,70,202,2,35,26,9,63,55,0,7,1,1
E33017560,691,611,192,419,0,18,9,9,55,50,0,3,2,7
E33017561,354,285,91,194,1,35,24,11,33,29,1,3,0,0
E33017562,279,222,53,169,2,22,17,5,29,25,1,3,0,4
E33017563,571,408,116,292,1,93,77,16,61,54,0,6,1,8
E33017564,328,245,70,175,0,48,41,7,34,33,0,1,0,1
E33017565,409,326,114,212,3,20,15,5,50,44,1,5,0,10
E33017566,349,268,59,209,0,33,25,8,44,37,0,6,1,4
E33017567,557,457,100,357,3,33,20,13,61,54,0,7,0,3
E33017568,330,257,89,168,1,29,22,7,40,32,3,5,0,3
E33017569,390,306,84,222,1,41,33,8,38,32,1,5,0,4
E33017570,329,256,85,171,1,30,25,5,38,33,1,3,1,4
E33017571,512,416,124,292,6,45,25,20,41,32,0,9,0,4
E33017572,372,305,134,171,0,20,11,9,40,30,2,4,4,7
E33017573,474,405,134,271,0,12,7,5,53,47,2,4,0,4
E33017574,369,280,91,189,1,21,10,11,55,51,2,1,1,12
E33017575,1329,1057,353,704,5,74,56,18,180,168,0,9,3,13
E33017576,337,274,94,180,1,31,23,8,28,24,0,3,1,3
E33017577,474,395,109,286,2,25,22,3,51,42,0,8,1,1
E33017578,582,450,175,275,3,42,36,6,79,68,2,5,4,8
E33017579,222,171,61,110,1,17,15,2,27,24,1,1,1,6
E33017580,890,718,227,491,4,37,30,7,101,85,5,8,3,30
E33017581,338,287,121,166,0,18,13,5,32,28,2,2,0,1
E33017582,299,243,81,162,1,13,12,1,39,36,0,3,0,3
E33017583,762,598,187,411,1,78,62,16,83,76,4,3,0,2
E33017584,323,271,104,167,0,25,20,5,26,22,1,1,2,1
E33017585,405,314,110,204,0,32,28,4,49,41,1,7,0,10
E33017586,716,596,200,396,0,42,33,9,66,57,1,8,0,12
E33017587,304,221,53,168,0,27,22,5,52,50,0,2,0,4
E33017588,780,642,197,445,0,30,26,4,102,90,6,5,1,6
E33017589,361,279,89,190,2,39,39,0,39,38,0,1,0,2
E33017590,727,514,153,361,5,72,55,17,128,121,1,6,0,8
E33017591,310,262,61,201,1,8,6,2,36,33,1,2,0,3
E33017592,331,275,57,218,0,15,10,5,37,35,0,2,0,4
E33017593,428,379,130,249,0,11,10,1,36,31,1,4,0,2
E33017594,246,186,50,136,1,19,17,2,34,32,0,1,1,6
E33017595,332,250,40,210,0,26,16,10,54,51,0,3,0,2
E33017596,339,220,68,152,1,62,53,9,56,51,0,4,1,0
E33017597,441,376,129,247,0,18,13,5,43,36,0,6,1,4
E33017598,435,333,105,228,1,51,41,10,48,39,0,7,2,2
E33017599,292,220,69,151,0,27,23,4,41,28,11,2,0,4
E33017600,927,701,215,486,6,85,70,15,127,119,1,7,0,8
E33017601,725,593,170,423,4,43,34,9,82,72,0,8,2,3
E33017602,828,695,171,524,0,53,45,8,78,70,2,5,1,2
E33017603,584,452,141,311,2,52,44,8,71,68,0,3,0,7
E33017604,705,569,163,406,2,51,37,14,81,75,0,4,2,2
E33017605,1026,606,160,446,3,89,49,40,319,307,0,11,1,9
E33017606,244,171,44,127,1,25,19,6,44,39,0,5,0,3
E33017607,441,372,111,261,0,28,20,8,40,34,1,5,0,1
E33017608,534,406,100,306,1,53,47,6,70,62,2,6,0,4
E33017609,355,273,93,180,2,40,37,3,38,31,3,4,0,2
E33017610,685,492,158,334,5,66,46,20,115,106,1,6,2,7
E33017611,498,379,113,266,2,45,36,9,69,65,1,3,0,3
E33017612,582,401,110,291,2,84,68,16,92,79,4,8,1,3
E33017613,240,169,40,129,2,22,16,6,44,42,0,1,1,3
E33017614,332,257,67,190,1,15,11,4,57,51,2,4,0,2
E33017615,413,328,83,245,1,45,38,7,38,35,1,2,0,1
E33017616,276,193,60,133,0,43,36,7,37,28,1,8,0,3
E33017617,430,308,107,201,0,25,18,7,86,74,0,9,3,11
E33017618,279,225,71,154,0,14,12,2,33,26,2,3,2,7
E33017619,412,305,74,231,1,49,43,6,52,46,0,2,4,5
E33017620,524,405,111,294,3,32,26,6,73,68,0,5,0,11
E33017621,931,667,174,493,8,74,61,13,130,104,12,10,4,52
E33017622,3677,2003,555,1448,20,569,442,127,1061,1029,7,19,6,24
E33017623,220,137,52,85,2,22,17,5,52,48,2,0,2,7
E33017624,436,326,101,225,0,36,23,13,67,61,2,3,1,7
E33017625,456,356,92,264,2,22,16,6,66,57,3,3,3,10
E33017626,254,190,69,121,3,17,9,8,36,28,2,6,0,8
E33017627,229,198,82,116,4,7,3,4,20,18,0,2,0,0
E33017628,2152,1750,431,1319,9,110,73,37,273,221,21,24,7,10
E33017629,382,308,95,213,2,23,18,5,43,40,0,1,2,6
E33017630,377,286,105,181,3,17,9,8,62,48,4,7,3,9
E33017631,274,216,76,140,1,25,21,4,30,26,0,4,0,2
E33017632,242,164,73,91,1,16,14,2,56,48,4,4,0,5
E33017633,241,193,86,107,0,15,11,4,26,22,3,1,0,7
E33017634,248,202,82,120,0,12,11,1,29,29,0,0,0,5
E33017635,233,192,75,117,3,16,12,4,19,17,0,2,0,3
E33017636,789,648,176,472,3,40,34,6,93,77,3,12,1,5
E33017637,266,229,64,165,1,15,13,2,21,20,0,1,0,0
E33017638,406,334,131,203,0,31,21,10,36,34,0,2,0,5
E33017639,392,315,122,193,2,29,22,7,44,36,0,8,0,2
E33017640,238,192,57,135,1,20,17,3,25,22,0,3,0,0
E33017641,352,268,89,179,0,34,27,7,50,38,0,11,1,0
E33017642,370,268,89,179,1,51,34,17,49,44,1,4,0,1
E33017643,392,295,78,217,1,33,24,9,61,50,1,10,0,2
E33017644,238,178,68,110,1,19,14,5,40,34,1,3,2,0
E33017645,300,261,82,179,1,11,10,1,20,18,0,2,0,7
E33017646,393,325,114,211,0,19,11,8,42,40,0,2,0,7
E33017647,406,339,100,239,0,29,19,10,37,36,0,1,0,1
E33017648,605,516,151,365,0,20,15,5,64,54,0,8,2,5
E33017649,370,296,92,204,3,36,24,12,30,24,0,5,1,5
E33017650,261,209,55,154,0,24,22,2,27,24,0,3,0,1
E33017651,341,275,93,182,0,23,14,9,39,37,1,1,0,4
E33017652,660,540,131,409,2,35,28,7,82,79,0,1,2,1
E33017653,485,409,131,278,3,21,16,5,49,43,2,4,0,3
E33017654,280,255,118,137,0,2,1,1,21,20,0,0,1,2
E33017655,258,225,82,143,0,10,8,2,22,19,0,3,0,1
E33017656,252,186,74,112,0,22,16,6,29,25,0,2,2,15
E33017657,293,250,83,167,3,13,7,6,24,21,2,1,0,3
E33017658,285,217,64,153,0,16,9,7,48,41,1,6,0,4
E33017659,312,235,69,166,4,39,32,7,33,30,0,2,1,1
E33017660,392,312,73,239,0,30,16,14,49,46,0,3,0,1
E33017661,436,333,97,236,0,37,30,7,53,45,0,8,0,13
E33017662,575,407,129,278,6,47,40,7,109,103,1,5,0,6
E33017663,334,255,87,168,7,29,17,12,43,43,0,0,0,0
E33017664,640,509,132,377,2,40,28,12,87,72,1,10,4,2
E33017665,301,243,75,168,2,22,14,8,33,31,0,2,0,1
E33017666,298,252,76,176,0,16,13,3,29,27,0,2,0,1
E33017667,262,215,61,154,0,20,16,4,26,23,2,1,0,1
E33017668,349,287,76,211,1,20,17,3,38,37,1,0,0,3
E33017669,641,471,135,336,3,50,30,20,112,98,1,9,4,5
E33017670,278,174,34,140,0,38,30,8,65,55,0,10,0,1
E33017671,558,411,116,295,5,39,31,8,100,90,0,9,1,3
E33017672,281,176,43,133,5,16,14,2,83,78,3,2,0,1
E33017673,689,478,149,329,0,56,38,18,151,138,1,10,2,4
E33017674,627,470,129,341,2,57,45,12,93,88,0,2,3,5
E33017675,650,443,113,330,2,63,39,24,139,130,3,5,1,3
E33017676,518,391,145,246,4,27,22,5,89,87,0,2,0,7
E33017677,627,467,156,311,3,55,37,18,97,89,1,7,0,5
E33017678,390,265,78,187,0,36,27,9,88,76,1,10,1,1
E33017679,413,278,73,205,3,45,27,18,81,72,1,8,0,6
E33017680,284,202,49,153,2,11,11,0,69,64,2,3,0,0
E33017681,1101,824,225,599,6,60,42,18,207,204,0,2,1,4
E33017682,354,218,61,157,3,53,32,21,80,76,0,3,1,0
E33017683,284,228,74,154,0,23,17,6,28,23,3,1,1,5
E33017684,1161,763,192,571,4,70,38,32,311,126,115,7,63,13
E33017685,287,194,38,156,0,53,49,4,39,21,12,0,6,1
E33017686,580,454,138,316,2,37,29,8,82,77,2,2,1,5
E33017687,246,191,61,130,1,9,6,3,43,40,0,2,1,2
E33017688,280,206,66,140,1,24,22,2,45,38,1,6,0,4
E33017689,379,258,90,168,1,36,28,8,83,79,1,2,1,1
E33017690,470,381,114,267,1,24,11,13,63,55,4,4,0,1
E33017691,335,293,82,211,2,16,8,8,24,23,0,1,0,0
E33017692,518,427,130,297,2,15,10,5,72,66,3,3,0,2
E33017693,295,235,64,171,3,11,8,3,43,33,3,3,4,3
E33017694,466,372,120,252,4,27,16,11,58,52,0,6,0,5
E33017695,409,318,124,194,1,32,19,13,47,39,0,4,4,11
E33017696,265,236,82,154,3,3,2,1,19,18,0,1,0,4
E33017697,245,198,73,125,0,12,9,3,32,28,0,4,0,3
E33017698,527,401,113,288,1,51,35,16,68,61,1,6,0,6
E33017699,328,294,126,168,0,6,2,4,25,20,3,1,1,3
E33017700,462,345,126,219,2,43,27,16,68,66,0,2,0,4
E33017701,437,340,98,242,3,48,21,27,44,39,2,2,1,2
E33017702,547,374,122,252,2,46,22,24,122,112,3,6,1,3
E33017703,361,304,106,198,3,15,6,9,32,29,1,2,0,7
E33017704,314,237,82,155,3,18,4,14,53,45,1,1,6,3
E33017705,266,222,57,165,2,17,6,11,22,21,0,1,0,3
E33017706,358,297,95,202,2,20,11,9,32,24,1,7,0,7
E33017707,328,249,89,160,2,31,10,21,39,36,0,3,0,7
E33017708,393,282,76,206,0,62,31,31,41,30,0,7,4,8
E33017709,597,431,103,328,3,90,56,34,72,67,0,5,0,1
E33017710,572,440,120,320,5,56,29,27,66,64,0,2,0,5
E33017711,273,210,64,146,1,25,16,9,37,32,0,5,0,0
E33017712,597,478,167,311,4,44,25,19,69,66,0,3,0,2
E33017713,351,272,56,216,3,27,15,12,47,42,2,3,0,2
E33017714,199,150,42,108,3,16,10,6,26,23,0,3,0,4
E33017715,284,185,50,135,1,48,27,21,46,42,0,3,1,4
E33017716,455,329,113,216,1,57,29,28,67,63,0,4,0,1
E33017717,248,193,64,129,0,15,12,3,38,35,0,1,2,2
E33017718,298,223,50,173,3,16,9,7,51,46,0,3,2,5
E33017719,397,334,121,213,0,8,2,6,53,51,0,2,0,2
E33017720,569,436,130,306,4,43,17,26,83,74,1,6,2,3
E33017721,350,288,110,178,3,20,11,9,37,32,0,4,1,2
E33017722,381,315,102,213,1,12,6,6,50,44,4,1,1,3
E33017723,297,254,73,181,1,7,5,2,35,31,0,4,0,0
E33017724,221,168,58,110,0,21,11,10,32,24,5,3,0,0
E33017725,523,428,165,263,5,18,13,5,65,53,1,9,2,7
E33017726,407,338,110,228,2,14,5,9,50,46,0,4,0,3
E33017727,359,273,75,198,1,19,16,3,64,54,3,7,0,2
E33017728,322,276,80,196,3,11,7,4,30,29,0,1,0,2
E33017729,383,283,86,197,1,47,37,10,50,43,0,6,1,2
E33017730,453,383,115,268,1,6,3,3,61,53,3,4,1,2
E33017731,323,260,68,192,1,15,7,8,45,37,0,8,0,2
E33017732,283,250,86,164,0,10,5,5,20,17,0,2,1,3
E33017733,341,275,83,192,1,10,8,2,53,47,3,2,1,2
E33017734,342,297,92,205,4,10,7,3,29,27,2,0,0,2
E33017735,506,389,137,252,4,40,26,14,71,64,1,6,0,2
E33017736,404,339,101,238,3,21,5,16,37,29,0,8,0,4
E33017737,384,321,95,226,0,16,8,8,45,37,2,5,1,2
E33017738,397,302,82,220,5,40,27,13,47,43,1,3,0,3
E33017739,402,304,80,224,1,27,12,15,60,54,0,3,3,10
E33017740,330,221,54,167,0,50,30,20,58,53,0,4,1,1
E33017741,316,261,75,186,0,15,8,7,38,35,1,1,1,2
E33017742,315,268,76,192,2,20,10,10,21,16,1,2,2,4
E33017743,398,299,81,218,1,28,14,14,70,66,0,2,2,0
E33017744,252,187,53,134,3,27,9,18,31,30,0,1,0,4
E33017745,333,271,75,196,0,17,7,10,44,40,0,4,0,1
E33017746,747,559,174,385,5,48,27,21,130,117,2,11,0,5
E33017747,488,356,113,243,1,43,23,20,86,80,0,6,0,2
E33017748,344,260,77,183,2,25,11,14,54,48,0,6,0,3
E33017749,341,235,52,183,6,24,10,14,74,70,0,4,0,2
E33017750,299,217,56,161,0,27,16,11,53,48,0,5,0,2
E33017751,361,266,88,178,4,33,17,16,55,50,2,3,0,3
E33017752,381,299,85,214,9,27,15,12,44,35,1,6,2,2
E33017753,286,240,76,164,3,7,4,3,34,30,0,3,1,2
E33017754,526,350,91,259,2,53,37,16,119,112,2,4,1,2
E33017755,601,411,106,305,1,62,28,34,124,116,0,8,0,3
E33017756,422,345,114,231,5,27,13,14,44,36,1,7,0,1
E33017757,265,219,67,152,0,12,3,9,31,30,0,1,0,3
E33017758,533,401,123,278,5,50,28,22,71,66,0,5,0,6
E33017759,309,232,66,166,2,32,26,6,39,37,0,2,0,4
E33017760,392,303,96,207,0,37,26,11,46,41,1,0,4,6
E33017761,380,287,104,183,1,28,20,8,58,54,0,4,0,6
E33017762,330,278,84,194,0,26,19,7,25,22,0,3,0,1
E33017763,303,260,76,184,2,13,10,3,24,19,0,3,2,4
E33017764,414,347,92,255,1,21,15,6,39,37,0,2,0,6
E33017765,299,217,69,148,3,46,43,3,31,27,0,4,0,2
E33017766,379,274,73,201,0,35,26,9,63,57,0,5,1,7
E33017767,266,210,66,144,2,24,18,6,24,22,0,2,0,6
E33017768,239,161,41,120,1,37,22,15,36,30,0,6,0,4
E33017769,462,387,108,279,0,13,11,2,60,53,0,7,0,2
E33017770,494,430,149,281,0,19,14,5,42,38,0,4,0,3
E33017771,290,222,72,150,0,26,17,9,42,39,0,3,0,0
E33017772,420,341,96,245,1,27,24,3,49,46,2,1,0,2
E33017773,395,308,106,202,2,38,26,12,43,35,0,6,2,4
E33017774,253,177,43,134,0,25,19,6,50,42,0,7,1,1
E33017775,473,359,108,251,3,61,54,7,49,39,4,6,0,1
E33017776,832,659,215,444,2,70,55,15,97,89,0,5,3,4
E33017777,932,740,237,503,4,75,51,24,109,99,0,10,0,4
E33017778,340,296,71,225,0,13,8,5,31,27,0,4,0,0
E33017779,394,328,78,250,1,37,15,22,27,25,0,2,0,1
E33017780,367,305,104,201,0,19,10,9,38,35,0,3,0,5
E33017781,294,181,47,134,1,36,20,16,75,70,1,3,1,1
E33017782,549,383,113,270,0,57,46,11,104,91,1,12,0,5
E33017783,868,707,221,486,4,56,42,14,98,79,2,16,1,3
E33017784,525,400,125,275,1,37,29,8,85,79,1,5,0,2
E33017785,447,338,87,251,3,31,22,9,70,64,1,5,0,5
E33017786,577,457,145,312,0,31,24,7,86,78,0,8,0,3
E33017787,367,243,63,180,0,42,30,12,78,66,0,10,2,4
E33017788,783,546,145,401,1,105,73,32,125,113,3,8,1,6
E33017789,284,201,72,129,1,37,21,16,41,33,0,7,1,4
E33017790,296,209,56,153,0,34,29,5,50,43,0,7,0,3
E33017791,330,255,69,186,0,43,34,9,32,29,0,3,0,0
E33017792,564,407,118,289,0,77,56,21,77,69,1,6,1,3
E33017793,284,213,65,148,0,34,27,7,35,30,1,1,3,2
E33017794,552,428,131,297,1,39,34,5,80,74,0,5,1,4
E33017795,389,315,81,234,2,37,29,8,35,33,0,2,0,0
E33017796,350,263,78,185,1,22,14,8,60,56,0,3,1,4
E33017797,401,355,96,259,0,14,12,2,27,27,0,0,0,5
E33017798,276,233,74,159,0,13,13,0,28,25,0,3,0,2
E33017799,369,303,94,209,0,16,9,7,47,42,1,4,0,3
E33017800,289,203,61,142,0,58,44,14,27,26,0,1,0,1
E33017801,1164,954,241,713,5,86,60,26,114,103,0,10,1,5
E33017802,467,378,103,275,3,32,24,8,53,46,1,6,0,1
E33017803,567,377,101,276,1,117,77,40,71,61,0,6,4,1
E33017804,941,686,218,468,4,103,75,28,144,130,2,11,1,4
E33017805,390,319,117,202,0,19,15,4,44,41,0,3,0,8
E33017806,331,257,34,223,0,4,1,3,69,66,0,3,0,1
E33017807,472,409,133,276,0,27,19,8,33,29,0,4,0,3
E33017808,257,173,50,123,0,17,15,2,65,60,0,5,0,2
E33017809,428,362,119,243,1,22,16,6,42,37,0,5,0,1
E33017810,506,406,133,273,1,57,38,19,39,33,3,2,1,3
E33017811,475,388,101,287,1,40,25,15,43,37,0,6,0,3
E33017812,306,226,57,169,0,35,17,18,44,37,4,2,1,1
E33017813,290,199,65,134,1,60,43,17,28,27,0,1,0,2
E33017814,283,214,75,139,1,34,16,18,31,28,0,3,0,3
E33017815,384,304,96,208,1,24,21,3,47,43,0,4,0,8
E33017816,489,360,103,257,6,47,26,21,75,64,0,10,1,1
E33017817,315,223,60,163,2,31,21,10,56,55,0,0,1,3
E33017818,327,243,98,145,0,38,26,12,40,37,1,2,0,6
E33017819,271,220,82,138,1,14,10,4,34,27,1,5,1,2
E33017820,732,640,232,408,4,25,19,6,61,48,7,6,0,2
E33017821,479,399,100,299,1,21,7,14,54,47,0,6,1,4
E33017822,300,234,58,176,3,18,13,5,44,38,1,5,0,1
E33017823,256,208,79,129,0,18,12,6,26,17,6,3,0,4
E33017824,343,264,109,155,0,20,13,7,54,50,2,2,0,5
E33017825,429,318,109,209,1,42,33,9,61,49,0,10,2,7
E33017826,298,218,62,156,3,26,21,5,45,44,0,1,0,6
E33017827,298,241,97,144,1,7,4,3,38,35,2,1,0,11
E33017828,266,223,67,156,2,11,10,1,27,24,0,1,2,3
E33017829,214,158,64,94,2,3,3,0,51,44,2,3,2,0
E33017830,323,226,87,139,0,14,9,5,76,60,3,4,9,7
E33017831,239,182,67,115,1,10,6,4,40,35,4,1,0,6
E33017832,261,202,82,120,1,20,14,6,25,17,1,7,0,13
E33017833,251,217,96,121,0,12,4,8,20,13,1,6,0,2
E33017834,320,254,113,141,0,9,7,2,55,45,6,4,0,2
E33017835,434,358,150,208,1,22,19,3,52,43,1,5,3,1
E33017836,382,318,107,211,1,19,15,4,43,38,0,4,1,1
E33017837,263,209,73,136,0,15,14,1,37,29,4,4,0,2
E33017838,273,212,88,124,1,37,22,15,23,17,0,3,3,0
E33017839,428,370,137,233,1,15,12,3,40,36,1,3,0,2
E33017840,538,358,117,241,2,64,44,20,105,92,3,9,1,9
E33017841,309,190,61,129,2,48,25,23,62,52,0,9,1,7
E33017842,221,164,70,94,0,10,8,2,45,37,4,1,3,2
E33017843,499,386,126,260,0,31,25,6,72,62,3,7,0,10
E33017844,294,230,70,160,0,27,12,15,32,30,0,2,0,5
E33017845,358,258,76,182,0,48,27,21,50,41,3,6,0,2
E33017846,369,311,92,219,1,19,15,4,37,30,0,5,2,1
E33017847,878,686,212,474,3,84,40,44,102,94,0,6,2,3
E33017848,460,367,103,264,1,29,17,12,60,53,1,6,0,3
E33017849,463,367,108,259,1,32,25,7,62,56,0,5,1,1
E33017850,690,482,129,353,6,86,61,25,111,102,1,7,1,5
E33017851,627,495,129,366,3,37,24,13,87,75,1,6,5,5
E33017852,537,362,86,276,5,58,52,6,111,107,1,3,0,1
E33017853,496,343,110,233,0,40,26,14,110,100,3,5,2,3
E33017854,295,219,70,149,0,15,13,2,59,55,0,4,0,2
E33017855,400,267,68,199,1,50,42,8,80,59,3,18,0,2
E33017856,312,217,62,155,4,20,16,4,70,61,0,6,3,1
E33017857,229,172,63,109,1,18,12,6,36,31,1,4,0,2
E33017858,508,396,151,245,0,32,27,5,76,70,1,3,2,4
E33017859,339,289,113,176,1,12,8,4,31,28,0,3,0,6
E33017860,282,218,76,142,1,10,8,2,52,47,0,4,1,1
E33017861,372,273,114,159,0,17,14,3,76,61,2,9,4,6
E33017862,595,462,176,286,3,34,24,10,89,75,4,7,3,7
E33017863,257,201,48,153,1,7,4,3,46,46,0,0,0,2
E33017864,280,221,75,146,0,18,13,5,38,31,0,5,2,3
E33017865,644,512,116,396,3,37,30,7,88,82,2,4,0,4
E33017866,288,230,64,166,1,11,9,2,44,44,0,0,0,2
E33017867,693,515,158,357,2,80,67,13,94,79,4,8,3,2
E33017868,379,271,74,197,1,62,57,5,39,36,2,1,0,6
E33017869,263,169,41,128,4,57,50,7,31,24,0,7,0,2
E33017870,354,295,93,202,3,16,15,1,36,35,0,1,0,4
E33017871,299,247,62,185,4,18,16,2,24,18,1,3,2,6
E33017872,441,339,112,227,2,27,22,5,69,57,1,9,2,4
E33017873,401,321,96,225,1,27,21,6,50,48,0,2,0,2
E33017874,529,439,139,300,4,29,25,4,54,46,2,6,0,3
E33017875,305,259,75,184,1,11,7,4,27,24,1,2,0,7
E33017876,262,228,88,140,2,7,6,1,24,21,1,2,0,1
E33017877,470,337,54,283,7,23,20,3,100,95,2,2,1,3
E33017878,766,597,175,422,1,60,46,14,104,96,0,6,2,4
E33017879,276,224,68,156,2,5,3,2,43,41,0,1,1,2
E33017880,491,395,114,281,0,41,27,14,53,52,0,1,0,2
E33017881,246,192,59,133,1,20,14,6,28,23,1,2,2,5
E33017882,391,311,96,215,0,22,10,12,52,46,2,4,0,6
E33017883,374,296,110,186,4,19,13,6,53,48,1,3,1,2
E33017884,426,363,141,222,1,18,10,8,40,34,3,3,0,4
E33017885,583,437,96,341,2,35,17,18,105,96,0,9,0,4
E33017886,313,258,97,161,2,10,5,5,39,33,0,5,1,4
E33017887,346,286,112,174,3,16,13,3,38,27,2,6,3,3
E33017888,484,403,159,244,2,21,13,8,51,44,0,7,0,7
E33017889,262,204,71,133,0,12,6,6,33,26,7,0,0,13
E33017890,217,178,75,103,1,16,6,10,22,21,0,0,1,0
E33017891,305,247,89,158,2,26,8,18,26,21,0,1,4,4
E33017892,313,241,99,142,3,19,11,8,47,35,6,4,2,3
E33017893,305,237,88,149,6,27,19,8,29,23,1,5,0,6
E33017894,341,286,108,178,1,13,10,3,36,34,0,2,0,5
E33017895,500,413,121,292,1,27,14,13,55,49,0,5,1,4
E33017896,438,352,80,272,3,17,8,9,60,55,1,2,2,6
E33017897,599,486,134,352,5,27,12,15,79,67,2,3,7,2
E33017898,299,227,63,164,3,47,12,35,19,18,0,0,1,3
E33017899,373,274,70,204,5,29,14,15,63,58,0,3,2,2
E33017900,276,207,76,131,0,19,7,12,43,36,4,3,0,7
E33017901,512,361,115,246,2,30,12,18,118,105,0,10,3,1
E33017902,399,310,111,199,3,45,15,30,38,37,0,1,0,3
E33017903,666,522,156,366,5,55,18,37,80,67,4,9,0,4
E33017904,411,350,105,245,6,17,6,11,38,32,0,6,0,0
E33017905,259,189,56,133,1,16,6,10,51,49,0,2,0,2
E33017906,245,204,62,142,1,8,8,0,32,31,0,1,0,0
E33017907,246,171,46,125,3,29,16,13,41,37,1,3,0,2
E33017908,262,204,65,139,1,12,5,7,44,39,0,5,0,1
E33017909,431,297,105,192,2,38,23,15,86,77,0,6,3,8
E33017910,519,412,115,297,3,31,16,15,73,67,0,3,3,0
E33017911,227,159,53,106,0,19,15,4,47,47,0,0,0,2
E33017912,431,280,95,185,1,33,15,18,114,106,1,7,0,3
E33017913,271,206,50,156,3,13,4,9,47,41,1,5,0,2
E33017914,252,182,50,132,0,9,4,5,57,54,1,2,0,4
E33017915,812,615,179,436,2,77,48,29,113,103,0,9,1,5
E33017916,344,257,77,180,2,15,9,6,68,62,0,6,0,2
E33017917,366,245,71,174,3,21,9,12,95,83,0,12,0,2
E33017918,467,381,92,289,5,35,16,19,44,41,0,2,1,2
E33017919,335,289,114,175,1,4,2,2,37,34,0,1,2,4
E33017920,276,179,68,111,2,29,18,11,65,53,1,6,5,1
E33017921,828,582,168,414,14,112,53,59,117,109,0,8,0,3
E33017922,353,269,90,179,5,16,6,10,60,53,6,1,0,3
E33017923,245,174,50,124,0,13,9,4,56,52,0,4,0,2
E33017924,289,204,50,154,0,27,8,19,57,51,0,5,1,1
E33017925,698,516,140,376,10,39,15,24,132,113,2,16,1,1
E33017926,595,503,177,326,0,24,11,13,64,53,1,10,0,4
E33017927,259,223,62,161,1,8,6,2,23,21,0,2,0,4
E33017928,1165,830,196,634,11,72,49,23,249,220,2,24,3,3
E33017929,523,441,127,314,3,33,19,14,43,42,0,1,0,3
E33017930,265,208,91,117,6,31,13,18,16,15,1,0,0,4
E33017931,232,166,69,97,0,31,17,14,32,31,0,1,0,3
E33017932,283,250,86,164,1,7,2,5,25,23,0,0,2,0
E33017933,590,497,165,332,3,23,16,7,66,57,0,9,0,1
E33017934,261,227,66,161,0,14,10,4,19,18,0,1,0,1
E33017935,337,247,57,190,8,43,16,27,39,35,1,2,1,0
E33017936,392,300,98,202,4,47,21,26,40,37,0,2,1,1
E33017937,266,216,90,126,2,15,8,7,27,20,0,3,4,6
E33017938,304,233,112,121,5,11,9,2,53,42,5,6,0,2
E33017939,495,371,119,252,8,33,21,12,79,75,1,1,2,4
E33017940,363,261,72,189,5,37,17,20,52,49,1,1,1,8
E33017941,619,448,161,287,3,37,22,15,118,107,0,5,6,13
E33017942,356,292,83,209,2,23,15,8,37,33,0,2,2,2
E33017943,393,306,91,215,2,27,15,12,56,51,1,2,2,2
E33017944,269,197,48,149,5,27,17,10,40,37,0,3,0,0
E33017945,585,409,124,285,6,74,43,31,91,83,1,6,1,5
E33017946,502,383,95,288,8,45,33,12,60,54,0,5,1,6
E33017947,537,423,136,287,6,23,11,12,82,75,0,4,3,3
E33017948,778,674,240,434,3,27,14,13,69,69,0,0,0,5
E33017949,344,277,99,178,2,17,8,9,44,38,0,4,2,4
E33017950,356,301,120,181,2,24,8,16,27,26,0,1,0,2
E33017951,368,261,76,185,3,51,21,30,52,44,4,4,0,1
E33017952,585,492,148,344,3,29,10,19,54,49,1,4,0,7
E33017953,381,319,89,230,3,19,6,13,38,35,1,2,0,2
E33017954,303,234,96,138,2,26,12,14,37,35,1,1,0,4
E33017955,255,197,64,133,0,14,8,6,42,33,0,3,6,2
E33017956,544,443,122,321,3,37,17,20,58,53,0,3,2,3
E33017957,342,268,81,187,0,25,18,7,41,34,0,4,3,8
E33017958,403,273,90,183,4,52,35,17,64,60,0,4,0,10
E33017959,294,250,114,136,0,15,7,8,27,24,0,2,1,2
E33017960,264,213,76,137,1,5,2,3,44,41,3,0,0,1
E33017961,301,256,95,161,3,11,5,6,30,30,0,0,0,1
E33017962,325,241,78,163,3,18,12,6,58,54,0,4,0,5
E33017963,637,502,188,314,2,38,23,15,86,72,1,9,4,9
E33017964,364,259,74,185,2,76,64,12,27,26,1,0,0,0
E33017965,333,254,71,183,1,34,28,6,39,32,1,6,0,5
E33017966,335,249,68,181,1,45,40,5,36,33,2,1,0,4
E33017967,225,161,46,115,3,36,33,3,25,21,0,4,0,0
E33017968,381,274,64,210,1,59,56,3,38,34,0,3,1,9
E33017969,408,297,80,217,2,65,57,8,41,35,1,5,0,3
E33017970,407,311,84,227,1,53,43,10,40,38,0,0,2,2
E33017971,442,297,66,231,4,87,77,10,50,45,0,4,1,4
E33017972,490,316,77,239,0,109,92,17,62,59,1,2,0,3
E33017973,443,391,118,273,5,16,9,7,27,22,0,3,2,4
E33017974,303,235,78,157,6,25,13,12,33,28,0,5,0,4
E33017975,256,195,65,130,1,20,11,9,37,35,0,2,0,3
E33017976,277,236,83,153,2,10,8,2,28,20,2,6,0,1
E33017977,340,241,61,180,3,40,26,14,55,51,0,1,3,1
E33017978,283,224,79,145,0,17,12,5,42,38,0,1,3,0
E33017979,538,411,102,309,6,42,27,15,76,70,0,4,2,3
E33017980,509,412,134,278,2,39,19,20,53,50,0,3,0,3
E33017981,579,433,125,308,5,65,44,21,74,68,0,6,0,2
E33017982,431,350,107,243,0,14,11,3,63,58,0,5,0,4
E33017983,368,307,100,207,4,11,8,3,46,39,2,5,0,0
E33017984,453,390,106,284,1,12,4,8,48,43,1,4,0,2
E33017985,710,414,108,306,10,202,141,61,77,69,3,5,0,7
E33017986,395,320,99,221,5,26,16,10,41,38,0,2,1,3
E33017987,766,627,178,449,0,54,31,23,82,74,0,8,0,3
E33017988,738,514,123,391,2,62,44,18,158,152,1,5,0,2
E33017989,305,257,73,184,0,7,6,1,40,39,0,1,0,1
E33017990,269,219,71,148,1,22,12,10,26,25,0,1,0,1
E33017991,398,317,83,234,2,43,24,19,32,26,1,5,0,4
E33017992,797,624,172,452,5,61,35,26,103,93,0,8,2,4
E33017993,720,586,193,393,4,52,23,29,73,67,1,2,3,5
E33017994,281,231,72,159,3,24,11,13,19,19,0,0,0,4
E33017995,545,417,117,300,1,55,23,32,68,61,0,5,2,4
E33017996,967,762,223,539,3,74,48,26,119,113,0,5,1,9
E33017997,379,335,64,271,2,8,2,6,32,31,0,1,0,2
E33017998,643,538,164,374,2,39,18,21,60,53,0,6,1,4
E33017999,759,622,176,446,4,46,19,27,82,74,0,8,0,5
E33018000,423,312,80,232,2,68,59,9,41,36,0,5,0,0
E33018001,363,228,50,178,1,85,75,10,46,42,1,3,0,3
E33018002,340,221,60,161,0,86,68,18,29,24,2,1,2,4
E33018003,504,434,114,320,0,25,17,8,41,35,0,6,0,4
E33018004,697,524,145,379,6,79,58,21,86,81,1,4,0,2
E33018005,326,229,90,139,0,25,17,8,68,61,2,5,0,4
E33018006,305,206,55,151,2,22,10,12,73,66,0,6,1,2
E33018007,2631,1990,603,1387,15,134,68,66,475,447,1,22,5,17
E33018008,7059,5296,1324,3972,46,587,320,267,1101,1001,24,67,9,29
E33018009,489,324,103,221,6,38,19,19,119,108,3,7,1,2
E33018010,339,226,69,157,4,39,17,22,63,58,1,4,0,7
E33018011,289,196,60,136,2,32,13,19,56,51,2,3,0,3
E33018012,251,141,35,106,0,53,21,32,51,49,0,1,1,6
E33018013,240,119,38,81,4,25,9,16,89,87,0,1,1,3
E33018014,476,335,99,236,0,27,14,13,113,105,2,5,1,1
E33018015,508,353,97,256,2,25,13,12,123,115,1,6,1,5
E33018016,604,368,117,251,3,55,30,25,176,171,0,5,0,2
E33018017,548,385,94,291,0,31,19,12,122,109,3,9,1,10
E33018018,309,266,58,208,3,6,2,4,33,29,0,1,3,1
E33018019,320,242,57,185,1,40,36,4,34,31,1,2,0,3
E33018020,573,449,112,337,2,39,29,10,79,71,0,7,1,4
E33018021,348,251,43,208,3,18,16,2,73,69,2,2,0,3
E33018022,330,236,25,211,1,27,7,20,66,65,0,1,0,0
E33018023,533,390,78,312,1,55,33,22,85,77,0,4,4,2
E33018024,301,216,28,188,0,11,6,5,70,59,3,4,4,4
E33018025,434,281,100,181,6,42,12,30,102,95,5,1,1,3
E33018026,372,287,104,183,4,29,12,17,50,45,1,4,0,2
E33018027,490,334,98,236,6,35,19,16,112,103,1,7,1,3
E33018028,592,498,151,347,5,18,7,11,69,64,0,3,2,2
E33018029,327,247,85,162,5,22,13,9,51,45,3,3,0,2
E33018030,938,708,191,517,15,84,34,50,124,114,4,5,1,7
E33018031,280,244,81,163,2,6,5,1,27,22,1,3,1,1
E33018032,276,202,78,124,1,36,16,20,37,36,1,0,0,0
E33018033,578,414,116,298,7,44,18,26,109,100,1,6,2,4
E33018034,572,433,155,278,10,66,51,15,61,51,3,5,2,2
E33018035,340,279,64,215,2,8,5,3,50,42,0,7,1,1
E33018036,322,265,80,185,5,12,7,5,38,34,2,2,0,2
E33018037,270,207,62,145,2,24,21,3,35,32,0,3,0,2
E33018038,577,453,148,305,3,38,30,8,78,61,6,11,0,5
E33018039,259,221,69,152,2,6,5,1,29,28,0,1,0,1
E33018040,302,248,80,168,0,14,10,4,39,34,3,2,0,1
E33018041,637,418,183,235,10,77,36,41,119,104,3,11,1,13
E33018042,599,430,185,245,7,51,33,18,96,84,6,4,2,15
E33018043,276,215,80,135,1,23,18,5,36,30,0,5,1,1
E33018044,266,213,90,123,1,17,14,3,26,24,0,2,0,9
E33018045,254,197,75,122,3,13,8,5,36,34,0,2,0,5
E33018046,457,363,146,217,5,30,27,3,52,43,0,7,2,7
E33018047,569,425,133,292,4,62,42,20,75,68,2,3,2,3
E33018048,641,509,160,349,5,27,24,3,98,89,0,8,1,2
E33018049,436,370,109,261,3,25,21,4,37,32,0,5,0,1
E33018050,230,163,61,102,1,21,12,9,39,33,1,4,1,6
E33018051,226,166,66,100,2,28,22,6,29,26,0,3,0,1
E33018052,345,272,82,190,1,20,17,3,51,46,0,2,3,1
E33018053,323,267,96,171,2,20,14,6,32,28,0,4,0,2
E33018054,452,326,107,219,1,64,52,12,56,48,1,7,0,5
E33018055,312,264,72,192,1,21,18,3,26,25,0,1,0,0
E33018056,632,516,146,370,4,36,26,10,70,65,0,3,2,6
E33018057,232,175,64,111,0,17,14,3,33,28,2,2,1,7
E33018058,545,462,152,310,3,19,15,4,58,50,1,7,0,3
E33018059,500,322,82,240,5,61,41,20,109,100,2,5,2,3
E33018060,609,457,131,326,2,72,54,18,78,73,0,4,1,0
E33018061,1212,883,194,689,9,125,80,45,190,180,1,9,0,5
E33018062,646,312,71,241,2,58,24,34,271,258,2,10,1,3
E33018063,638,410,111,299,6,45,33,12,172,160,0,11,1,5
E33018064,394,255,76,179,1,39,25,14,94,86,0,5,3,5
E33018065,505,290,71,219,3,59,33,26,147,135,1,10,1,6
E33018066,643,377,108,269,4,50,29,21,210,194,2,11,3,2
E33018067,1579,1049,321,728,9,228,148,80,285,275,1,8,1,8
E33018068,404,180,51,129,2,78,50,28,139,130,0,7,2,5
E33018069,267,163,59,104,0,40,34,6,62,55,0,6,1,2
E33018070,514,287,57,230,3,93,75,18,125,119,1,5,0,6
E33018071,690,514,101,413,1,44,30,14,126,114,1,10,1,5
E33018072,242,148,57,91,2,57,45,12,32,26,0,5,1,3
E33018073,359,253,70,183,2,42,32,10,61,58,0,2,1,1
E33018074,2833,1611,344,1267,24,198,126,72,981,925,8,39,9,19
E33018075,2024,1720,483,1237,11,117,87,30,171,159,1,11,0,5
E33018076,535,390,97,293,3,53,42,11,85,74,0,10,1,4
E33018077,422,371,98,273,1,18,14,4,31,28,0,2,1,1
E33018078,276,236,65,171,1,12,6,6,26,23,1,2,0,1
E33018079,295,224,71,153,0,26,13,13,42,39,0,3,0,3
E33018080,347,272,69,203,3,30,20,10,40,39,0,1,0,2
E33018081,304,257,87,170,0,10,5,5,35,33,0,2,0,2
E33018082,361,297,99,198,0,24,18,6,37,31,0,5,1,3
E33018083,259,219,56,163,1,12,8,4,25,16,0,8,1,2
E33018084,316,251,72,179,1,13,7,6,49,46,0,3,0,2
E33018085,420,293,116,177,2,23,15,8,101,93,0,5,3,1
E33018086,856,668,249,419,4,58,34,24,114,111,0,3,0,12
E33018087,517,436,145,291,3,26,16,10,50,44,1,5,0,2
E33018088,428,370,145,225,2,7,5,2,43,41,0,1,1,6
E33018089,384,322,116,206,4,11,5,6,47,42,1,2,2,0
E33018090,289,262,83,179,0,2,0,2,24,22,0,0,2,1
E33018091,541,422,133,289,3,37,22,15,75,70,0,4,1,4
E33018092,312,227,62,165,1,34,13,21,49,45,0,3,1,1
E33018093,304,212,67,145,9,18,9,9,64,54,0,6,4,1
E33018094,333,261,73,188,0,26,16,10,46,39,4,2,1,0
E33018095,407,324,92,232,2,35,24,11,42,39,0,3,0,4
E33018096,646,511,142,369,2,44,30,14,87,76,0,10,1,2
E33018097,253,190,65,125,0,26,17,9,37,35,0,1,1,0
E33018098,277,222,76,146,0,17,12,5,36,33,0,3,0,2
E33018099,256,176,55,121,2,38,26,12,37,31,1,2,3,3
E33018100,654,505,138,367,1,56,26,30,86,79,0,4,3,6
E33018101,316,261,54,207,0,15,11,4,40,38,0,2,0,0
E33018102,735,554,169,385,2,94,72,22,83,79,0,1,3,2
E33018103,324,240,59,181,4,32,20,12,45,41,0,4,0,3
E33018104,703,484,117,367,4,98,68,30,108,104,0,2,2,9
E33018105,413,316,89,227,5,53,37,16,38,31,0,5,2,1
E33018106,495,395,117,278,3,42,30,12,52,46,0,6,0,3
E33018107,228,150,43,107,2,24,18,6,50,46,1,0,3,2
E33018108,522,394,135,259,4,62,52,10,61,60,0,1,0,1
E33018109,179,132,38,94,2,21,10,11,23,23,0,0,0,1
E33018110,488,359,90,269,2,76,43,33,47,41,1,4,1,4
E33018111,473,343,112,231,5,53,34,19,68,64,1,3,0,4
E33018112,623,437,136,301,3,87,49,38,90,81,0,9,0,6
E33018113,481,372,96,276,4,51,26,25,50,45,0,5,0,4
E33018114,2455,1903,546,1357,15,279,177,102,249,231,3,14,1,9
E33018115,821,575,184,391,6,109,62,47,118,108,0,10,0,13
E33018116,363,258,89,169,2,69,50,19,34,29,0,4,1,0
E33018117,383,258,67,191,1,54,34,20,69,60,2,7,0,1
E33018118,256,193,63,130,2,22,12,10,37,35,1,0,1,2
E33018119,452,283,70,213,7,68,43,25,92,88,0,3,1,2
E33018120,465,364,108,256,3,50,29,21,45,45,0,0,0,3
E33018121,649,428,106,322,11,99,57,42,100,97,0,2,1,11
E33018122,667,503,126,377,9,54,28,26,95,86,0,7,2,6
E33018123,314,234,97,137,4,45,24,21,29,23,1,5,0,2
E33018124,508,384,99,285,3,49,26,23,68,62,0,6,0,4
E33018125,470,365,98,267,3,30,19,11,67,63,0,4,0,5
E33018126,261,155,51,104,1,35,29,6,70,68,0,0,2,0
E33018127,356,216,60,156,8,64,45,19,67,60,5,2,0,1
E33018128,368,228,61,167,3,61,37,24,73,70,1,2,0,3
E33018129,771,643,140,503,10,51,24,27,64,59,0,5,0,3
E33018130,791,584,174,410,11,77,40,37,114,106,0,8,0,5
E33018131,935,750,173,577,7,57,34,23,116,108,0,7,1,5
E33018132,333,243,73,170,4,26,14,12,57,54,1,2,0,3
E33018133,739,598,181,417,10,68,41,27,63,58,0,5,0,0
E33018134,198,85,24,61,4,42,24,18,67,63,1,2,1,0
E33018135,308,231,74,157,2,14,12,2,60,54,3,3,0,1
E33018136,740,572,112,460,14,34,20,14,113,102,1,9,1,7
E33018137,251,190,70,120,2,21,15,6,36,35,0,1,0,2
E33018138,415,342,90,252,1,17,8,9,50,45,0,5,0,5
E33018139,1718,1210,355,855,24,157,77,80,317,303,0,11,3,10
E33018140,562,367,103,264,11,52,35,17,129,122,0,7,0,3
E33018141,391,282,82,200,4,34,20,14,71,68,0,2,1,0
E33018142,7601,4965,1559,3406,59,389,216,173,2139,2036,17,72,14,49
E33018143,209,165,62,103,0,17,9,8,25,23,1,1,0,2
E33018144,370,271,66,205,6,36,24,12,54,49,1,2,2,3
E33018145,233,144,37,107,1,40,26,14,48,45,1,2,0,0
E33018146,282,166,50,116,1,40,32,8,73,72,0,1,0,2
E33018147,384,244,66,178,4,72,48,24,63,57,0,6,0,1
E33018148,487,382,117,265,1,45,27,18,56,52,0,4,0,3
E33018149,507,425,109,316,6,31,17,14,45,41,0,4,0,0
E33018150,271,202,57,145,2,13,9,4,52,46,0,6,0,2
E33018151,397,181,64,117,7,59,23,36,147,144,0,3,0,3
E33018152,405,270,76,194,4,62,38,24,69,64,0,4,1,0
E33018153,1018,846,220,626,8,49,30,19,108,100,0,6,2,7
E33018154,370,280,87,193,1,34,22,12,53,50,1,2,0,2
E33018155,345,251,73,178,4,33,23,10,56,49,1,4,2,1
E33018156,315,239,70,169,1,25,20,5,47,41,0,6,0,3
E33018157,410,319,99,220,5,38,23,15,43,40,0,2,1,5
E33018158,486,312,86,226,4,70,50,20,94,88,1,5,0,6
E33018159,257,145,35,110,4,39,30,9,64,58,0,6,0,5
E33018160,842,658,157,501,1,87,42,45,89,87,0,1,1,7
E33018161,1571,1126,277,849,10,167,98,69,262,237,2,23,0,6
E33018162,1151,800,187,613,8,149,77,72,192,177,5,10,0,2
E33018163,385,268,77,191,2,55,34,21,57,46,4,7,0,3
E33018164,584,439,117,322,10,66,44,22,66,64,0,2,0,3
E33018165,313,231,53,178,4,41,20,21,37,36,0,1,0,0
E33018166,303,218,50,168,3,30,19,11,48,45,0,2,1,4
E33018167,1481,1107,258,849,18,102,46,56,247,225,1,18,3,7
E33018168,1022,739,196,543,4,133,83,50,141,136,2,3,0,5
E33018169,707,500,130,370,5,107,57,50,92,85,0,6,1,3
E33018170,2807,2305,631,1674,22,277,152,125,195,186,0,8,1,8
E33018171,526,350,90,260,4,78,53,25,92,86,0,6,0,2
E33018172,249,171,40,131,3,37,26,11,38,36,0,2,0,0
E33018173,274,190,51,139,6,38,32,6,35,34,1,0,0,5
E33018174,665,456,105,351,10,83,50,33,112,104,0,7,1,4
E33018175,385,288,68,220,6,40,33,7,48,44,0,3,1,3
E33018176,744,542,118,424,11,95,63,32,96,91,0,5,0,0
E33018177,964,750,204,546,13,102,70,32,96,89,3,4,0,3
E33018178,3543,2535,669,1866,32,163,90,73,795,751,2,35,7,18
E33018179,374,251,77,174,4,32,21,11,84,74,1,7,2,3
E33018180,1619,1057,253,804,20,148,98,50,371,341,7,15,8,23
E33018181,368,254,58,196,2,28,22,6,83,78,0,4,1,1
E33018182,994,653,162,491,7,74,41,33,252,239,0,10,3,8
E33018183,1151,793,201,592,11,95,57,38,244,229,0,15,0,8
E33018184,242,111,23,88,1,59,28,31,69,68,0,1,0,2
E33018185,362,217,41,176,4,33,25,8,103,101,0,1,1,5
E33018186,370,157,43,114,5,59,35,24,148,141,0,5,2,1
E33018187,2425,1884,513,1371,27,156,93,63,345,313,2,24,6,13
E33018188,367,273,76,197,3,31,12,19,56,51,1,4,0,4
E33018189,351,146,35,111,2,74,47,27,127,121,0,5,1,2
E33018190,742,566,155,411,8,50,32,18,115,111,1,3,0,3
E33018191,527,247,60,187,4,106,61,45,164,156,0,7,1,6
E33018192,424,330,93,237,6,24,12,12,63,57,0,4,2,1
E33018193,588,424,90,334,5,29,10,19,126,119,0,7,0,4
E33018194,675,464,123,341,5,80,42,38,118,110,0,8,0,8
E33018195,1193,784,183,601,15,165,95,70,224,207,3,12,2,5
E33018196,700,448,105,343,17,140,108,32,90,85,1,4,0,5
E33018197,1208,875,257,618,9,145,59,86,174,167,0,6,1,5
E33018198,458,324,75,249,3,46,31,15,83,74,0,6,3,2
E33018199,539,384,112,272,4,62,36,26,75,71,0,4,0,14
E33018200,493,310,103,207,4,68,45,23,106,104,0,2,0,5
E33018201,385,252,83,169,1,76,57,19,51,50,0,1,0,5
E33018202,805,583,153,430,9,101,60,41,109,100,0,7,2,3
E33018203,824,524,161,363,5,98,58,40,188,168,7,11,2,9
E33018204,301,203,62,141,1,54,30,24,41,40,0,1,0,2
E33018205,312,237,59,178,4,26,16,10,44,40,0,3,1,1
E33018206,370,274,87,187,2,52,32,20,40,39,0,1,0,2
E33018207,255,208,57,151,2,22,11,11,20,17,1,1,1,3
E33018208,208,126,43,83,1,27,21,6,51,47,0,4,0,3
E33018209,257,191,36,155,2,31,13,18,29,25,0,3,1,4
E33018210,932,644,177,467,8,143,95,48,131,119,0,9,3,6
E33018211,327,230,81,149,1,46,20,26,46,46,0,0,0,4
E33018212,277,187,71,116,3,33,22,11,52,49,1,2,0,2
E33018213,293,213,62,151,0,40,30,10,37,31,0,4,2,3
E33018214,264,158,67,91,1,62,50,12,41,37,0,4,0,2
E33018215,327,244,90,154,1,42,26,16,37,34,0,3,0,3
E33018216,197,148,39,109,0,30,20,10,19,18,0,1,0,0
E33018217,236,141,31,110,1,43,27,16,51,46,0,5,0,0
E33018218,420,223,56,167,4,75,51,24,114,106,0,4,4,4
E33018219,745,523,204,319,6,117,78,39,97,96,0,1,0,2
E33018220,282,178,45,133,1,49,29,20,54,53,0,0,1,0
E33018221,301,209,60,149,1,44,23,21,45,40,0,5,0,2
E33018222,277,188,54,134,6,38,21,17,44,40,0,3,1,1
E33018223,960,610,162,448,12,118,68,50,214,202,1,11,0,6
E33018224,222,139,37,102,6,42,16,26,34,32,0,1,1,1
E33018225,1134,711,194,517,12,163,95,68,237,224,2,6,5,11
E33018226,226,165,56,109,5,19,14,5,36,34,0,2,0,1
E33018227,530,353,80,273,3,102,72,30,72,66,0,3,3,0
E33018228,275,207,48,159,3,35,19,16,30,27,1,2,0,0
E33018229,279,206,46,160,3,40,31,9,30,26,1,3,0,0
E33018230,380,256,86,170,5,59,38,21,60,55,1,4,0,0
E33018231,299,226,57,169,0,35,23,12,36,31,0,5,0,2
E33018232,242,179,51,128,3,27,23,4,33,31,1,1,0,0
E33018233,312,218,54,164,4,40,25,15,48,46,1,1,0,2
E33018234,252,167,66,101,5,37,28,9,41,41,0,0,0,2
E33018235,470,362,83,279,3,35,21,14,68,62,0,6,0,2
E33018236,258,158,35,123,2,56,30,26,39,35,0,4,0,3
E33018237,417,316,88,228,4,51,43,8,44,42,0,2,0,2
E33018238,562,399,139,260,7,73,53,20,82,78,0,4,0,1
E33018239,928,562,126,436,11,198,140,58,148,139,0,9,0,9
E33018240,452,329,123,206,4,43,28,15,73,70,2,1,0,3
E33018241,207,157,55,102,2,20,16,4,28,25,0,3,0,0
E33018242,668,497,155,342,3,78,62,16,83,77,0,6,0,7
E33018243,923,742,259,483,7,65,48,17,102,99,0,3,0,7
E33018244,339,258,68,190,3,30,19,11,44,43,0,1,0,4
E33018245,1178,858,225,633,15,116,73,43,183,166,0,16,1,6
E33018246,715,563,155,408,7,68,40,28,72,67,0,4,1,5
E33018247,509,396,117,279,5,63,37,26,41,35,1,5,0,4
E33018248,864,498,143,355,10,81,49,32,271,254,0,17,0,4
E33018249,313,218,76,142,3,35,26,9,54,52,0,2,0,3
E33018250,1189,789,292,497,7,176,88,88,206,197,1,8,0,11
E33018251,1419,979,293,686,8,144,78,66,262,231,10,9,12,26
E33018252,686,514,152,362,7,69,38,31,95,89,2,3,1,1
E33018253,230,152,33,119,4,46,13,33,24,20,0,3,1,4
E33018254,306,235,68,167,2,32,17,15,32,29,0,3,0,5
E33018255,633,488,149,339,4,64,53,11,77,73,2,2,0,0
E33018256,218,164,32,132,1,31,26,5,18,18,0,0,0,4
E33018257,810,629,161,468,8,74,49,25,95,84,0,9,2,4
E33018258,560,419,120,299,6,67,51,16,63,61,0,2,0,5
E33018259,252,175,43,132,0,39,26,13,37,35,1,1,0,1
E33018260,375,263,79,184,2,68,48,20,39,37,1,1,0,3
E33018261,244,174,53,121,5,24,18,6,34,33,0,0,1,7
E33018262,693,564,140,424,11,42,32,10,73,68,0,4,1,3
E33018263,739,568,157,411,5,83,63,20,79,68,0,10,1,4
E33018264,993,720,194,526,9,144,105,39,116,109,0,6,1,4
E33018265,786,564,158,406,4,104,73,31,113,103,3,7,0,1
E33018266,350,244,88,156,2,56,41,15,46,45,0,1,0,2
E33018267,301,183,72,111,5,51,32,19,60,52,1,3,4,2
E33018268,222,152,59,93,1,24,16,8,43,38,0,3,2,2
E33018269,385,241,87,154,2,44,26,18,94,89,0,5,0,4
E33018270,389,311,103,208,1,35,25,10,42,41,0,1,0,0
E33018271,1469,1080,233,847,15,157,94,63,216,193,2,19,2,1
E33018272,741,493,155,338,7,108,73,35,131,126,1,4,0,2
E33018273,207,143,53,90,4,23,17,6,33,29,0,2,2,4
E33018274,1078,844,190,654,10,73,48,25,141,127,2,12,0,10
E33018275,4354,3200,756,2444,48,415,258,157,666,625,2,34,5,25
E33018276,793,527,141,386,7,125,87,38,126,124,0,1,1,8
E33018277,443,260,111,149,3,83,41,42,90,86,0,4,0,7
E33018278,357,215,73,142,7,71,42,29,63,58,0,4,1,1
E33018279,276,194,70,124,0,31,15,16,48,46,0,1,1,3
E33018280,535,375,123,252,2,67,31,36,83,73,3,6,1,8
E33018281,225,157,62,95,0,37,22,15,25,24,1,0,0,6
E33018282,573,306,98,208,6,126,71,55,120,116,0,2,2,15
E33018283,446,319,99,220,6,53,33,20,65,60,0,4,1,3
E33018284,367,267,91,176,3,54,28,26,41,40,0,1,0,2
E33018285,372,274,117,157,2,63,37,26,31,28,0,3,0,2
E33018286,516,339,111,228,5,76,46,30,93,88,1,3,1,3
E33018287,195,154,63,91,1,25,15,10,14,13,0,0,1,1
E33018288,233,150,62,88,2,27,15,12,47,42,0,5,0,7
E33018289,391,297,83,214,4,38,25,13,49,44,0,5,0,3
E33018290,273,165,50,115,3,46,23,23,54,48,0,3,3,5
E33018291,423,326,100,226,4,37,18,19,54,52,0,1,1,2
E33018292,767,514,119,395,10,79,52,27,157,151,0,6,0,7
E33018293,491,371,110,261,1,58,40,18,59,56,0,3,0,2
E33018294,551,418,109,309,7,34,20,14,88,81,0,6,1,4
E33018295,757,623,202,421,7,42,25,17,81,76,0,5,0,4
E33018296,358,277,79,198,5,23,15,8,46,44,0,2,0,7
E33018297,598,499,100,399,5,37,18,19,54,47,1,5,1,3
E33018298,694,545,149,396,7,61,43,18,79,73,1,4,1,2
E33018299,343,251,66,185,5,22,11,11,65,62,2,1,0,0
E33018300,553,414,122,292,7,44,18,26,85,76,0,3,6,3
E33018301,973,692,213,479,8,151,83,68,114,102,1,10,1,8
E33018302,727,568,168,400,6,72,37,35,77,66,0,10,1,4
E33018303,445,308,58,250,2,37,20,17,97,85,0,10,2,1
E33018304,1078,731,211,520,10,146,90,56,186,179,1,5,1,5
E33018305,248,203,62,141,2,14,8,6,27,25,0,2,0,2
E33018306,319,217,52,165,1,17,8,9,80,74,0,3,3,4
E33018307,330,229,42,187,4,37,16,21,58,53,0,5,0,2
E33018308,741,579,152,427,2,63,38,25,91,85,0,6,0,6
E33018309,596,419,137,282,5,71,44,27,95,89,1,4,1,6
E33018310,559,434,106,328,5,33,23,10,84,80,0,3,1,3
E33018311,606,469,151,318,3,54,34,20,75,66,0,8,1,5
E33018312,315,267,83,184,3,12,10,2,31,31,0,0,0,2
E33018313,819,495,136,359,9,110,59,51,199,188,3,8,0,6
E33018314,519,301,92,209,7,64,43,21,147,137,0,3,7,0
E33018315,215,150,37,113,2,14,5,9,44,39,2,3,0,5
E33018316,704,556,131,425,3,38,12,26,107,105,0,2,0,0
E33018317,304,242,63,179,1,13,5,8,47,47,0,0,0,1
E33018318,1300,1005,249,756,20,78,32,46,192,172,2,18,0,5
E33018319,386,303,98,205,0,22,10,12,57,50,0,6,1,4
E33018320,314,233,55,178,1,13,5,8,64,57,1,5,1,3
E33018321,712,524,96,428,7,38,12,26,140,130,1,9,0,3
E33018322,595,485,175,310,2,35,16,19,70,67,0,3,0,3
E33018323,690,536,134,402,3,39,16,23,107,101,0,6,0,5
E33018324,542,427,102,325,5,41,15,26,67,59,0,8,0,2
E33018325,470,335,95,240,2,44,28,16,88,85,0,2,1,1
E33018326,654,476,118,358,5,27,14,13,142,127,1,10,4,4
E33018327,208,144,45,99,1,20,5,15,43,39,2,1,1,0
E33018328,628,414,122,292,12,41,21,20,154,145,2,7,0,7
E33018329,585,407,118,289,4,66,29,37,106,98,0,8,0,2
E33018330,506,371,96,275,1,38,11,27,92,73,3,10,6,4
E33018331,130,93,27,66,0,5,1,4,32,27,2,2,1,0
E33018332,326,247,71,176,1,34,11,23,42,38,0,4,0,2
E33018333,682,523,134,389,1,70,38,32,85,79,0,2,4,3
E33018334,840,625,182,443,7,69,23,46,133,128,0,5,0,6
E33018335,409,297,98,199,5,40,14,26,63,58,0,5,0,4
E33018336,907,681,203,478,4,82,28,54,137,123,1,8,5,3
E33018337,207,142,46,96,0,25,13,12,38,32,0,5,1,2
E33018338,1300,996,252,744,6,98,47,51,193,175,1,17,0,7
E33018339,247,162,47,115,1,30,12,18,52,48,0,4,0,2
E33018340,580,356,71,285,5,44,17,27,173,163,1,7,2,2
E33018341,2289,1627,374,1253,17,159,52,107,464,434,1,25,4,22
E33018342,311,243,54,189,1,27,11,16,39,34,0,5,0,1
E33018343,680,503,97,406,8,43,21,22,117,103,0,14,0,9
E33018344,290,226,55,171,0,27,16,11,36,34,0,1,1,1
E33018345,1096,940,290,650,3,63,32,31,87,84,0,2,1,3
E33018346,236,180,49,131,2,17,3,14,36,29,2,5,0,1
E33018347,370,204,43,161,4,51,24,27,111,106,0,5,0,0
E33018348,804,531,173,358,2,95,37,58,167,154,0,10,3,9
E33018349,545,420,113,307,3,39,12,27,79,74,0,5,0,4
E33018350,741,426,123,303,3,97,35,62,214,200,2,10,2,1
E33018351,1121,759,266,493,11,114,47,67,229,213,0,14,2,8
E33018352,337,230,72,158,6,29,10,19,67,61,0,4,2,5
E33018353,635,479,106,373,1,31,15,16,121,108,6,6,1,3
E33018354,539,324,72,252,1,73,29,44,135,122,0,10,3,6
E33018355,391,221,56,165,0,66,25,41,103,93,3,4,3,1
E33018356,279,219,61,158,1,11,5,6,46,43,0,3,0,2
E33018357,638,489,117,372,4,34,17,17,108,98,1,8,1,3
E33018358,350,272,66,206,1,15,5,10,61,48,0,11,2,1
E33018359,215,166,41,125,1,19,4,15,29,27,0,2,0,0
E33018360,880,690,179,511,9,90,42,48,86,77,0,8,1,5
E33018361,711,469,133,336,5,66,22,44,168,153,1,14,0,3
E33018362,560,368,99,269,3,60,16,44,123,122,0,1,0,6
E33018363,1518,1008,241,767,4,166,77,89,331,316,0,13,2,9
E33018364,263,192,58,134,6,34,25,9,30,28,0,2,0,1
E33018365,385,302,98,204,2,22,13,9,59,45,1,12,1,0
E33018366,599,401,128,273,6,124,94,30,67,60,0,6,1,1
E33018367,375,283,111,172,0,47,42,5,44,43,0,1,0,1
E33018368,658,523,156,367,8,56,38,18,63,58,1,3,1,8
E33018369,265,197,65,132,1,33,29,4,33,33,0,0,0,1
E33018370,318,263,77,186,1,28,20,8,24,22,0,2,0,2
E33018371,404,320,104,216,2,48,40,8,33,31,0,2,0,1
E33018372,933,721,207,514,5,112,82,30,92,88,0,3,1,3
E33018373,972,769,175,594,8,81,66,15,109,101,0,7,1,5
E33018374,206,154,44,110,0,34,28,6,18,16,0,1,1,0
E33018375,503,400,113,287,1,61,52,9,40,38,0,2,0,1
E33018376,228,137,33,104,1,50,44,6,38,36,0,2,0,2
E33018377,435,322,119,203,2,65,59,6,45,42,1,2,0,1
E33018378,508,401,133,268,2,52,41,11,51,49,0,2,0,2
E33018379,548,411,135,276,2,84,69,15,47,43,0,4,0,4
E33018380,498,374,88,286,6,50,35,15,65,57,0,6,2,3
E33018381,1521,1257,376,881,13,116,90,26,131,120,0,10,1,4
E33018382,217,150,40,110,2,38,34,4,26,25,0,1,0,1
E33018383,486,372,92,280,8,45,30,15,59,55,1,2,1,2
E33018384,518,364,99,265,4,73,54,19,73,65,1,6,1,4
E33018385,381,286,83,203,3,46,33,13,46,46,0,0,0,0
E33018386,1115,659,196,463,8,244,189,55,198,190,1,6,1,6
E33018387,460,330,100,230,1,84,68,16,41,37,0,4,0,4
E33018388,412,304,146,158,2,66,56,10,38,34,0,4,0,2
E33018389,876,589,157,432,12,120,84,36,147,137,0,10,0,8
E33018390,632,463,140,323,4,97,84,13,64,57,0,6,1,4
E33018391,678,535,161,374,7,77,64,13,57,49,5,1,2,2
E33018392,271,213,61,152,4,29,26,3,25,22,0,3,0,0
E33018393,370,272,80,192,2,57,46,11,36,33,0,2,1,3
E33018394,499,394,111,283,7,49,38,11,46,41,0,4,1,3
E33018395,729,552,152,400,3,81,65,16,89,81,1,7,0,4
E33018396,213,164,45,119,0,14,10,4,33,31,0,1,1,2
E33018397,316,260,65,195,2,29,19,10,23,19,1,2,1,2
E33018398,334,248,73,175,1,47,35,12,36,35,0,1,0,2
E33018399,490,356,131,225,1,87,75,12,45,38,0,7,0,1
E33018400,281,205,79,126,2,44,38,6,27,25,0,1,1,3
E33018401,203,159,75,84,2,16,13,3,26,22,0,4,0,0
E33018402,284,209,53,156,0,54,47,7,20,18,0,2,0,1
E33018403,260,203,68,135,0,37,30,7,18,17,0,1,0,2
E33018404,272,219,67,152,1,36,26,10,15,13,0,1,1,1
E33018405,356,265,68,197,6,30,24,6,52,51,0,1,0,3
E33018406,223,170,40,130,2,22,15,7,27,26,0,1,0,2
E33018407,264,210,62,148,3,27,17,10,22,20,0,1,1,2
E33018408,202,166,49,117,1,23,18,5,11,10,0,1,0,1
E33018409,249,203,75,128,5,16,12,4,24,23,0,1,0,1
E33018410,627,468,154,314,6,83,73,10,68,62,0,3,3,2
E33018411,790,593,198,395,2,100,86,14,87,81,1,4,1,8
E33018412,960,767,203,564,8,71,54,17,111,94,0,15,2,3
E33018413,272,200,45,155,1,38,28,10,33,29,0,4,0,0
E33018414,262,207,80,127,1,31,28,3,22,18,0,4,0,1
E33018415,325,221,94,127,3,62,50,12,37,33,0,4,0,2
E33018416,402,295,95,200,5,57,51,6,43,42,0,1,0,2
E33018417,227,162,51,111,1,40,30,10,24,24,0,0,0,0
E33018418,249,190,70,120,2,30,23,7,27,24,0,2,1,0
E33018419,219,151,47,104,1,23,19,4,44,39,2,3,0,0
E33018420,219,171,55,116,0,28,21,7,19,18,0,0,1,1
E33018421,771,586,194,392,4,107,91,16,67,62,0,5,0,7
E33018422,354,302,123,179,1,28,24,4,19,16,1,2,0,4
E33018423,446,318,87,231,1,69,52,17,54,50,0,4,0,4
E33018424,377,302,86,216,2,29,16,13,41,39,0,2,0,3
E33018425,307,244,77,167,2,31,18,13,25,23,0,2,0,5
E33018426,320,262,67,195,5,24,16,8,27,26,1,0,0,2
E33018427,287,241,55,186,1,15,10,5,29,29,0,0,0,1
E33018428,265,214,64,150,2,20,14,6,24,21,2,1,0,5
E33018429,635,471,154,317,2,77,56,21,82,71,1,10,0,3
E33018430,704,544,199,345,5,44,33,11,80,71,0,5,4,31
E33018431,759,493,125,368,5,138,117,21,122,116,0,6,0,1
E33018432,484,357,99,258,2,68,60,8,56,51,1,4,0,1
E33018433,510,360,99,261,4,78,61,17,66,56,0,9,1,2
E33018434,5218,3981,1134,2847,29,530,398,132,639,545,35,28,31,39
E33018435,205,119,42,77,0,59,51,8,22,20,0,2,0,5
E33018436,216,153,48,105,1,27,25,2,31,30,0,1,0,4
E33018437,304,190,65,125,0,74,63,11,36,33,0,3,0,4
E33018438,386,252,82,170,1,90,75,15,42,38,0,4,0,1
E33018439,239,154,48,106,0,49,37,12,32,29,0,3,0,4
E33018440,250,204,61,143,0,25,20,5,15,13,1,0,1,6
E33018441,378,273,78,195,3,78,68,10,22,18,1,1,2,2
E33018442,1250,1061,268,793,7,77,56,21,102,94,0,6,2,3
E33018443,204,150,34,116,2,24,19,5,24,23,0,1,0,4
E33018444,622,462,166,296,3,88,70,18,65,55,2,8,0,4
E33018445,252,213,71,142,1,20,16,4,16,16,0,0,0,2
E33018446,270,210,76,134,1,41,34,7,16,15,0,1,0,2
E33018447,174,140,38,102,0,18,17,1,15,13,1,1,0,1
E33018448,407,341,124,217,1,24,18,6,40,38,0,2,0,1
E33018449,449,330,107,223,4,64,45,19,49,45,1,2,1,2
E33018450,313,221,64,157,5,40,32,8,43,38,0,3,2,4
E33018451,229,154,39,115,4,43,39,4,27,26,0,1,0,1
E33018452,1978,1485,384,1101,21,207,147,60,252,232,2,18,0,13
E33018453,582,419,132,287,1,86,65,21,73,71,0,2,0,3
E33018454,252,201,72,129,0,24,21,3,26,23,0,2,1,1
E33018455,369,269,84,185,4,56,47,9,36,34,1,1,0,4
E33018456,279,221,78,143,0,38,32,6,17,17,0,0,0,3
E33018457,237,169,55,114,1,40,32,8,26,23,0,1,2,1
E33018458,246,150,49,101,4,51,41,10,40,34,4,2,0,1
E33018459,272,200,59,141,2,44,35,9,23,20,2,1,0,3
E33018460,657,495,136,359,2,81,68,13,73,69,0,4,0,6
E33018461,340,232,69,163,2,57,49,8,49,45,0,4,0,0
E33018462,220,142,51,91,1,42,35,7,33,29,1,2,1,2
E33018463,414,315,77,238,5,41,32,9,52,46,0,6,0,1
E33018464,340,244,77,167,2,50,43,7,44,40,1,2,1,0
E33018465,216,152,39,113,0,42,38,4,21,18,0,3,0,1
E33018466,287,201,59,142,1,49,41,8,34,31,0,3,0,2
E33018467,199,165,61,104,2,18,16,2,13,11,0,2,0,1
E33018468,262,201,61,140,1,25,20,5,33,32,0,1,0,2
E33018469,427,315,107,208,3,71,63,8,35,32,0,2,1,3
E33018470,1311,1081,314,767,4,90,60,30,128,112,2,14,0,8
E33018471,206,155,42,113,1,27,19,8,21,21,0,0,0,2
E33018472,410,317,82,235,0,53,40,13,40,36,0,4,0,0
E33018473,245,162,54,108,7,41,31,10,30,27,0,2,1,5
E33018474,253,191,78,113,2,41,37,4,18,18,0,0,0,1
E33018475,210,164,50,114,0,36,30,6,9,8,0,1,0,1
E33018476,320,242,101,141,3,48,40,8,27,25,0,1,1,0
E33018477,215,159,34,125,2,32,27,5,20,20,0,0,0,2
E33018478,269,180,48,132,1,37,25,12,48,47,0,1,0,3
E33018479,193,149,61,88,2,32,24,8,9,9,0,0,0,1
E33018480,521,387,109,278,4,69,49,20,59,57,0,2,0,2
E33018481,326,232,88,144,0,57,47,10,37,33,3,1,0,0
E33018482,585,422,137,285,3,92,72,20,65,58,1,5,1,3
E33018483,498,377,118,259,4,68,53,15,48,39,1,8,0,1
E33018484,516,332,98,234,3,79,60,19,101,96,0,5,0,1
E33018485,667,495,181,314,5,105,71,34,60,56,0,3,1,2
E33018486,292,238,66,172,0,33,24,9,20,18,1,1,0,1
E33018487,493,392,120,272,2,54,39,15,43,39,0,4,0,2
E33018488,875,660,177,483,7,117,88,29,88,80,0,8,0,3
E33018489,375,301,86,215,1,45,36,9,27,26,0,0,1,1
E33018490,708,492,136,356,1,120,95,25,89,80,0,4,5,6
E33018491,430,302,95,207,5,68,55,13,52,51,0,1,0,3
E33018492,536,423,135,288,5,52,36,16,56,51,0,5,0,0
E33018493,474,316,107,209,2,58,49,9,92,88,0,4,0,6
E33018494,404,290,78,212,4,63,39,24,46,41,1,2,2,1
E33018495,266,170,44,126,1,49,44,5,45,43,0,2,0,1
E33018496,315,237,69,168,5,27,20,7,43,43,0,0,0,3
E33018497,582,429,102,327,2,66,51,15,82,77,1,3,1,3
E33018498,947,673,159,514,5,110,83,27,146,128,3,14,1,13
E33018499,307,210,58,152,1,41,29,12,55,52,1,2,0,0
E33018500,497,350,106,244,3,90,75,15,51,49,0,2,0,3
E33018501,713,543,172,371,5,87,70,17,71,62,1,7,1,7
E33018502,509,368,117,251,3,75,62,13,60,54,1,4,1,3
E33018503,424,302,87,215,4,73,54,19,43,42,0,1,0,2
E33018504,486,343,91,252,3,72,55,17,65,60,1,4,0,3
E33018505,388,268,92,176,2,65,59,6,52,52,0,0,0,1
E33018506,234,164,43,121,2,44,35,9,22,21,0,1,0,2
E33018507,423,305,106,199,7,63,58,5,48,45,0,3,0,0
E33018508,1540,1074,324,750,17,206,155,51,232,213,1,16,2,11
E33018509,466,327,89,238,7,44,27,17,88,84,0,4,0,0
E33018510,416,269,77,192,4,44,28,16,97,90,0,7,0,2
E33018511,240,164,62,102,0,52,43,9,23,23,0,0,0,1
E33018512,758,595,181,414,7,90,67,23,64,59,0,5,0,2
E33018513,258,190,44,146,0,38,29,9,29,26,0,3,0,1
E33018514,442,328,68,260,1,57,44,13,53,48,2,3,0,3
E33018515,338,235,57,178,3,54,42,12,42,41,0,1,0,4
E33018516,831,549,157,392,2,77,55,22,194,189,0,4,1,9
E33018517,365,259,67,192,1,47,37,10,55,49,1,1,4,3
E33018518,520,421,110,311,2,47,40,7,50,48,0,2,0,0
E33018519,146,105,32,73,0,15,7,8,26,22,0,2,2,0
E33018520,467,336,110,226,6,60,40,20,61,59,0,1,1,4
E33018521,247,176,84,92,2,20,10,10,47,45,1,1,0,2
E33018522,634,510,152,358,0,51,43,8,70,65,0,3,2,3
E33018523,299,192,49,143,2,42,28,14,60,58,1,1,0,3
E33018524,424,357,119,238,4,37,28,9,26,26,0,0,0,0
E33018525,236,203,30,173,3,6,3,3,23,18,0,5,0,1
E33018526,407,299,75,224,5,56,34,22,37,33,0,4,0,10
E33018527,708,498,168,330,3,92,65,27,111,104,0,6,1,4
E33018528,271,213,84,129,1,26,20,6,30,26,0,4,0,1
E33018529,609,442,128,314,4,99,76,23,63,61,0,1,1,1
E33018530,422,328,87,241,2,46,39,7,42,39,1,2,0,4
E33018531,451,339,112,227,1,72,64,8,36,29,0,2,5,3
E33018532,205,169,47,122,4,25,21,4,5,5,0,0,0,2
E33018533,279,197,52,145,1,48,40,8,28,27,0,1,0,5
E33018534,958,602,160,442,4,179,129,50,170,155,1,13,1,3
E33018535,598,365,112,253,5,145,120,25,82,75,2,5,0,1
E33018536,541,394,110,284,3,89,70,19,50,47,0,3,0,5
E33018537,218,171,56,115,0,37,30,7,10,9,1,0,0,0
E33018538,454,312,70,242,2,89,67,22,49,43,1,5,0,2
E33018539,239,162,58,104,1,56,47,9,17,16,0,1,0,3
E33018540,557,397,106,291,4,83,60,23,70,68,0,2,0,3
E33018541,1174,625,195,430,8,198,142,56,338,319,4,7,8,5
E33018542,959,671,193,478,5,190,147,43,88,81,0,7,0,5
E33018543,479,342,113,229,1,73,61,12,60,58,0,2,0,3
E33018544,290,202,54,148,2,60,43,17,24,20,0,4,0,2
E33018545,378,294,113,181,3,45,34,11,33,30,0,3,0,3
E33018546,336,243,83,160,5,61,46,15,27,26,0,1,0,0
E33018547,289,182,42,140,1,41,32,9,62,59,0,3,0,3
E33018548,318,216,65,151,1,55,37,18,39,35,0,3,1,7
E33018549,246,199,82,117,2,24,21,3,20,20,0,0,0,1
E33018550,458,369,126,243,4,34,21,13,50,49,0,1,0,1
E33018551,255,192,64,128,2,36,22,14,24,24,0,0,0,1
E33018552,814,600,195,405,8,122,97,25,80,73,3,3,1,4
E33018553,295,203,66,137,1,65,47,18,24,19,1,4,0,2
E33018554,223,171,55,116,0,24,18,6,26,22,1,3,0,2
E33018555,314,216,70,146,4,44,27,17,47,46,0,1,0,3
E33018556,1052,870,208,662,5,63,37,26,111,96,3,9,3,3
E33018557,211,156,50,106,0,23,15,8,30,25,2,3,0,2
E33018558,282,226,48,178,3,20,15,5,33,33,0,0,0,0
E33018559,473,312,82,230,5,76,49,27,68,62,0,6,0,12
E33018560,247,152,51,101,1,63,50,13,28,25,0,3,0,3
E33018561,337,235,80,155,4,55,41,14,41,39,0,1,1,2
E33018562,398,303,81,222,8,48,31,17,36,32,0,4,0,3
E33018563,246,153,42,111,5,39,29,10,48,43,0,1,4,1
E33018564,1017,785,241,544,4,112,87,25,109,101,1,7,0,7
E33018565,1534,1079,267,812,13,212,139,73,219,200,3,14,2,11
E33018566,661,410,125,285,2,164,128,36,83,74,1,7,1,2
E33018567,601,492,112,380,10,33,23,10,63,58,0,5,0,3
E33018568,1727,1369,288,1081,21,103,56,47,228,215,0,13,0,6
E33018569,1091,836,189,647,15,86,55,31,152,145,0,5,2,2
E33018570,846,597,120,477,6,131,85,46,112,105,3,4,0,0
E33018571,445,325,78,247,4,49,34,15,65,65,0,0,0,2
E33018572,1478,1096,270,826,21,142,94,48,215,203,2,10,0,4
E33018573,470,340,74,266,4,36,28,8,86,82,0,4,0,4
E33018574,863,643,172,471,2,76,55,21,138,127,0,10,1,4
E33018575,1195,963,210,753,13,56,39,17,158,146,1,11,0,5
E33018576,378,310,69,241,7,21,14,7,37,34,1,2,0,3
E33018577,739,422,104,318,8,124,88,36,180,174,0,3,3,5
E33018578,2077,1527,416,1111,21,225,166,59,289,276,3,9,1,15
E33018579,1643,1159,401,758,11,202,148,54,259,242,0,16,1,12
E33018580,847,625,168,457,16,78,60,18,126,122,0,4,0,2
E33018581,598,491,100,391,3,25,16,9,76,71,0,5,0,3
E33018582,329,246,61,185,8,28,19,9,47,44,0,3,0,0
E33018583,606,438,117,321,3,75,55,20,89,80,1,7,1,1
E33018584,452,337,93,244,3,52,37,15,55,48,0,6,1,5
E33018585,229,138,33,105,5,60,48,12,25,24,0,1,0,1
E33018586,348,278,99,179,0,18,8,10,48,43,3,2,0,4
E33018587,324,257,93,164,1,18,16,2,47,43,0,2,2,1
E33018588,306,231,72,159,3,23,15,8,43,40,1,2,0,6
E33018589,602,429,107,322,2,42,22,20,128,119,2,4,3,1
E33018590,693,579,112,467,8,27,13,14,76,69,2,5,0,3
E33018591,326,267,63,204,0,10,9,1,49,48,0,1,0,0
E33018592,545,400,78,322,4,28,11,17,110,105,0,4,1,3
E33018593,636,476,117,359,2,18,11,7,135,126,0,7,2,5
E33018594,271,217,62,155,1,13,10,3,37,28,0,2,7,3
E33018595,381,289,96,193,6,14,12,2,70,61,2,7,0,2
E33018596,545,460,132,328,4,28,18,10,51,49,1,1,0,2
E33018597,1392,1044,370,674,13,179,134,45,147,133,2,9,3,9
E33018598,554,426,127,299,6,43,31,12,78,72,0,5,1,1
E33018599,287,224,46,178,3,18,13,5,42,41,0,0,1,0
E33018600,297,219,61,158,2,25,17,8,48,45,1,2,0,3
E33018601,228,166,50,116,4,20,15,5,38,32,0,6,0,0
E33018602,2105,1495,386,1109,20,194,141,53,382,366,0,15,1,14
E33018603,210,178,55,123,1,10,8,2,19,17,0,2,0,2
E33018604,719,611,183,428,4,20,16,4,78,70,1,5,2,6
E33018605,715,556,151,405,7,71,52,19,77,69,1,7,0,4
E33018606,412,321,83,238,5,21,15,6,62,56,0,5,1,3
E33018607,952,803,267,536,10,45,31,14,89,79,3,5,2,5
E33018608,288,205,70,135,1,29,22,7,52,47,0,5,0,1
E33018609,1634,1321,338,983,17,65,45,20,221,212,0,8,1,10
E33018610,411,360,117,243,2,10,4,6,37,33,2,2,0,2
E33018611,728,570,159,411,2,75,55,20,77,71,0,4,2,4
E33018612,636,484,161,323,7,55,41,14,86,78,0,6,2,4
E33018613,613,476,108,368,3,52,40,12,79,70,0,9,0,3
E33018614,353,282,65,217,5,14,9,5,50,48,0,2,0,2
E33018615,219,179,57,122,3,5,4,1,31,27,0,4,0,1
E33018616,612,462,127,335,13,49,36,13,87,78,2,5,2,1
E33018617,526,389,90,299,7,48,39,9,79,78,0,1,0,3
E33018618,443,329,88,241,1,39,26,13,72,69,1,2,0,2
E33018619,350,297,72,225,8,10,4,6,35,33,0,1,1,0
E33018620,816,604,154,450,5,70,52,18,128,122,1,3,2,9
E33018621,1001,819,217,602,5,39,23,16,133,125,0,8,0,5
E33018622,296,220,55,165,9,21,16,5,44,39,0,5,0,2
E33018623,840,697,173,524,7,37,30,7,95,90,0,5,0,4
E33018624,908,672,158,514,13,84,56,28,138,123,1,13,1,1
E33018625,493,417,123,294,4,27,16,11,43,41,1,1,0,2
E33018626,270,223,56,167,2,13,8,5,32,32,0,0,0,0
E33018627,226,172,55,117,2,12,11,1,38,34,2,1,1,2
E33018628,205,154,56,98,1,15,10,5,32,30,0,2,0,3
E33018629,292,233,58,175,5,23,16,7,30,30,0,0,0,1
E33018630,524,407,118,289,5,42,34,8,67,64,0,3,0,3
E33018631,454,351,96,255,3,27,13,14,69,65,2,2,0,4
E33018632,1495,1131,310,821,14,137,103,34,206,190,3,11,2,7
E33018633,995,755,194,561,11,52,35,17,173,164,0,9,0,4
E33018634,143,110,29,81,0,8,3,5,23,22,1,0,0,2
E33018635,801,521,149,372,5,130,59,71,137,130,1,5,1,8
E33018636,835,615,172,443,4,108,50,58,105,97,0,5,3,3
E33018637,266,200,44,156,4,31,11,20,30,28,0,2,0,1
E33018638,237,185,58,127,3,24,15,9,23,22,0,1,0,2
E33018639,670,449,136,313,2,136,71,65,80,76,0,3,1,3
E33018640,807,561,142,419,4,138,74,64,100,91,1,8,0,4
E33018641,1108,840,243,597,5,161,105,56,99,94,0,5,0,3
E33018642,406,276,89,187,0,72,41,31,56,50,2,4,0,2
E33018643,229,174,49,125,5,32,13,19,14,10,0,3,1,4
E33018644,1255,703,200,503,7,284,121,163,253,232,0,21,0,8
E33018645,375,243,75,168,2,56,27,29,72,71,0,1,0,2
E33018646,1036,707,231,476,7,180,100,80,139,126,1,10,2,3
E33018647,531,390,119,271,0,82,42,40,57,49,1,3,4,2
E33018648,572,447,82,365,8,63,33,30,53,49,0,3,1,1
E33018649,367,298,89,209,4,29,15,14,36,33,0,3,0,0
E33018650,662,484,130,354,3,98,46,52,73,66,0,7,0,4
E33018651,404,256,65,191,3,59,35,24,81,77,1,3,0,5
E33018652,203,143,44,99,1,31,15,16,25,20,1,4,0,3
E33018653,219,155,41,114,1,36,19,17,27,25,0,1,1,0
E33018654,804,539,178,361,5,147,109,38,112,108,1,3,0,1
E33018655,204,122,38,84,7,26,14,12,46,43,0,3,0,3
E33018656,689,498,155,343,5,80,35,45,99,96,0,1,2,7
E33018657,220,175,49,126,2,22,11,11,21,21,0,0,0,0
E33018658,398,315,76,239,1,38,23,15,43,41,0,2,0,1
E33018659,261,198,68,130,5,31,16,15,27,19,2,6,0,0
E33018660,363,298,104,194,2,40,21,19,23,19,0,4,0,0
E33018661,260,195,51,144,1,33,16,17,29,27,0,1,1,2
E33018662,911,705,147,558,8,81,43,38,111,101,1,9,0,6
E33018663,356,239,86,153,1,69,41,28,42,40,0,1,1,5
E33018664,233,183,49,134,3,27,11,16,19,17,0,2,0,1
E33018665,313,208,66,142,2,52,23,29,48,42,0,4,2,3
E33018666,3500,2700,710,1990,25,366,180,186,398,364,6,23,5,11
E33018667,326,247,72,175,2,42,21,21,35,33,0,2,0,0
E33018668,254,193,72,121,1,28,14,14,30,26,0,3,1,2
E33018669,175,125,37,88,2,33,14,19,14,13,0,1,0,1
E33018670,312,229,82,147,2,50,25,25,29,27,0,1,1,2
E33018671,224,149,44,105,0,35,11,24,38,36,0,2,0,2
E33018672,2241,1597,398,1199,19,281,138,143,325,295,1,25,4,19
E33018673,470,348,97,251,4,58,29,29,55,51,0,4,0,5
E33018674,214,171,60,111,0,18,10,8,24,23,0,1,0,1
E33018675,311,273,69,204,0,5,5,0,32,25,1,5,1,1
E33018676,397,287,107,180,1,68,43,25,38,37,0,1,0,3
E33018677,411,256,66,190,2,103,76,27,50,47,0,3,0,0
E33018678,249,213,49,164,2,13,10,3,19,18,0,0,1,2
E33018679,268,210,75,135,1,27,21,6,29,28,0,1,0,1
E33018680,223,163,48,115,0,37,21,16,21,19,0,2,0,2
E33018681,1217,845,216,629,4,214,124,90,144,130,0,14,0,10
E33018682,237,166,42,124,0,35,20,15,35,31,0,3,1,1
E33018683,650,522,168,354,4,70,46,24,48,46,1,1,0,6
E33018684,615,399,133,266,3,151,123,28,57,50,1,4,2,5
E33018685,705,495,162,333,4,149,121,28,55,51,0,4,0,2
E33018686,409,265,92,173,1,77,59,18,60,58,0,1,1,6
E33018687,188,118,31,87,1,31,20,11,35,31,0,3,1,3
E33018688,449,328,122,206,0,64,56,8,54,49,0,5,0,3
E33018689,423,301,123,178,2,57,42,15,59,54,2,3,0,4
E33018690,305,228,83,145,1,36,30,6,38,36,0,2,0,2
E33018691,382,254,93,161,3,47,32,15,77,74,1,1,1,1
E33018692,215,171,60,111,2,21,16,5,20,20,0,0,0,1
E33018693,350,260,92,168,3,43,35,8,43,37,0,6,0,1
E33018694,526,369,111,258,3,78,68,10,71,63,0,6,2,5
E33018695,641,503,122,381,3,36,24,12,98,88,1,6,3,1
E33018696,636,510,124,386,10,68,43,25,44,34,3,6,1,4
E33018697,235,159,47,112,1,48,42,6,27,23,0,4,0,0
E33018698,509,375,109,266,2,73,57,16,58,57,0,1,0,1
E33018699,772,561,155,406,5,132,104,28,69,59,0,8,2,5
E33018700,243,166,71,95,1,49,41,8,27,24,0,1,2,0
E33018701,346,247,70,177,2,58,45,13,37,35,0,2,0,2
E33018702,266,177,60,117,0,56,37,19,32,28,0,3,1,1
E33018703,367,257,87,170,3,49,27,22,58,58,0,0,0,0
E33018704,237,168,54,114,2,44,40,4,20,18,0,2,0,3
E33018705,243,156,55,101,0,50,37,13,37,36,0,0,1,0
E33018706,1569,1098,325,773,11,265,206,59,180,169,0,10,1,15
E33018707,366,270,79,191,1,65,55,10,28,26,0,2,0,2
E33018708,820,687,144,543,5,47,25,22,78,75,1,2,0,3
E33018709,356,278,103,175,2,44,36,8,31,29,0,2,0,1
E33018710,669,531,151,380,3,63,44,19,71,67,0,4,0,1
E33018711,1963,1423,444,979,9,326,234,92,190,181,2,6,1,15
E33018712,213,136,50,86,0,50,40,10,27,23,0,4,0,0
E33018713,219,144,31,113,0,41,30,11,32,26,0,6,0,2
E33018714,1242,1007,262,745,2,97,57,40,126,112,1,12,1,10
E33018715,464,374,108,266,3,46,34,12,39,39,0,0,0,2
E33018716,996,840,228,612,0,70,52,18,83,78,0,5,0,3
E33018717,1066,776,245,531,4,135,108,27,142,126,2,11,3,9
E33018718,895,741,251,490,5,58,37,21,88,76,1,11,0,3
E33018719,871,658,168,490,7,77,52,25,120,109,1,10,0,9
E33018720,567,374,96,278,4,102,60,42,84,74,0,9,1,3
E33018721,849,690,204,486,4,71,48,23,82,72,0,5,5,2
E33018722,245,155,42,113,0,55,45,10,35,33,0,2,0,0
E33018723,356,260,74,186,7,44,31,13,44,38,2,3,1,1
E33018724,336,254,70,184,2,44,28,16,34,32,0,2,0,2
E33018725,836,640,189,451,0,72,56,16,122,116,0,6,0,2
E33018726,509,381,120,261,6,66,43,23,54,51,1,1,1,2
E33018727,660,508,145,363,5,65,45,20,78,72,0,5,1,4
E33018728,329,243,82,161,1,40,32,8,42,38,0,4,0,3
E33018729,525,400,108,292,1,69,57,12,50,45,1,4,0,5
E33018730,556,351,124,227,5,134,112,22,62,56,0,5,1,4
E33018731,261,192,76,116,1,38,25,13,28,23,0,3,2,2
E33018732,272,197,52,145,0,44,33,11,30,28,0,2,0,1
E33018733,783,558,174,384,3,130,86,44,88,82,0,6,0,4
E33018734,220,168,56,112,0,29,24,5,20,19,0,1,0,3
E33018735,264,185,65,120,1,51,34,17,27,25,0,2,0,0
E33018736,462,330,97,233,3,76,56,20,52,47,0,4,1,1
E33018737,721,562,215,347,3,36,10,26,115,102,1,12,0,5
E33018738,318,251,87,164,6,27,9,18,33,30,0,1,2,1
E33018739,466,341,126,215,3,32,6,26,70,65,2,3,0,20
E33018740,330,244,85,159,10,31,16,15,44,37,2,5,0,1
E33018741,836,573,176,397,10,102,29,73,146,127,3,13,3,5
E33018742,279,152,44,108,6,38,10,28,70,62,2,5,1,13
E33018743,204,143,38,105,8,17,6,11,35,30,1,2,2,1
E33018744,321,210,57,153,3,51,18,33,52,45,2,5,0,5
E33018745,499,386,113,273,2,50,15,35,56,53,0,3,0,5
E33018746,200,131,32,99,3,30,5,25,35,30,1,3,1,1
E33018747,276,179,66,113,4,55,21,34,36,28,3,3,2,2
E33018748,299,224,61,163,2,28,5,23,44,39,2,3,0,1
E33018749,348,221,96,125,2,52,17,35,65,58,2,4,1,8
E33018750,359,272,53,219,3,20,8,12,59,48,1,7,3,5
E33018751,1614,1102,329,773,19,177,58,119,306,276,6,20,4,10
E33018752,264,164,48,116,6,29,9,20,63,54,2,6,1,2
E33018753,525,328,90,238,11,98,33,65,80,76,1,2,1,8
E33018754,271,199,54,145,3,19,6,13,48,41,2,4,1,2
E33018755,216,166,71,95,2,8,3,5,37,33,0,3,1,3
E33018756,317,221,65,156,3,36,6,30,54,47,3,3,1,3
E33018757,234,177,54,123,2,17,7,10,37,33,1,3,0,1
E33018758,210,170,65,105,2,16,3,13,21,18,3,0,0,1
E33018759,248,174,51,123,1,24,14,10,46,41,2,3,0,3
E33018760,602,389,117,272,10,61,21,40,136,120,3,13,0,6
E33018761,244,180,64,116,4,14,3,11,43,34,2,7,0,3
E33018762,343,246,86,160,4,22,7,15,65,56,0,9,0,6
E33018763,767,565,182,383,7,44,15,29,145,128,6,11,0,6
E33018764,481,334,134,200,7,20,3,17,115,108,5,2,0,5
E33018765,421,276,99,177,5,54,23,31,80,72,2,3,3,6
E33018766,291,196,45,151,3,32,8,24,58,49,3,6,0,2
E33018767,298,209,53,156,5,41,18,23,41,37,0,3,1,2
E33018768,788,426,136,290,21,98,32,66,234,226,2,6,0,9
E33018769,295,202,66,136,8,40,10,30,44,39,0,5,0,1
E33018770,246,141,56,85,3,9,3,6,89,82,3,3,1,4
E33018771,828,526,157,369,17,54,14,40,223,215,5,2,1,8
E33018772,373,229,91,138,6,34,4,30,98,91,3,4,0,6
E33018773,519,332,91,241,13,62,14,48,107,99,0,8,0,5
E33018774,772,547,211,336,13,80,11,69,125,114,4,5,2,7
E33018775,201,145,50,95,5,12,4,8,36,34,0,2,0,3
E33018776,201,138,46,92,0,16,1,15,44,37,5,0,2,3
E33018777,369,234,102,132,6,35,6,29,93,90,0,3,0,1
E33018778,221,133,53,80,1,25,3,22,58,54,0,2,2,4
E33018779,247,167,55,112,0,20,3,17,60,57,1,2,0,0
E33018780,270,178,63,115,4,20,4,16,66,61,1,1,3,2
E33018781,634,431,147,284,8,57,21,36,132,114,3,15,0,6
E33018782,300,229,96,133,4,22,3,19,45,42,0,2,1,0
E33018783,788,545,180,365,5,61,24,37,170,155,3,12,0,7
E33018784,501,347,134,213,3,44,24,20,97,90,1,5,1,10
E33018785,553,306,86,220,11,139,54,85,95,83,2,9,1,2
E33018786,483,329,81,248,9,46,9,37,95,87,0,5,3,4
E33018787,924,657,207,450,14,111,38,73,142,127,3,8,4,0
E33018788,205,138,51,87,4,23,6,17,40,36,0,2,2,0
E33018789,2207,1107,303,804,24,223,75,148,845,810,5,18,12,8
E33018790,255,176,59,117,1,39,13,26,39,31,1,6,1,0
E33018791,242,163,43,120,5,25,9,16,46,41,2,3,0,3
E33018792,234,180,52,128,3,29,6,23,22,20,0,2,0,0
E33018793,222,175,68,107,4,20,7,13,22,18,0,4,0,1
E33018794,349,259,86,173,3,25,7,18,59,57,0,2,0,3
E33018795,859,690,140,550,5,50,20,30,113,99,1,11,2,1
E33018796,280,199,66,133,0,27,12,15,49,38,3,6,2,5
E33018797,237,183,49,134,0,31,19,12,22,20,1,0,1,1
E33018798,829,679,193,486,7,71,32,39,68,55,4,6,3,4
E33018799,650,463,126,337,3,86,45,41,95,93,1,1,0,3
E33018800,691,472,122,350,3,70,35,35,142,132,0,8,2,4
E33018801,309,227,48,179,1,30,12,18,46,43,0,3,0,5
E33018802,234,172,43,129,0,29,10,19,29,27,1,1,0,4
E33018803,1242,913,241,672,4,181,66,115,138,122,4,10,2,6
E33018804,2123,1706,497,1209,11,173,74,99,227,183,17,14,13,6
E33018805,393,247,56,191,1,57,25,32,85,79,1,4,1,3
E33018806,412,237,56,181,2,51,24,27,120,112,3,5,0,2
E33018807,365,280,67,213,2,37,19,18,45,41,1,3,0,1
E33018808,479,304,94,210,6,47,21,26,118,112,1,5,0,4
E33018809,338,231,62,169,1,52,24,28,50,42,3,4,1,4
E33018810,328,246,49,197,2,24,12,12,54,47,0,6,1,2
E33018811,336,241,68,173,0,37,16,21,55,49,1,4,1,3
E33018812,335,250,67,183,1,32,15,17,49,47,0,2,0,3
E33018813,370,275,68,207,1,34,16,18,56,51,1,3,1,4
E33018814,206,125,32,93,2,30,15,15,42,39,1,2,0,7
E33018815,428,308,86,222,1,54,27,27,58,49,0,8,1,7
E33018816,667,500,119,381,6,76,34,42,82,70,1,10,1,3
E33018817,229,148,46,102,0,47,22,25,33,31,0,2,0,1
E33018818,409,299,83,216,2,43,13,30,63,56,1,5,1,2
E33018819,213,141,46,95,0,22,10,12,45,40,3,2,0,5
E33018820,693,391,83,308,3,99,53,46,195,182,1,12,0,5
E33018821,1161,888,193,695,3,86,36,50,177,168,2,5,2,7
E33018822,998,716,166,550,2,119,44,75,152,142,2,5,3,9
E33018823,325,229,52,177,2,36,16,20,58,54,1,3,0,0
E33018824,1448,1220,268,952,5,63,14,49,154,141,3,10,0,6
E33018825,1441,1091,223,868,13,81,32,49,247,225,3,15,4,9
E33018826,886,737,178,559,4,53,25,28,88,77,1,9,1,4
E33018827,525,352,77,275,3,71,37,34,97,84,4,9,0,2
E33018828,401,282,52,230,2,49,19,30,65,56,2,5,2,3
E33018829,246,165,36,129,0,37,18,19,43,30,1,12,0,1
E33018830,376,243,57,186,3,64,31,33,64,59,2,3,0,2
E33018831,440,353,87,266,1,32,15,17,52,43,2,4,3,2
E33018832,267,203,52,151,0,23,8,15,40,37,1,2,0,1
E33018833,735,556,119,437,8,40,20,20,122,107,0,13,2,9
E33018834,605,406,117,289,1,80,37,43,107,99,3,5,0,11
E33018835,762,579,139,440,4,66,15,51,110,100,2,7,1,3
E33018836,605,486,114,372,1,51,21,30,67,59,2,6,0,0
E33018837,289,192,53,139,1,46,15,31,49,38,0,8,3,1
E33018838,260,198,36,162,0,30,13,17,32,31,0,1,0,0
E33018839,256,172,48,124,3,32,11,21,46,42,0,3,1,3
E33018840,201,146,41,105,2,20,8,12,30,29,0,1,0,3
E33018841,458,367,89,278,3,37,17,20,50,49,0,1,0,1
E33018842,369,235,53,182,6,57,22,35,70,63,0,7,0,1
E33018843,230,168,59,109,3,12,5,7,46,42,1,3,0,1
E33018844,648,514,147,367,3,35,16,19,95,86,1,7,1,1
E33018845,283,206,52,154,2,20,6,14,53,50,1,2,0,2
E33018846,313,232,67,165,1,30,13,17,49,47,0,2,0,1
E33018847,738,544,131,413,3,83,38,45,101,97,0,4,0,7
E33018848,1372,1039,264,775,6,102,43,59,215,196,1,13,5,10
E33018849,1518,1026,278,748,8,219,101,118,257,231,4,22,0,8
E33018850,257,168,46,122,2,35,14,21,52,49,0,3,0,0
E33018851,853,607,158,449,6,109,42,67,126,116,0,9,1,5
E33018852,1563,1020,238,782,13,220,95,125,301,290,0,11,0,9
E33018853,937,624,156,468,10,118,47,71,175,168,0,7,0,10
E33018854,775,530,118,412,6,92,40,52,144,133,2,9,0,3
E33018855,988,627,161,466,4,189,122,67,164,148,0,15,1,4
E33018856,280,169,39,130,0,24,14,10,84,81,0,3,0,3
E33018857,403,289,92,197,1,45,20,25,67,66,0,1,0,1
E33018858,381,253,60,193,3,47,28,19,77,69,1,6,1,1
E33018859,615,375,108,267,1,100,52,48,131,130,0,1,0,8
E33018860,372,267,61,206,2,34,19,15,68,65,0,3,0,1
E33018861,991,676,128,548,4,135,55,80,175,160,4,10,1,1
E33018862,541,435,112,323,0,58,39,19,45,40,0,5,0,3
E33018863,557,406,122,284,4,78,54,24,68,60,0,8,0,1
E33018864,490,378,96,282,2,54,41,13,55,54,0,1,0,1
E33018865,339,248,80,168,1,38,26,12,50,47,0,1,2,2
E33018866,1268,872,215,657,3,197,144,53,190,179,0,9,2,6
E33018867,863,601,155,446,2,119,81,38,139,121,5,13,0,2
E33018868,311,238,75,163,0,34,20,14,38,35,0,3,0,1
E33018869,765,529,178,351,2,144,93,51,83,79,0,4,0,7
E33018870,423,295,93,202,3,61,42,19,59,53,1,5,0,5
E33018871,473,343,103,240,0,72,43,29,54,49,0,3,2,4
E33018872,505,416,133,283,1,42,25,17,43,35,1,6,1,3
E33018873,201,125,39,86,2,43,29,14,29,26,0,3,0,2
E33018874,204,138,49,89,0,29,22,7,32,30,0,2,0,5
E33018875,212,152,46,106,1,22,17,5,32,31,0,1,0,5
E33018876,218,172,64,108,0,25,16,9,20,18,0,0,2,1
E33018877,206,165,41,124,2,16,12,4,19,17,0,2,0,4
E33018878,701,464,110,354,4,78,54,24,153,138,0,15,0,2
E33018879,428,328,123,205,2,56,42,14,41,39,0,2,0,1
E33018880,496,390,107,283,1,58,34,24,46,40,1,4,1,1
E33018881,1042,731,181,550,5,138,96,42,163,144,0,16,3,5
E33018882,223,179,56,123,0,21,8,13,20,15,0,5,0,3
E33018883,304,219,68,151,2,40,30,10,42,40,1,1,0,1
E33018884,353,283,91,192,0,35,20,15,34,31,0,2,1,1
E33018885,463,301,64,237,2,68,44,24,89,83,0,6,0,3
E33018886,448,329,101,228,0,53,40,13,62,54,0,5,3,4
E33018887,504,385,127,258,1,49,31,18,65,59,1,5,0,4
E33018888,213,128,40,88,2,35,19,16,46,43,0,3,0,2
E33018889,310,229,68,161,2,23,14,9,53,45,0,8,0,3
E33018890,212,139,35,104,1,37,26,11,34,32,0,2,0,1
E33018891,208,172,38,134,2,12,5,7,21,19,0,2,0,1
E33018892,251,191,47,144,0,27,18,9,31,27,0,3,1,2
E33018893,1520,1072,279,793,5,178,127,51,256,238,1,16,1,9
E33018894,258,185,63,122,1,35,26,9,35,35,0,0,0,2
E33018895,546,471,151,320,0,37,28,9,38,35,0,3,0,0
E33018896,199,134,34,100,0,28,16,12,35,32,0,3,0,2
E33018897,398,328,86,242,2,27,18,9,37,32,1,3,1,4
E33018898,336,256,74,182,0,34,16,18,45,33,5,6,1,1
E33018899,423,348,94,254,1,26,13,13,43,39,0,4,0,5
E33018900,271,209,59,150,2,21,16,5,39,37,0,2,0,0
E33018901,272,157,63,94,2,44,34,10,65,62,0,3,0,4
E33018902,375,275,93,182,1,41,25,16,54,48,0,5,1,4
E33018903,479,387,128,259,1,46,33,13,37,35,1,1,0,8
E33018904,261,190,45,145,2,38,21,17,26,26,0,0,0,5
E33018905,258,181,60,121,1,38,27,11,38,33,1,3,1,0
E33018906,253,157,52,105,0,29,19,10,66,58,0,3,5,1
E33018907,291,248,54,194,0,11,5,6,32,29,0,3,0,0
E33018908,649,494,89,405,1,44,25,19,106,99,1,4,2,4
E33018909,1763,1039,231,808,8,128,74,54,537,441,66,28,2,51
E33018910,627,435,111,324,3,71,47,24,113,104,0,8,1,5
E33018911,559,381,116,265,7,93,58,35,75,69,0,6,0,3
E33018912,422,362,94,268,0,20,14,6,37,29,0,7,1,3
E33018913,577,430,114,316,1,75,43,32,68,61,0,4,3,3
E33018914,236,167,58,109,2,23,12,11,44,39,0,5,0,0
E33018915,436,355,84,271,4,29,14,15,46,41,0,5,0,2
E33018916,248,197,54,143,0,26,19,7,23,23,0,0,0,2
E33018917,821,591,101,490,7,74,37,37,146,134,1,11,0,3
E33018918,509,366,84,282,2,56,31,25,82,70,0,10,2,3
E33018919,390,330,81,249,0,27,16,11,33,29,0,4,0,0
E33018920,4002,3175,729,2446,13,281,151,130,517,475,9,28,5,16
E33018921,1440,1171,302,869,4,124,82,42,135,127,0,8,0,6
E33018922,443,323,88,235,2,64,37,27,51,50,0,1,0,3
E33018923,306,230,84,146,1,22,14,8,47,44,0,3,0,6
E33018924,523,409,113,296,1,46,34,12,65,57,0,4,4,2
E33018925,349,271,80,191,3,26,17,9,45,40,0,4,1,4
E33018926,3403,2710,681,2029,7,282,156,126,394,359,8,25,2,10
E33018927,758,629,164,465,6,42,21,21,76,65,1,9,1,5
E33018928,237,202,76,126,0,17,13,4,16,14,0,1,1,2
E33018929,265,215,71,144,0,24,16,8,24,20,0,3,1,2
E33018930,301,262,59,203,1,15,13,2,21,17,0,4,0,2
E33018931,260,210,63,147,1,25,21,4,24,21,0,3,0,0
E33018932,197,146,38,108,1,23,22,1,27,20,0,7,0,0
E33018933,272,190,77,113,2,46,36,10,29,27,0,2,0,5
E33018934,208,161,58,103,0,25,19,6,20,17,0,3,0,2
E33018935,753,576,179,397,1,96,83,13,77,73,0,4,0,3
E33018936,270,225,81,144,0,20,18,2,22,16,0,5,1,3
E33018937,378,329,66,263,2,22,19,3,25,23,0,2,0,0
E33018938,612,468,152,316,0,78,59,19,62,55,1,5,1,4
E33018939,221,183,55,128,0,22,19,3,15,13,0,1,1,1
E33018940,230,186,62,124,2,10,6,4,30,25,1,3,1,2
E33018941,311,221,69,152,5,39,23,16,45,40,0,5,0,1
E33018942,640,484,152,332,3,56,40,16,94,89,0,3,2,3
E33018943,1487,1086,262,824,5,192,124,68,199,183,1,14,1,5
E33018944,349,248,67,181,3,51,40,11,43,38,0,3,2,4
E33018945,686,536,146,390,3,65,40,25,76,72,0,2,2,6
E33018946,181,121,31,90,0,38,24,14,20,18,0,1,1,2
E33018947,733,538,175,363,1,104,71,33,88,83,0,5,0,2
E33018948,400,311,94,217,2,36,29,7,48,44,1,3,0,3
E33018949,531,401,121,280,4,67,40,27,56,53,0,2,1,3
E33018950,720,559,139,420,1,84,57,27,74,69,0,5,0,2
E33018951,655,461,140,321,1,89,68,21,100,95,0,5,0,4
E33018952,285,176,58,118,2,25,15,10,70,59,0,7,4,12
E33018953,368,255,102,153,2,28,16,12,80,72,2,5,1,3
E33018954,354,246,92,154,2,40,26,14,63,59,0,3,1,3
E33018955,410,299,112,187,1,30,23,7,79,72,3,3,1,1
E33018956,856,659,225,434,4,84,59,25,102,91,1,10,0,7
E33018957,218,172,72,100,4,15,4,11,20,17,1,2,0,7
E33018958,517,358,90,268,0,48,27,21,105,89,2,14,0,6
E33018959,238,184,76,108,3,9,0,9,41,26,9,6,0,1
E33018960,303,233,89,144,3,28,14,14,36,28,5,3,0,3
E33018961,240,166,52,114,4,13,1,12,54,49,3,1,1,3
E33018962,198,136,47,89,0,22,6,16,36,30,1,3,2,4
E33018963,225,167,61,106,0,26,4,22,28,22,2,4,0,4
E33018964,234,172,62,110,1,15,6,9,45,37,3,2,3,1
E33018965,191,145,52,93,0,11,5,6,32,29,0,3,0,3
E33018966,903,621,186,435,9,84,24,60,181,158,15,6,2,8
E33018967,297,212,60,152,1,35,24,11,45,39,1,3,2,4
E33018968,754,543,150,393,3,64,34,30,138,125,7,5,1,6
E33018969,322,234,68,166,3,42,31,11,41,36,0,5,0,2
E33018970,240,179,61,118,1,24,17,7,35,31,0,2,2,1
E33018971,312,229,78,151,1,19,13,6,61,54,1,4,2,2
E33018972,206,144,43,101,0,31,21,10,26,24,0,1,1,5
E33018973,251,185,69,116,4,14,6,8,47,41,1,5,0,1
E33018974,226,154,46,108,1,19,11,8,50,46,1,0,3,2
E33018975,303,217,76,141,0,21,11,10,62,56,1,5,0,3
E33018976,202,143,40,103,1,17,13,4,39,31,0,7,1,2
E33018977,693,457,146,311,3,121,74,47,108,97,0,11,0,4
E33018978,232,171,55,116,2,26,17,9,30,27,0,3,0,3
E33018979,317,236,71,165,3,33,17,16,44,40,1,2,1,1
E33018980,1972,1538,473,1065,15,125,76,49,276,235,12,25,4,18
E33018981,261,196,65,131,0,30,20,10,34,29,1,4,0,1
E33018982,693,493,135,358,2,83,60,23,111,103,1,7,0,4
E33018983,315,247,103,144,2,24,17,7,34,32,1,1,0,8
E33018984,393,260,72,188,2,53,14,39,77,72,0,5,0,1
E33018985,482,183,54,129,9,68,23,45,222,217,1,4,0,0
E33018986,590,417,102,315,4,77,30,47,89,83,4,2,0,3
E33018987,274,152,36,116,4,51,18,33,61,54,2,3,2,6
E33018988,219,158,41,117,1,25,6,19,33,30,2,1,0,2
E33018989,213,158,43,115,2,12,8,4,40,38,1,1,0,1
E33018990,465,275,81,194,2,56,22,34,129,121,3,4,1,3
E33018991,417,348,104,244,0,26,10,16,40,38,0,1,1,3
E33018992,3274,2557,691,1866,15,188,50,138,497,441,14,32,10,17
E33018993,1060,802,215,587,7,73,20,53,168,155,0,12,1,10
E33018994,664,481,134,347,1,49,16,33,128,117,3,7,1,5
E33018995,445,335,103,232,3,23,8,15,79,65,0,8,6,5
E33018996,218,166,62,104,0,22,10,12,30,30,0,0,0,0
E33018997,444,299,92,207,5,42,17,25,93,78,2,12,1,5
E33018998,306,208,60,148,3,41,15,26,53,49,0,3,1,1
E33018999,350,246,59,187,3,33,6,27,66,59,0,7,0,2
E33019000,213,164,39,125,0,12,0,12,35,32,1,2,0,2
E33019001,241,171,35,136,0,14,1,13,54,51,0,1,2,2
E33019002,353,242,80,162,1,34,13,21,69,63,1,4,1,7
E33019003,203,140,40,100,4,11,2,9,46,42,1,2,1,2
E33019004,378,270,82,188,0,36,12,24,68,64,0,4,0,4
E33019005,281,247,83,164,2,5,0,5,26,22,0,3,1,1
E33019006,249,167,44,123,2,22,12,10,55,49,1,4,1,3
E33019007,333,221,68,153,1,29,8,21,80,76,1,3,0,2
E33019008,198,151,58,93,0,10,2,8,37,31,0,5,1,0
E33019009,322,227,59,168,5,26,11,15,62,59,0,1,2,2
E33019010,298,211,59,152,2,19,6,13,64,57,1,6,0,2
E33019011,303,214,80,134,3,34,12,22,51,42,1,5,3,1
E33019012,235,167,54,113,2,17,6,11,48,43,1,3,1,1
E33019013,235,175,62,113,1,11,5,6,46,43,0,2,1,2
E33019014,216,157,55,102,1,21,9,12,33,32,1,0,0,4
E33019015,311,260,66,194,2,11,4,7,38,30,1,5,2,0
E33019016,319,249,98,151,1,18,6,12,45,42,0,3,0,6
E33019017,1411,1144,337,807,7,77,20,57,173,156,1,13,3,10
E33019018,1797,1480,462,1018,12,95,34,61,201,185,4,12,0,9
E33019019,236,182,55,127,1,18,8,10,34,25,0,9,0,1
E33019020,840,643,202,441,5,75,34,41,116,102,2,12,0,1
E33019021,224,170,62,108,1,25,11,14,25,24,0,1,0,3
E33019022,416,294,84,210,2,52,13,39,67,65,0,2,0,1
E33019023,909,706,173,533,7,77,27,50,117,108,1,8,0,2
E33019024,524,403,129,274,1,36,13,23,78,64,4,9,1,6
E33019025,421,297,92,205,0,33,13,20,89,75,4,9,1,2
E33019026,283,173,50,123,6,52,16,36,50,45,1,4,0,2
E33019027,789,552,128,424,9,77,26,51,149,145,0,4,0,2
E33019028,510,349,91,258,4,63,22,41,92,87,0,5,0,2
E33019029,348,272,100,172,5,26,7,19,43,38,0,5,0,2
E33019030,625,441,168,273,7,42,14,28,123,103,8,8,4,12
E33019031,234,134,46,88,2,15,3,12,75,70,3,2,0,8
E33019032,351,223,81,142,2,29,10,19,94,87,1,5,1,3
E33019033,532,438,122,316,4,24,10,14,62,57,0,5,0,4
E33019034,599,404,107,297,0,55,12,43,127,113,4,9,1,13
E33019035,901,610,183,427,5,106,38,68,167,153,3,11,0,13
E33019036,403,292,89,203,4,26,7,19,79,72,2,5,0,2
E33019037,385,225,92,133,4,28,2,26,90,74,10,5,1,38
E33019038,236,164,77,87,3,13,2,11,48,43,2,1,2,8
E33019039,464,315,139,176,0,53,5,48,89,81,2,6,0,7
E33019040,196,134,54,80,3,13,3,10,44,42,0,2,0,2
E33019041,420,268,120,148,9,56,13,43,85,72,6,7,0,2
E33019042,234,170,75,95,2,19,1,18,37,32,1,2,2,6
E33019043,1041,867,229,638,4,52,22,30,115,104,2,9,0,3
E33019044,625,508,143,365,2,63,40,23,49,42,1,5,1,3
E33019045,337,278,72,206,0,29,16,13,30,27,0,2,1,0
E33019046,226,174,48,126,2,35,24,11,14,10,2,2,0,1
E33019047,339,255,60,195,2,40,19,21,39,38,0,1,0,3
E33019048,371,238,61,177,3,46,32,14,81,78,2,1,0,3
E33019049,1386,1037,286,751,4,164,81,83,174,166,0,8,0,7
E33019050,604,427,122,305,2,85,45,40,84,79,0,5,0,6
E33019051,460,344,71,273,1,61,37,24,49,45,0,4,0,5
E33019052,211,158,40,118,2,22,11,11,29,28,0,1,0,0
E33019053,406,284,89,195,3,51,30,21,64,57,2,5,0,4
E33019054,491,378,79,299,1,58,38,20,54,49,1,1,3,0
E33019055,212,167,51,116,0,18,13,5,27,27,0,0,0,0
E33019056,358,281,67,214,2,27,9,18,47,39,1,6,1,1
E33019057,205,150,37,113,1,30,12,18,23,18,1,2,2,1
E33019058,374,285,73,212,1,43,28,15,45,43,0,2,0,0
E33019059,234,182,69,113,4,30,17,13,18,17,0,1,0,0
E33019060,441,322,113,209,2,73,36,37,41,38,0,2,1,3
E33019061,338,252,75,177,4,45,23,22,35,35,0,0,0,2
E33019062,370,249,72,177,3,51,29,22,65,60,0,3,2,2
E33019063,445,360,101,259,3,34,19,15,46,41,0,5,0,2
E33019064,493,407,92,315,5,29,9,20,49,46,1,2,0,3
E33019065,358,284,78,206,1,30,18,12,42,39,0,3,0,1
E33019066,469,351,99,252,2,54,32,22,61,56,1,4,0,1
E33019067,292,204,56,148,1,33,17,16,53,44,0,9,0,1
E33019068,624,460,143,317,1,85,53,32,74,61,5,7,1,4
E33019069,419,315,90,225,2,43,28,15,57,55,1,1,0,2
E33019070,441,322,77,245,3,48,29,19,66,58,0,7,1,2
E33019071,712,556,170,386,3,68,34,34,83,77,1,2,3,2
E33019072,359,270,80,190,2,26,17,9,58,51,0,7,0,3
E33019073,297,195,60,135,3,45,21,24,52,49,1,2,0,2
E33019074,1687,1319,329,990,17,165,72,93,180,171,2,6,1,6
E33019075,765,604,162,442,5,85,41,44,67,63,1,3,0,4
E33019076,209,173,45,128,0,13,8,5,23,21,0,2,0,0
E33019077,497,373,96,277,2,47,31,16,71,64,1,4,2,4
E33019078,281,217,70,147,4,19,10,9,38,32,0,5,1,3
E33019079,409,274,87,187,5,58,26,32,69,65,0,4,0,3
E33019080,214,154,33,121,0,21,14,7,39,34,0,3,2,0
E33019081,1060,832,189,643,8,85,38,47,120,112,1,7,0,15
E33019082,462,359,85,274,4,27,9,18,69,60,0,8,1,3
E33019083,235,187,43,144,1,9,6,3,36,36,0,0,0,2
E33019084,445,368,85,283,1,13,4,9,62,60,2,0,0,1
E33019085,816,643,221,422,5,53,21,32,113,106,1,6,0,2
E33019086,198,157,41,116,1,15,9,6,25,19,2,3,1,0
E33019087,429,298,100,198,1,51,21,30,78,71,1,4,2,1
E33019088,445,343,98,245,2,30,15,15,68,66,0,2,0,2
E33019089,429,350,64,286,2,25,11,14,51,45,0,6,0,1
E33019090,359,275,77,198,0,28,10,18,55,49,1,5,0,1
E33019091,2283,1871,467,1404,6,142,67,75,250,219,15,14,2,14
E33019092,637,519,140,379,0,39,18,21,76,68,1,7,0,3
E33019093,578,427,118,309,2,35,16,19,110,102,2,5,1,4
E33019094,306,225,61,164,2,24,6,18,54,51,0,3,0,1
E33019095,488,397,90,307,1,38,16,22,51,47,0,4,0,1
E33019096,1096,732,180,552,7,99,45,54,247,233,1,13,0,11
E33019097,547,449,116,333,4,27,17,10,64,58,0,5,1,3
E33019098,237,180,74,106,0,9,6,3,45,40,1,0,4,3
E33019099,741,522,187,335,5,66,30,36,145,134,1,9,1,3
E33019100,287,197,45,152,0,32,11,21,58,56,0,2,0,0
E33019101,547,441,116,325,4,48,18,30,48,42,1,4,1,6
E33019102,261,187,54,133,1,29,12,17,42,39,0,3,0,2
E33019103,601,343,98,245,3,73,24,49,181,169,2,10,0,1
E33019104,295,230,72,158,4,15,6,9,43,39,0,3,1,3
E33019105,1193,780,186,594,6,112,47,65,289,272,0,17,0,6
E33019106,259,205,65,140,4,8,3,5,40,36,1,3,0,2
E33019107,154,122,50,72,1,15,4,11,14,13,0,1,0,2
E33019108,307,254,83,171,1,17,4,13,32,29,2,1,0,3
E33019109,494,371,104,267,8,46,15,31,64,57,0,5,2,5
E33019110,267,210,63,147,1,30,16,14,24,22,1,1,0,2
E33019111,263,197,60,137,0,33,16,17,33,27,0,6,0,0
E33019112,269,204,59,145,2,16,7,9,42,41,0,1,0,5
E33019113,897,649,235,414,8,139,79,60,97,93,0,4,0,4
E33019114,519,438,110,328,1,28,17,11,45,40,4,1,0,7
E33019115,1255,798,161,637,18,136,41,95,300,281,1,16,2,3
E33019116,286,203,55,148,2,32,10,22,41,30,4,2,5,8
E33019117,985,734,186,548,10,131,58,73,108,100,1,7,0,2
E33019118,371,288,79,209,1,42,8,34,38,35,0,3,0,2
E33019119,382,328,112,216,1,28,9,19,25,22,0,3,0,0
E33019120,450,332,73,259,5,46,13,33,64,60,0,4,0,3
E33019121,465,367,110,257,4,48,15,33,46,42,0,4,0,0
E33019122,474,364,90,274,3,44,23,21,60,51,1,7,1,3
E33019123,218,170,61,109,1,20,8,12,25,23,0,2,0,2
E33019124,308,223,78,145,2,14,1,13,66,51,14,1,0,3
E33019125,169,114,41,73,2,32,8,24,21,20,0,1,0,0
E33019126,381,297,80,217,2,25,10,15,53,51,0,1,1,4
E33019127,622,486,139,347,0,54,16,38,81,76,0,5,0,1
E33019128,616,462,130,332,4,73,18,55,74,67,4,3,0,3
E33019129,530,419,133,286,5,40,6,34,64,50,0,13,1,2
E33019130,219,176,35,141,0,13,5,8,27,25,0,2,0,3
E33019131,242,188,65,123,2,22,3,19,30,26,0,2,2,0
E33019132,677,559,166,393,4,35,10,25,79,72,3,2,2,0
E33019133,413,323,82,241,3,34,7,27,52,49,1,2,0,1
E33019134,514,368,103,265,4,74,12,62,65,56,1,7,1,3
E33019135,272,206,64,142,1,27,7,20,35,34,0,1,0,3
E33019136,312,229,46,183,1,46,8,38,34,32,0,1,1,2
E33019137,385,272,76,196,3,46,7,39,52,49,0,3,0,12
E33019138,1320,915,248,667,9,192,116,76,200,183,1,14,2,4
E33019139,256,205,56,149,0,24,14,10,24,23,0,1,0,3
E33019140,640,453,119,334,4,106,47,59,76,72,0,4,0,1
E33019141,986,638,159,479,6,155,74,81,182,175,1,6,0,5
E33019142,1423,831,245,586,3,237,124,113,346,331,0,15,0,6
E33019143,278,217,66,151,2,22,11,11,34,33,0,1,0,3
E33019144,653,463,136,327,1,115,61,54,70,65,0,4,1,4
E33019145,383,304,77,227,1,31,20,11,43,40,1,2,0,4
E33019146,268,192,56,136,0,16,10,6,53,46,0,7,0,7
E33019147,533,328,74,254,2,94,44,50,106,97,0,8,1,3
E33019148,398,275,78,197,0,63,26,37,56,52,0,3,1,4
E33019149,347,249,58,191,0,41,20,21,55,52,0,3,0,2
E33019150,994,779,251,528,3,110,45,65,96,83,1,8,4,6
E33019151,373,277,87,190,1,35,21,14,54,51,1,2,0,6
E33019152,293,244,62,182,2,22,13,9,25,21,0,4,0,0
E33019153,555,362,108,254,3,89,46,43,94,89,0,5,0,7
E33019154,295,230,57,173,1,23,11,12,40,38,0,2,0,1
E33019155,215,172,41,131,1,10,1,9,31,28,1,2,0,1
E33019156,306,216,46,170,3,27,14,13,56,50,1,4,1,4
E33019157,345,262,62,200,1,34,20,14,46,45,0,1,0,2
E33019158,517,369,87,282,2,60,36,24,84,78,0,5,1,2
E33019159,313,214,63,151,1,52,26,26,45,40,0,5,0,1
E33019160,761,593,184,409,4,63,39,24,98,94,1,3,0,3
E33019161,212,160,49,111,0,17,11,6,30,24,2,3,1,5
E33019162,517,389,86,303,7,45,23,22,73,66,0,6,1,3
E33019163,261,205,65,140,2,22,10,12,31,30,1,0,0,1
E33019164,909,686,194,492,2,112,68,44,108,101,1,5,1,1
E33019165,659,385,141,244,6,118,62,56,150,143,0,4,3,0
E33019166,693,561,172,389,5,70,31,39,52,49,1,2,0,5
E33019167,233,168,51,117,1,19,15,4,41,32,0,5,4,4
E33019168,1612,1090,263,827,14,217,66,151,277,254,3,19,1,14
E33019169,250,193,48,145,0,22,6,16,30,26,1,3,0,5
E33019170,602,472,132,340,3,50,22,28,64,51,4,9,0,13
E33019171,225,174,79,95,0,16,6,10,29,29,0,0,0,6
E33019172,283,201,53,148,1,47,29,18,33,31,0,2,0,1
E33019173,399,302,82,220,2,41,15,26,47,41,0,5,1,7
E33019174,1090,860,292,568,3,133,67,66,87,82,0,5,0,7
E33019175,513,378,129,249,4,76,47,29,48,43,0,5,0,7
E33019176,269,224,58,166,3,16,3,13,26,23,0,3,0,0
E33019177,163,121,33,88,0,17,5,12,25,23,0,0,2,0
E33019178,244,185,51,134,0,33,16,17,26,25,0,1,0,0
E33019179,350,259,87,172,1,35,21,14,50,46,1,3,0,5
E33019180,340,256,64,192,2,20,8,12,60,57,0,3,0,2
E33019181,699,566,174,392,1,52,26,26,73,69,0,4,0,7
E33019182,711,547,183,364,3,57,15,42,101,84,4,10,3,3
E33019183,446,302,84,218,2,65,22,43,76,69,0,6,1,1
E33019184,212,167,41,126,3,13,4,9,28,24,0,3,1,1
E33019185,780,546,170,376,6,102,31,71,122,109,0,6,7,4
E33019186,222,143,49,94,1,22,4,18,51,49,0,2,0,5
E33019187,381,304,87,217,0,26,11,15,47,41,1,4,1,4
E33019188,197,156,36,120,0,12,4,8,28,23,3,2,0,1
E33019189,463,315,100,215,3,65,28,37,78,74,0,4,0,2
E33019190,266,218,53,165,1,17,5,12,29,27,0,2,0,1
E33019191,365,281,81,200,3,25,4,21,50,44,0,6,0,6
E33019192,465,377,168,209,3,18,11,7,57,44,4,4,5,10
E33019193,219,164,51,113,1,22,11,11,31,29,1,1,0,1
E33019194,794,589,185,404,9,80,40,40,111,96,2,13,0,5
E33019195,338,248,70,178,1,36,14,22,51,40,2,5,4,2
E33019196,521,382,114,268,1,44,14,30,91,80,3,3,5,3
E33019197,263,206,69,137,0,22,9,13,34,31,0,2,1,1
E33019198,242,191,63,128,1,15,5,10,30,29,0,1,0,5
E33019199,219,166,55,111,1,21,4,17,29,28,0,1,0,2
E33019200,320,224,79,145,0,33,15,18,61,56,0,5,0,2
E33019201,641,470,139,331,1,61,32,29,104,92,1,11,0,5
E33019202,262,209,54,155,2,15,13,2,36,35,0,1,0,0
E33019203,1180,762,198,564,6,226,131,95,181,166,2,13,0,5
E33019204,789,562,154,408,4,110,50,60,109,101,0,8,0,4
E33019205,350,289,85,204,0,31,13,18,28,25,0,3,0,2
E33019206,1853,1285,378,907,7,178,89,89,351,329,1,20,1,32
E33019207,220,161,43,118,1,33,17,16,24,22,0,2,0,1
E33019208,233,194,48,146,1,10,4,6,28,25,1,2,0,0
E33019209,241,195,81,114,1,29,15,14,14,11,0,2,1,2
E33019210,212,170,49,121,2,12,5,7,27,24,0,1,2,1
E33019211,227,194,54,140,0,14,4,10,16,16,0,0,0,3
E33019212,296,235,90,145,1,27,18,9,32,25,4,2,1,1
E33019213,306,271,74,197,1,4,0,4,28,27,0,1,0,2
E33019214,195,146,48,98,1,15,6,9,31,26,0,2,3,2
E33019215,300,232,85,147,1,24,10,14,42,36,0,6,0,1
E33019216,292,211,65,146,3,31,15,16,46,44,0,2,0,1
E33019217,601,523,201,322,1,25,10,15,49,42,0,7,0,3
E33019218,458,370,118,252,2,38,21,17,47,41,0,5,1,1
E33019219,200,160,38,122,2,14,8,6,23,21,0,2,0,1
E33019220,242,173,59,114,0,29,18,11,40,33,1,4,2,0
E33019221,315,227,56,171,4,24,13,11,55,50,0,4,1,5
E33019222,296,239,63,176,1,26,15,11,30,26,0,4,0,0
E33019223,604,409,92,317,6,86,58,28,102,95,0,7,0,1
E33019224,669,526,122,404,5,90,60,30,46,43,0,3,0,2
E33019225,331,232,75,157,4,60,44,16,32,29,0,2,1,3
E33019226,349,241,65,176,3,58,39,19,44,38,0,6,0,3
E33019227,362,304,52,252,2,30,19,11,25,23,0,1,1,1
E33019228,938,617,139,478,9,155,99,56,154,145,1,8,0,3
E33019229,484,363,93,270,4,49,29,20,67,63,0,4,0,1
E33019230,770,557,117,440,4,90,55,35,114,104,0,10,0,5
E33019231,291,204,49,155,2,34,18,16,48,40,1,5,2,3
E33019232,1378,1041,276,765,7,181,98,83,145,132,1,9,3,4
E33019233,504,363,82,281,5,50,36,14,85,70,0,14,1,1
E33019234,224,158,35,123,2,26,17,9,38,37,0,1,0,0
E33019235,262,198,39,159,1,15,6,9,47,45,0,2,0,1
E33019236,214,143,52,91,0,40,25,15,31,27,0,4,0,0
E33019237,1084,808,236,572,5,123,75,48,144,128,0,13,3,4
E33019238,355,289,85,204,3,35,20,15,27,21,0,6,0,1
E33019239,552,440,113,327,4,55,38,17,50,45,0,5,0,3
E33019240,750,594,156,438,5,57,32,25,89,84,0,5,0,5
E33019241,323,258,74,184,1,18,15,3,45,40,0,3,2,1
E33019242,664,449,84,365,2,82,55,27,128,122,2,3,1,3
E33019243,432,309,98,211,0,54,31,23,67,60,1,6,0,2
E33019244,238,174,59,115,3,30,18,12,31,28,0,1,2,0
E33019245,200,151,50,101,0,23,22,1,25,19,0,6,0,1
E33019246,316,217,59,158,1,54,25,29,42,37,1,3,1,2
E33019247,247,186,54,132,2,27,23,4,31,27,1,2,1,1
E33019248,234,171,35,136,1,32,22,10,30,28,0,2,0,0
E33019249,2187,1690,315,1375,18,149,98,51,319,295,1,22,1,11
E33019250,284,215,65,150,2,28,20,8,39,35,0,2,2,0
E33019251,422,338,87,251,1,42,29,13,41,37,1,3,0,0
E33019252,413,298,91,207,6,51,35,16,53,48,1,4,0,5
E33019253,898,563,144,419,1,109,82,27,215,171,11,25,8,10
E33019254,552,440,111,329,3,46,27,19,61,56,1,4,0,2
E33019255,2155,1642,389,1253,14,215,142,73,273,259,0,14,0,11
E33019256,625,524,117,407,3,31,18,13,60,53,1,5,1,7
E33019257,245,211,67,144,1,11,8,3,20,19,0,1,0,2
E33019258,246,179,64,115,2,28,18,10,34,30,2,2,0,3
E33019259,359,259,79,180,1,28,19,9,67,63,2,2,0,4
E33019260,667,485,136,349,5,54,35,19,115,107,1,6,1,8
E33019261,217,173,53,120,0,19,14,5,22,22,0,0,0,3
E33019262,1653,1088,225,863,9,209,112,97,339,310,11,14,4,8
E33019263,1282,901,213,688,10,153,88,65,213,196,1,13,3,5
E33019264,653,449,123,326,1,57,37,20,132,122,2,8,0,14
E33019265,1020,709,165,544,13,134,89,45,157,147,1,9,0,7
E33019266,517,355,97,258,6,92,60,32,59,55,0,4,0,5
E33019267,615,460,139,321,3,70,50,20,78,76,0,2,0,4
E33019268,338,237,60,177,2,42,36,6,57,53,0,2,2,0
E33019269,202,144,38,106,4,31,21,10,21,19,0,2,0,2
E33019270,416,306,100,206,2,53,30,23,55,53,0,1,1,0
E33019271,664,444,115,329,3,88,55,33,127,109,2,14,2,2
E33019272,360,271,70,201,2,37,30,7,49,46,0,3,0,1
E33019273,203,154,36,118,0,14,10,4,34,27,1,6,0,1
E33019274,436,380,99,281,5,16,11,5,31,25,0,5,1,4
E33019275,687,595,181,414,3,44,32,12,43,37,2,2,2,2
E33019276,325,254,102,152,4,23,15,8,42,37,0,3,2,2
E33019277,618,402,123,279,5,97,62,35,112,99,0,11,2,2
E33019278,208,169,52,117,2,12,9,3,25,21,1,2,1,0
E33019279,269,230,67,163,0,14,10,4,24,23,0,1,0,1
E33019280,283,203,34,169,1,26,18,8,52,51,0,1,0,1
E33019281,257,178,56,122,3,29,22,7,46,40,0,6,0,1
E33019282,229,193,59,134,0,9,3,6,26,21,0,3,2,1
E33019283,3251,2590,645,1945,18,197,116,81,429,394,5,27,3,17
E33019284,308,242,86,156,3,22,15,7,37,31,0,5,1,4
E33019285,266,185,53,132,3,29,16,13,47,37,0,10,0,2
E33019286,445,324,99,225,6,55,38,17,58,54,1,2,1,2
E33019287,413,331,98,233,5,38,28,10,37,32,0,5,0,2
E33019288,617,493,164,329,1,46,27,19,76,68,0,8,0,1
E33019289,972,757,202,555,6,77,33,44,132,117,5,10,0,0
E33019290,315,249,77,172,1,25,17,8,39,37,0,1,1,1
E33019291,989,779,231,548,0,81,48,33,125,116,1,8,0,4
E33019292,284,252,86,166,1,11,5,6,20,18,0,2,0,0
E33019293,209,161,43,118,0,17,10,7,27,26,0,1,0,4
E33019294,639,485,150,335,3,68,54,14,79,78,0,1,0,4
E33019295,205,154,43,111,1,19,15,4,29,23,0,5,1,2
E33019296,441,336,76,260,3,47,34,13,54,50,1,3,0,1
E33019297,373,286,83,203,1,40,27,13,44,37,1,5,1,2
E33019298,612,478,163,315,9,49,35,14,75,56,6,13,0,1
E33019299,377,271,71,200,6,37,21,16,63,57,1,5,0,0
E33019300,746,572,178,394,9,65,39,26,99,87,1,11,0,1
E33019301,309,227,69,158,1,37,21,16,42,35,3,3,1,2
E33019302,254,197,54,143,2,26,17,9,28,23,1,4,0,1
E33019303,904,718,252,466,5,60,33,27,118,111,1,5,1,3
E33019304,314,249,89,160,3,32,18,14,30,30,0,0,0,0
E33019305,586,397,70,327,11,62,37,25,114,110,0,4,0,2
E33019306,735,539,156,383,8,64,35,29,122,115,1,5,1,2
E33019307,325,231,53,178,1,28,16,12,65,60,0,4,1,0
E33019308,498,333,84,249,8,56,30,26,91,81,1,6,3,10
E33019309,290,231,63,168,4,20,7,13,35,31,0,3,1,0
E33019310,504,254,58,196,4,46,25,21,196,189,1,5,1,4
E33019311,244,177,50,127,2,23,18,5,34,30,2,1,1,8
E33019312,407,302,86,216,4,32,20,12,67,63,1,3,0,2
E33019313,210,143,44,99,2,23,12,11,40,38,2,0,0,2
E33019314,350,278,91,187,0,17,10,7,55,49,1,3,2,0
E33019315,2175,1883,585,1298,6,59,29,30,218,205,1,10,2,9
E33019316,1190,810,206,604,9,137,74,63,228,215,4,9,0,6
E33019317,270,203,68,135,6,19,14,5,39,36,0,3,0,3
E33019318,333,254,87,167,6,22,8,14,51,46,2,3,0,0
E33019319,196,148,37,111,2,16,10,6,30,28,0,2,0,0
E33019320,348,237,75,162,3,40,25,15,67,67,0,0,0,1
E33019321,786,577,156,421,7,72,36,36,125,113,3,8,1,5
E33019322,441,340,82,258,2,29,11,18,69,64,0,4,1,1
E33019323,234,135,33,102,7,26,11,15,65,64,0,1,0,1
E33019324,205,155,52,103,1,26,13,13,23,22,1,0,0,0
E33019325,832,525,147,378,9,149,76,73,145,131,1,11,2,4
E33019326,199,150,32,118,5,15,8,7,28,27,0,1,0,1
E33019327,264,191,49,142,2,24,14,10,43,36,0,5,2,4
E33019328,432,299,76,223,6,52,20,32,70,66,0,4,0,5
E33019329,913,669,140,529,13,87,56,31,142,130,0,10,2,2
E33019330,354,266,75,191,3,28,17,11,56,45,4,7,0,1
E33019331,467,405,103,302,3,11,6,5,48,46,0,2,0,0
E33019332,291,238,70,168,2,16,4,12,34,29,1,3,1,1
E33019333,200,154,49,105,3,21,6,15,22,21,0,1,0,0
E33019334,452,315,77,238,9,38,14,24,89,85,2,2,0,1
E33019335,676,479,153,326,12,83,18,65,99,88,0,11,0,3
E33019336,399,307,110,197,2,40,15,25,49,43,0,6,0,1
E33019337,5016,4223,847,3376,24,124,63,61,629,599,4,23,3,16
E33019338,825,613,153,460,17,94,29,65,99,89,3,6,1,2
E33019339,287,213,81,132,4,23,5,18,38,32,6,0,0,9
E33019340,617,477,134,343,11,25,6,19,102,95,0,6,1,2
E33019341,301,228,63,165,5,25,7,18,43,40,0,2,1,0
E33019342,206,156,45,111,3,14,7,7,33,29,1,2,1,0
E33019343,378,229,73,156,5,51,16,35,91,89,0,1,1,2
E33019344,331,242,62,180,7,35,7,28,44,42,0,2,0,3
E33019345,304,216,73,143,4,44,8,36,38,33,0,4,1,2
E33019346,247,145,41,104,4,23,2,21,74,68,0,6,0,1
E33019347,255,164,52,112,3,34,8,26,54,54,0,0,0,0
E33019348,573,344,100,244,10,61,17,44,156,131,9,6,10,2
E33019349,470,338,116,222,8,50,6,44,70,60,0,9,1,4
E33019350,279,228,84,144,4,8,3,5,39,38,0,1,0,0
E33019351,455,319,106,213,10,48,9,39,73,69,2,2,0,5
E33019352,259,191,59,132,1,21,5,16,46,42,2,2,0,0
E33019353,245,147,31,116,4,33,3,30,60,53,0,7,0,1
E33019354,338,252,88,164,3,24,7,17,58,54,0,3,1,1
E33019355,284,207,65,142,2,13,3,10,62,59,1,1,1,0
E33019356,353,251,74,177,2,25,3,22,72,62,0,9,1,3
E33019357,451,346,95,251,7,36,5,31,61,53,2,6,0,1
E33019358,338,210,78,132,2,24,5,19,95,89,0,5,1,7
E33019359,784,479,129,350,15,81,11,70,204,195,0,9,0,5
E33019360,213,150,50,100,0,18,4,14,45,42,0,2,1,0
E33019361,285,143,52,91,6,28,3,25,105,102,2,1,0,3
E33019362,371,210,67,143,6,68,8,60,85,76,1,7,1,2
E33019363,721,492,113,379,3,73,48,25,151,139,1,8,3,2
E33019364,385,298,92,206,3,24,9,15,51,44,4,0,3,9
E33019365,344,200,57,143,10,30,9,21,98,96,0,2,0,6
E33019366,299,211,57,154,3,20,6,14,65,57,1,6,1,0
E33019367,292,170,55,115,5,50,12,38,66,62,0,3,1,1
E33019368,591,455,147,308,8,34,26,8,91,85,0,6,0,3
E33019369,315,229,65,164,0,33,28,5,52,48,0,4,0,1
E33019370,353,248,79,169,4,15,11,4,86,79,0,3,4,0
E33019371,333,230,63,167,7,19,11,8,71,63,3,5,0,6
E33019372,285,214,76,138,2,23,15,8,44,43,0,1,0,2
E33019373,273,190,31,159,3,23,8,15,54,51,0,2,1,3
E33019374,752,520,110,410,13,42,28,14,175,164,2,9,0,2
E33019375,417,297,67,230,4,33,19,14,83,80,0,3,0,0
E33019376,266,189,47,142,1,16,8,8,60,58,0,2,0,0
E33019377,546,374,87,287,4,22,9,13,145,137,0,8,0,1
E33019378,250,210,58,152,3,6,5,1,28,26,0,2,0,3
E33019379,1036,866,208,658,7,39,22,17,118,109,0,8,1,6
E33019380,236,181,51,130,4,18,15,3,32,27,0,3,2,1
E33019381,506,325,87,238,5,47,26,21,128,113,1,13,1,1
E33019382,564,375,124,251,8,77,51,26,100,90,2,7,1,4
E33019383,493,321,80,241,13,66,38,28,91,83,1,6,1,2
E33019384,380,275,78,197,5,25,18,7,71,66,0,5,0,4
E33019385,271,218,48,170,0,16,8,8,36,35,0,1,0,1
E33019386,664,490,146,344,8,42,27,15,115,101,2,11,1,9
E33019387,1184,966,334,632,9,68,44,24,135,119,2,11,3,6
E33019388,272,149,38,111,3,32,22,10,81,76,2,3,0,7
E33019389,1338,939,166,773,8,113,55,58,271,251,0,18,2,7
E33019390,1720,1264,300,964,22,159,57,102,270,248,2,18,2,5
E33019391,1149,738,184,554,14,136,67,69,259,251,0,8,0,2
E33019392,305,231,63,168,3,19,12,7,46,39,2,4,1,6
E33019393,278,217,57,160,3,6,3,3,47,44,0,3,0,5
E33019394,599,456,137,319,6,24,11,13,111,104,0,5,2,2
E33019395,588,495,129,366,4,15,9,6,72,65,0,5,2,2
E33019396,301,232,59,173,5,29,18,11,33,29,0,4,0,2
E33019397,275,187,44,143,5,28,15,13,53,48,0,5,0,2
E33019398,1582,1328,346,982,5,74,37,37,168,156,1,9,2,7
E33019399,2411,1945,376,1569,21,66,32,34,371,347,3,20,1,8
E33019400,1405,1113,294,819,11,114,67,47,164,148,1,14,1,3
E33019401,1517,1254,273,981,14,40,20,20,197,189,2,5,1,12
E33019402,457,353,93,260,3,34,25,9,64,59,3,2,0,3
E33019403,293,222,34,188,1,12,5,7,57,56,0,1,0,1
E33019404,657,423,126,297,10,128,81,47,95,87,5,3,0,1
E33019405,245,158,39,119,3,37,24,13,47,43,4,0,0,0
E33019406,266,204,54,150,3,30,23,7,29,24,2,3,0,0
E33019407,517,417,86,331,11,18,8,10,69,67,0,2,0,2
E33019408,967,790,220,570,11,52,27,25,112,106,0,5,1,2
E33019409,257,193,69,124,2,20,12,8,39,36,1,2,0,3
E33019410,470,354,105,249,3,19,9,10,92,86,1,5,0,2
E33019411,1293,1083,340,743,14,74,37,37,115,102,1,10,2,7
E33019412,266,176,60,116,1,28,15,13,55,41,9,4,1,6
E33019413,540,420,121,299,5,25,18,7,87,82,2,3,0,3
E33019414,352,220,88,132,2,65,38,27,63,54,7,2,0,2
E33019415,208,146,40,106,2,23,13,10,34,29,1,3,1,3
E33019416,244,184,51,133,3,17,13,4,40,36,0,2,2,0
E33019417,1852,1142,272,870,18,205,135,70,483,451,4,24,4,4
E33019418,245,164,56,108,0,39,29,10,40,35,1,2,2,2
E33019419,237,178,49,129,2,23,12,11,34,32,0,1,1,0
E33019420,562,421,114,307,9,52,24,28,79,77,0,2,0,1
E33019421,557,407,142,265,4,49,30,19,89,80,0,9,0,8
E33019422,353,263,69,194,2,37,19,18,47,39,2,4,2,4
E33019423,291,234,76,158,2,20,9,11,34,30,0,4,0,1
E33019424,711,545,183,362,4,86,31,55,72,65,1,6,0,4
E33019425,512,411,123,288,5,44,19,25,49,41,3,5,0,3
E33019426,176,140,55,85,0,16,5,11,20,18,0,2,0,0
E33019427,282,229,57,172,3,20,2,18,30,27,0,3,0,0
E33019428,195,150,43,107,2,15,4,11,27,24,0,3,0,1
E33019429,209,165,57,108,1,17,8,9,24,23,0,1,0,2
E33019430,327,230,55,175,5,36,14,22,54,49,2,1,2,2
E33019431,275,190,51,139,0,38,12,26,45,43,0,2,0,2
E33019432,656,474,148,326,3,92,30,62,82,71,1,9,1,5
E33019433,317,252,78,174,0,22,9,13,41,39,0,2,0,2
E33019434,1154,874,205,669,17,92,32,60,168,153,0,14,1,3
E33019435,231,190,53,137,0,21,8,13,18,16,1,1,0,2
E33019436,1442,1138,260,878,12,104,36,68,182,169,2,9,2,6
E33019437,280,221,59,162,1,18,10,8,36,31,0,5,0,4
E33019438,320,270,88,182,2,22,12,10,24,22,1,0,1,2
E33019439,994,760,185,575,4,26,14,12,194,186,0,8,0,10
E33019440,876,344,105,239,6,129,73,56,392,381,2,6,3,5
E33019441,355,263,108,155,2,47,5,42,39,31,3,5,0,4
E33019442,250,203,79,124,1,11,2,9,32,25,4,2,1,3
E33019443,436,308,105,203,6,33,11,22,82,77,2,3,0,7
E33019444,411,284,104,180,2,61,12,49,61,56,0,5,0,3
E33019445,223,137,55,82,5,45,8,37,34,31,1,2,0,2
E33019446,633,371,100,271,11,152,33,119,92,86,0,5,1,7
E33019447,493,320,79,241,11,40,6,34,117,103,1,13,0,5
E33019448,466,350,95,255,9,50,13,37,55,51,0,4,0,2
E33019449,338,257,81,176,4,24,8,16,51,45,0,6,0,2
E33019450,391,256,67,189,7,62,12,50,62,59,0,2,1,4
E33019451,696,460,136,324,9,96,16,80,126,120,0,5,1,5
E33019452,223,160,73,87,1,23,4,19,31,27,0,3,1,8
E33019453,223,163,58,105,3,13,3,10,39,35,0,4,0,5
E33019454,201,146,52,94,2,17,3,14,35,33,0,1,1,1
E33019455,442,308,86,222,5,47,7,40,76,66,1,8,1,6
E33019456,1025,700,176,524,11,172,129,43,134,127,0,7,0,8
E33019457,526,409,120,289,0,37,22,15,76,68,1,6,1,4
E33019458,319,254,48,206,3,20,14,6,40,33,0,7,0,2
E33019459,290,217,49,168,1,32,25,7,38,32,0,6,0,2
E33019460,223,157,45,112,1,30,16,14,34,33,0,1,0,1
E33019461,692,534,153,381,1,86,60,26,67,58,0,9,0,4
E33019462,299,210,63,147,9,19,12,7,59,54,0,3,2,2
E33019463,426,297,91,206,4,62,46,16,58,53,3,2,0,5
E33019464,678,526,111,415,6,53,31,22,91,88,0,2,1,2
E33019465,638,485,123,362,3,50,26,24,98,92,0,6,0,2
E33019466,296,230,70,160,5,25,15,10,36,33,1,2,0,0
E33019467,1240,830,189,641,5,139,103,36,262,251,0,11,0,4
E33019468,337,268,72,196,1,24,17,7,43,35,6,2,0,1
E33019469,1289,867,260,607,3,233,157,76,183,173,1,8,1,3
E33019470,217,154,33,121,0,29,16,13,33,32,0,0,1,1
E33019471,272,188,44,144,0,39,26,13,45,45,0,0,0,0
E33019472,244,181,48,133,2,26,18,8,35,31,0,4,0,0
E33019473,515,378,89,289,6,56,38,18,75,71,0,4,0,0
E33019474,831,574,139,435,6,129,87,42,120,114,0,6,0,2
E33019475,690,541,145,396,3,63,41,22,77,71,0,3,3,6
E33019476,791,590,163,427,5,86,60,26,107,97,0,10,0,3
E33019477,439,315,90,225,6,66,44,22,52,49,0,3,0,0
E33019478,459,324,96,228,1,88,64,24,46,44,0,2,0,0
E33019479,228,156,56,100,1,22,5,17,47,46,1,0,0,2
E33019480,220,165,56,109,1,14,5,9,40,38,0,2,0,0
E33019481,257,174,49,125,0,18,5,13,64,58,0,5,1,1
E33019482,293,217,73,144,6,14,6,8,54,53,0,1,0,2
E33019483,1072,813,239,574,10,93,30,63,151,138,2,8,3,5
E33019484,372,255,62,193,5,54,12,42,54,51,0,3,0,4
E33019485,543,394,110,284,7,24,9,15,105,95,6,4,0,13
E33019486,317,207,59,148,1,48,17,31,61,59,0,1,1,0
E33019487,246,164,54,110,3,17,3,14,56,51,0,3,2,6
E33019488,655,451,101,350,10,48,13,35,143,136,0,7,0,3
E33019489,271,189,62,127,3,23,1,22,55,51,1,3,0,1
E33019490,627,498,122,376,8,27,6,21,90,87,1,1,1,4
E33019491,815,575,140,435,15,78,25,53,142,131,3,8,0,5
E33019492,298,223,60,163,2,16,8,8,57,50,2,5,0,0
E33019493,3967,3019,773,2246,42,292,91,201,589,547,5,33,4,25
E33019494,429,342,97,245,7,19,5,14,58,45,4,9,0,3
E33019495,2288,1917,595,1322,26,114,28,86,223,200,5,16,2,8
E33019496,948,734,164,570,8,77,31,46,126,113,0,12,1,3
E33019497,540,386,113,273,4,32,14,18,113,106,0,7,0,5
E33019498,137,105,22,83,3,7,2,5,21,18,0,2,1,1
E33019499,521,330,113,217,4,93,14,79,88,80,1,6,1,6
E33019500,272,173,47,126,5,36,5,31,57,53,2,2,0,1
E33019501,200,150,45,105,2,21,4,17,24,20,0,4,0,3
E33019502,364,306,112,194,0,27,7,20,30,27,1,2,0,1
E33019503,225,173,51,122,2,18,4,14,32,30,1,1,0,0
E33019504,371,276,94,182,3,42,5,37,45,42,0,3,0,5
E33019505,339,285,84,201,1,12,1,11,38,37,0,1,0,3
E33019506,568,379,91,288,2,105,19,86,78,75,0,3,0,4
E33019507,495,374,112,262,2,64,13,51,53,49,0,3,1,2
E33019508,163,111,37,74,3,22,8,14,26,21,1,4,0,1
E33019509,1347,883,283,600,11,216,63,153,233,217,1,15,0,4
E33019510,721,470,123,347,7,78,16,62,164,158,3,3,0,2
E33019511,254,196,61,135,4,24,4,20,26,26,0,0,0,4
E33019512,637,434,154,280,7,97,15,82,93,89,2,2,0,6
E33019513,246,190,59,131,2,24,3,21,30,28,0,2,0,0
E33019514,418,286,96,190,1,60,6,54,68,61,2,4,1,3
E33019515,566,336,103,233,3,63,8,55,161,154,2,3,2,3
E33019516,570,366,102,264,4,68,16,52,129,121,2,5,1,3
E33019517,314,242,94,148,1,17,5,12,45,42,1,2,0,9
E33019518,1720,1066,292,774,24,219,94,125,398,376,3,18,1,13
E33019519,269,214,68,146,2,17,5,12,34,30,0,4,0,2
E33019520,273,197,71,126,3,34,9,25,37,36,1,0,0,2
E33019521,1748,1466,271,1195,9,59,16,43,205,177,1,24,3,9
E33019522,652,476,103,373,6,28,12,16,136,131,1,4,0,6
E33019523,382,283,74,209,4,44,9,35,51,47,3,1,0,0
E33019524,302,246,70,176,2,22,5,17,31,27,0,4,0,1
E33019525,293,221,55,166,7,24,11,13,38,35,1,2,0,3
E33019526,412,305,99,206,4,37,5,32,62,55,4,3,0,4
E33019527,331,221,63,158,2,39,7,32,68,65,0,3,0,1
E33019528,316,227,84,143,4,27,2,25,56,49,2,4,1,2
E33019529,303,222,94,128,1,37,6,31,39,35,1,3,0,4
E33019530,214,149,62,87,0,25,2,23,37,32,1,4,0,3
E33019531,1313,1008,305,703,6,121,50,71,173,164,0,8,1,5
E33019532,1026,786,238,548,12,84,49,35,138,129,0,9,0,6
E33019533,792,559,190,369,7,104,44,60,119,113,0,6,0,3
E33019534,249,189,51,138,0,24,8,16,36,30,0,6,0,0
E33019535,205,139,45,94,1,24,12,12,41,35,2,3,1,0
E33019536,316,255,73,182,0,16,6,10,45,44,0,1,0,0
E33019537,246,188,64,124,1,21,4,17,35,34,0,1,0,1
E33019538,282,238,92,146,3,11,1,10,26,24,0,2,0,4
E33019539,539,417,149,268,2,43,18,25,75,67,0,6,2,2
E33019540,383,266,63,203,1,44,24,20,70,66,0,4,0,2
E33019541,317,197,67,130,0,62,26,36,58,55,0,3,0,0
E33019542,839,589,167,422,3,93,41,52,147,139,0,7,1,7
E33019543,237,178,53,125,4,15,4,11,39,36,0,2,1,1
E33019544,215,154,51,103,3,29,14,15,26,22,0,4,0,3
E33019545,287,240,78,162,3,11,7,4,31,24,0,7,0,2
E33019546,312,249,71,178,3,13,4,9,46,43,0,3,0,1
E33019547,283,213,67,146,1,32,17,15,36,33,0,3,0,1
E33019548,485,366,130,236,4,32,8,24,80,75,1,3,1,3
E33019549,596,436,163,273,9,63,25,38,84,81,0,3,0,4
E33019550,359,273,98,175,0,29,11,18,55,51,2,2,0,2
E33019551,795,612,233,379,7,65,39,26,103,95,0,8,0,8
E33019552,737,599,182,417,5,45,23,22,87,82,0,5,0,1
E33019553,466,378,127,251,4,42,18,24,42,39,1,2,0,0
E33019554,332,258,88,170,3,30,14,16,39,35,0,3,1,2
E33019555,1324,898,248,650,20,184,75,109,219,206,0,12,1,3
E33019556,476,323,107,216,2,62,32,30,84,75,3,6,0,5
E33019557,720,527,137,390,4,63,30,33,120,107,1,12,0,6
E33019558,260,209,65,144,1,22,10,12,26,23,1,0,2,2
E33019559,199,164,53,111,0,16,5,11,18,17,1,0,0,1
E33019560,327,271,70,201,2,15,5,10,39,39,0,0,0,0
E33019561,207,155,38,117,1,21,13,8,29,27,0,2,0,1
E33019562,321,237,55,182,1,33,13,20,48,39,0,8,1,2
E33019563,386,317,84,233,0,14,5,9,53,42,2,6,3,2
E33019564,247,188,65,123,2,10,3,7,44,41,0,3,0,3
E33019565,1147,1000,246,754,5,51,16,35,86,84,1,1,0,5
E33019566,235,194,45,149,2,13,6,7,22,22,0,0,0,4
E33019567,239,208,45,163,0,7,4,3,23,21,0,0,2,1
E33019568,1099,861,260,601,7,96,40,56,129,106,3,16,4,6
E33019569,224,165,39,126,2,16,9,7,39,38,0,0,1,2
E33019570,660,506,175,331,5,25,10,15,122,114,2,6,0,2
E33019571,1080,958,175,783,0,36,14,22,85,82,1,2,0,1
E33019572,137,78,23,55,2,14,6,8,42,41,0,1,0,1
E33019573,260,192,40,152,0,29,6,23,39,33,1,3,2,0
E33019574,799,564,171,393,5,96,38,58,124,112,2,8,2,10
E33019575,1104,815,246,569,5,108,31,77,169,152,2,11,4,7
E33019576,1124,852,233,619,7,88,34,54,170,148,12,8,2,7
E33019577,366,217,57,160,2,49,12,37,93,85,2,5,1,5
E33019578,249,162,41,121,3,49,31,18,34,33,0,1,0,1
E33019579,470,332,108,224,4,52,33,19,77,72,2,2,1,5
E33019580,330,183,61,122,3,50,39,11,93,89,3,1,0,1
E33019581,674,484,174,310,2,61,40,21,122,117,1,3,1,5
E33019582,200,136,54,82,0,30,23,7,32,30,0,2,0,2
E33019583,477,419,137,282,3,31,21,10,22,21,0,1,0,2
E33019584,113,63,18,45,0,28,24,4,22,21,0,1,0,0
E33019585,590,427,134,293,3,71,56,15,88,81,0,6,1,1
E33019586,236,185,62,123,1,27,25,2,22,22,0,0,0,1
E33019587,205,145,53,92,1,30,18,12,29,24,1,4,0,0
E33019588,285,178,50,128,3,60,42,18,43,40,0,3,0,1
E33019589,207,148,31,117,0,25,15,10,33,29,2,2,0,1
E33019590,315,210,80,130,1,40,25,15,61,53,3,4,1,3
E33019591,905,610,182,428,6,164,124,40,118,113,0,4,1,7
E33019592,503,313,92,221,4,79,59,20,104,97,0,7,0,3
E33019593,483,362,150,212,0,61,42,19,57,54,0,3,0,3
E33019594,255,150,41,109,1,65,39,26,38,34,0,3,1,1
E33019595,1525,1207,260,947,11,108,71,37,192,180,2,8,2,7
E33019596,263,171,52,119,0,38,25,13,46,44,0,2,0,8
E33019597,2480,2042,628,1414,12,236,171,65,177,155,2,15,5,13
E33019598,1254,1021,319,702,11,80,54,26,137,122,2,9,4,5
E33019599,579,407,126,281,3,86,63,23,80,77,0,1,2,3
E33019600,393,277,100,177,0,78,54,24,37,30,0,7,0,1
E33019601,240,169,55,114,1,27,18,9,43,39,2,2,0,0
E33019602,285,195,38,157,1,29,20,9,56,50,1,3,2,4
E33019603,355,269,106,163,1,52,38,14,31,29,0,2,0,2
E33019604,701,557,188,369,6,76,48,28,59,59,0,0,0,3
E33019605,292,241,70,171,0,23,8,15,28,28,0,0,0,0
E33019606,253,197,66,131,0,28,20,8,27,26,1,0,0,1
E33019607,518,355,106,249,4,93,66,27,62,59,0,3,0,4
E33019608,312,229,65,164,0,36,20,16,42,38,0,4,0,5
E33019609,699,566,178,388,6,53,42,11,72,63,4,5,0,2
E33019610,598,405,111,294,3,107,87,20,82,79,1,2,0,1
E33019611,615,493,93,400,4,47,34,13,68,59,1,5,3,3
E33019612,415,282,91,191,2,90,65,25,40,39,1,0,0,1
E33019613,372,287,83,204,0,43,36,7,39,34,4,0,1,3
E33019614,220,186,55,131,2,16,12,4,13,9,0,3,1,3
E33019615,1047,692,186,506,5,212,171,41,132,127,2,2,1,6
E33019616,259,182,71,111,4,45,33,12,28,26,0,2,0,0
E33019617,593,401,124,277,5,119,99,20,62,59,0,3,0,6
E33019618,486,340,68,272,3,77,60,17,62,53,1,7,1,4
E33019619,502,399,95,304,4,37,19,18,59,54,0,3,2,3
E33019620,381,256,82,174,2,70,27,43,51,47,1,3,0,2
E33019621,824,393,128,265,9,107,56,51,308,300,1,6,1,7
E33019622,1290,941,273,668,7,152,73,79,181,163,0,12,6,9
E33019623,424,332,86,246,4,41,14,27,47,42,0,5,0,0
E33019624,587,499,115,384,4,31,19,12,51,46,1,3,1,2
E33019625,472,346,89,257,3,52,23,29,69,57,0,10,2,2
E33019626,413,319,88,231,2,45,24,21,45,43,0,2,0,2
E33019627,263,212,45,167,1,21,12,9,28,28,0,0,0,1
E33019628,258,179,47,132,0,39,15,24,37,35,0,2,0,3
E33019629,287,213,63,150,1,47,22,25,26,24,0,2,0,0
E33019630,450,351,97,254,3,46,24,22,49,46,0,3,0,1
E33019631,454,335,95,240,4,53,28,25,57,52,2,3,0,5
E33019632,961,667,178,489,6,142,80,62,143,131,0,10,2,3
E33019633,481,399,129,270,2,40,20,20,38,28,0,9,1,2
E33019634,398,286,94,192,0,63,29,34,48,41,0,7,0,1
E33019635,773,526,160,366,9,118,55,63,112,105,0,6,1,8
E33019636,616,371,110,261,2,167,75,92,74,68,0,4,2,2
E33019637,611,399,101,298,3,128,55,73,78,75,0,2,1,3
E33019638,416,302,95,207,3,54,31,23,55,51,0,4,0,2
E33019639,382,256,86,170,4,68,27,41,53,51,0,2,0,1
E33019640,1141,831,250,581,7,162,73,89,137,123,0,14,0,4
E33019641,531,394,127,267,3,77,32,45,55,55,0,0,0,2
E33019642,466,275,86,189,1,92,45,47,91,86,1,4,0,7
E33019643,257,193,59,134,1,28,16,12,35,30,0,4,1,0
E33019644,248,161,46,115,2,44,26,18,41,37,0,2,2,0
E33019645,347,228,67,161,1,46,23,23,61,57,1,2,1,11
E33019646,220,162,57,105,1,28,7,21,28,28,0,0,0,1
E33019647,1396,1128,324,804,10,139,49,90,115,102,0,11,2,4
E33019648,295,254,44,210,4,12,6,6,25,24,1,0,0,0
E33019649,373,316,60,256,2,27,18,9,28,26,0,1,1,0
E33019650,3114,2266,519,1747,26,354,219,135,460,430,3,25,2,8
E33019651,885,612,134,478,11,96,52,44,164,160,0,3,1,2
E33019652,1135,679,159,520,9,103,60,43,336,311,5,19,1,8
E33019653,1189,805,154,651,8,121,70,51,255,238,2,14,1,0
E33019654,1274,958,262,696,9,141,98,43,165,145,2,15,3,1
E33019655,861,609,134,475,16,76,36,40,160,149,1,9,1,0
E33019656,615,459,111,348,11,55,21,34,88,81,1,5,1,2
E33019657,473,296,93,203,4,38,27,11,103,41,56,2,4,32
E33019658,305,230,57,173,2,32,16,16,41,40,0,0,1,0
E33019659,823,552,120,432,18,77,37,40,170,159,0,11,0,6
E33019660,786,626,177,449,3,59,35,24,90,82,4,3,1,8
E33019661,293,190,46,144,0,28,13,15,74,68,0,6,0,1
E33019662,1656,1018,232,786,17,159,81,78,452,436,1,14,1,10
E33019663,251,193,70,123,2,26,8,18,30,28,1,1,0,0
E33019664,245,206,48,158,1,13,4,9,24,20,2,2,0,1
E33019665,275,214,54,160,1,13,6,7,44,40,0,4,0,3
E33019666,349,253,81,172,2,33,12,21,60,58,0,2,0,1
E33019667,949,666,202,464,2,107,41,66,172,157,2,11,2,2
E33019668,256,207,76,131,1,14,6,8,33,33,0,0,0,1
E33019669,1406,1158,253,905,4,44,16,28,190,175,1,13,1,10
E33019670,419,275,72,203,3,43,21,22,90,86,0,4,0,8
E33019671,612,455,145,310,3,52,19,33,98,91,0,7,0,4
E33019672,291,178,46,132,3,26,8,18,83,77,1,5,0,1
E33019673,397,277,80,197,4,31,11,20,83,74,1,7,1,2
E33019674,508,386,111,275,3,39,12,27,71,68,0,3,0,9
E33019675,530,418,135,283,2,34,15,19,76,69,0,7,0,0
E33019676,341,255,88,167,2,26,9,17,56,53,1,2,0,2
E33019677,363,248,56,192,1,26,14,12,85,74,3,8,0,3
E33019678,237,183,56,127,1,16,8,8,36,34,0,2,0,1
E33019679,1731,1011,236,775,13,218,76,142,483,457,2,23,1,6
E33019680,684,567,143,424,4,27,12,15,84,75,3,6,0,2
E33019681,773,521,123,398,6,97,41,56,146,139,2,4,1,3
E33019682,694,557,153,404,6,50,22,28,78,70,2,6,0,3
E33019683,1273,893,204,689,8,166,102,64,201,192,1,7,1,5
E33019684,268,199,67,132,2,36,21,15,29,27,1,1,0,2
E33019685,1470,1137,287,850,7,125,43,82,194,175,3,14,2,7
E33019686,1582,1019,232,787,11,147,45,102,396,177,115,18,86,9
E33019687,218,164,71,93,0,11,4,7,42,30,10,0,2,1
E33019688,1803,1285,368,917,10,287,238,49,212,188,4,19,1,9
E33019689,141,116,44,72,1,14,13,1,9,8,0,0,1,1
E33019690,2536,1841,473,1368,12,341,270,71,330,306,0,21,3,12
E33019691,777,571,141,430,5,105,81,24,94,82,0,10,2,2
E33019692,203,165,58,107,1,21,19,2,16,16,0,0,0,0
E33019693,543,427,139,288,3,62,50,12,51,48,1,2,0,0
E33019694,858,621,189,432,3,132,110,22,95,88,0,7,0,7
E33019695,216,173,42,131,1,19,16,3,22,20,0,2,0,1
E33019696,578,386,124,262,6,118,102,16,66,56,0,10,0,2
E33019697,270,184,42,142,5,29,22,7,51,47,1,1,2,1
E33019698,229,173,49,124,2,34,32,2,19,16,0,2,1,1
E33019699,219,153,58,95,2,35,31,4,25,23,0,2,0,4
E33019700,370,336,100,236,2,13,10,3,17,17,0,0,0,2
E33019701,1105,933,301,632,6,85,71,14,77,69,1,4,3,4
E33019702,686,570,181,389,7,52,44,8,56,52,1,0,3,1
E33019703,220,182,75,107,0,21,11,10,16,14,0,2,0,1
E33019704,243,192,58,134,2,25,21,4,21,18,0,2,1,3
E33019705,330,264,60,204,2,23,11,12,41,39,0,2,0,0
E33019706,286,218,58,160,0,32,22,10,33,33,0,0,0,3
E33019707,572,408,140,268,1,87,69,18,74,68,0,6,0,2
E33019708,455,321,100,221,4,41,14,27,84,79,0,4,1,5
E33019709,395,291,93,198,3,33,15,18,67,57,2,3,5,1
E33019710,1030,855,199,656,7,73,31,42,90,83,0,6,1,5
E33019711,1187,907,240,667,5,142,94,48,129,116,0,11,2,4
E33019712,400,337,132,205,2,32,16,16,26,25,0,1,0,3
E33019713,344,261,62,199,1,47,27,20,34,34,0,0,0,1
E33019714,321,252,83,169,0,23,16,7,45,42,0,3,0,1
E33019715,306,213,51,162,0,48,33,15,42,41,0,1,0,3
E33019716,718,600,195,405,3,47,29,18,62,57,0,5,0,6
E33019717,368,290,92,198,0,40,25,15,36,31,0,5,0,2
E33019718,1081,802,268,534,6,26,13,13,240,222,6,8,4,7
E33019719,812,669,153,516,7,19,8,11,113,99,1,13,0,4
E33019720,1546,1245,267,978,19,63,30,33,213,202,1,8,2,6
E33019721,208,173,40,133,2,8,2,6,25,24,0,1,0,0
E33019722,597,486,102,384,2,42,16,26,60,51,4,4,1,7
E33019723,551,403,113,290,1,37,15,22,104,97,0,6,1,6
E33019724,2466,1847,589,1258,16,91,31,60,493,467,1,23,2,19
E33019725,966,835,279,556,8,36,7,29,85,78,0,5,2,2
E33019726,394,271,67,204,4,33,8,25,82,78,1,3,0,4
E33019727,220,132,38,94,1,23,5,18,47,42,0,3,2,17
E33019728,245,150,47,103,1,28,8,20,65,59,0,4,2,1
E33019729,826,654,175,479,5,45,18,27,116,108,2,5,1,6
E33019730,483,388,110,278,5,36,8,28,53,51,0,1,1,1
E33019731,1326,1073,228,845,15,48,18,30,186,165,1,15,5,4
E33019732,471,414,126,288,3,19,9,10,35,32,0,3,0,0
E33019733,278,201,54,147,0,31,7,24,44,40,0,3,1,2
E33019734,550,443,90,353,4,26,14,12,77,70,0,7,0,0
E33019735,355,287,86,201,1,22,5,17,44,41,0,3,0,1
E33019736,532,444,105,339,3,21,8,13,62,58,0,4,0,2
E33019737,461,382,92,290,5,13,5,8,60,56,0,4,0,1
E33019738,543,466,133,333,2,20,4,16,51,48,1,2,0,4
E33019739,313,241,80,161,1,26,12,14,44,40,0,2,2,1
E33019740,882,759,242,517,6,42,12,30,70,57,1,11,1,5
E33019741,365,269,71,198,4,22,7,15,70,67,0,3,0,0
E33019742,306,232,63,169,4,28,10,18,40,37,1,2,0,2
E33019743,639,472,157,315,3,55,12,43,100,93,1,5,1,9
E33019744,527,349,127,222,3,60,17,43,112,105,0,7,0,3
E33019745,849,643,232,411,6,49,13,36,146,136,1,9,0,5
E33019746,242,161,62,99,1,20,6,14,57,51,1,2,3,3
E33019747,264,188,53,135,2,28,14,14,45,26,14,5,0,1
E33019748,414,328,117,211,2,20,9,11,52,45,6,1,0,12
E33019749,295,221,58,163,2,32,20,12,39,33,5,1,0,1
E33019750,1116,864,216,648,10,79,41,38,154,142,0,12,0,9
E33019751,1119,838,251,587,11,38,15,23,224,214,2,8,0,8
E33019752,245,164,45,119,0,12,10,2,66,62,0,4,0,3
E33019753,333,263,69,194,1,16,3,13,51,45,0,6,0,2
E33019754,365,248,72,176,5,32,8,24,78,69,1,6,2,2
E33019755,230,172,50,122,2,18,2,16,35,34,0,1,0,3
E33019756,313,244,75,169,2,21,6,15,45,40,0,5,0,1
E33019757,402,241,71,170,6,64,25,39,90,81,0,9,0,1
E33019758,224,165,34,131,2,13,7,6,43,40,0,3,0,1
E33019759,234,150,39,111,0,32,9,23,50,43,0,6,1,2
E33019760,210,94,26,68,3,24,3,21,85,77,4,4,0,4
E33019761,616,421,119,302,3,54,23,31,136,127,0,8,1,2
E33019762,210,112,30,82,5,30,13,17,60,54,0,5,1,3
E33019763,239,145,34,111,2,11,2,9,78,74,0,4,0,3
E33019764,511,343,93,250,7,63,16,47,96,90,0,6,0,2
E33019765,427,273,55,218,4,30,14,16,117,113,2,2,0,3
E33019766,477,322,105,217,5,69,29,40,75,69,0,6,0,6
E33019767,601,370,94,276,4,68,33,35,154,144,0,10,0,5
E33019768,243,197,58,139,3,11,4,7,32,29,0,3,0,0
E33019769,839,666,221,445,3,40,9,31,110,102,3,5,0,20
E33019770,753,429,126,303,5,38,14,24,279,267,1,9,2,2
E33019771,286,219,70,149,2,17,10,7,36,32,4,0,0,12
E33019772,617,468,128,340,12,32,7,25,102,87,3,12,0,3
E33019773,521,280,53,227,4,36,20,16,193,190,0,3,0,8
E33019774,222,170,55,115,2,13,10,3,36,31,0,4,1,1
E33019775,206,125,39,86,2,18,12,6,54,51,1,2,0,7
E33019776,232,161,39,122,0,25,15,10,44,40,1,3,0,2
E33019777,265,164,39,125,4,15,7,8,79,70,0,9,0,3
E33019778,424,272,92,180,7,64,38,26,80,73,0,6,1,1
E33019779,403,312,72,240,4,23,10,13,61,58,0,3,0,3
E33019780,277,207,53,154,2,22,10,12,46,43,0,3,0,0
E33019781,634,454,125,329,7,72,41,31,101,98,0,3,0,0
E33019782,556,426,175,251,8,62,47,15,57,55,0,1,1,3
E33019783,375,292,71,221,6,13,8,5,53,51,0,1,1,11
E33019784,544,358,102,256,11,49,25,24,124,116,2,6,0,2
E33019785,1438,1004,269,735,20,146,86,60,263,247,1,14,1,5
E33019786,1425,1091,279,812,12,53,34,19,267,238,2,25,2,2
E33019787,400,329,94,235,7,25,11,14,38,37,0,1,0,1
E33019788,615,379,106,273,4,89,61,28,131,119,2,8,2,12
E33019789,184,137,37,100,1,12,2,10,34,27,0,7,0,0
E33019790,1606,1163,418,745,8,127,36,91,298,260,18,13,7,10
E33019791,376,305,63,242,3,13,5,8,52,46,0,6,0,3
E33019792,983,662,116,546,6,135,59,76,174,158,2,14,0,6
E33019793,237,170,32,138,1,22,4,18,44,41,0,3,0,0
E33019794,612,426,132,294,8,77,36,41,95,89,1,3,2,6
E33019795,591,401,87,314,2,88,41,47,93,84,0,9,0,7
E33019796,432,339,95,244,3,33,13,20,56,49,0,5,2,1
E33019797,890,567,136,431,6,114,50,64,197,180,1,16,0,6
E33019798,457,315,82,233,7,48,30,18,85,84,0,1,0,2
E33019799,404,270,71,199,2,65,33,32,65,54,1,9,1,2
E33019800,579,404,94,310,1,71,40,31,102,96,1,4,1,1
E33019801,357,271,60,211,3,33,18,15,49,47,0,2,0,1
E33019802,462,199,56,143,5,69,17,52,185,112,44,2,27,4
E33019803,223,147,36,111,2,31,13,18,43,37,2,3,1,0
E33019804,867,659,176,483,10,66,20,46,129,123,3,3,0,3
E33019805,376,268,92,176,4,46,11,35,55,52,0,3,0,3
E33019806,289,207,80,127,3,29,10,19,45,43,0,2,0,5
E33019807,2608,1761,469,1292,11,184,78,106,641,262,249,14,116,11
E33019808,405,274,102,172,6,68,36,32,56,53,0,2,1,1
E33019809,266,174,68,106,3,31,19,12,58,57,0,0,1,0
E33019810,307,238,53,185,4,23,16,7,41,34,0,7,0,1
E33019811,294,213,81,132,3,28,24,4,50,49,0,1,0,0
E33019812,396,297,88,209,3,36,26,10,57,52,0,5,0,3
E33019813,225,165,51,114,4,29,15,14,26,25,0,1,0,1
E33019814,236,160,51,109,1,20,17,3,53,44,0,8,1,2
E33019815,208,160,61,99,1,17,11,6,29,23,1,2,3,1
E33019816,224,169,80,89,2,35,15,20,18,18,0,0,0,0
E33019817,306,210,77,133,2,37,18,19,57,55,0,2,0,0
E33019818,439,339,102,237,0,41,30,11,59,53,0,5,1,0
E33019819,239,172,61,111,2,22,10,12,40,38,0,2,0,3
E33019820,595,438,134,304,4,42,27,15,107,94,1,11,1,4
E33019821,236,163,55,108,2,36,15,21,33,30,0,3,0,2
E33019822,407,276,73,203,0,50,35,15,76,72,0,4,0,5
E33019823,1371,795,220,575,12,154,76,78,405,383,0,19,3,5
E33019824,842,513,137,376,5,123,76,47,190,182,4,3,1,11
E33019825,237,157,34,123,1,31,22,9,47,41,1,4,1,1
E33019826,456,316,71,245,12,44,25,19,83,81,0,2,0,1
E33019827,1613,1123,222,901,29,169,102,67,277,254,9,9,5,15
E33019828,1678,1278,315,963,17,143,82,61,230,222,0,5,3,10
E33019829,4368,3072,796,2276,50,411,233,178,808,733,16,42,17,27
E33019830,315,192,53,139,1,37,16,21,79,72,2,4,1,6
E33019831,292,185,39,146,4,18,8,10,77,70,2,5,0,8
E33019832,308,172,54,118,0,37,22,15,95,85,1,7,2,4
E33019833,1342,813,228,585,14,199,106,93,299,272,1,22,4,17
E33019834,818,471,130,341,11,105,52,53,228,213,2,11,2,3
E33019835,1259,942,232,710,10,71,35,36,230,212,4,12,2,6
E33019836,391,302,58,244,6,26,13,13,57,54,1,1,1,0
E33019837,286,195,58,137,3,35,23,12,53,49,0,1,3,0
E33019838,317,195,50,145,2,42,19,23,75,71,0,4,0,3
E33019839,1903,1034,304,730,19,281,160,121,560,537,1,18,4,9
E33019840,247,128,41,87,3,41,28,13,73,70,0,2,1,2
E33019841,825,634,164,470,5,67,36,31,113,99,0,11,3,6
E33019842,319,172,48,124,3,60,34,26,78,73,0,5,0,6
E33019843,334,243,87,156,3,45,25,20,42,39,0,1,2,1
E33019844,896,657,163,494,14,61,32,29,161,153,2,6,0,3
E33019845,598,470,123,347,5,37,25,12,79,75,0,4,0,7
E33019846,348,287,80,207,4,18,13,5,39,38,0,1,0,0
E33019847,894,659,156,503,7,69,45,24,154,143,1,9,1,5
E33019848,204,144,54,90,2,21,16,5,32,32,0,0,0,5
E33019849,1179,870,222,648,7,51,32,19,245,232,0,12,1,6
E33019850,347,236,51,185,5,43,21,22,63,60,0,3,0,0
E33019851,1138,837,215,622,17,84,47,37,190,181,0,7,2,10
E33019852,2898,2133,492,1641,33,183,108,75,531,508,0,20,3,18
E33019853,341,236,71,165,2,42,25,17,58,56,0,2,0,3
E33019854,2990,2464,512,1952,24,114,65,49,373,341,3,20,9,15
E33019855,335,258,81,177,2,30,11,19,43,43,0,0,0,2
E33019856,207,147,49,98,2,25,20,5,30,26,1,3,0,3
E33019857,268,192,47,145,1,31,17,14,41,38,1,2,0,3
E33019858,225,121,28,93,5,44,15,29,54,50,0,4,0,1
E33019859,200,140,59,81,1,35,23,12,24,23,0,1,0,0
E33019860,384,273,87,186,2,49,25,24,57,55,0,2,0,3
E33019861,516,391,95,296,6,39,22,17,77,71,0,6,0,3
E33019862,257,181,61,120,4,37,26,11,31,30,0,1,0,4
E33019863,310,214,75,139,4,42,23,19,47,41,0,4,2,3
E33019864,419,263,77,186,7,55,33,22,89,84,0,5,0,5
E33019865,353,233,72,161,4,47,27,20,66,61,0,4,1,3
E33019866,406,288,78,210,6,34,21,13,76,72,0,4,0,2
E33019867,228,119,28,91,3,44,29,15,59,58,0,1,0,3
E33019868,1810,1306,432,874,15,89,38,51,389,363,3,15,8,11
E33019869,251,175,50,125,6,29,17,12,40,39,0,1,0,1
E33019870,1577,1057,312,745,13,204,122,82,296,278,2,16,0,7
E33019871,305,241,67,174,3,22,12,10,39,34,0,2,3,0
E33019872,474,351,102,249,6,58,34,24,56,55,0,1,0,3
E33019873,391,325,72,253,3,14,8,6,44,39,3,2,0,5
E33019874,993,748,195,553,4,102,64,38,135,126,1,6,2,4
E33019875,309,218,59,159,4,51,33,18,35,34,0,1,0,1
E33019876,515,400,96,304,7,21,12,9,82,74,0,7,1,5
E33019877,403,293,74,219,2,28,17,11,77,70,0,7,0,3
E33019878,696,529,125,404,8,33,22,11,123,117,0,6,0,3
E33019879,1912,1380,412,968,16,248,159,89,253,241,4,4,4,15
E33019880,388,295,102,193,1,24,15,9,67,62,1,4,0,1
E33019881,1589,1196,293,903,11,43,23,20,333,325,0,5,3,6
E33019882,1137,899,184,715,9,53,23,30,174,164,1,8,1,2
E33019883,293,188,37,151,3,21,11,10,73,71,0,2,0,8
E33019884,507,332,101,231,4,55,27,28,110,102,1,7,0,6
E33019885,254,193,50,143,2,13,12,1,43,42,0,1,0,3
E33019886,1743,1424,334,1090,15,73,38,35,221,206,0,14,1,10
E33019887,1325,1043,305,738,12,70,47,23,197,175,1,21,0,3
E33019888,1063,847,191,656,12,56,35,21,143,134,0,8,1,5
E33019889,409,305,66,239,2,15,7,8,85,77,0,8,0,2
E33019890,1437,1058,253,805,22,100,54,46,250,235,1,13,1,7
E33019891,901,688,182,506,10,53,32,21,146,138,1,7,0,4
E33019892,1290,1046,252,794,8,51,22,29,182,172,1,9,0,3
E33019893,768,488,135,353,4,82,43,39,187,178,0,9,0,7
E33019894,675,541,126,415,1,27,15,12,100,86,0,13,1,6
E33019895,983,721,188,533,6,58,33,25,186,175,1,9,1,12
E33019896,483,361,96,265,4,35,21,14,81,75,0,6,0,2
E33019897,189,92,20,72,2,23,14,9,72,63,0,3,6,0
E33019898,391,298,72,226,4,24,13,11,62,60,0,1,1,3
E33019899,855,624,175,449,7,60,33,27,160,153,0,7,0,4
E33019900,982,705,182,523,15,96,48,48,162,143,1,17,1,4
E33019901,270,167,55,112,3,44,26,18,55,51,0,2,2,1
E33019902,496,380,158,222,6,38,26,12,69,64,2,2,1,3
E33019903,1354,1104,320,784,19,114,67,47,110,99,2,9,0,7
E33019904,1824,1384,321,1063,23,77,35,42,333,307,4,19,3,7
E33019905,410,314,55,259,8,20,9,11,65,52,2,9,2,3
E33019906,313,254,60,194,3,13,9,4,41,38,0,1,2,2
E33019907,609,476,156,320,5,50,28,22,75,72,0,1,2,3
E33019908,1352,1080,232,848,7,52,26,26,208,193,0,15,0,5
E33019909,1999,1421,295,1126,19,120,65,55,432,406,0,21,5,7
E33019910,326,200,54,146,0,37,26,11,87,81,3,2,1,2
E33019911,280,134,24,110,0,32,14,18,113,111,0,2,0,1
E33019912,583,442,114,328,5,38,21,17,95,86,1,6,2,3
E33019913,905,697,184,513,2,58,32,26,144,129,1,13,1,4
E33019914,504,316,69,247,4,58,36,22,122,114,4,4,0,4
E33019915,268,164,60,104,2,21,13,8,78,75,0,2,1,3
E33019916,664,437,123,314,7,67,47,20,152,144,3,3,2,1
E33019917,1666,1324,369,955,21,117,66,51,200,184,0,14,2,4
E33019918,312,222,68,154,2,35,27,8,50,46,0,4,0,3
E33019919,429,241,82,159,8,77,40,37,102,97,1,4,0,1
E33019920,987,630,224,406,7,160,109,51,180,165,0,11,4,10
E33019921,309,244,85,159,2,31,20,11,29,28,0,1,0,3
E33019922,840,476,146,330,3,144,86,58,209,201,0,5,3,8
E33019923,317,201,61,140,2,47,31,16,62,60,0,2,0,5
E33019924,1351,1130,352,778,12,93,54,39,113,97,1,10,5,3
E33019925,331,253,64,189,4,23,10,13,47,42,0,5,0,4
E33019926,340,223,80,143,2,50,27,23,58,55,0,3,0,7
E33019927,604,343,108,235,2,105,66,39,147,136,1,7,3,7
E33019928,431,275,86,189,6,60,42,18,87,80,1,4,2,3
E33019929,347,208,69,139,5,63,33,30,68,59,0,7,2,3
E33019930,365,263,75,188,5,30,18,12,63,62,0,1,0,4
E33019931,359,228,57,171,1,74,51,23,53,52,0,1,0,3
E33019932,202,110,34,76,0,45,37,8,47,45,0,2,0,0
E33019933,330,212,69,143,2,42,24,18,72,70,0,2,0,2
E33019934,520,365,99,266,5,47,24,23,98,93,0,4,1,5
E33019935,2605,1996,493,1503,32,114,54,60,455,419,0,31,5,8
E33019936,233,169,40,129,1,13,8,5,49,44,0,5,0,1
E33019937,306,210,44,166,4,17,11,6,74,66,2,6,0,1
E33019938,677,517,132,385,3,32,19,13,124,113,2,7,2,1
E33019939,264,169,47,122,2,30,15,15,57,55,0,2,0,6
E33019940,415,275,71,204,6,54,38,16,78,72,0,5,1,2
E33019941,348,270,75,195,0,34,27,7,44,43,0,1,0,0
E33019942,323,261,77,184,2,21,12,9,37,34,0,3,0,2
E33019943,612,438,98,340,8,34,20,14,128,119,1,7,1,4
E33019944,600,386,100,286,3,82,50,32,123,117,0,6,0,6
E33019945,186,131,41,90,0,11,7,4,42,35,0,4,3,2
E33019946,576,447,125,322,2,31,14,17,94,87,2,3,2,2
E33019947,601,513,162,351,3,32,18,14,52,48,0,4,0,1
E33019948,447,281,94,187,1,80,51,29,79,74,0,3,2,6
E33019949,1160,780,188,592,9,106,55,51,254,231,0,23,0,11
E33019950,1061,782,225,557,15,78,46,32,179,169,2,7,1,7
E33019951,559,429,100,329,9,23,12,11,96,92,1,3,0,2
E33019952,343,193,53,140,3,45,22,23,98,92,2,3,1,4
E33019953,358,176,56,120,1,66,50,16,112,107,0,4,1,3
E33019954,1440,969,254,715,16,213,153,60,238,211,2,15,10,4
E33019955,440,291,79,212,2,36,22,14,103,98,0,5,0,8
E33019956,210,159,44,115,1,7,2,5,37,37,0,0,0,6
E33019957,1535,1181,353,828,13,98,49,49,239,230,1,7,1,4
E33019958,698,487,124,363,11,70,53,17,126,121,1,3,1,4
E33019959,533,404,116,288,6,59,39,20,56,55,0,1,0,8
E33019960,245,167,56,111,5,35,26,9,38,35,1,2,0,0
E33019961,215,167,68,99,1,20,11,9,24,22,0,2,0,3
E33019962,246,165,58,107,5,37,27,10,36,35,0,1,0,3
E33019963,227,174,47,127,4,16,8,8,32,31,0,1,0,1
E33019964,224,169,42,127,3,29,19,10,22,19,0,3,0,1
E33019965,444,315,91,224,1,74,44,30,49,48,0,1,0,5
E33019966,284,215,74,141,6,16,2,14,45,40,0,4,1,2
E33019967,634,542,186,356,5,24,15,9,59,52,3,4,0,4
E33019968,258,227,61,166,1,8,2,6,19,17,0,1,1,3
E33019969,436,355,113,242,2,29,22,7,48,44,1,3,0,2
E33019970,417,323,88,235,4,22,14,8,63,51,3,5,4,5
E33019971,474,392,123,269,4,22,14,8,54,50,1,3,0,2
E33019972,489,378,120,258,3,31,17,14,73,68,0,4,1,4
E33019973,362,333,101,232,0,5,1,4,21,19,0,2,0,3
E33019974,324,265,65,200,2,22,6,16,33,30,0,3,0,2
E33019975,367,325,108,217,1,15,9,6,26,24,0,2,0,0
E33019976,409,348,123,225,1,18,7,11,41,33,6,2,0,1
E33019977,420,357,113,244,1,22,12,10,33,28,1,4,0,7
E33019978,338,267,64,203,4,15,8,7,47,45,0,2,0,5
E33019979,230,181,56,125,2,19,12,7,27,26,0,0,1,1
E33019980,333,269,91,178,4,18,3,15,41,38,0,3,0,1
E33019981,281,233,93,140,1,15,12,3,31,28,0,3,0,1
E33019982,278,233,92,141,1,14,11,3,27,23,0,4,0,3
E33019983,349,267,84,183,2,29,18,11,49,43,0,6,0,2
E33019984,909,760,236,524,5,40,22,18,95,85,0,8,2,9
E33019985,321,213,53,160,10,63,51,12,30,30,0,0,0,5
E33019986,259,190,45,145,3,28,14,14,37,32,2,1,2,1
E33019987,704,583,143,440,5,40,21,19,73,67,4,2,0,3
E33019988,364,298,94,204,6,34,9,25,23,22,0,0,1,3
E33019989,534,414,88,326,3,46,39,7,67,61,0,6,0,4
E33019990,212,161,54,107,0,20,8,12,23,22,0,1,0,8
E33019991,370,300,112,188,1,33,21,12,33,30,0,3,0,3
E33019992,281,234,78,156,1,10,8,2,36,33,1,2,0,0
E33019993,3173,2466,634,1832,27,208,123,85,455,410,16,29,0,17
E33019994,381,300,73,227,2,31,17,14,43,41,1,1,0,5
E33019995,326,246,53,193,4,30,17,13,44,42,0,1,1,2
E33019996,329,280,76,204,2,23,5,18,19,17,0,2,0,5
E33019997,345,255,78,177,1,46,32,14,41,36,0,5,0,2
E33019998,292,246,71,175,2,8,7,1,32,29,1,2,0,4
E33019999,352,296,71,225,0,29,12,17,27,25,0,2,0,0
E33020000,576,439,115,324,4,59,56,3,65,57,3,5,0,9
E33020001,288,233,69,164,1,15,11,4,36,34,0,2,0,3
E33020002,565,449,127,322,1,40,25,15,68,63,0,5,0,7
E33020003,271,205,71,134,2,15,5,10,49,44,0,5,0,0
E33020004,357,307,111,196,0,17,13,4,28,27,0,1,0,5
E33020005,497,388,108,280,0,37,27,10,69,59,1,9,0,3
E33020006,449,356,79,277,5,25,18,7,58,53,0,2,3,5
E33020007,369,317,95,222,0,17,14,3,31,28,0,2,1,4
E33020008,302,254,80,174,3,14,10,4,30,26,0,4,0,1
E33020009,263,240,67,173,0,3,2,1,20,18,0,2,0,0
E33020010,306,278,87,191,3,11,5,6,9,9,0,0,0,5
E33020011,1438,1066,288,778,6,160,100,60,195,176,4,15,0,11
E33020012,654,443,112,331,4,116,94,22,82,77,0,5,0,9
E33020013,357,230,55,175,2,72,66,6,49,47,0,2,0,4
E33020014,336,234,61,173,0,53,45,8,47,43,1,2,1,2
E33020015,383,328,124,204,3,15,10,5,28,26,0,2,0,9
E33020016,280,266,76,190,1,0,0,0,13,13,0,0,0,0
E33020017,281,215,65,150,3,22,18,4,37,34,0,3,0,4
E33020018,366,320,100,220,2,11,7,4,29,28,0,1,0,4
E33020019,365,306,83,223,0,20,13,7,36,32,0,4,0,3
E33020020,328,275,79,196,0,10,9,1,40,36,0,4,0,3
E33020021,254,217,85,132,1,14,13,1,22,22,0,0,0,0
E33020022,307,231,73,158,2,32,27,5,35,29,0,5,1,7
E33020023,305,180,49,131,1,59,48,11,60,56,2,2,0,5
E33020024,245,186,49,137,1,29,15,14,26,26,0,0,0,3
E33020025,353,250,72,178,2,55,43,12,42,41,0,1,0,4
E33020026,374,251,81,170,9,60,42,18,52,44,0,6,2,2
E33020027,272,167,33,134,2,55,32,23,44,40,2,2,0,4
E33020028,245,203,68,135,1,22,8,14,17,14,1,2,0,2
E33020029,274,244,107,137,1,9,6,3,18,17,1,0,0,2
E33020030,318,269,94,175,1,18,9,9,26,23,2,1,0,4
E33020031,321,249,98,151,4,22,18,4,41,38,0,0,3,5
E33020032,299,234,68,166,2,10,6,4,50,47,1,1,1,3
E33020033,295,244,67,177,1,7,3,4,42,38,0,3,1,1
E33020034,348,284,75,209,1,17,14,3,43,42,0,1,0,3
E33020035,249,171,54,117,0,36,23,13,39,36,1,2,0,3
E33020036,363,279,81,198,3,24,15,9,53,50,0,2,1,4
E33020037,321,263,80,183,1,28,18,10,25,24,0,1,0,4
E33020038,647,443,128,315,2,79,53,26,118,107,2,8,1,5
E33020039,308,248,58,190,0,26,22,4,33,26,0,7,0,1
E33020040,486,365,112,253,6,38,29,9,73,65,1,6,1,4
E33020041,465,300,96,204,3,72,43,29,86,78,2,5,1,4
E33020042,482,339,99,240,3,58,35,23,81,75,0,5,1,1
E33020043,283,188,65,123,3,29,16,13,59,53,0,4,2,4
E33020044,344,278,90,188,0,18,11,7,44,39,1,3,1,4
E33020045,475,313,80,233,6,63,34,29,93,88,1,2,2,0
E33020046,306,250,66,184,4,14,8,6,38,35,0,3,0,0
E33020047,304,239,67,172,4,15,7,8,44,41,0,3,0,2
E33020048,695,564,161,403,1,43,26,17,83,78,0,5,0,4
E33020049,347,281,51,230,0,16,11,5,45,39,1,3,2,5
E33020050,297,183,46,137,4,49,37,12,59,54,0,5,0,2
E33020051,358,233,56,177,3,45,29,16,72,69,1,2,0,5
E33020052,387,288,79,209,1,54,45,9,39,35,0,4,0,5
E33020053,298,235,63,172,4,16,10,6,42,39,0,3,0,1
E33020054,340,259,68,191,0,32,16,16,46,37,1,3,5,3
E33020055,579,481,115,366,3,34,20,14,59,52,0,5,2,2
E33020056,449,345,100,245,3,44,29,15,53,45,0,6,2,4
E33020057,303,198,49,149,2,63,45,18,35,33,0,0,2,5
E33020058,547,414,109,305,4,44,23,21,81,77,1,3,0,4
E33020059,309,221,75,146,2,41,33,8,44,43,1,0,0,1
E33020060,293,208,66,142,2,33,30,3,47,42,4,0,1,3
E33020061,332,250,70,180,4,31,20,11,44,42,0,2,0,3
E33020062,335,221,57,164,6,50,25,25,57,52,0,5,0,1
E33020063,338,268,80,188,0,26,23,3,40,38,1,1,0,4
E33020064,320,263,83,180,1,19,9,10,34,31,0,2,1,3
E33020065,647,490,141,349,4,47,26,21,103,95,2,4,2,3
E33020066,481,356,99,257,8,20,15,5,93,90,0,3,0,4
E33020067,449,313,63,250,0,69,28,41,63,57,0,6,0,4
E33020068,362,261,58,203,4,43,26,17,44,40,0,3,1,10
E33020069,495,332,100,232,3,88,57,31,69,64,1,4,0,3
E33020070,450,315,85,230,1,67,41,26,65,59,1,5,0,2
E33020071,293,197,75,122,2,30,17,13,59,52,0,3,4,5
E33020072,386,287,81,206,6,52,28,24,41,38,0,2,1,0
E33020073,777,637,145,492,6,40,24,16,89,81,0,8,0,5
E33020074,463,320,88,232,0,67,51,16,72,70,0,2,0,4
E33020075,309,226,79,147,1,34,15,19,46,45,0,1,0,2
E33020076,310,234,74,160,2,23,14,9,51,49,0,2,0,0
E33020077,574,363,82,281,8,89,63,26,113,107,0,6,0,1
E33020078,269,205,64,141,2,22,18,4,31,29,0,2,0,9
E33020079,366,230,55,175,5,107,17,90,22,21,0,1,0,2
E33020080,261,147,48,99,2,75,12,63,30,30,0,0,0,7
E33020081,379,173,40,133,3,151,24,127,51,50,0,1,0,1
E33020082,926,652,168,484,10,138,58,80,120,114,1,4,1,6
E33020083,672,402,105,297,8,172,46,126,87,81,0,6,0,3
E33020084,675,482,135,347,2,53,37,16,131,125,0,5,1,7
E33020085,282,189,51,138,0,25,10,15,68,57,6,5,0,0
E33020086,567,420,107,313,4,48,29,19,89,86,0,3,0,6
E33020087,450,306,93,213,7,38,18,20,93,86,0,6,1,6
E33020088,246,153,52,101,0,37,28,9,55,55,0,0,0,1
E33020089,307,188,53,135,7,36,20,16,74,71,1,1,1,2
E33020090,402,273,70,203,7,45,22,23,71,69,0,2,0,6
E33020091,394,298,80,218,0,33,23,10,57,53,1,3,0,6
E33020092,318,200,59,141,1,47,25,22,64,62,0,2,0,6
E33020093,290,193,58,135,4,41,21,20,51,45,1,3,2,1
E33020094,369,244,44,200,7,39,11,28,77,73,0,4,0,2
E33020095,570,341,99,242,4,106,67,39,112,103,1,8,0,7
E33020096,501,324,86,238,5,68,39,29,99,92,0,7,0,5
E33020097,273,187,64,123,4,36,5,31,43,35,0,8,0,3
E33020098,307,220,71,149,0,27,13,14,57,50,0,7,0,3
E33020099,358,206,80,126,1,34,16,18,112,106,2,4,0,5
E33020100,352,210,56,154,4,57,22,35,78,70,3,3,2,3
E33020101,325,228,110,118,0,31,22,9,57,53,0,4,0,9
E33020102,499,371,137,234,2,37,17,20,83,81,0,2,0,6
E33020103,484,283,101,182,2,86,42,44,98,93,5,0,0,15
E33020104,412,326,112,214,2,36,26,10,43,41,1,1,0,5
E33020105,392,238,93,145,5,48,25,23,93,90,0,3,0,8
E33020106,331,156,62,94,0,59,27,32,109,99,0,4,6,7
E33020107,418,259,106,153,4,35,16,19,116,109,0,3,4,4
E33020108,373,256,94,162,3,52,22,30,54,46,0,4,4,8
E33020109,292,181,78,103,1,65,16,49,37,34,0,2,1,8
E33020110,262,186,66,120,2,30,17,13,40,40,0,0,0,4
E33020111,258,172,54,118,5,38,14,24,41,40,0,1,0,2
E33020112,293,201,93,108,1,44,13,31,42,35,0,5,2,5
E33020113,477,247,99,148,2,89,29,60,132,124,1,5,2,7
E33020114,412,280,90,190,5,49,26,23,73,70,0,3,0,5
E33020115,337,156,64,92,3,45,17,28,123,111,1,8,3,10
E33020116,297,196,80,116,2,48,21,27,49,41,2,4,2,2
E33020117,279,200,65,135,0,26,14,12,45,36,1,5,3,8
E33020118,428,303,108,195,3,56,26,30,58,51,0,6,1,8
E33020119,300,214,66,148,4,47,24,23,34,31,0,2,1,1
E33020120,224,163,60,103,1,25,16,9,33,31,0,2,0,2
E33020121,220,156,37,119,5,24,16,8,31,28,0,3,0,4
E33020122,306,215,102,113,1,37,16,21,47,45,0,2,0,6
E33020123,427,331,69,262,5,25,14,11,62,59,0,2,1,4
E33020124,312,225,79,146,3,32,20,12,47,39,0,4,4,5
E33020125,613,383,99,284,6,149,123,26,66,63,0,3,0,9
E33020126,396,243,99,144,6,40,13,27,97,66,5,21,5,10
E33020127,279,182,78,104,3,34,20,14,56,54,0,1,1,4
E33020128,372,232,115,117,4,51,17,34,83,74,0,8,1,2
E33020129,360,248,88,160,1,41,14,27,64,56,4,4,0,6
E33020130,461,303,99,204,4,55,35,20,86,74,0,12,0,13
E33020131,595,438,155,283,4,65,34,31,81,72,0,8,1,7
E33020132,336,167,50,117,0,91,39,52,74,70,0,3,1,4
E33020133,391,274,89,185,2,60,23,37,47,42,0,3,2,8
E33020134,258,148,69,79,1,50,12,38,55,35,10,0,10,4
E33020135,458,303,95,208,5,84,29,55,63,61,0,1,1,3
E33020136,326,227,92,135,0,44,24,20,47,44,0,2,1,8
E33020137,281,187,54,133,2,45,28,17,44,41,0,3,0,3
E33020138,338,209,54,155,5,61,39,22,60,52,0,7,1,3
E33020139,399,289,109,180,3,52,16,36,44,41,0,3,0,11
E33020140,230,138,56,82,1,55,23,32,32,30,0,1,1,4
E33020141,505,340,82,258,3,93,67,26,60,59,0,1,0,9
E33020142,252,165,49,116,3,42,29,13,39,35,2,2,0,3
E33020143,315,247,85,162,0,23,20,3,44,42,0,2,0,1
E33020144,510,360,114,246,3,73,50,23,68,62,4,2,0,6
E33020145,400,303,96,207,3,38,21,17,50,48,0,2,0,6
E33020146,333,156,56,100,2,127,100,27,40,34,0,2,4,8
E33020147,335,201,57,144,4,84,46,38,42,37,1,4,0,4
E33020148,277,184,68,116,0,38,25,13,51,51,0,0,0,4
E33020149,339,243,84,159,0,38,24,14,53,49,0,3,1,5
E33020150,666,476,138,338,4,78,60,18,104,100,0,3,1,4
E33020151,332,251,66,185,0,32,18,14,45,39,0,6,0,4
E33020152,229,160,60,100,2,38,29,9,24,22,1,1,0,5
E33020153,533,371,127,244,6,71,47,24,75,70,0,5,0,10
E33020154,358,236,64,172,24,62,40,22,34,32,1,1,0,2
E33020155,429,281,65,216,9,102,83,19,36,34,0,2,0,1
E33020156,327,225,39,186,11,58,40,18,29,26,2,0,1,4
E33020157,352,239,61,178,4,79,63,16,27,26,0,1,0,3
E33020158,459,305,79,226,6,101,72,29,44,38,0,5,1,3
E33020159,490,361,125,236,3,45,24,21,69,63,0,2,4,12
E33020160,600,396,126,270,7,80,31,49,113,109,1,3,0,4
E33020161,686,443,129,314,8,108,53,55,120,112,0,5,3,7
E33020162,470,279,112,167,1,83,33,50,95,89,0,5,1,12
E33020163,415,233,90,143,0,86,37,49,93,90,0,3,0,3
E33020164,4628,3400,893,2507,31,455,261,194,710,662,0,43,5,32
E33020165,518,390,154,236,5,60,35,25,54,50,0,4,0,9
E33020166,475,315,98,217,4,75,47,28,75,69,0,3,3,6
E33020167,541,356,110,246,7,92,51,41,79,73,1,4,1,7
E33020168,238,148,44,104,2,61,48,13,26,24,0,2,0,1
E33020169,306,185,72,113,2,30,20,10,89,84,0,3,2,0
E33020170,488,324,93,231,3,102,58,44,58,49,1,4,4,1
E33020171,416,241,65,176,3,93,52,41,67,61,2,4,0,12
E33020172,664,446,130,316,6,122,86,36,75,71,2,2,0,15
E33020173,225,119,34,85,4,69,50,19,30,30,0,0,0,3
E33020174,399,284,72,212,1,57,44,13,54,50,0,4,0,3
E33020175,466,304,83,221,6,100,75,25,52,49,0,3,0,4
E33020176,1787,1321,334,987,11,197,130,67,245,228,2,15,0,13
E33020177,756,579,159,420,6,51,31,20,113,109,2,2,0,7
E33020178,313,198,78,120,4,67,53,14,36,33,0,1,2,8
E33020179,1007,759,179,580,10,107,71,36,123,115,2,5,1,8
E33020180,1073,764,216,548,8,125,70,55,169,162,0,5,2,7
E33020181,393,261,88,173,6,46,21,25,75,71,0,4,0,5
E33020182,496,327,113,214,4,87,47,40,72,64,0,7,1,6
E33020183,273,186,71,115,0,36,22,14,45,41,0,4,0,6
E33020184,282,214,90,124,1,24,13,11,37,35,0,2,0,6
E33020185,304,215,75,140,0,49,29,20,36,33,0,2,1,4
E33020186,642,411,113,298,9,92,66,26,119,110,1,8,0,11
E33020187,318,224,70,154,4,56,33,23,27,17,0,10,0,7
E33020188,465,325,117,208,2,71,39,32,63,56,0,7,0,4
E33020189,268,207,100,107,1,24,15,9,31,29,0,2,0,5
E33020190,474,251,77,174,11,143,88,55,60,50,0,10,0,9
E33020191,430,219,69,150,2,109,68,41,96,88,5,2,1,4
E33020192,579,409,130,279,5,86,47,39,71,67,0,3,1,8
E33020193,380,227,67,160,3,68,48,20,80,76,0,1,3,2
E33020194,421,260,111,149,5,76,33,43,77,77,0,0,0,3
E33020195,359,234,106,128,1,54,30,24,63,56,0,4,3,7
E33020196,293,214,46,168,6,50,42,8,23,22,1,0,0,0
E33020197,333,221,57,164,5,77,67,10,28,27,0,1,0,2
E33020198,527,347,75,272,9,103,86,17,61,58,0,2,1,7
E33020199,317,191,63,128,1,54,40,14,56,55,0,1,0,15
E33020200,546,380,99,281,3,75,56,19,85,75,1,6,3,3
E33020201,415,285,76,209,5,48,40,8,65,61,0,3,1,12
E33020202,400,275,97,178,1,63,57,6,57,52,1,1,3,4
E33020203,566,401,116,285,8,85,68,17,67,60,0,7,0,5
E33020204,620,468,97,371,10,49,37,12,92,87,0,4,1,1
E33020205,384,252,85,167,1,69,45,24,57,54,0,3,0,5
E33020206,607,440,136,304,2,77,59,18,82,73,0,8,1,6
E33020207,282,210,78,132,1,40,30,10,28,26,0,2,0,3
E33020208,487,358,95,263,4,72,53,19,52,48,1,2,1,1
E33020209,336,209,59,150,7,74,62,12,43,40,0,2,1,3
E33020210,340,209,53,156,1,86,74,12,40,36,0,3,1,4
E33020211,322,231,66,165,5,57,47,10,24,18,0,6,0,5
E33020212,362,245,80,165,2,72,57,15,41,39,0,2,0,2
E33020213,678,473,141,332,14,83,45,38,102,96,0,5,1,6
E33020214,262,167,57,110,1,35,25,10,54,52,0,2,0,5
E33020215,843,624,205,419,7,88,56,32,121,105,0,14,2,3
E33020216,293,193,76,117,5,27,14,13,64,61,0,3,0,4
E33020217,330,198,66,132,3,36,24,12,90,85,2,2,1,3
E33020218,241,150,57,93,0,33,22,11,55,51,2,1,1,3
E33020219,350,260,84,176,3,30,18,12,51,44,1,6,0,6
E33020220,465,314,107,207,4,63,36,27,82,76,1,5,0,2
E33020221,239,150,56,94,4,27,19,8,57,56,0,1,0,1
E33020222,496,350,100,250,6,51,31,20,84,77,2,4,1,5
E33020223,336,245,57,188,2,48,39,9,38,34,0,3,1,3
E33020224,431,313,82,231,1,50,40,10,63,55,0,7,1,4
E33020225,409,279,89,190,1,83,72,11,44,40,0,4,0,2
E33020226,754,497,157,340,2,78,50,28,160,153,0,4,3,17
E33020227,355,245,90,155,1,42,26,16,62,60,0,0,2,5
E33020228,1037,819,199,620,16,61,30,31,135,126,0,9,0,6
E33020229,395,245,77,168,2,60,33,27,79,74,0,2,3,9
E33020230,1211,869,236,633,9,87,58,29,231,203,9,13,6,15
E33020231,406,241,69,172,1,56,27,29,106,100,1,5,0,2
E33020232,405,250,67,183,4,32,14,18,114,108,3,3,0,5
E33020233,252,174,43,131,2,31,19,12,44,38,0,5,1,1
E33020234,334,148,52,96,1,76,38,38,109,102,2,4,1,0
E33020235,578,411,117,294,1,71,61,10,86,82,0,4,0,9
E33020236,294,209,67,142,2,48,40,8,31,29,0,2,0,4
E33020237,323,211,63,148,2,65,62,3,41,34,0,3,4,4
E33020238,379,258,70,188,4,66,57,9,47,45,0,2,0,4
E33020239,253,175,56,119,1,36,28,8,37,31,0,4,2,4
E33020240,399,290,80,210,2,54,35,19,46,38,1,7,0,7
E33020241,315,231,62,169,3,35,29,6,42,41,0,1,0,4
E33020242,535,407,100,307,1,53,39,14,70,59,0,11,0,4
E33020243,352,235,64,171,3,70,50,20,41,38,2,1,0,3
E33020244,378,248,68,180,0,69,50,19,59,55,0,4,0,2
E33020245,556,396,95,301,3,82,61,21,73,64,2,7,0,2
E33020246,416,292,129,163,1,42,19,23,74,70,1,3,0,7
E33020247,330,141,46,95,0,75,38,37,109,106,0,2,1,5
E33020248,466,343,151,192,3,36,21,15,71,63,1,3,4,13
E33020249,376,260,79,181,5,57,34,23,47,41,0,3,3,7
E33020250,638,407,136,271,5,124,94,30,94,90,0,1,3,8
E33020251,472,290,107,183,3,89,44,45,81,72,2,5,2,9
E33020252,472,329,96,233,0,66,38,28,74,65,1,8,0,3
E33020253,218,133,45,88,7,36,21,15,40,38,2,0,0,2
E33020254,227,121,37,84,3,38,18,20,60,54,1,5,0,5
E33020255,499,315,106,209,4,105,64,41,69,65,0,4,0,6
E33020256,333,288,56,232,0,16,12,4,28,23,2,3,0,1
E33020257,386,326,89,237,2,20,15,5,33,27,0,6,0,5
E33020258,496,362,133,229,4,59,40,19,67,64,0,2,1,4
E33020259,596,433,121,312,4,45,25,20,104,93,1,8,2,10
E33020260,694,544,155,389,2,34,17,17,107,95,0,11,1,7
E33020261,281,216,64,152,3,12,7,5,45,45,0,0,0,5
E33020262,619,435,145,290,8,80,54,26,81,72,0,7,2,15
E33020263,431,288,92,196,0,55,20,35,85,77,1,7,0,3
E33020264,656,480,144,336,5,55,34,21,110,102,0,6,2,6
E33020265,387,206,68,138,4,96,66,30,73,69,1,2,1,8
E33020266,401,283,93,190,1,40,19,21,75,71,0,4,0,2
E33020267,413,279,97,182,1,51,29,22,70,67,1,1,1,12
E33020268,415,317,71,246,2,25,11,14,68,63,1,4,0,3
E33020269,316,234,79,155,2,14,8,6,58,54,1,3,0,8
E33020270,593,362,136,226,7,83,61,22,130,118,0,9,3,11
E33020271,276,204,62,142,2,29,19,10,38,35,0,3,0,3
E33020272,379,272,96,176,3,33,26,7,61,49,2,8,2,10
E33020273,520,403,118,285,1,27,19,8,84,77,0,5,2,5
E33020274,283,216,61,155,3,30,17,13,33,28,3,2,0,1
E33020275,330,272,57,215,1,29,25,4,26,24,1,1,0,2
E33020276,397,262,97,165,2,68,29,39,57,53,0,2,2,8
E33020277,296,197,87,110,3,52,26,26,33,30,0,0,3,11
E33020278,413,297,107,190,0,49,26,23,58,50,0,6,2,9
E33020279,547,397,170,227,3,65,29,36,77,67,1,5,4,5
E33020280,277,199,78,121,3,28,12,16,44,40,0,4,0,3
E33020281,281,194,57,137,1,27,16,11,56,53,0,2,1,3
E33020282,328,245,72,173,2,24,18,6,53,50,0,0,3,4
E33020283,402,274,75,199,1,54,42,12,72,69,1,2,0,1
E33020284,620,414,126,288,7,75,53,22,120,113,1,1,5,4
E33020285,367,252,69,183,7,39,31,8,64,58,0,6,0,5
E33020286,425,293,82,211,4,41,31,10,71,65,1,5,0,16
E33020287,305,193,62,131,4,41,21,20,61,55,2,3,1,6
E33020288,406,312,127,185,5,32,18,14,45,37,4,2,2,12
E33020289,663,445,122,323,6,64,36,28,144,137,1,5,1,4
E33020290,1021,712,224,488,9,98,52,46,192,183,3,5,1,10
E33020291,263,196,67,129,1,15,12,3,51,48,0,3,0,0
E33020292,305,241,75,166,1,20,15,5,39,34,0,4,1,4
E33020293,282,210,57,153,0,35,28,7,32,30,0,2,0,5
E33020294,423,285,69,216,2,37,32,5,92,82,0,10,0,7
E33020295,362,286,86,200,1,40,33,7,32,26,2,4,0,3
E33020296,288,222,74,148,1,31,24,7,32,31,0,1,0,2
E33020297,645,473,136,337,5,83,56,27,79,69,2,8,0,5
E33020298,572,449,114,335,3,43,34,9,70,67,0,3,0,7
E33020299,393,324,79,245,1,16,15,1,49,44,0,5,0,3
E33020300,359,314,86,228,1,10,6,4,32,28,0,3,1,2
E33020301,368,254,111,143,0,40,16,24,64,59,0,5,0,10
E33020302,431,284,126,158,5,57,32,25,76,68,1,6,1,9
E33020303,228,168,77,91,2,22,9,13,34,30,0,4,0,2
E33020304,441,334,138,196,1,35,19,16,69,66,0,1,2,2
E33020305,454,295,114,181,1,39,9,30,112,107,1,2,2,7
E33020306,310,162,56,106,4,74,25,49,67,58,0,9,0,3
E33020307,386,261,90,171,3,55,30,25,60,52,1,7,0,7
E33020308,456,286,105,181,3,83,35,48,78,72,0,6,0,6
E33020309,527,341,173,168,0,84,28,56,87,79,0,7,1,15
E33020310,573,371,141,230,6,109,60,49,80,75,0,4,1,7
E33020311,262,146,56,90,3,58,28,30,49,45,2,1,1,6
E33020312,294,186,45,141,2,70,53,17,30,28,0,2,0,6
E33020313,318,222,68,154,0,47,43,4,47,43,0,3,1,2
E33020314,371,208,53,155,7,111,99,12,40,36,2,1,1,5
E33020315,351,224,71,153,3,56,45,11,67,64,0,3,0,1
E33020316,330,191,70,121,2,69,41,28,59,56,0,2,1,9
E33020317,287,175,60,115,1,39,32,7,67,62,0,5,0,5
E33020318,259,178,56,122,0,20,13,7,56,53,0,3,0,5
E33020319,490,271,84,187,1,87,51,36,123,113,1,6,3,8
E33020320,280,196,54,142,6,22,16,6,50,48,1,1,0,6
E33020321,433,269,114,155,1,67,28,39,84,81,0,2,1,12
E33020322,387,263,58,205,2,45,29,16,75,71,0,4,0,2
E33020323,314,201,59,142,5,42,31,11,62,56,0,0,6,4
E33020324,428,328,90,238,6,33,21,12,59,52,0,7,0,2
E33020325,381,280,76,204,8,42,34,8,49,47,0,2,0,2
E33020326,310,229,69,160,6,38,27,11,36,34,0,2,0,1
E33020327,750,494,147,347,5,114,83,31,128,120,2,6,0,9
E33020328,382,273,74,199,4,48,36,12,57,52,0,5,0,0
E33020329,537,340,98,242,3,90,64,26,94,86,2,5,1,10
E33020330,451,327,91,236,5,45,40,5,68,68,0,0,0,6
E33020331,512,394,101,293,7,51,40,11,60,54,2,3,1,0
E33020332,244,166,50,116,0,31,23,8,46,42,0,4,0,1
E33020333,343,258,84,174,3,44,42,2,36,35,0,1,0,2
E33020334,540,336,101,235,5,81,59,22,108,104,0,4,0,10
E33020335,226,119,47,72,1,37,14,23,65,63,0,1,1,4
E33020336,429,263,87,176,3,62,18,44,97,93,1,1,2,4
E33020337,293,202,64,138,3,18,11,7,67,64,0,3,0,3
E33020338,266,147,51,96,3,53,14,39,62,54,0,5,3,1
E33020339,264,144,51,93,1,34,12,22,85,83,0,2,0,0
E33020340,415,232,71,161,3,52,27,25,126,119,2,2,3,2
E33020341,490,383,137,246,5,33,14,19,65,64,0,1,0,4
E33020342,227,149,47,102,0,15,7,8,59,54,0,5,0,4
E33020343,338,244,93,151,5,13,6,7,70,65,0,4,1,6
E33020344,464,288,105,183,2,52,32,20,119,116,0,1,2,3
E33020345,346,268,83,185,2,25,18,7,46,41,0,4,1,5
E33020346,823,644,160,484,5,76,55,21,98,91,0,7,0,0
E33020347,465,320,112,208,6,69,63,6,65,58,0,4,3,5
E33020348,277,172,50,122,4,73,63,10,25,23,0,1,1,3
E33020349,1030,813,197,616,9,66,48,18,140,120,1,16,3,2
E33020350,240,136,37,99,6,55,47,8,40,35,0,4,1,3
E33020351,432,294,101,193,4,61,40,21,67,63,1,3,0,6
E33020352,409,290,103,187,2,52,46,6,64,63,0,1,0,1
E33020353,395,246,89,157,1,37,20,17,107,102,0,5,0,4
E33020354,355,154,50,104,2,24,8,16,173,170,1,1,1,2
E33020355,255,121,34,87,1,30,22,8,95,88,6,1,0,8
E33020356,729,431,111,320,7,72,44,28,213,201,2,7,3,6
E33020357,864,580,202,378,13,122,67,55,144,133,0,10,1,5
E33020358,302,127,34,93,3,34,21,13,130,127,0,3,0,8
E33020359,296,209,83,126,1,25,18,7,58,56,0,2,0,3
E33020360,434,317,114,203,4,31,21,10,74,69,0,4,1,8
E33020361,593,461,142,319,5,50,32,18,75,66,0,8,1,2
E33020362,569,462,126,336,5,32,13,19,66,54,2,9,1,4
E33020363,500,346,123,223,3,40,21,19,98,92,2,4,0,13
E33020364,393,311,86,225,4,17,10,7,56,55,0,1,0,5
E33020365,412,320,94,226,3,32,23,9,56,54,0,2,0,1
E33020366,273,204,52,152,6,24,19,5,37,36,0,1,0,2
E33020367,262,195,65,130,2,28,20,8,33,30,0,2,1,4
E33020368,429,352,84,268,3,22,18,4,48,45,0,3,0,4
E33020369,337,223,63,160,0,33,24,9,79,75,3,1,0,2
E33020370,478,272,89,183,6,86,43,43,108,98,0,10,0,6
E33020371,315,223,57,166,3,25,13,12,58,45,6,5,2,6
E33020372,270,150,56,94,4,47,31,16,58,58,0,0,0,11
E33020373,573,445,113,332,8,47,16,31,68,60,0,5,3,5
E33020374,282,186,79,107,3,14,5,9,76,64,0,12,0,3
E33020375,343,216,89,127,2,53,34,19,68,62,0,4,2,4
E33020376,427,263,77,186,3,49,27,22,99,96,0,3,0,13
E33020377,452,282,73,209,1,70,43,27,97,90,0,6,1,2
E33020378,419,294,76,218,4,75,44,31,44,37,1,5,1,2
E33020379,364,231,71,160,1,86,70,16,43,39,0,4,0,3
E33020380,311,213,50,163,4,60,50,10,32,29,0,3,0,2
E33020381,327,194,55,139,6,73,56,17,51,43,1,4,3,3
E33020382,279,169,42,127,0,76,67,9,29,24,0,5,0,5
E33020383,809,605,168,437,8,118,100,18,68,61,1,5,1,10
E33020384,506,369,94,275,0,77,69,8,51,48,0,3,0,9
E33020385,364,242,57,185,2,64,59,5,50,43,0,7,0,6
E33020386,572,441,126,315,1,57,43,14,72,68,3,1,0,1
E33020387,300,227,76,151,2,15,10,5,49,42,0,7,0,7
E33020388,481,313,122,191,5,46,26,20,105,94,0,8,3,12
E33020389,800,546,122,424,13,110,82,28,123,118,0,5,0,8
E33020390,261,205,83,122,1,22,18,4,28,24,0,4,0,5
E33020391,407,338,125,213,0,19,12,7,49,46,0,3,0,1
E33020392,266,195,72,123,0,33,17,16,37,30,0,4,3,1
E33020393,352,295,85,210,2,18,15,3,36,34,0,2,0,1
E33020394,415,285,83,202,19,51,28,23,52,45,1,5,1,8
E33020395,698,514,145,369,7,82,66,16,87,81,0,4,2,8
E33020396,333,219,39,180,16,64,40,24,29,26,0,3,0,5
E33020397,333,219,63,156,3,40,28,12,70,67,0,3,0,1
E33020398,366,286,78,208,2,31,23,8,46,42,2,1,1,1
E33020399,439,279,69,210,6,73,54,19,73,68,3,2,0,8
E33020400,737,562,164,398,7,75,37,38,88,79,0,8,1,5
E33020401,901,676,216,460,6,66,49,17,140,135,1,3,1,13
E33020402,629,474,161,313,4,48,33,15,99,90,0,7,2,4
E33020403,328,206,72,134,1,83,16,67,31,25,1,4,1,7
E33020404,414,316,91,225,9,50,32,18,35,34,0,1,0,4
E33020405,255,164,68,96,1,44,19,25,45,35,0,8,2,1
E33020406,577,402,114,288,8,94,69,25,69,65,1,2,1,4
E33020407,345,271,80,191,2,32,23,9,37,28,5,3,1,3
E33020408,420,302,102,200,1,65,38,27,50,46,0,3,1,2
E33020409,363,304,95,209,4,20,11,9,32,29,0,2,1,3
E33020410,393,289,96,193,4,30,20,10,61,56,0,5,0,9
E33020411,328,236,59,177,8,52,45,7,28,20,0,6,2,4
E33020412,496,336,108,228,8,76,58,18,67,64,0,3,0,9
E33020413,518,338,105,233,5,84,70,14,83,77,2,4,0,8
E33020414,498,328,95,233,1,74,47,27,86,78,1,4,3,9
E33020415,392,292,99,193,4,43,23,20,50,45,0,5,0,3
E33020416,398,287,73,214,12,38,30,8,60,56,0,4,0,1
E33020417,289,204,59,145,3,35,17,18,46,44,1,1,0,1
E33020418,228,160,47,113,4,30,18,12,28,26,0,1,1,6
E33020419,355,232,73,159,0,52,23,29,70,65,0,5,0,1
E33020420,278,186,33,153,2,54,15,39,34,29,1,4,0,2
E33020421,416,275,105,170,3,47,33,14,86,78,1,7,0,5
E33020422,1546,1123,320,803,16,207,86,121,188,170,4,12,2,12
E33020423,594,398,113,285,8,91,35,56,91,85,0,6,0,6
E33020424,328,236,66,170,3,39,37,2,47,44,1,2,0,3
E33020425,572,386,91,295,3,108,90,18,69,63,0,5,1,6
E33020426,306,230,64,166,15,26,8,18,31,29,0,2,0,4
E33020427,422,277,80,197,3,72,51,21,67,65,0,2,0,3
E33020428,439,295,85,210,3,67,35,32,69,60,1,6,2,5
E33020429,381,252,60,192,8,61,52,9,52,47,1,4,0,8
E33020430,523,385,105,280,5,47,28,19,85,76,3,6,0,1
E33020431,347,241,70,171,9,39,23,16,56,52,0,4,0,2
E33020432,900,663,178,485,18,112,83,29,94,85,2,7,0,13
E33020433,326,231,70,161,5,49,42,7,37,34,0,2,1,4
E33020434,344,258,66,192,18,25,11,14,42,38,0,4,0,1
E33020435,719,487,144,343,7,121,86,35,98,83,0,12,3,6
E33020436,367,226,46,180,9,101,92,9,27,23,0,4,0,4
E33020437,223,167,58,109,2,29,19,10,24,21,0,3,0,1
E33020438,331,273,79,194,1,20,17,3,35,34,1,0,0,2
E33020439,447,350,98,252,2,56,30,26,34,34,0,0,0,5
E33020440,519,386,118,268,3,64,31,33,61,55,2,3,1,5
E33020441,256,171,46,125,3,52,38,14,28,24,0,2,2,2
E33020442,656,439,101,338,6,130,107,23,72,65,1,6,0,9
E33020443,283,193,40,153,1,66,60,6,22,19,0,3,0,1
E33020444,683,475,139,336,9,114,91,23,84,76,1,6,1,1
E33020445,344,267,62,205,8,33,28,5,35,30,0,5,0,1
E33020446,328,228,81,147,2,57,50,7,40,36,0,4,0,1
E33020447,466,357,122,235,1,61,51,10,43,40,1,2,0,4
E33020448,307,245,55,190,2,31,26,5,29,25,1,3,0,0
E33020449,552,412,120,292,5,67,36,31,68,61,0,7,0,0
E33020450,352,227,48,179,7,56,38,18,62,59,0,2,1,0
E33020451,510,387,77,310,6,45,33,12,66,61,0,5,0,6
E33020452,367,293,73,220,2,27,14,13,42,36,0,6,0,3
E33020453,423,327,98,229,6,34,19,15,55,51,0,4,0,1
E33020454,602,440,106,334,8,75,56,19,78,75,1,2,0,1
E33020455,390,275,79,196,7,68,42,26,34,31,0,3,0,6
E33020456,390,234,49,185,1,94,65,29,52,47,1,4,0,9
E33020457,282,166,35,131,4,79,67,12,31,31,0,0,0,2
E33020458,459,317,72,245,5,83,65,18,45,40,0,4,1,9
E33020459,285,197,42,155,3,49,37,12,28,24,2,2,0,8
E33020460,305,203,43,160,8,45,28,17,47,43,0,4,0,2
E33020461,279,170,49,121,1,73,60,13,34,31,0,3,0,1
E33020462,546,341,94,247,12,128,73,55,56,50,0,4,2,9
E33020463,396,311,86,225,4,41,28,13,39,35,0,4,0,1
E33020464,329,253,87,166,2,42,35,7,27,21,0,5,1,5
E33020465,906,646,176,470,10,143,102,41,99,89,0,8,2,8
E33020466,552,365,94,271,6,122,110,12,54,53,0,1,0,5
E33020467,486,306,72,234,5,114,94,20,56,49,1,6,0,5
E33020468,502,400,120,280,7,38,24,14,51,47,0,1,3,6
E33020469,690,508,121,387,4,93,69,24,84,75,1,7,1,1
E33020470,577,412,95,317,14,85,50,35,65,60,0,5,0,1
E33020471,546,405,88,317,5,53,37,16,79,75,0,4,0,4
E33020472,502,382,77,305,2,52,45,7,58,52,0,6,0,8
E33020473,477,379,102,277,1,38,23,15,50,44,0,6,0,9
E33020474,565,425,110,315,5,67,43,24,62,59,0,3,0,6
E33020475,720,538,143,395,7,50,24,26,123,114,0,6,3,2
E33020476,343,264,83,181,4,23,10,13,50,43,3,4,0,2
E33020477,338,251,64,187,2,28,6,22,55,53,0,2,0,2
E33020478,1212,815,194,621,4,117,35,82,268,247,3,15,3,8
E33020479,739,604,146,458,4,39,20,19,90,86,0,4,0,2
E33020480,333,249,73,176,3,25,11,14,49,42,2,1,4,7
E33020481,273,220,82,138,2,22,10,12,29,25,0,4,0,0
E33020482,439,331,96,235,3,31,13,18,73,67,0,5,1,1
E33020483,437,350,102,248,0,33,15,18,53,48,1,4,0,1
E33020484,1630,1015,241,774,15,184,73,111,408,401,0,6,1,8
E33020485,309,218,54,164,0,40,17,23,49,43,0,6,0,2
E33020486,296,207,52,155,1,54,22,32,30,28,0,2,0,4
E33020487,342,221,59,162,1,50,24,26,63,54,0,9,0,7
E33020488,433,325,105,220,2,33,14,19,71,67,2,2,0,2
E33020489,1159,849,237,612,6,94,41,53,202,189,0,12,1,8
E33020490,387,272,86,186,3,45,20,25,64,60,0,4,0,3
E33020491,315,264,69,195,1,11,4,7,38,29,1,8,0,1
E33020492,751,622,196,426,1,44,24,20,78,69,4,4,1,6
E33020493,420,262,83,179,4,99,45,54,52,48,0,3,1,3
E33020494,675,443,128,315,10,138,46,92,72,68,0,3,1,12
E33020495,569,403,116,287,1,69,25,44,91,87,0,4,0,5
E33020496,680,433,115,318,3,68,25,43,173,157,3,10,3,3
E33020497,295,188,46,142,8,35,9,26,61,58,0,2,1,3
E33020498,292,222,65,157,3,40,9,31,26,26,0,0,0,1
E33020499,510,410,128,282,3,38,18,20,49,45,0,3,1,10
E33020500,736,522,136,386,3,74,25,49,134,123,0,8,3,3
E33020501,680,502,124,378,7,48,19,29,121,112,0,9,0,2
E33020502,308,228,67,161,3,26,14,12,50,46,0,4,0,1
E33020503,370,266,83,183,3,28,6,22,69,64,0,5,0,4
E33020504,717,624,204,420,4,32,13,19,54,50,2,2,0,3
E33020505,313,234,72,162,1,27,12,15,50,42,0,8,0,1
E33020506,600,496,162,334,7,21,13,8,64,56,0,6,2,12
E33020507,416,309,94,215,5,31,13,18,68,62,0,3,3,3
E33020508,335,258,64,194,0,14,7,7,59,51,0,5,3,4
E33020509,420,319,86,233,2,15,3,12,80,75,0,4,1,4
E33020510,367,272,80,192,0,25,16,9,70,58,1,10,1,0
E33020511,388,301,90,211,0,32,18,14,52,50,0,2,0,3
E33020512,265,182,55,127,1,14,4,10,65,61,1,3,0,3
E33020513,331,234,63,171,1,45,22,23,50,41,0,7,2,1
E33020514,329,253,71,182,5,21,7,14,45,43,0,2,0,5
E33020515,317,243,79,164,1,14,6,8,55,49,2,4,0,4
E33020516,595,458,126,332,2,53,18,35,79,72,0,7,0,3
E33020517,308,252,59,193,0,10,5,5,42,40,0,2,0,4
E33020518,350,301,103,198,0,11,4,7,34,30,1,2,1,4
E33020519,281,186,49,137,1,28,6,22,62,56,1,5,0,4
E33020520,327,246,78,168,1,43,13,30,36,32,0,4,0,1
E33020521,444,291,87,204,1,53,17,36,93,88,0,4,1,6
E33020522,372,250,74,176,4,50,13,37,64,55,0,7,2,4
E33020523,421,301,89,212,3,46,21,25,69,62,0,7,0,2
E33020524,243,176,75,101,2,21,4,17,40,36,2,2,0,4
E33020525,281,177,54,123,0,46,13,33,58,52,0,5,1,0
E33020526,243,163,62,101,2,26,8,18,49,45,0,2,2,3
E33020527,468,332,103,229,3,35,12,23,92,84,1,6,1,6
E33020528,331,180,61,119,1,53,23,30,92,82,1,8,1,5
E33020529,494,294,69,225,3,84,35,49,111,99,0,9,3,2
E33020530,585,398,132,266,4,72,29,43,106,100,0,5,1,5
E33020531,285,237,77,160,1,6,3,3,36,35,0,1,0,5
E33020532,895,603,171,432,7,81,27,54,200,180,0,19,1,4
E33020533,288,231,61,170,0,11,4,7,44,37,0,6,1,2
E33020534,389,330,96,234,0,12,5,7,47,39,0,8,0,0
E33020535,388,293,74,219,1,20,5,15,72,65,1,6,0,2
E33020536,380,300,75,225,1,15,8,7,60,48,0,9,3,4
E33020537,405,335,103,232,1,11,4,7,55,49,1,5,0,3
E33020538,312,261,71,190,1,9,6,3,36,33,0,3,0,5
E33020539,7810,5925,1505,4420,52,537,204,333,1264,1163,18,70,13,32
E33020540,911,761,270,491,3,50,24,26,95,84,2,8,1,2
E33020541,372,273,83,190,2,32,9,23,64,57,1,6,0,1
E33020542,1948,1296,342,954,21,204,81,123,418,389,0,29,0,9
E33020543,310,218,72,146,2,37,14,23,52,44,2,5,1,1
E33020544,253,187,64,123,1,32,18,14,31,29,0,2,0,2
E33020545,627,395,116,279,4,40,15,25,184,171,2,9,2,4
E33020546,424,255,63,192,4,63,17,46,99,88,1,9,1,3
E33020547,463,318,83,235,3,48,13,35,89,78,0,11,0,5
E33020548,455,298,72,226,6,40,16,24,109,98,0,8,3,2
E33020549,415,295,85,210,5,35,9,26,78,73,1,2,2,2
E33020550,572,399,136,263,2,48,16,32,120,110,2,7,1,3
E33020551,354,266,72,194,1,18,3,15,64,59,0,5,0,5
E33020552,1016,685,198,487,6,104,32,72,211,196,0,13,2,10
E33020553,423,319,105,214,0,18,7,11,82,77,1,3,1,4
E33020554,389,299,74,225,1,16,4,12,68,63,1,4,0,5
E33020555,294,234,66,168,0,11,7,4,48,42,1,5,0,1
E33020556,427,345,117,228,1,24,11,13,55,50,0,4,1,2
E33020557,418,352,116,236,0,21,9,12,42,38,0,4,0,3
E33020558,346,296,100,196,1,9,2,7,35,33,1,1,0,5
E33020559,197,111,48,63,1,48,7,41,33,29,0,4,0,4
E33020560,291,140,39,101,2,45,12,33,102,96,0,5,1,2
E33020561,284,156,45,111,1,53,19,34,72,63,0,7,2,2
E33020562,376,283,87,196,2,39,13,26,48,44,0,4,0,4
E33020563,315,182,56,126,6,47,13,34,78,73,0,5,0,2
E33020564,352,189,70,119,3,86,18,68,67,62,1,3,1,7
E33020565,338,281,85,196,0,12,7,5,43,38,1,4,0,2
E33020566,609,441,97,344,12,68,16,52,86,78,0,6,2,2
E33020567,403,345,98,247,2,13,4,9,42,39,0,2,1,1
E33020568,690,537,141,396,3,28,14,14,119,114,0,5,0,3
E33020569,518,358,93,265,1,56,22,34,101,97,0,3,1,2
E33020570,256,168,36,132,1,29,13,16,51,48,1,2,0,7
E33020571,288,176,55,121,0,35,13,22,74,73,0,0,1,3
E33020572,317,234,60,174,0,20,10,10,61,51,2,4,4,2
E33020573,650,450,134,316,3,37,14,23,152,144,0,8,0,8
E33020574,337,248,59,189,1,25,6,19,62,54,0,6,2,1
E33020575,407,285,89,196,1,32,17,15,86,80,0,5,1,3
E33020576,286,170,56,114,2,15,3,12,94,91,0,3,0,5
E33020577,583,382,128,254,2,40,12,28,153,143,5,5,0,6
E33020578,364,231,66,165,2,45,10,35,84,79,1,3,1,2
E33020579,528,384,125,259,2,28,12,16,111,101,1,7,2,3
E33020580,342,255,65,190,0,44,18,26,39,33,1,5,0,4
E33020581,254,216,68,148,4,15,6,9,16,15,0,1,0,3
E33020582,265,183,53,130,0,48,19,29,32,28,0,2,2,2
E33020583,427,338,86,252,4,39,13,26,46,44,0,2,0,0
E33020584,422,304,75,229,4,59,27,32,52,49,0,3,0,3
E33020585,300,199,67,132,1,17,6,11,79,69,0,8,2,4
E33020586,531,406,95,311,2,21,4,17,98,88,1,8,1,4
E33020587,275,198,58,140,2,16,4,12,57,52,0,4,1,2
E33020588,317,233,73,160,1,19,4,15,61,52,1,6,2,3
E33020589,300,173,45,128,4,21,6,15,98,93,0,5,0,4
E33020590,639,442,103,339,5,61,24,37,125,116,1,6,2,6
E33020591,796,440,115,325,13,97,27,70,239,227,2,10,0,7
E33020592,538,383,106,277,2,34,4,30,111,96,4,9,2,8
E33020593,1602,1313,295,1018,15,57,30,27,215,201,1,12,1,2
E33020594,881,521,164,357,7,130,49,81,214,199,2,11,2,9
E33020595,387,310,87,223,4,11,3,8,58,50,0,7,1,4
E33020596,299,225,83,142,3,24,6,18,44,42,0,2,0,3
E33020597,252,150,36,114,3,50,13,37,48,46,0,2,0,1
E33020598,280,215,43,172,0,15,5,10,44,39,2,3,0,6
E33020599,769,534,138,396,6,79,29,50,149,142,2,5,0,1
E33020600,271,187,67,120,0,26,10,16,58,54,0,4,0,0
E33020601,331,253,107,146,4,34,14,20,38,35,0,3,0,2
E33020602,288,223,68,155,1,25,10,15,37,32,1,3,1,2
E33020603,294,246,80,166,0,12,6,6,36,36,0,0,0,0
E33020604,752,552,156,396,9,79,31,48,108,95,2,11,0,4
E33020605,272,221,70,151,1,12,6,6,35,35,0,0,0,3
E33020606,401,325,113,212,0,21,4,17,55,52,0,3,0,0
E33020607,409,347,121,226,3,15,6,9,44,39,0,5,0,0
E33020608,516,424,157,267,2,34,11,23,51,44,2,3,2,5
E33020609,277,202,80,122,0,10,5,5,63,58,1,4,0,2
E33020610,286,193,59,134,3,57,21,36,30,26,0,4,0,3
E33020611,294,189,53,136,1,56,23,33,46,44,0,1,1,2
E33020612,431,293,83,210,2,50,13,37,81,77,2,2,0,5
E33020613,290,153,32,121,4,91,38,53,42,37,0,5,0,0
E33020614,311,235,79,156,2,35,14,21,39,38,1,0,0,0
E33020615,523,433,153,280,3,25,10,15,59,53,0,5,1,3
E33020616,803,579,178,401,4,92,38,54,127,118,1,8,0,1
E33020617,1835,1441,317,1124,18,76,25,51,295,261,1,29,4,5
E33020618,590,467,109,358,2,27,15,12,92,87,1,3,1,2
E33020619,275,180,50,130,2,36,9,27,53,46,2,3,2,4
E33020620,248,144,41,103,4,51,23,28,45,34,2,6,3,4
E33020621,715,526,170,356,6,73,30,43,105,97,1,7,0,5
E33020622,511,383,98,285,1,36,11,25,82,66,0,15,1,9
E33020623,305,226,75,151,0,19,5,14,58,53,1,2,2,2
E33020624,341,261,88,173,5,28,14,14,44,37,1,3,3,3
E33020625,1189,901,211,690,6,77,35,42,202,189,0,12,1,3
E33020626,3179,2533,579,1954,10,61,34,27,563,537,2,19,5,12
E33020627,254,150,49,101,1,22,8,14,76,71,1,2,2,5
E33020628,310,246,78,168,2,27,17,10,34,31,1,2,0,1
E33020629,1151,804,319,485,4,155,50,105,185,168,3,10,4,3
E33020630,842,652,142,510,1,48,16,32,141,137,1,2,1,0
E33020631,678,502,129,373,6,43,19,24,124,115,0,5,4,3
E33020632,628,449,119,330,4,73,25,48,100,97,0,3,0,2
E33020633,383,274,78,196,4,66,34,32,39,34,1,3,1,0
E33020634,596,434,70,364,7,91,33,58,59,54,1,4,0,5
E33020635,319,181,58,123,3,89,29,60,44,42,1,1,0,2
E33020636,361,309,108,201,3,8,4,4,36,31,1,4,0,5
E33020637,620,510,187,323,2,41,12,29,65,55,0,6,4,2
E33020638,366,326,96,230,2,7,3,4,26,22,0,4,0,5
E33020639,539,445,116,329,0,24,11,13,70,65,0,5,0,0
E33020640,341,290,90,200,1,10,3,7,39,32,1,6,0,1
E33020641,321,267,77,190,4,12,6,6,38,36,1,1,0,0
E33020642,824,560,156,404,11,104,46,58,143,132,0,9,2,6
E33020643,1402,1098,289,809,6,63,16,47,227,208,6,13,0,8
E33020644,5103,3528,1092,2436,26,178,69,109,1343,1256,19,56,12,28
E33020645,311,232,69,163,1,54,43,11,24,20,0,4,0,0
E33020646,468,323,103,220,1,97,78,19,44,43,0,1,0,3
E33020647,550,393,115,278,1,104,89,15,48,45,1,1,1,4
E33020648,309,240,77,163,1,49,38,11,16,12,0,4,0,3
E33020649,331,260,77,183,0,43,26,17,26,24,0,1,1,2
E33020650,284,181,56,125,2,60,55,5,39,33,0,4,2,2
E33020651,380,307,91,216,1,44,39,5,28,26,1,1,0,0
E33020652,488,426,145,281,0,32,25,7,28,23,0,5,0,2
E33020653,313,257,100,157,1,28,24,4,23,22,0,1,0,4
E33020654,447,350,114,236,0,70,61,9,24,22,0,2,0,3
E33020655,466,362,110,252,1,64,55,9,37,29,0,5,3,2
E33020656,377,278,81,197,1,58,55,3,39,37,0,0,2,1
E33020657,296,239,77,162,1,25,24,1,24,20,0,3,1,7
E33020658,321,256,69,187,3,36,28,8,23,19,1,2,1,3
E33020659,507,351,97,254,10,94,58,36,48,40,3,4,1,4
E33020660,605,479,125,354,3,79,65,14,41,40,0,1,0,3
E33020661,348,261,88,173,2,48,45,3,33,28,2,3,0,4
E33020662,570,381,108,273,4,139,134,5,44,39,0,4,1,2
E33020663,413,287,85,202,7,85,58,27,30,27,0,3,0,4
E33020664,268,216,53,163,1,34,30,4,16,13,0,3,0,1
E33020665,440,327,104,223,10,68,59,9,30,25,2,2,1,5
E33020666,283,241,85,156,0,13,13,0,25,23,0,2,0,4
E33020667,284,208,76,132,0,43,36,7,28,21,1,5,1,5
E33020668,322,278,103,175,2,14,12,2,23,22,0,1,0,5
E33020669,511,384,111,273,3,81,74,7,37,35,2,0,0,6
E33020670,419,364,103,261,3,33,25,8,19,17,0,1,1,0
E33020671,325,259,75,184,1,28,20,8,30,23,1,6,0,7
E33020672,367,297,92,205,0,38,34,4,29,26,0,3,0,3
E33020673,259,210,49,161,6,19,14,5,22,22,0,0,0,2
E33020674,456,344,98,246,3,62,49,13,43,40,0,2,1,4
E33020675,750,526,161,365,2,147,123,24,72,65,0,6,1,3
E33020676,294,189,59,130,1,66,57,9,37,35,0,2,0,1
E33020677,350,252,88,164,3,49,40,9,42,39,2,1,0,4
E33020678,846,637,189,448,12,102,80,22,86,79,0,7,0,9
E33020679,626,453,132,321,7,84,64,20,78,74,0,4,0,4
E33020680,282,216,68,148,1,37,25,12,26,25,0,1,0,2
E33020681,298,256,90,166,1,22,15,7,18,13,0,2,3,1
E33020682,493,394,120,274,0,56,44,12,42,39,2,1,0,1
E33020683,549,455,134,321,1,44,39,5,43,40,0,1,2,6
E33020684,693,575,205,370,2,58,50,8,53,50,0,2,1,5
E33020685,302,220,54,166,0,53,48,5,26,25,0,0,1,3
E33020686,519,376,106,270,6,98,85,13,37,31,4,1,1,2
E33020687,301,210,61,149,2,46,38,8,38,33,0,5,0,5
E33020688,278,247,85,162,1,15,10,5,14,11,0,2,1,1
E33020689,240,180,66,114,2,35,27,8,23,19,0,2,2,0
E33020690,395,345,129,216,1,19,15,4,29,25,1,2,1,1
E33020691,320,264,89,175,2,18,14,4,34,30,0,4,0,2
E33020692,272,210,79,131,3,22,20,2,34,29,1,1,3,3
E33020693,279,221,74,147,0,31,26,5,26,23,2,1,0,1
E33020694,340,260,72,188,0,43,32,11,36,34,0,1,1,1
E33020695,584,447,129,318,2,91,83,8,40,36,1,3,0,4
E33020696,361,283,99,184,1,43,36,7,30,27,0,3,0,4
E33020697,580,462,161,301,3,72,66,6,42,40,0,1,1,1
E33020698,337,273,71,202,1,38,35,3,25,18,2,4,1,0
E33020699,274,185,48,137,2,48,41,7,37,31,2,4,0,2
E33020700,279,213,56,157,0,53,49,4,11,10,0,1,0,2
E33020701,249,187,43,144,1,41,34,7,14,14,0,0,0,6
E33020702,534,374,126,248,3,106,95,11,49,42,0,6,1,2
E33020703,811,587,205,382,7,134,113,21,76,70,0,6,0,7
E33020704,369,271,92,179,0,61,53,8,36,36,0,0,0,1
E33020705,406,309,109,200,3,56,45,11,38,36,0,1,1,0
E33020706,334,222,59,163,2,69,61,8,41,37,0,2,2,0
E33020707,445,323,94,229,4,63,57,6,54,48,3,2,1,1
E33020708,800,566,189,377,4,139,125,14,85,81,1,3,0,6
E33020709,467,352,105,247,2,55,45,10,53,50,0,3,0,5
E33020710,373,309,99,210,2,28,21,7,31,22,2,6,1,3
E33020711,766,581,165,416,3,109,89,20,70,65,0,4,1,3
E33020712,356,304,114,190,1,30,27,3,16,14,0,2,0,5
E33020713,580,535,160,375,0,16,11,5,27,26,0,1,0,2
E33020714,278,244,100,144,0,12,9,3,20,19,0,1,0,2
E33020715,457,372,116,256,4,45,39,6,32,30,1,1,0,4
E33020716,280,211,66,145,1,35,33,2,31,29,0,1,1,2
E33020717,266,194,63,131,0,42,37,5,27,25,0,0,2,3
E33020718,427,327,125,202,5,64,55,9,28,22,2,2,2,3
E33020719,446,317,111,206,4,77,64,13,40,33,1,6,0,8
E33020720,530,439,131,308,2,33,29,4,54,49,0,5,0,2
E33020721,437,313,105,208,2,67,50,17,54,48,1,4,1,1
E33020722,672,543,166,377,2,67,53,14,57,56,0,1,0,3
E33020723,378,300,82,218,0,42,33,9,33,30,0,3,0,3
E33020724,393,328,112,216,1,28,22,6,35,28,0,2,5,1
E33020725,434,301,99,202,1,70,60,10,57,55,0,2,0,5
E33020726,628,465,137,328,4,89,74,15,68,67,0,1,0,2
E33020727,1812,1399,347,1052,20,137,107,30,246,221,4,21,0,10
E33020728,282,209,79,130,0,39,32,7,29,28,0,1,0,5
E33020729,521,418,97,321,2,31,21,10,60,49,0,6,5,10
E33020730,588,448,143,305,4,52,45,7,77,72,0,4,1,7
E33020731,286,195,55,140,1,69,65,4,19,18,0,1,0,2
E33020732,230,161,53,108,1,47,38,9,20,16,1,3,0,1
E33020733,255,195,55,140,1,29,21,8,28,22,2,4,0,2
E33020734,246,190,61,129,1,32,27,5,23,20,0,2,1,0
E33020735,257,197,56,141,1,38,31,7,21,14,1,4,2,0
E33020736,281,191,55,136,2,51,45,6,35,33,0,2,0,2
E33020737,289,250,92,158,0,24,22,2,15,15,0,0,0,0
E33020738,378,271,91,180,5,52,32,20,50,42,3,4,1,0
E33020739,341,240,75,165,2,51,45,6,42,36,2,3,1,6
E33020740,408,299,99,200,2,67,60,7,37,33,1,3,0,3
E33020741,271,220,60,160,1,31,28,3,19,18,0,1,0,0
E33020742,321,259,74,185,0,36,32,4,24,20,0,4,0,2
E33020743,245,171,51,120,1,42,38,4,28,24,0,2,2,3
E33020744,267,218,64,154,1,27,20,7,18,17,0,1,0,3
E33020745,460,367,113,254,0,52,43,9,39,36,0,3,0,2
E33020746,294,236,82,154,1,28,16,12,29,27,0,2,0,0
E33020747,354,275,85,190,2,44,38,6,32,29,0,3,0,1
E33020748,298,216,86,130,2,32,24,8,42,39,1,2,0,6
E33020749,528,430,116,314,10,23,15,8,64,56,2,6,0,1
E33020750,542,476,148,328,1,21,19,2,44,37,0,6,1,0
E33020751,512,468,108,360,2,13,9,4,29,27,0,2,0,0
E33020752,472,411,134,277,6,33,30,3,21,19,0,2,0,1
E33020753,390,310,99,211,2,30,22,8,45,44,0,0,1,3
E33020754,383,302,89,213,2,49,42,7,28,23,0,5,0,2
E33020755,222,180,50,130,0,19,17,2,19,14,0,5,0,4
E33020756,355,292,89,203,2,29,26,3,32,28,0,1,3,0
E33020757,743,600,174,426,7,47,35,12,84,77,0,6,1,5
E33020758,411,323,81,242,3,41,29,12,40,33,0,7,0,4
E33020759,400,309,107,202,3,44,29,15,38,31,0,6,1,6
E33020760,628,490,134,356,1,46,36,10,87,80,1,5,1,4
E33020761,396,304,83,221,4,54,24,30,33,30,0,2,1,1
E33020762,327,256,82,174,2,44,34,10,25,24,1,0,0,0
E33020763,577,438,139,299,9,73,62,11,51,47,0,4,0,6
E33020764,298,223,74,149,6,36,25,11,30,28,0,2,0,3
E33020765,285,230,71,159,6,21,20,1,27,25,0,2,0,1
E33020766,751,567,210,357,3,90,73,17,90,78,0,12,0,1
E33020767,520,413,134,279,5,54,40,14,46,37,0,9,0,2
E33020768,379,303,91,212,0,37,31,6,38,31,0,7,0,1
E33020769,318,240,72,168,0,37,30,7,39,35,1,2,1,2
E33020770,324,260,74,186,6,30,24,6,26,23,0,3,0,2
E33020771,639,514,165,349,4,59,44,15,57,54,1,2,0,5
E33020772,302,183,51,132,1,69,52,17,42,42,0,0,0,7
E33020773,276,213,66,147,1,31,20,11,31,25,2,4,0,0
E33020774,310,245,81,164,2,30,23,7,32,31,0,1,0,1
E33020775,325,259,76,183,3,26,15,11,36,34,0,2,0,1
E33020776,273,214,70,144,1,26,20,6,32,27,0,5,0,0
E33020777,684,566,196,370,3,60,42,18,52,47,1,4,0,3
E33020778,304,236,67,169,1,27,19,8,37,35,0,2,0,3
E33020779,261,195,53,142,1,39,36,3,25,22,0,2,1,1
E33020780,250,177,57,120,2,27,21,6,38,34,3,1,0,6
E33020781,267,194,75,119,1,29,20,9,41,35,3,3,0,2
E33020782,332,270,78,192,1,16,9,7,36,31,0,5,0,9
E33020783,389,304,103,201,2,31,30,1,51,47,0,3,1,1
E33020784,560,462,138,324,1,45,38,7,47,43,0,4,0,5
E33020785,392,315,109,206,3,38,30,8,33,32,0,0,1,3
E33020786,399,333,120,213,0,33,30,3,29,25,0,4,0,4
E33020787,240,190,71,119,0,30,19,11,18,17,0,1,0,2
E33020788,318,258,96,162,1,26,17,9,29,24,1,3,1,4
E33020789,668,470,144,326,2,113,107,6,74,67,0,5,2,9
E33020790,476,343,115,228,3,73,59,14,51,49,0,2,0,6
E33020791,724,591,194,397,2,61,54,7,69,57,1,9,2,1
E33020792,303,257,86,171,0,28,26,2,15,15,0,0,0,3
E33020793,354,270,95,175,0,46,39,7,34,28,0,6,0,4
E33020794,341,275,58,217,7,16,12,4,43,42,0,1,0,0
E33020795,268,186,62,124,1,41,39,2,39,36,1,2,0,1
E33020796,285,194,63,131,4,48,41,7,36,32,2,2,0,3
E33020797,307,253,91,162,1,13,8,5,38,35,0,2,1,2
E33020798,441,345,91,254,1,30,23,7,63,56,1,6,0,2
E33020799,349,300,90,210,1,19,12,7,26,23,1,1,1,3
E33020800,600,488,160,328,4,55,40,15,51,50,0,1,0,2
E33020801,259,223,67,156,0,9,7,2,26,23,1,2,0,1
E33020802,573,400,121,279,3,65,52,13,100,93,3,2,2,5
E33020803,442,345,123,222,4,57,45,12,32,29,0,3,0,4
E33020804,490,395,162,233,1,43,30,13,45,39,1,3,2,6
E33020805,332,285,107,178,1,17,14,3,28,27,0,1,0,1
E33020806,409,342,127,215,0,27,24,3,35,28,2,3,2,5
E33020807,245,214,75,139,1,6,5,1,22,20,0,2,0,2
E33020808,257,222,85,137,3,15,14,1,15,14,0,1,0,2
E33020809,493,387,138,249,1,64,58,6,38,34,0,3,1,3
E33020810,274,221,68,153,0,28,28,0,17,16,1,0,0,8
E33020811,457,412,142,270,2,18,12,6,24,21,1,2,0,1
E33020812,333,263,75,188,1,37,24,13,30,25,1,4,0,2
E33020813,348,287,107,180,0,25,24,1,35,31,0,2,2,1
E33020814,256,186,62,124,0,48,39,9,20,19,0,1,0,2
E33020815,342,216,60,156,2,59,45,14,63,57,0,4,2,2
E33020816,581,433,115,318,5,77,66,11,63,57,1,4,1,3
E33020817,1119,762,209,553,4,196,151,45,147,134,1,12,0,10
E33020818,346,265,63,202,0,26,17,9,52,52,0,0,0,3
E33020819,349,251,61,190,2,58,44,14,35,31,0,3,1,3
E33020820,400,282,87,195,5,54,40,14,56,50,1,5,0,3
E33020821,352,263,79,184,0,57,50,7,31,25,0,6,0,1
E33020822,256,177,56,121,2,54,41,13,21,18,0,1,2,2
E33020823,442,344,108,236,1,55,49,6,38,36,0,2,0,4
E33020824,317,226,58,168,1,75,72,3,12,11,0,1,0,3
E33020825,660,423,130,293,1,165,149,16,67,58,0,5,4,4
E33020826,472,334,119,215,5,68,51,17,63,58,1,3,1,2
E33020827,251,166,52,114,0,46,23,23,33,27,0,6,0,6
E33020828,591,473,147,326,1,78,69,9,37,32,0,3,2,2
E33020829,777,528,155,373,3,113,88,25,130,121,0,7,2,3
E33020830,569,408,88,320,5,73,48,25,80,71,0,9,0,3
E33020831,586,390,122,268,2,121,82,39,67,61,1,5,0,6
E33020832,502,357,113,244,8,90,74,16,43,41,0,2,0,4
E33020833,390,320,112,208,5,26,16,10,39,36,0,3,0,0
E33020834,356,302,97,205,1,15,10,5,35,35,0,0,0,3
E33020835,357,264,91,173,2,31,23,8,55,47,6,2,0,5
E33020836,477,385,127,258,1,44,29,15,40,37,0,2,1,7
E33020837,312,236,83,153,1,56,43,13,16,14,0,2,0,3
E33020838,362,289,89,200,1,36,33,3,32,31,0,1,0,4
E33020839,1085,812,242,570,15,137,100,37,119,105,3,8,3,2
E33020840,471,299,113,186,5,116,96,20,47,42,0,5,0,4
E33020841,671,446,106,340,4,144,115,29,66,54,1,11,0,11
E33020842,283,185,44,141,1,56,41,15,40,39,0,1,0,1
E33020843,386,291,82,209,2,50,43,7,41,37,1,1,2,2
E33020844,272,190,57,133,1,50,42,8,28,27,1,0,0,3
E33020845,308,189,49,140,2,68,58,10,47,45,0,1,1,2
E33020846,424,282,93,189,0,77,64,13,64,62,0,2,0,1
E33020847,323,226,61,165,1,61,50,11,29,29,0,0,0,6
E33020848,491,332,88,244,3,112,87,25,41,39,0,2,0,3
E33020849,276,179,62,117,3,35,24,11,54,54,0,0,0,5
E33020850,337,267,81,186,0,14,9,5,55,55,0,0,0,1
E33020851,393,287,83,204,2,50,41,9,49,45,0,4,0,5
E33020852,660,534,198,336,2,56,46,10,60,51,1,5,3,8
E33020853,294,199,57,142,4,54,46,8,34,30,0,4,0,3
E33020854,293,195,63,132,5,53,42,11,38,34,0,4,0,2
E33020855,472,302,94,208,1,87,68,19,78,73,0,4,1,4
E33020856,988,562,151,411,1,165,142,23,257,239,3,10,5,3
E33020857,240,173,66,107,0,46,38,8,20,18,1,1,0,1
E33020858,293,223,66,157,2,43,36,7,21,19,1,1,0,4
E33020859,299,176,46,130,1,91,81,10,30,26,0,4,0,1
E33020860,396,300,82,218,2,60,49,11,31,28,0,2,1,3
E33020861,461,289,117,172,4,130,108,22,36,34,2,0,0,2
E33020862,609,404,113,291,1,118,92,26,82,78,0,3,1,4
E33020863,360,250,89,161,5,70,49,21,35,31,0,3,1,0
E33020864,499,362,98,264,3,89,69,20,45,45,0,0,0,0
E33020865,289,212,68,144,10,32,31,1,33,32,0,1,0,2
E33020866,259,173,55,118,2,51,46,5,31,31,0,0,0,2
E33020867,255,162,49,113,0,57,42,15,31,31,0,0,0,5
E33020868,258,186,53,133,0,41,35,6,30,28,0,2,0,1
E33020869,315,217,49,168,3,50,41,9,44,39,0,4,1,1
E33020870,653,504,129,375,3,81,63,18,59,54,0,5,0,6
E33020871,284,190,60,130,3,54,40,14,36,34,0,2,0,1
E33020872,527,383,119,264,3,70,51,19,67,65,0,2,0,4
E33020873,349,221,55,166,2,64,54,10,60,54,0,3,3,2
E33020874,457,338,97,241,1,47,41,6,66,63,1,2,0,5
E33020875,666,493,142,351,7,78,59,19,86,78,0,6,2,2
E33020876,264,200,44,156,4,32,25,7,25,21,1,2,1,3
E33020877,382,261,83,178,5,70,63,7,42,34,0,7,1,4
E33020878,328,223,59,164,1,37,32,5,66,63,1,2,0,1
E33020879,247,147,53,94,1,50,39,11,46,41,1,2,2,3
E33020880,959,719,204,515,8,100,72,28,125,117,1,5,2,7
E33020881,388,244,80,164,6,64,41,23,71,66,0,2,3,3
E33020882,2760,2055,484,1571,15,308,234,74,370,337,12,18,3,12
E33020883,544,380,108,272,2,85,69,16,71,67,0,3,1,6
E33020884,273,186,66,120,2,39,31,8,46,41,1,4,0,0
E33020885,324,187,57,130,4,67,57,10,63,60,1,1,1,3
E33020886,375,246,81,165,1,71,62,9,55,49,0,5,1,2
E33020887,339,217,57,160,3,53,38,15,65,62,0,1,2,1
E33020888,686,508,174,334,7,99,91,8,62,57,1,4,0,10
E33020889,523,379,108,271,5,86,72,14,47,44,0,3,0,6
E33020890,297,176,66,110,6,49,34,15,56,50,0,4,2,10
E33020891,503,374,119,255,1,82,71,11,42,39,0,3,0,4
E33020892,346,226,66,160,5,60,53,7,53,49,1,3,0,2
E33020893,602,435,129,306,2,69,36,33,88,83,1,3,1,8
E33020894,539,405,125,280,0,88,50,38,42,40,0,2,0,4
E33020895,335,233,75,158,2,48,35,13,50,47,1,1,1,2
E33020896,253,161,41,120,2,40,30,10,50,49,1,0,0,0
E33020897,428,304,96,208,3,70,54,16,51,47,1,3,0,0
E33020898,312,244,74,170,1,25,21,4,39,37,0,2,0,3
E33020899,255,193,48,145,1,24,22,2,33,33,0,0,0,4
E33020900,535,410,129,281,6,66,42,24,47,44,0,3,0,6
E33020901,267,161,49,112,0,58,47,11,48,42,2,3,1,0
E33020902,325,252,69,183,3,54,49,5,12,10,0,1,1,4
E33020903,401,335,89,246,4,41,40,1,20,18,0,2,0,1
E33020904,343,257,70,187,1,49,44,5,31,30,0,1,0,5
E33020905,704,502,132,370,6,78,63,15,114,104,2,8,0,4
E33020906,571,423,163,260,7,68,44,24,69,64,0,4,1,4
E33020907,338,216,87,129,2,33,24,9,79,69,0,5,5,8
E33020908,358,277,105,172,3,22,14,8,55,49,0,4,2,1
E33020909,396,261,92,169,6,75,51,24,50,45,1,4,0,4
E33020910,451,271,87,184,3,51,35,16,119,92,0,21,6,7
E33020911,386,279,86,193,5,53,48,5,46,43,0,2,1,3
E33020912,316,225,87,138,3,37,27,10,43,36,0,0,7,8
E33020913,242,190,52,138,4,28,27,1,18,14,0,3,1,2
E33020914,563,426,135,291,2,78,67,11,56,49,1,5,1,1
E33020915,422,299,121,178,2,43,25,18,76,74,0,1,1,2
E33020916,841,490,169,321,3,171,112,59,166,161,0,3,2,11
E33020917,343,173,42,131,5,110,82,28,51,48,0,3,0,4
E33020918,243,158,52,106,1,52,36,16,32,29,0,3,0,0
E33020919,349,236,63,173,1,50,42,8,58,56,1,0,1,4
E33020920,470,322,100,222,5,80,62,18,60,57,1,1,1,3
E33020921,258,167,36,131,1,61,52,9,28,28,0,0,0,1
E33020922,329,265,77,188,1,32,26,6,29,27,0,1,1,2
E33020923,240,187,60,127,0,34,29,5,18,16,0,2,0,1
E33020924,456,294,69,225,2,88,75,13,63,53,3,4,3,9
E33020925,584,398,110,288,1,98,61,37,79,75,0,3,1,8
E33020926,401,285,103,182,1,39,29,10,68,66,0,2,0,8
E33020927,341,239,75,164,4,50,39,11,47,40,1,6,0,1
E33020928,411,249,91,158,4,40,32,8,115,110,1,2,2,3
E33020929,776,575,168,407,10,119,95,24,67,60,1,2,4,5
E33020930,268,222,84,138,0,26,18,8,19,17,0,1,1,1
E33020931,287,241,71,170,3,20,16,4,21,20,0,1,0,2
E33020932,414,294,79,215,2,50,39,11,60,54,0,2,4,8
E33020933,412,291,92,199,1,61,48,13,58,54,0,4,0,1
E33020934,327,272,73,199,1,18,14,4,35,33,0,2,0,1
E33020935,579,409,96,313,2,99,87,12,65,60,0,5,0,4
E33020936,371,286,80,206,3,48,42,6,32,31,1,0,0,2
E33020937,308,200,63,137,1,67,56,11,37,34,0,2,1,3
E33020938,401,284,93,191,4,71,61,10,39,37,0,1,1,3
E33020939,313,215,60,155,0,70,68,2,28,25,0,3,0,0
E33020940,329,239,84,155,0,52,44,8,35,34,0,1,0,3
E33020941,381,295,89,206,2,39,31,8,43,40,1,2,0,2
E33020942,593,440,126,314,5,75,62,13,72,65,1,3,3,1
E33020943,407,290,89,201,4,50,37,13,59,53,3,3,0,4
E33020944,349,251,77,174,2,49,47,2,45,43,0,1,1,2
E33020945,293,193,53,140,1,58,55,3,38,31,2,5,0,3
E33020946,551,378,137,241,2,63,47,16,105,97,0,7,1,3
E33020947,630,450,156,294,3,56,39,17,118,103,4,6,5,3
E33020948,358,260,82,178,0,40,33,7,52,48,0,2,2,6
E33020949,443,291,106,185,0,57,45,12,90,85,0,5,0,5
E33020950,277,201,69,132,1,15,11,4,58,55,2,1,0,2
E33020951,293,181,65,116,1,36,29,7,74,70,1,3,0,1
E33020952,553,417,156,261,3,92,75,17,39,33,0,5,1,2
E33020953,226,169,49,120,1,31,26,5,23,23,0,0,0,2
E33020954,293,202,54,148,3,34,26,8,50,45,0,5,0,4
E33020955,665,545,172,373,1,68,59,9,46,41,0,2,3,5
E33020956,448,310,82,228,8,69,49,20,58,55,1,0,2,3
E33020957,517,376,115,261,0,83,68,15,54,50,0,4,0,4
E33020958,612,451,142,309,2,62,44,18,93,83,2,8,0,4
E33020959,522,428,128,300,1,39,37,2,49,43,0,5,1,5
E33020960,429,311,92,219,4,45,36,9,66,60,2,3,1,3
E33020961,310,235,61,174,2,40,31,9,33,32,1,0,0,0
E33020962,381,298,87,211,6,30,27,3,44,42,0,2,0,3
E33020963,319,241,67,174,3,51,46,5,23,21,0,2,0,1
E33020964,480,399,146,253,2,46,41,5,30,27,0,3,0,3
E33020965,704,511,171,340,9,108,84,24,73,69,0,2,2,3
E33020966,281,181,46,135,3,55,50,5,31,23,0,5,3,11
E33020967,289,255,83,172,0,7,5,2,26,24,0,2,0,1
E33020968,301,252,83,169,0,24,17,7,23,20,0,3,0,2
E33020969,232,190,54,136,1,21,17,4,18,18,0,0,0,2
E33020970,322,283,92,191,0,19,11,8,16,11,1,3,1,4
E33020971,380,271,73,198,5,55,16,39,49,46,0,3,0,0
E33020972,465,314,81,233,5,100,82,18,44,40,0,4,0,2
E33020973,463,359,97,262,6,53,37,16,44,39,0,4,1,1
E33020974,324,265,64,201,7,25,17,8,21,19,1,1,0,6
E33020975,243,208,60,148,0,21,14,7,14,13,1,0,0,0
E33020976,369,288,73,215,3,34,20,14,40,38,0,1,1,4
E33020977,225,153,53,100,1,61,50,11,9,9,0,0,0,1
E33020978,482,352,82,270,4,70,55,15,51,47,0,3,1,5
E33020979,357,257,55,202,1,69,52,17,29,26,0,3,0,1
E33020980,260,169,40,129,9,52,38,14,30,25,1,3,1,0
E33020981,285,175,44,131,1,67,60,7,37,35,0,2,0,5
E33020982,343,262,75,187,5,42,34,8,34,33,0,1,0,0
E33020983,406,303,86,217,2,59,48,11,41,36,1,4,0,1
E33020984,896,500,106,394,8,272,225,47,112,98,1,13,0,4
E33020985,613,480,100,380,7,69,54,15,56,48,0,5,3,1
E33020986,416,335,85,250,4,43,34,9,31,25,1,5,0,3
E33020987,606,407,116,291,3,142,109,33,53,52,0,1,0,1
E33020988,370,274,71,203,4,49,40,9,41,35,1,5,0,2
E33020989,370,271,53,218,2,65,56,9,30,26,1,3,0,2
E33020990,578,420,110,310,2,98,84,14,56,49,1,5,1,2
E33020991,767,554,143,411,8,126,96,30,72,62,0,10,0,7
E33020992,358,247,48,199,1,79,65,14,30,26,0,4,0,1
E33020993,327,239,68,171,3,37,30,7,45,45,0,0,0,3
E33020994,339,251,64,187,1,40,26,14,42,41,0,1,0,5
E33020995,287,210,48,162,4,40,29,11,33,33,0,0,0,0
E33020996,305,242,69,173,1,34,28,6,28,24,0,4,0,0
E33020997,368,306,75,231,2,23,16,7,34,31,0,3,0,3
E33020998,437,373,112,261,1,11,9,2,51,45,1,5,0,1
E33020999,7937,6502,1532,4970,36,713,499,214,652,612,4,30,6,34
E33021000,438,369,90,279,1,28,20,8,39,33,0,6,0,1
E33021001,298,253,84,169,1,10,7,3,33,31,0,2,0,1
E33021002,301,223,60,163,0,37,28,9,35,31,0,3,1,6
E33021003,410,325,83,242,3,29,21,8,49,46,0,3,0,4
E33021004,564,406,118,288,5,67,52,15,83,75,0,7,1,3
E33021005,570,414,122,292,6,58,43,15,89,85,0,4,0,3
E33021006,274,227,74,153,2,15,13,2,29,26,0,3,0,1
E33021007,266,198,62,136,1,30,19,11,35,32,0,3,0,2
E33021008,484,408,128,280,0,21,18,3,53,49,0,3,1,2
E33021009,559,441,127,314,4,45,24,21,63,59,0,4,0,6
E33021010,257,230,64,166,2,2,1,1,17,16,0,1,0,6
E33021011,255,210,80,130,2,13,13,0,27,25,0,2,0,3
E33021012,283,232,70,162,0,17,15,2,34,31,0,3,0,0
E33021013,320,268,86,182,2,10,7,3,39,35,0,4,0,1
E33021014,422,299,80,219,3,50,40,10,68,62,1,5,0,2
E33021015,553,422,141,281,5,30,17,13,91,72,4,8,7,5
E33021016,401,344,106,238,2,23,21,2,29,23,2,4,0,3
E33021017,574,469,158,311,2,32,24,8,69,64,0,5,0,2
E33021018,281,178,54,124,0,35,30,5,68,67,0,1,0,0
E33021019,289,260,113,147,0,8,7,1,17,15,1,1,0,4
E33021020,335,245,83,162,0,31,23,8,58,55,0,2,1,1
E33021021,342,285,107,178,0,20,18,2,37,30,0,7,0,0
E33021022,848,690,219,471,11,46,35,11,89,80,2,6,1,12
E33021023,411,343,96,247,2,27,17,10,32,30,0,2,0,7
E33021024,662,536,149,387,3,40,26,14,76,74,0,1,1,7
E33021025,404,296,73,223,5,20,17,3,78,68,0,9,1,5
E33021026,416,324,131,193,2,36,27,9,48,41,5,1,1,6
E33021027,444,334,103,231,4,36,20,16,56,51,0,5,0,14
E33021028,419,324,101,223,4,37,19,18,52,47,0,3,2,2
E33021029,257,216,71,145,1,11,5,6,26,25,0,1,0,3
E33021030,544,439,146,293,1,30,23,7,68,60,1,7,0,6
E33021031,296,272,91,181,2,1,1,0,20,18,0,2,0,1
E33021032,325,258,73,185,2,18,15,3,45,44,0,1,0,2
E33021033,370,312,81,231,3,17,13,4,37,35,0,2,0,1
E33021034,675,518,144,374,5,52,42,10,94,86,1,6,1,6
E33021035,466,381,117,264,2,36,31,5,47,44,0,3,0,0
E33021036,249,231,74,157,0,5,4,1,12,10,0,2,0,1
E33021037,1898,1453,382,1071,18,81,54,27,342,319,2,20,1,4
E33021038,473,323,97,226,1,41,32,9,106,94,5,4,3,2
E33021039,272,246,80,166,3,4,3,1,17,17,0,0,0,2
E33021040,244,214,65,149,1,6,6,0,23,17,1,5,0,0
E33021041,328,266,61,205,4,18,9,9,38,32,3,3,0,2
E33021042,323,248,79,169,2,31,30,1,39,34,0,2,3,3
E33021043,301,250,76,174,1,21,15,6,27,23,1,2,1,2
E33021044,390,339,93,246,2,10,6,4,37,34,0,1,2,2
E33021045,338,258,77,181,1,12,10,2,66,64,0,2,0,1
E33021046,349,299,73,226,5,13,7,6,31,29,0,2,0,1
E33021047,373,256,78,178,3,50,42,8,64,60,0,4,0,0
E33021048,689,561,166,395,4,48,40,8,71,62,0,9,0,5
E33021049,355,306,95,211,0,7,5,2,41,35,1,3,2,1
E33021050,466,408,127,281,0,16,13,3,39,34,2,3,0,3
E33021051,423,359,118,241,1,26,23,3,35,33,0,2,0,2
E33021052,542,492,161,331,2,5,3,2,42,38,0,4,0,1
E33021053,484,402,132,270,1,17,12,5,56,51,1,4,0,8
E33021054,289,252,82,170,0,5,2,3,30,29,0,1,0,2
E33021055,254,216,55,161,0,10,6,4,26,21,2,1,2,2
E33021056,292,260,92,168,0,9,7,2,22,22,0,0,0,1
E33021057,234,196,65,131,1,10,4,6,25,25,0,0,0,2
E33021058,378,326,113,213,2,16,8,8,31,29,0,2,0,3
E33021059,385,322,97,225,3,18,11,7,41,32,3,3,3,1
E33021060,290,237,75,162,1,12,9,3,37,30,2,4,1,3
E33021061,457,389,138,251,4,13,6,7,44,40,0,1,3,7
E33021062,356,306,98,208,0,9,8,1,39,36,0,3,0,2
E33021063,376,297,97,200,0,21,16,5,56,55,0,1,0,2
E33021064,255,212,58,154,0,9,7,2,31,28,0,3,0,3
E33021065,373,311,89,222,0,21,11,10,37,34,0,2,1,4
E33021066,545,435,135,300,6,33,24,9,68,58,2,8,0,3
E33021067,1216,981,272,709,13,65,50,15,152,142,0,10,0,5
E33021068,395,320,89,231,1,16,5,11,54,50,1,0,3,4
E33021069,243,218,76,142,1,5,3,2,15,15,0,0,0,4
E33021070,281,235,66,169,0,20,13,7,26,24,0,2,0,0
E33021071,290,254,96,158,2,6,4,2,27,25,0,2,0,1
E33021072,479,409,151,258,2,20,14,6,45,41,0,4,0,3
E33021073,294,258,90,168,2,3,2,1,30,28,0,2,0,1
E33021074,361,276,60,216,5,6,4,2,72,68,0,4,0,2
E33021075,232,200,56,144,3,10,5,5,19,19,0,0,0,0
E33021076,381,350,129,221,2,5,4,1,24,19,4,1,0,0
E33021077,362,241,47,194,3,6,3,3,107,98,3,6,0,5
E33021078,472,373,104,269,6,24,17,7,62,53,1,7,1,7
E33021079,272,237,73,164,0,10,9,1,22,20,0,2,0,3
E33021080,411,302,95,207,3,59,27,32,47,43,3,1,0,0
E33021081,331,264,63,201,3,25,9,16,39,37,0,1,1,0
E33021082,411,271,82,189,7,78,38,40,49,36,7,4,2,6
E33021083,297,235,72,163,0,35,20,15,25,22,1,2,0,2
E33021084,712,538,113,425,6,76,37,39,86,82,2,2,0,6
E33021085,411,307,82,225,3,67,33,34,33,26,2,5,0,1
E33021086,295,225,52,173,0,37,15,22,30,27,2,1,0,3
E33021087,373,315,106,209,3,25,12,13,27,24,1,2,0,3
E33021088,556,459,135,324,1,54,34,20,37,35,0,2,0,5
E33021089,778,566,166,400,1,111,43,68,99,91,0,6,2,1
E33021090,471,373,106,267,2,45,24,21,44,34,1,7,2,7
E33021091,295,215,54,161,6,40,18,22,34,34,0,0,0,0
E33021092,385,278,58,220,3,51,22,29,49,44,1,3,1,4
E33021093,275,236,66,170,0,23,18,5,15,15,0,0,0,1
E33021094,737,541,175,366,4,96,41,55,92,77,0,12,3,4
E33021095,405,301,85,216,1,72,39,33,30,26,0,3,1,1
E33021096,263,209,75,134,0,34,10,24,17,17,0,0,0,3
E33021097,378,279,72,207,1,42,27,15,51,41,3,5,2,5
E33021098,417,311,96,215,1,53,25,28,51,45,0,6,0,1
E33021099,317,277,86,191,0,12,5,7,26,24,1,1,0,2
E33021100,315,273,71,202,1,24,12,12,17,16,0,1,0,0
E33021101,455,323,85,238,1,88,40,48,41,36,1,3,1,2
E33021102,642,432,134,298,4,132,65,67,72,61,1,6,4,2
E33021103,315,262,63,199,0,18,10,8,32,28,0,4,0,3
E33021104,291,217,54,163,0,47,31,16,21,15,0,6,0,6
E33021105,563,400,105,295,3,107,58,49,50,43,0,6,1,3
E33021106,299,241,78,163,0,33,16,17,21,19,0,2,0,4
E33021107,614,510,133,377,5,35,18,17,61,55,0,5,1,3
E33021108,375,305,92,213,1,24,12,12,43,30,1,12,0,2
E33021109,328,269,87,182,2,31,26,5,21,19,0,2,0,5
E33021110,706,584,154,430,2,64,28,36,55,49,0,6,0,1
E33021111,422,293,68,225,0,90,57,33,38,34,0,3,1,1
E33021112,448,265,72,193,0,119,58,61,60,57,2,1,0,4
E33021113,578,441,129,312,3,79,37,42,52,42,0,5,5,3
E33021114,256,159,46,113,1,50,29,21,45,38,1,6,0,1
E33021115,360,283,85,198,1,51,23,28,25,21,2,2,0,0
E33021116,387,268,96,172,5,76,46,30,38,38,0,0,0,0
E33021117,259,156,44,112,2,59,33,26,40,37,0,2,1,2
E33021118,288,234,84,150,2,18,10,8,30,25,0,5,0,4
E33021119,444,294,95,199,2,89,41,48,51,48,0,1,2,8
E33021120,928,739,236,503,9,95,52,43,82,73,2,7,0,3
E33021121,706,528,162,366,7,72,38,34,91,83,1,7,0,8
E33021122,379,296,89,207,4,38,23,15,38,33,1,4,0,3
E33021123,434,320,82,238,9,57,33,24,44,38,1,3,2,4
E33021124,337,253,71,182,4,44,13,31,34,30,1,2,1,2
E33021125,317,217,56,161,1,55,23,32,42,41,0,1,0,2
E33021126,398,278,76,202,1,74,27,47,43,37,0,4,2,2
E33021127,748,517,175,342,1,156,62,94,70,63,0,5,2,4
E33021128,269,159,50,109,0,62,22,40,45,40,0,3,2,3
E33021129,894,672,166,506,10,98,37,61,112,103,3,6,0,2
E33021130,292,166,53,113,1,87,47,40,38,37,0,1,0,0
E33021131,738,546,161,385,3,123,51,72,60,49,1,10,0,6
E33021132,394,294,73,221,5,53,23,30,42,41,0,1,0,0
E33021133,537,381,101,280,6,77,43,34,70,63,1,4,2,3
E33021134,429,358,104,254,3,26,12,14,42,40,0,2,0,0
E33021135,385,302,88,214,3,45,27,18,32,25,1,6,0,3
E33021136,274,204,74,130,2,49,34,15,19,15,0,4,0,0
E33021137,344,292,96,196,1,18,14,4,31,26,0,5,0,2
E33021138,264,229,63,166,0,15,6,9,20,18,1,0,1,0
E33021139,299,214,56,158,2,42,28,14,41,35,0,5,1,0
E33021140,451,326,101,225,1,69,36,33,52,46,1,2,3,3
E33021141,1378,959,262,697,4,250,158,92,162,150,0,12,0,3
E33021142,264,163,41,122,0,76,12,64,25,25,0,0,0,0
E33021143,467,375,106,269,5,19,8,11,67,61,2,4,0,1
E33021144,642,437,132,305,0,130,47,83,71,69,0,2,0,4
E33021145,259,209,68,141,2,30,18,12,17,15,0,2,0,1
E33021146,457,386,98,288,2,24,19,5,43,41,0,2,0,2
E33021147,671,517,156,361,5,60,36,24,86,80,2,2,2,3
E33021148,373,283,84,199,1,46,27,19,40,39,0,1,0,3
E33021149,311,277,104,173,2,13,7,6,17,14,0,3,0,2
E33021150,328,289,81,208,1,18,11,7,18,17,0,1,0,2
E33021151,263,192,59,133,0,52,28,24,19,17,0,2,0,0
E33021152,485,347,91,256,1,92,56,36,45,38,0,7,0,0
E33021153,294,211,67,144,0,42,14,28,39,35,0,4,0,2
E33021154,382,303,92,211,2,29,10,19,44,42,0,1,1,4
E33021155,382,299,90,209,1,38,14,24,39,37,0,1,1,5
E33021156,437,296,87,209,0,89,42,47,49,47,0,2,0,3
E33021157,353,242,93,149,2,78,55,23,30,28,0,1,1,1
E33021158,299,218,77,141,2,34,15,19,41,38,1,2,0,4
E33021159,241,179,52,127,2,32,27,5,25,23,0,2,0,3
E33021160,515,372,137,235,1,80,45,35,54,53,0,0,1,8
E33021161,495,374,112,262,2,68,36,32,47,44,0,3,0,4
E33021162,436,297,78,219,1,76,50,26,58,51,0,7,0,4
E33021163,506,350,105,245,1,89,39,50,60,54,3,2,1,6
E33021164,536,353,102,251,2,103,52,51,74,71,0,3,0,4
E33021165,552,415,102,313,4,72,33,39,58,49,0,2,7,3
E33021166,433,335,100,235,2,53,36,17,38,38,0,0,0,5
E33021167,1007,626,184,442,11,189,115,74,174,162,0,8,4,7
E33021168,544,379,130,249,4,118,75,43,39,39,0,0,0,4
E33021169,387,312,77,235,4,37,28,9,32,29,0,3,0,2
E33021170,299,216,80,136,1,42,27,15,38,27,4,7,0,2
E33021171,617,439,126,313,2,90,61,29,85,81,2,0,2,1
E33021172,254,224,72,152,0,3,2,1,24,19,0,5,0,3
E33021173,502,436,139,297,1,20,8,12,41,38,0,3,0,4
E33021174,294,257,84,173,1,12,5,7,22,20,0,2,0,2
E33021175,346,279,83,196,1,22,10,12,34,31,2,1,0,10
E33021176,524,393,151,242,4,53,23,30,71,63,0,7,1,3
E33021177,450,361,135,226,1,27,12,15,58,53,0,4,1,3
E33021178,261,144,55,89,7,65,30,35,44,39,1,2,2,1
E33021179,288,199,75,124,3,54,32,22,31,27,0,4,0,1
E33021180,410,331,112,219,0,48,24,24,30,28,0,2,0,1
E33021181,471,318,94,224,3,94,38,56,52,51,1,0,0,4
E33021182,378,261,80,181,5,64,32,32,45,42,2,1,0,3
E33021183,407,287,103,184,4,64,29,35,45,44,0,1,0,7
E33021184,319,266,104,162,1,25,11,14,24,24,0,0,0,3
E33021185,437,349,102,247,2,36,10,26,48,42,2,1,3,2
E33021186,451,326,123,203,6,57,19,38,61,58,0,3,0,1
E33021187,728,478,148,330,6,126,68,58,114,105,1,7,1,4
E33021188,355,243,71,172,1,49,28,21,57,56,0,0,1,5
E33021189,258,184,66,118,0,32,11,21,42,37,0,4,1,0
E33021190,704,480,144,336,4,125,83,42,89,84,0,5,0,6
E33021191,483,337,100,237,5,75,36,39,62,60,0,2,0,4
E33021192,223,162,59,103,3,29,12,17,26,21,0,4,1,3
E33021193,267,208,58,150,7,12,7,5,39,35,0,4,0,1
E33021194,251,223,60,163,0,11,6,5,16,14,0,2,0,1
E33021195,344,305,72,233,2,4,3,1,33,28,0,5,0,0
E33021196,503,338,132,206,2,100,47,53,59,52,0,7,0,4
E33021197,252,196,73,123,1,31,20,11,22,18,0,3,1,2
E33021198,500,341,118,223,1,93,64,29,62,57,0,5,0,3
E33021199,340,234,105,129,1,63,36,27,40,37,0,2,1,2
E33021200,487,355,93,262,3,60,29,31,68,65,0,3,0,1
E33021201,431,322,142,180,1,43,19,24,58,51,1,4,2,7
E33021202,409,296,108,188,1,69,25,44,39,35,0,3,1,4
E33021203,558,427,110,317,3,46,26,20,77,67,0,10,0,5
E33021204,253,160,43,117,2,30,13,17,56,51,1,4,0,5
E33021205,281,203,64,139,0,35,10,25,43,37,0,6,0,0
E33021206,422,285,71,214,0,67,33,34,68,60,2,4,2,2
E33021207,495,419,163,256,1,15,7,8,57,54,0,3,0,3
E33021208,347,304,120,184,0,11,9,2,29,25,2,0,2,3
E33021209,473,322,72,250,1,107,68,39,40,37,0,3,0,3
E33021210,436,323,105,218,0,63,30,33,47,41,1,4,1,3
E33021211,499,348,128,220,0,100,54,46,49,44,0,2,3,2
E33021212,335,236,68,168,2,51,24,27,39,37,0,2,0,7
E33021213,277,196,75,121,4,43,19,24,30,27,0,2,1,4
E33021214,254,202,56,146,1,18,8,10,31,29,1,1,0,2
E33021215,161,109,33,76,0,29,19,10,21,19,0,2,0,2
E33021216,409,278,90,188,0,81,52,29,47,40,0,6,1,3
E33021217,248,156,59,97,2,62,44,18,24,22,1,1,0,4
E33021218,399,285,98,187,3,57,36,21,51,47,1,3,0,3
E33021219,286,243,77,166,1,15,9,6,22,21,0,1,0,5
E33021220,580,501,107,394,1,23,18,5,49,48,0,1,0,6
E33021221,289,236,58,178,2,23,11,12,23,23,0,0,0,5
E33021222,570,501,140,361,5,14,9,5,48,44,0,4,0,2
E33021223,487,338,103,235,5,85,62,23,57,49,1,7,0,2
E33021224,315,241,70,171,0,47,45,2,25,21,0,4,0,2
E33021225,416,290,87,203,3,79,70,9,42,41,0,0,1,2
E33021226,496,369,83,286,1,76,66,10,48,41,1,4,2,2
E33021227,470,371,107,264,4,58,47,11,30,27,1,2,0,7
E33021228,280,198,39,159,4,49,32,17,29,27,0,1,1,0
E33021229,295,184,42,142,1,70,62,8,34,27,0,7,0,6
E33021230,265,207,55,152,7,22,12,10,28,27,0,0,1,1
E33021231,413,287,86,201,2,95,80,15,23,21,0,2,0,6
E33021232,281,212,50,162,0,38,34,4,28,25,0,2,1,3
E33021233,325,198,51,147,3,102,89,13,17,16,0,0,1,5
E33021234,485,326,91,235,3,95,85,10,54,51,1,2,0,7
E33021235,301,254,51,203,0,34,29,5,13,10,0,1,2,0
E33021236,544,405,126,279,0,109,97,12,29,25,0,3,1,1
E33021237,364,245,69,176,3,85,65,20,31,30,0,1,0,0
E33021238,305,227,68,159,2,45,36,9,29,26,1,2,0,2
E33021239,412,306,73,233,1,76,46,30,25,24,0,0,1,4
E33021240,360,214,72,142,3,97,71,26,46,38,6,1,1,0
E33021241,294,156,45,111,0,118,95,23,19,19,0,0,0,1
E33021242,268,202,25,177,3,38,28,10,25,25,0,0,0,0
E33021243,284,238,63,175,2,16,13,3,26,25,0,1,0,2
E33021244,300,247,61,186,0,20,13,7,32,29,0,3,0,1
E33021245,519,370,102,268,2,89,79,10,56,50,1,5,0,2
E33021246,372,273,70,203,0,68,65,3,27,22,0,4,1,4
E33021247,245,185,63,122,2,15,8,7,40,40,0,0,0,3
E33021248,378,299,120,179,0,49,35,14,26,21,1,4,0,4
E33021249,341,247,90,157,0,39,32,7,47,46,0,1,0,8
E33021250,249,183,62,121,2,25,18,7,34,32,0,2,0,5
E33021251,255,211,64,147,1,10,9,1,28,26,0,2,0,5
E33021252,294,246,64,182,1,22,21,1,23,20,0,3,0,2
E33021253,242,181,49,132,0,34,31,3,26,21,0,1,4,1
E33021254,253,203,62,141,0,25,23,2,22,20,0,2,0,3
E33021255,443,303,101,202,3,83,67,16,50,45,0,4,1,4
E33021256,439,321,108,213,0,74,65,9,41,36,0,5,0,3
E33021257,257,187,53,134,2,41,34,7,25,23,0,1,1,2
E33021258,322,196,62,134,3,86,77,9,33,31,0,2,0,4
E33021259,400,262,70,192,3,90,75,15,41,40,1,0,0,4
E33021260,501,352,131,221,4,77,52,25,64,62,0,1,1,4
E33021261,685,577,169,408,3,39,28,11,65,63,1,1,0,1
E33021262,794,518,162,356,0,136,97,39,128,119,0,8,1,12
E33021263,332,250,61,189,0,45,37,8,34,31,1,2,0,3
E33021264,869,673,178,495,1,106,77,29,83,80,0,0,3,6
E33021265,364,201,67,134,3,74,49,25,82,70,2,3,7,4
E33021266,425,313,84,229,2,57,39,18,52,49,1,2,0,1
E33021267,295,192,68,124,1,42,28,14,56,48,0,6,2,4
E33021268,308,234,67,167,1,32,28,4,41,36,0,5,0,0
E33021269,219,181,69,112,0,14,10,4,21,17,4,0,0,3
E33021270,320,283,105,178,2,12,10,2,20,16,0,4,0,3
E33021271,608,469,157,312,2,54,37,17,77,75,0,2,0,6
E33021272,523,391,138,253,2,51,28,23,76,68,0,8,0,3
E33021273,367,289,104,185,6,35,31,4,32,30,0,2,0,5
E33021274,278,155,46,109,2,88,84,4,31,22,0,3,6,2
E33021275,249,161,58,103,6,38,32,6,44,42,0,0,2,0
E33021276,255,138,40,98,1,81,66,15,28,27,0,1,0,7
E33021277,371,294,90,204,5,32,23,9,37,31,1,5,0,3
E33021278,355,234,72,162,4,65,41,24,51,45,0,6,0,1
E33021279,5837,4448,1223,3225,30,615,481,134,719,657,23,21,18,25
E33021280,257,123,48,75,2,110,97,13,20,20,0,0,0,2
E33021281,658,382,136,246,3,168,130,38,97,89,0,6,2,8
E33021282,387,210,58,152,1,93,51,42,80,76,0,2,2,3
E33021283,364,199,67,132,2,58,34,24,99,96,0,2,1,6
E33021284,320,194,73,121,2,62,39,23,58,48,0,6,4,4
E33021285,329,241,82,159,1,26,18,8,58,55,0,3,0,3
E33021286,401,226,77,149,3,65,44,21,105,99,0,4,2,2
E33021287,278,193,76,117,1,33,22,11,49,45,0,4,0,2
E33021288,278,166,59,107,1,52,32,20,56,54,0,1,1,3
E33021289,509,385,125,260,3,53,36,17,65,58,0,3,4,3
E33021290,239,157,55,102,2,30,20,10,45,45,0,0,0,5
E33021291,286,211,70,141,0,22,16,6,49,44,2,3,0,4
E33021292,342,248,80,168,0,56,47,9,35,31,0,2,2,3
E33021293,296,193,57,136,2,64,57,7,27,23,0,4,0,10
E33021294,372,252,75,177,0,64,57,7,51,46,0,5,0,5
E33021295,296,239,73,166,0,27,24,3,28,25,1,2,0,2
E33021296,407,335,119,216,0,29,24,5,38,33,0,5,0,5
E33021297,358,291,108,183,0,23,19,4,44,42,0,1,1,0
E33021298,416,289,97,192,0,56,45,11,67,65,1,1,0,4
E33021299,1050,746,194,552,4,156,120,36,143,136,2,5,0,1
E33021300,251,135,44,91,3,48,29,19,65,59,1,5,0,0
E33021301,517,406,110,296,0,52,33,19,54,54,0,0,0,5
E33021302,255,191,74,117,0,24,18,6,36,30,1,5,0,4
E33021303,495,358,106,252,1,63,49,14,69,64,0,4,1,4
E33021304,323,194,63,131,2,56,45,11,69,66,0,2,1,2
E33021305,349,228,64,164,0,51,34,17,66,57,1,4,4,4
E33021306,268,193,73,120,1,29,24,5,40,37,1,1,1,5
E33021307,277,188,66,122,0,21,12,9,63,60,0,2,1,5
E33021308,374,317,107,210,0,18,14,4,38,33,2,3,0,1
E33021309,262,216,81,135,3,19,12,7,24,19,0,5,0,0
E33021310,410,330,114,216,2,32,27,5,42,39,1,2,0,4
E33021311,494,363,140,223,1,57,41,16,67,64,0,3,0,6
E33021312,389,301,91,210,2,46,41,5,36,32,0,3,1,4
E33021313,268,190,44,146,3,46,33,13,28,26,0,2,0,1
E33021314,332,268,95,173,1,38,33,5,23,20,1,2,0,2
E33021315,352,246,74,172,1,55,48,7,42,39,1,1,1,8
E33021316,543,426,150,276,0,71,62,9,43,39,0,4,0,3
E33021317,469,339,105,234,2,78,65,13,48,40,2,6,0,2
E33021318,324,286,98,188,0,10,5,5,23,22,0,1,0,5
E33021319,344,235,79,156,1,39,30,9,63,62,0,0,1,6
E33021320,632,509,167,342,3,50,34,16,58,55,1,2,0,12
E33021321,284,215,74,141,1,43,24,19,24,19,0,5,0,1
E33021322,809,567,209,358,3,121,87,34,113,107,0,5,1,5
E33021323,779,452,114,338,2,125,106,19,181,170,3,7,1,19
E33021324,369,264,90,174,2,61,48,13,41,40,0,1,0,1
E33021325,335,240,65,175,1,48,39,9,42,40,0,2,0,4
E33021326,289,183,59,124,7,50,34,16,47,38,0,9,0,2
E33021327,358,263,90,173,2,46,36,10,44,42,0,2,0,3
E33021328,746,600,186,414,3,76,62,14,64,59,1,4,0,3
E33021329,273,248,63,185,1,9,6,3,13,12,0,1,0,2
E33021330,272,176,52,124,0,77,74,3,18,15,1,2,0,1
E33021331,282,195,60,135,3,39,27,12,44,38,3,3,0,1
E33021332,541,332,116,216,5,127,114,13,76,70,2,2,2,1
E33021333,353,238,76,162,2,78,66,12,34,31,1,1,1,1
E33021334,413,288,105,183,1,74,65,9,48,44,0,4,0,2
E33021335,250,175,45,130,2,40,31,9,29,29,0,0,0,4
E33021336,361,231,67,164,0,91,79,12,39,33,0,5,1,0
E33021337,444,354,159,195,1,25,19,6,55,48,3,4,0,9
E33021338,331,217,78,139,0,42,30,12,69,65,0,4,0,3
E33021339,479,336,132,204,0,60,37,23,81,77,0,4,0,2
E33021340,255,199,67,132,1,13,9,4,33,29,0,0,4,9
E33021341,426,345,136,209,2,28,22,6,47,44,1,2,0,4
E33021342,765,615,182,433,4,67,53,14,74,71,0,2,1,5
E33021343,414,325,97,228,3,54,45,9,31,27,2,2,0,1
E33021344,296,253,106,147,1,23,21,2,18,13,1,2,2,1
E33021345,379,238,73,165,2,100,90,10,32,28,0,1,3,7
E33021346,384,247,69,178,1,80,68,12,51,48,0,2,1,5
E33021347,559,388,134,254,2,107,94,13,59,56,0,3,0,3
E33021348,215,148,39,109,1,51,47,4,13,9,1,2,1,2
E33021349,407,260,88,172,1,86,73,13,58,54,1,3,0,2
E33021350,653,483,188,295,3,112,94,18,53,50,0,2,1,2
E33021351,303,202,117,85,6,11,4,7,57,47,4,3,3,27
E33021352,377,261,146,115,2,14,5,9,86,72,9,5,0,14
E33021353,240,175,67,108,1,18,2,16,44,40,0,4,0,2
E33021354,293,197,88,109,5,18,2,16,63,49,6,7,1,10
E33021355,368,274,117,157,1,24,4,20,60,48,3,8,1,9
E33021356,406,310,156,154,4,10,1,9,73,55,7,7,4,9
E33021357,394,296,117,179,3,35,2,33,56,46,3,6,1,4
E33021358,344,206,76,130,4,74,4,70,58,54,0,4,0,2
E33021359,393,272,101,171,7,38,9,29,65,63,2,0,0,11
E33021360,240,173,61,112,0,33,2,31,33,31,1,1,0,1
E33021361,489,314,135,179,5,71,4,67,88,78,3,6,1,11
E33021362,414,242,98,144,4,59,7,52,106,93,5,2,6,3
E33021363,334,247,84,163,4,36,6,30,43,41,2,0,0,4
E33021364,614,437,184,253,4,53,10,43,107,96,3,8,0,13
E33021365,404,254,118,136,3,35,7,28,107,95,4,3,5,5
E33021366,317,244,134,110,5,19,3,16,36,28,3,5,0,13
E33021367,386,244,109,135,3,42,2,40,76,62,9,3,2,21
E33021368,636,445,205,240,10,41,2,39,117,112,2,3,0,23
E33021369,587,403,145,258,12,57,10,47,105,92,3,8,2,10
E33021370,292,225,128,97,3,26,4,22,26,23,1,2,0,12
E33021371,266,181,91,90,1,27,12,15,43,38,4,1,0,14
E33021372,259,213,112,101,2,10,0,10,27,24,1,2,0,7
E33021373,239,169,70,99,4,18,2,16,45,41,2,2,0,3
E33021374,298,195,89,106,3,32,11,21,58,52,2,1,3,10
E33021375,333,243,130,113,1,18,3,15,62,52,6,4,0,9
E33021376,414,322,137,185,3,29,5,24,59,53,2,4,0,1
E33021377,794,498,172,326,6,85,17,68,196,182,3,10,1,9
E33021378,334,250,114,136,2,19,2,17,57,50,0,4,3,6
E33021379,422,257,103,154,6,33,8,25,118,107,5,5,1,8
E33021380,300,226,118,108,2,11,7,4,51,38,3,10,0,10
E33021381,351,269,145,124,5,20,1,19,46,39,3,4,0,11
E33021382,343,232,102,130,2,38,2,36,66,57,4,4,1,5
E33021383,640,446,170,276,7,57,8,49,115,101,7,5,2,15
E33021384,278,209,97,112,0,17,2,15,44,39,1,1,3,8
E33021385,323,235,143,92,3,15,0,15,55,44,9,0,2,15
E33021386,524,355,181,174,2,46,8,38,113,108,2,2,1,8
E33021387,269,177,114,63,4,36,28,8,39,36,2,1,0,13
E33021388,315,243,119,124,0,22,8,14,42,35,3,2,2,8
E33021389,228,167,82,85,3,13,1,12,36,29,6,0,1,9
E33021390,309,232,118,114,1,10,4,6,52,51,1,0,0,14
E33021391,432,258,105,153,7,47,16,31,113,106,4,3,0,7
E33021392,392,255,135,120,0,27,11,16,97,80,16,1,0,13
E33021393,246,180,83,97,1,13,0,13,44,40,1,3,0,8
E33021394,612,378,177,201,2,64,7,57,149,133,10,4,2,19
E33021395,381,282,106,176,5,24,14,10,55,49,3,1,2,15
E33021396,1378,827,179,648,20,99,32,67,414,203,128,13,70,18
E33021397,567,416,157,259,7,47,20,27,88,73,7,6,2,9
E33021398,429,283,104,179,3,43,14,29,95,86,3,4,2,5
E33021399,372,211,85,126,4,18,5,13,123,114,4,3,2,16
E33021400,332,198,71,127,4,20,4,16,107,92,8,7,0,3
E33021401,733,541,179,362,4,58,14,44,119,96,13,6,4,11
E33021402,516,375,125,250,8,54,7,47,71,65,2,3,1,8
E33021403,427,350,118,232,0,22,9,13,51,47,1,2,1,4
E33021404,308,241,93,148,1,12,1,11,51,42,3,3,3,3
E33021405,278,221,105,116,3,13,1,12,35,28,2,3,2,6
E33021406,419,330,147,183,10,35,14,21,31,25,0,5,1,13
E33021407,457,323,170,153,4,36,13,23,78,63,6,4,5,16
E33021408,455,336,133,203,3,41,9,32,67,54,6,7,0,8
E33021409,262,196,82,114,1,20,5,15,42,27,9,6,0,3
E33021410,329,251,81,170,6,22,14,8,46,37,4,4,1,4
E33021411,504,339,116,223,2,53,16,37,108,101,1,3,3,2
E33021412,328,233,64,169,2,28,8,20,63,53,3,6,1,2
E33021413,1404,1038,312,726,18,120,33,87,213,192,3,17,1,15
E33021414,445,328,105,223,3,23,6,17,83,68,2,9,4,8
E33021415,302,201,78,123,9,32,14,18,59,51,5,3,0,1
E33021416,274,185,78,107,4,21,6,15,61,54,5,2,0,3
E33021417,616,443,149,294,6,67,23,44,90,76,6,6,2,10
E33021418,319,202,65,137,1,54,23,31,56,47,4,4,1,6
E33021419,351,236,75,161,5,55,25,30,54,48,0,6,0,1
E33021420,238,148,47,101,3,22,6,16,59,44,5,7,3,6
E33021421,326,206,53,153,5,37,5,32,72,70,0,1,1,6
E33021422,601,405,139,266,4,89,19,70,96,82,5,9,0,7
E33021423,315,211,74,137,7,32,7,25,61,55,3,3,0,4
E33021424,258,176,55,121,0,23,5,18,55,42,5,5,3,4
E33021425,1871,1350,451,899,24,175,61,114,308,278,5,19,6,14
E33021426,409,292,86,206,5,19,2,17,83,76,2,3,2,10
E33021427,425,291,102,189,1,48,11,37,80,74,1,5,0,5
E33021428,558,406,149,257,9,52,16,36,87,78,1,5,3,4
E33021429,366,268,82,186,5,39,13,26,52,45,1,5,1,2
E33021430,306,189,73,116,6,33,8,25,74,62,6,5,1,4
E33021431,393,287,99,188,2,36,7,29,66,57,3,6,0,2
E33021432,466,393,119,274,4,16,1,15,50,40,0,9,1,3
E33021433,343,288,111,177,2,14,3,11,36,31,3,2,0,3
E33021434,338,201,63,138,8,65,28,37,57,49,2,5,1,7
E33021435,336,219,64,155,6,47,16,31,61,36,17,2,6,3
E33021436,378,263,67,196,5,50,21,29,56,45,2,5,4,4
E33021437,286,192,51,141,2,26,11,15,63,59,0,3,1,3
E33021438,470,324,105,219,8,63,25,38,68,54,3,7,4,7
E33021439,767,547,150,397,13,95,27,68,105,96,0,9,0,7
E33021440,641,527,190,337,4,29,8,21,73,62,3,4,4,8
E33021441,617,439,196,243,2,64,29,35,96,82,5,8,1,16
E33021442,302,164,49,115,6,81,43,38,48,42,1,5,0,3
E33021443,407,220,57,163,6,128,59,69,50,45,2,2,1,3
E33021444,364,263,127,136,1,22,2,20,73,67,4,2,0,5
E33021445,396,274,124,150,5,29,13,16,76,64,4,6,2,12
E33021446,279,231,102,129,1,10,3,7,34,32,2,0,0,3
E33021447,373,278,123,155,3,31,6,25,47,45,1,1,0,14
E33021448,263,190,113,77,2,27,3,24,36,32,2,2,0,8
E33021449,420,277,116,161,4,37,8,29,87,73,9,3,2,15
E33021450,348,230,74,156,7,45,6,39,63,59,0,4,0,3
E33021451,339,260,87,173,2,15,1,14,59,56,0,3,0,3
E33021452,761,513,149,364,16,78,15,63,145,137,1,6,1,9
E33021453,628,418,152,266,9,61,9,52,136,126,1,7,2,4
E33021454,260,184,68,116,1,19,1,18,53,44,4,5,0,3
E33021455,401,264,97,167,11,43,2,41,80,74,0,4,2,3
E33021456,540,337,111,226,17,60,7,53,117,111,2,4,0,9
E33021457,528,407,213,194,2,31,7,24,73,66,3,3,1,15
E33021458,291,211,136,75,1,13,11,2,52,45,2,5,0,14
E33021459,295,243,141,102,4,10,4,6,31,27,0,3,1,7
E33021460,237,157,89,68,2,20,13,7,55,51,1,2,1,3
E33021461,281,202,129,73,2,13,3,10,54,47,1,6,0,10
E33021462,429,309,133,176,7,24,11,13,82,64,15,2,1,7
E33021463,230,180,118,62,4,9,5,4,31,25,1,3,2,6
E33021464,258,194,82,112,2,15,11,4,46,41,0,5,0,1
E33021465,305,231,109,122,2,27,8,19,40,36,1,3,0,5
E33021466,221,177,86,91,1,0,0,0,33,24,5,2,2,10
E33021467,413,306,132,174,7,23,10,13,68,57,5,5,1,9
E33021468,299,218,80,138,1,7,0,7,64,49,7,5,3,9
E33021469,254,191,89,102,0,8,1,7,49,41,4,4,0,6
E33021470,616,408,143,265,13,113,42,71,79,70,0,8,1,3
E33021471,623,427,198,229,8,42,16,26,136,121,10,5,0,10
E33021472,364,213,75,138,2,26,6,20,112,105,1,5,1,11
E33021473,313,223,72,151,1,45,14,31,41,32,3,4,2,3
E33021474,975,679,223,456,9,128,38,90,152,126,6,15,5,7
E33021475,232,175,88,87,2,5,2,3,41,38,1,0,2,9
E33021476,563,381,129,252,9,61,16,45,111,102,1,7,1,1
E33021477,326,271,98,173,0,18,6,12,31,30,0,1,0,6
E33021478,344,251,78,173,6,50,20,30,35,34,0,1,0,2
E33021479,687,457,157,300,4,70,17,53,147,134,1,10,2,9
E33021480,516,332,136,196,4,86,33,53,89,82,1,6,0,5
E33021481,274,200,83,117,10,32,13,19,29,28,0,1,0,3
E33021482,498,355,116,239,1,42,12,30,91,73,1,10,7,9
E33021483,299,235,81,154,3,11,3,8,43,34,5,3,1,7
E33021484,256,196,87,109,1,8,4,4,42,35,5,2,0,9
E33021485,405,304,132,172,0,32,8,24,61,54,0,4,3,8
E33021486,324,246,124,122,3,12,5,7,49,37,4,8,0,14
E33021487,249,195,93,102,1,20,3,17,30,24,4,2,0,3
E33021488,522,401,144,257,0,30,9,21,83,81,1,0,1,8
E33021489,198,151,73,78,1,4,0,4,36,11,21,4,0,6
E33021490,333,246,106,140,2,12,4,8,52,42,1,8,1,21
E33021491,239,186,71,115,0,24,6,18,26,21,0,5,0,3
E33021492,279,223,99,124,1,19,8,11,29,21,1,4,3,7
E33021493,475,324,141,183,5,32,7,25,102,89,4,9,0,12
E33021494,238,151,62,89,1,3,1,2,60,40,15,5,0,23
E33021495,238,137,62,75,0,22,10,12,61,49,10,0,2,18
E33021496,467,359,121,238,2,30,15,15,73,67,0,3,3,3
E33021497,468,344,106,238,3,44,22,22,75,69,1,4,1,2
E33021498,296,210,77,133,1,23,12,11,51,38,8,4,1,11
E33021499,304,236,96,140,0,17,10,7,37,30,3,4,0,14
E33021500,878,679,251,428,5,25,12,13,152,131,15,4,2,17
E33021501,291,236,87,149,2,16,4,12,37,33,3,1,0,0
E33021502,233,188,58,130,1,9,5,4,34,30,0,2,2,1
E33021503,714,531,145,386,3,71,30,41,106,96,0,6,4,3
E33021504,334,249,81,168,0,35,15,20,46,44,1,1,0,4
E33021505,296,230,74,156,1,24,8,16,40,36,1,2,1,1
E33021506,384,298,97,201,0,16,7,9,69,42,11,5,11,1
E33021507,537,471,121,350,3,21,4,17,37,28,3,6,0,5
E33021508,781,517,133,384,4,147,62,85,109,92,2,11,4,4
E33021509,265,168,31,137,0,62,30,32,34,32,0,2,0,1
E33021510,382,239,66,173,1,78,31,47,60,50,3,7,0,4
E33021511,306,193,36,157,1,52,23,29,59,45,3,6,5,1
E33021512,382,277,67,210,1,56,23,33,46,44,0,2,0,2
E33021513,319,253,64,189,1,25,16,9,38,36,0,1,1,2
E33021514,475,384,113,271,1,26,9,17,58,50,1,6,1,6
E33021515,443,371,78,293,0,19,10,9,50,46,0,4,0,3
E33021516,399,295,57,238,2,58,20,38,40,35,0,0,5,4
E33021517,1218,942,212,730,7,88,38,50,176,158,5,13,0,5
E33021518,270,207,51,156,2,10,6,4,47,44,0,3,0,4
E33021519,277,201,63,138,5,31,14,17,38,35,1,2,0,2
E33021520,346,247,64,183,1,49,23,26,44,36,0,3,5,5
E33021521,530,372,67,305,3,71,25,46,81,68,3,5,5,3
E33021522,328,211,52,159,4,56,21,35,56,51,0,4,1,1
E33021523,388,257,69,188,1,64,24,40,62,50,0,12,0,4
E33021524,389,277,68,209,0,51,21,30,60,55,0,4,1,1
E33021525,580,412,86,326,1,46,21,25,120,105,2,12,1,1
E33021526,1488,1020,275,745,8,174,74,100,274,267,2,4,1,12
E33021527,301,252,53,199,3,13,0,13,33,30,1,1,1,0
E33021528,295,237,58,179,6,19,6,13,31,26,1,4,0,2
E33021529,281,209,53,156,2,23,14,9,45,36,2,3,4,2
E33021530,325,203,75,128,2,33,11,22,80,67,12,1,0,7
E33021531,346,262,85,177,1,24,12,12,57,55,0,1,1,2
E33021532,296,238,88,150,2,18,6,12,37,33,1,3,0,1
E33021533,479,361,137,224,4,38,16,22,75,64,1,7,3,1
E33021534,432,302,84,218,2,43,22,21,79,72,1,6,0,6
E33021535,355,269,70,199,1,27,9,18,55,51,1,3,0,3
E33021536,301,206,67,139,2,25,9,16,60,45,10,3,2,8
E33021537,1176,801,205,596,6,208,93,115,156,141,2,13,0,5
E33021538,474,356,113,243,1,36,16,20,72,62,5,2,3,9
E33021539,554,382,101,281,2,59,24,35,105,97,4,2,2,6
E33021540,343,263,95,168,0,20,7,13,49,27,17,4,1,11
E33021541,405,283,80,203,2,49,20,29,65,57,1,4,3,6
E33021542,280,179,42,137,3,52,29,23,45,42,0,3,0,1
E33021543,388,278,86,192,2,36,16,20,72,68,1,3,0,0
E33021544,553,374,136,238,2,89,41,48,84,79,0,5,0,4
E33021545,287,191,53,138,2,43,18,25,50,48,0,0,2,1
E33021546,415,290,64,226,2,41,15,26,80,71,2,7,0,2
E33021547,289,212,65,147,1,34,13,21,40,38,0,1,1,2
E33021548,239,165,42,123,1,41,20,21,29,24,2,3,0,3
E33021549,323,246,43,203,1,29,11,18,43,39,2,0,2,4
E33021550,592,413,113,300,3,81,39,42,92,83,2,5,2,3
E33021551,368,268,91,177,1,43,19,24,54,49,0,4,1,2
E33021552,434,329,99,230,2,52,23,29,49,38,2,5,4,2
E33021553,274,201,82,119,0,31,9,22,41,26,10,0,5,1
E33021554,498,426,107,319,1,23,5,18,46,41,0,3,2,2
E33021555,636,471,117,354,1,49,30,19,113,105,0,7,1,2
E33021556,310,271,57,214,1,13,4,9,25,19,4,2,0,0
E33021557,322,231,52,179,0,41,12,29,48,40,1,6,1,2
E33021558,400,309,56,253,2,37,17,20,45,43,0,2,0,7
E33021559,309,244,54,190,1,21,7,14,43,34,4,3,2,0
E33021560,304,243,62,181,1,14,4,10,44,38,4,2,0,2
E33021561,289,201,35,166,0,37,8,29,47,44,0,2,1,4
E33021562,316,227,60,167,1,39,13,26,49,39,3,3,4,0
E33021563,618,433,89,344,1,88,41,47,94,82,2,10,0,2
E33021564,410,264,62,202,5,76,35,41,60,53,0,5,2,5
E33021565,364,267,68,199,0,40,15,25,56,53,0,3,0,1
E33021566,342,262,66,196,1,32,14,18,44,40,0,4,0,3
E33021567,259,190,46,144,3,32,10,22,30,21,1,6,2,4
E33021568,1422,1157,244,913,3,55,16,39,203,186,0,15,2,4
E33021569,295,241,56,185,3,13,8,5,36,31,0,5,0,2
E33021570,276,200,48,152,1,38,18,20,35,33,0,2,0,2
E33021571,285,208,55,153,1,36,20,16,39,38,0,1,0,1
E33021572,273,172,31,141,2,56,21,35,41,35,1,4,1,2
E33021573,530,392,111,281,2,63,26,37,72,59,1,12,0,1
E33021574,633,410,92,318,1,99,42,57,120,111,2,7,0,3
E33021575,270,205,47,158,5,31,11,20,26,22,0,4,0,3
E33021576,336,199,59,140,2,59,27,32,76,68,2,6,0,0
E33021577,416,297,83,214,1,59,26,33,54,45,0,6,3,5
E33021578,352,270,78,192,0,33,14,19,46,41,0,5,0,3
E33021579,257,175,53,122,1,32,19,13,46,42,1,3,0,3
E33021580,343,257,66,191,0,35,15,20,46,41,1,3,1,5
E33021581,387,256,84,172,1,63,30,33,60,53,3,4,0,7
E33021582,314,282,66,216,0,7,5,2,22,20,0,2,0,3
E33021583,325,210,61,149,2,75,66,9,37,33,1,3,0,1
E33021584,249,217,67,150,0,17,14,3,15,12,0,3,0,0
E33021585,356,310,96,214,0,26,21,5,18,15,0,3,0,2
E33021586,306,224,71,153,0,51,33,18,31,30,0,1,0,0
E33021587,280,194,45,149,2,47,40,7,35,32,0,1,2,2
E33021588,323,251,55,196,3,11,6,5,52,47,0,5,0,6
E33021589,306,233,70,163,0,37,29,8,34,30,0,4,0,2
E33021590,289,239,69,170,0,22,15,7,26,21,2,3,0,2
E33021591,527,348,108,240,4,127,117,10,44,41,0,3,0,4
E33021592,284,203,63,140,1,39,30,9,33,30,1,2,0,8
E33021593,291,206,58,148,0,52,50,2,30,24,0,4,2,3
E33021594,321,246,69,177,1,46,41,5,24,20,0,4,0,4
E33021595,270,222,83,139,2,25,16,9,21,18,0,3,0,0
E33021596,434,343,101,242,1,41,23,18,49,46,0,3,0,0
E33021597,579,400,109,291,2,95,62,33,72,69,0,3,0,10
E33021598,506,388,102,286,2,47,30,17,66,60,0,6,0,3
E33021599,524,386,131,255,1,65,42,23,71,64,0,6,1,1
E33021600,295,209,57,152,0,48,34,14,34,31,1,2,0,4
E33021601,597,444,152,292,1,76,43,33,73,65,0,4,4,3
E33021602,400,343,104,239,0,26,23,3,30,30,0,0,0,1
E33021603,414,330,82,248,2,38,32,6,37,33,0,4,0,7
E33021604,666,433,143,290,3,140,103,37,88,85,1,2,0,2
E33021605,264,177,54,123,0,34,23,11,52,46,0,5,1,1
E33021606,974,766,225,541,1,110,87,23,89,85,0,4,0,8
E33021607,301,263,69,194,1,8,7,1,28,27,1,0,0,1
E33021608,445,398,138,260,1,11,10,1,31,27,0,4,0,4
E33021609,555,460,149,311,3,25,19,6,63,59,0,4,0,4
E33021610,375,301,102,199,0,31,25,6,41,37,1,3,0,2
E33021611,305,234,65,169,3,33,29,4,31,28,0,2,1,4
E33021612,276,190,73,117,0,43,37,6,39,35,0,2,2,4
E33021613,397,317,94,223,2,32,27,5,46,43,0,3,0,0
E33021614,344,256,80,176,0,51,39,12,33,30,1,2,0,4
E33021615,363,260,84,176,2,47,32,15,48,46,1,0,1,6
E33021616,302,211,68,143,2,34,18,16,52,48,0,3,1,3
E33021617,247,185,68,117,0,34,19,15,25,24,0,1,0,3
E33021618,667,509,134,375,1,66,49,17,86,79,0,7,0,5
E33021619,381,295,88,207,0,35,22,13,46,36,0,7,3,5
E33021620,450,286,88,198,1,75,56,19,82,77,0,4,1,6
E33021621,482,330,99,231,0,70,48,22,78,74,0,4,0,4
E33021622,375,268,90,178,1,51,35,16,51,48,0,2,1,4
E33021623,231,181,54,127,3,22,9,13,22,22,0,0,0,3
E33021624,564,467,161,306,1,51,47,4,42,38,0,4,0,3
E33021625,330,268,77,191,0,28,17,11,32,28,0,3,1,2
E33021626,276,215,60,155,1,19,9,10,37,33,0,4,0,4
E33021627,362,228,72,156,2,43,30,13,86,81,1,1,3,3
E33021628,495,339,106,233,3,58,41,17,91,84,0,7,0,4
E33021629,408,328,102,226,7,39,25,14,33,30,0,3,0,1
E33021630,321,236,72,164,1,35,25,10,47,41,0,1,5,2
E33021631,303,199,47,152,2,81,57,24,20,18,0,0,2,1
E33021632,341,264,79,185,1,47,39,8,27,25,0,1,1,2
E33021633,337,245,58,187,3,60,44,16,28,24,0,4,0,1
E33021634,849,670,183,487,2,104,86,18,69,66,1,1,1,4
E33021635,290,217,60,157,0,37,32,5,31,27,0,2,2,5
E33021636,258,186,51,135,0,45,38,7,24,20,1,3,0,3
E33021637,322,228,76,152,2,51,40,11,40,38,0,1,1,1
E33021638,250,199,56,143,0,13,9,4,33,30,0,2,1,5
E33021639,454,363,97,266,3,29,22,7,49,46,0,3,0,10
E33021640,562,417,149,268,4,60,35,25,78,71,1,5,1,3
E33021641,264,231,86,145,1,18,13,5,13,10,2,1,0,1
E33021642,277,208,60,148,1,40,31,9,23,18,0,3,2,5
E33021643,224,142,53,89,2,45,29,16,31,26,0,5,0,4
E33021644,237,181,51,130,3,31,23,8,20,19,0,1,0,2
E33021645,287,214,62,152,0,37,29,8,35,35,0,0,0,1
E33021646,403,338,94,244,0,40,29,11,22,19,0,3,0,3
E33021647,636,418,133,285,2,98,53,45,114,102,0,9,3,4
E33021648,254,214,64,150,1,20,14,6,18,14,0,4,0,1
E33021649,261,207,59,148,1,21,11,10,27,25,1,1,0,5
E33021650,580,419,130,289,2,73,42,31,79,71,1,6,1,7
E33021651,244,169,66,103,0,33,16,17,41,40,0,0,1,1
E33021652,281,176,50,126,3,32,19,13,68,65,1,2,0,2
E33021653,306,209,52,157,1,39,25,14,56,48,1,6,1,1
E33021654,273,218,77,141,3,30,25,5,20,20,0,0,0,2
E33021655,550,385,121,264,2,51,30,21,102,98,2,2,0,10
E33021656,868,647,177,470,6,88,58,30,122,113,0,8,1,5
E33021657,1455,1040,326,714,3,92,59,33,311,296,0,7,8,9
E33021658,441,285,89,196,4,30,18,12,120,108,0,4,8,2
E33021659,301,226,74,152,0,39,26,13,36,33,0,3,0,0
E33021660,252,146,49,97,1,44,33,11,52,50,0,1,1,9
E33021661,302,183,42,141,0,48,31,17,68,55,0,7,6,3
E33021662,539,373,115,258,0,77,64,13,86,80,1,5,0,3
E33021663,377,233,60,173,1,107,66,41,33,24,2,6,1,3
E33021664,575,353,75,278,1,178,126,52,39,35,1,2,1,4
E33021665,433,253,79,174,4,137,72,65,37,30,0,4,3,2
E33021666,272,210,52,158,0,16,9,7,45,42,0,3,0,1
E33021667,341,252,72,180,3,28,15,13,57,50,1,4,2,1
E33021668,564,432,113,319,1,36,27,9,90,82,1,6,1,5
E33021669,369,309,108,201,3,24,16,8,29,27,2,0,0,4
E33021670,621,485,134,351,1,58,37,21,71,63,0,2,6,6
E33021671,644,520,157,363,2,44,21,23,73,67,0,6,0,5
E33021672,254,190,52,138,0,16,6,10,46,43,0,2,1,2
E33021673,242,191,81,110,2,29,18,11,20,18,0,1,1,0
E33021674,249,184,62,122,0,14,11,3,47,42,0,3,2,4
E33021675,476,328,94,234,7,51,32,19,89,82,1,4,2,1
E33021676,667,497,136,361,2,85,63,22,73,63,3,6,1,10
E33021677,282,198,67,131,0,52,38,14,31,28,1,2,0,1
E33021678,606,446,134,312,1,88,70,18,70,62,0,8,0,1
E33021679,331,257,80,177,2,27,23,4,45,42,0,1,2,0
E33021680,453,335,102,233,4,48,30,18,60,53,0,7,0,6
E33021681,391,288,114,174,0,60,48,12,40,35,0,5,0,3
E33021682,307,215,52,163,0,35,24,11,54,48,0,4,2,3
E33021683,577,459,135,324,2,44,33,11,69,62,2,4,1,3
E33021684,312,260,96,164,0,28,13,15,22,21,0,1,0,2
E33021685,1534,1134,342,792,5,186,127,59,198,176,2,20,0,11
E33021686,449,339,102,237,2,71,53,18,33,26,2,5,0,4
E33021687,354,257,68,189,2,58,52,6,35,28,0,7,0,2
E33021688,571,428,126,302,2,79,53,26,56,50,4,1,1,6
E33021689,1292,958,307,651,3,165,95,70,163,144,0,18,1,3
E33021690,240,172,37,135,2,30,27,3,33,27,1,5,0,3
E33021691,378,289,77,212,0,26,18,8,61,54,0,7,0,2
E33021692,352,257,74,183,1,45,22,23,46,41,0,4,1,3
E33021693,1061,887,237,650,1,87,57,30,80,73,3,3,1,6
E33021694,518,395,123,272,0,58,29,29,64,56,0,5,3,1
E33021695,254,200,80,120,1,31,22,9,20,18,0,2,0,2
E33021696,251,187,60,127,0,28,22,6,35,33,0,2,0,1
E33021697,272,227,77,150,2,20,11,9,21,19,1,1,0,2
E33021698,252,198,55,143,1,32,21,11,21,20,0,1,0,0
E33021699,693,607,159,448,3,27,25,2,49,44,1,4,0,7
E33021700,369,268,94,174,0,62,56,6,36,32,0,4,0,3
E33021701,539,423,95,328,1,56,43,13,53,47,1,5,0,6
E33021702,750,597,169,428,2,83,66,17,62,49,1,9,3,6
E33021703,479,332,114,218,0,79,63,16,60,57,0,3,0,8
E33021704,801,546,148,398,11,159,133,26,81,74,1,6,0,4
E33021705,347,281,94,187,0,27,21,6,37,33,0,3,1,2
E33021706,320,250,80,170,1,24,15,9,43,41,0,2,0,2
E33021707,286,211,49,162,1,41,32,9,32,29,0,2,1,1
E33021708,465,340,99,241,1,58,42,16,61,58,0,3,0,5
E33021709,554,409,111,298,5,67,44,23,72,59,4,7,2,1
E33021710,415,336,92,244,0,36,33,3,35,30,0,5,0,8
E33021711,252,209,71,138,1,13,9,4,28,27,0,1,0,1
E33021712,299,267,57,210,0,10,7,3,21,16,0,5,0,1
E33021713,356,268,77,191,1,60,53,7,26,23,0,3,0,1
E33021714,498,380,109,271,1,64,59,5,52,48,0,4,0,1
E33021715,251,160,53,107,0,59,57,2,29,27,1,0,1,3
E33021716,310,198,50,148,0,73,61,12,38,35,1,2,0,1
E33021717,240,178,54,124,3,39,39,0,14,14,0,0,0,6
E33021718,823,657,159,498,2,62,38,24,98,91,0,7,0,4
E33021719,450,385,93,292,2,25,22,3,34,31,0,3,0,4
E33021720,1195,918,278,640,5,149,112,37,119,104,0,15,0,4
E33021721,252,206,54,152,0,17,11,6,29,24,0,4,1,0
E33021722,518,316,91,225,1,99,77,22,100,82,6,11,1,2
E33021723,292,272,84,188,1,3,1,2,15,13,0,2,0,1
E33021724,278,250,91,159,1,13,11,2,13,12,0,1,0,1
E33021725,505,358,115,243,5,25,10,15,110,95,6,8,1,7
E33021726,306,213,58,155,1,45,26,19,43,38,2,3,0,4
E33021727,438,319,99,220,5,44,30,14,66,59,2,4,1,4
E33021728,325,247,65,182,3,36,27,9,38,37,1,0,0,1
E33021729,444,326,105,221,4,32,22,10,78,66,1,7,4,4
E33021730,301,216,64,152,2,35,26,9,48,43,2,3,0,0
E33021731,409,302,100,202,2,31,22,9,71,52,14,2,3,3
E33021732,356,291,99,192,2,21,12,9,37,32,1,3,1,5
E33021733,420,301,121,180,2,66,46,20,50,32,5,6,7,1
E33021734,347,197,63,134,2,32,15,17,107,58,29,4,16,9
E33021735,276,201,69,132,1,24,21,3,45,34,5,3,3,5
E33021736,314,244,80,164,3,35,22,13,32,27,0,5,0,0
E33021737,297,219,119,100,0,15,8,7,52,51,1,0,0,11
E33021738,445,330,105,225,4,50,31,19,54,49,5,0,0,7
E33021739,380,260,122,138,0,46,33,13,71,62,2,5,2,3
E33021740,244,182,71,111,0,24,17,7,36,28,1,6,1,2
E33021741,268,145,71,74,5,12,6,6,88,80,5,2,1,18
E33021742,258,168,56,112,1,44,36,8,42,35,1,4,2,3
E33021743,392,310,102,208,2,36,32,4,43,39,2,1,1,1
E33021744,315,206,86,120,4,38,23,15,59,53,3,3,0,8
E33021745,395,252,88,164,5,42,18,24,85,77,3,5,0,11
E33021746,331,246,89,157,4,34,30,4,44,40,0,3,1,3
E33021747,510,423,149,274,1,22,11,11,59,55,3,1,0,5
E33021748,468,343,123,220,1,41,29,12,73,69,2,1,1,10
E33021749,447,348,131,217,2,40,28,12,55,53,0,2,0,2
E33021750,430,342,127,215,3,31,17,14,52,46,1,5,0,2
E33021751,263,187,60,127,0,25,12,13,45,39,2,4,0,6
E33021752,457,317,100,217,0,64,50,14,68,65,2,1,0,8
E33021753,376,279,100,179,1,30,20,10,59,50,0,8,1,7
E33021754,274,193,77,116,0,24,18,6,53,49,1,3,0,4
E33021755,297,208,96,112,0,21,14,7,55,46,1,7,1,13
E33021756,481,347,128,219,0,39,30,9,88,80,1,4,3,7
E33021757,260,174,77,97,0,20,9,11,57,44,4,4,5,9
E33021758,248,174,67,107,0,28,24,4,41,38,3,0,0,5
E33021759,287,216,90,126,0,18,14,4,44,33,6,4,1,9
E33021760,246,140,40,100,1,20,9,11,70,64,5,1,0,15
E33021761,327,264,117,147,0,24,19,5,33,28,1,2,2,6
E33021762,954,659,213,446,4,94,73,21,183,164,12,5,2,14
E33021763,260,157,76,81,2,7,5,2,71,63,6,2,0,23
E33021764,377,270,109,161,0,48,34,14,56,50,1,4,1,3
E33021765,268,199,91,108,2,19,16,3,38,29,3,5,1,10
E33021766,345,233,112,121,0,21,15,6,76,69,5,2,0,15
E33021767,373,272,118,154,1,11,7,4,79,69,3,7,0,10
E33021768,281,213,107,106,1,11,4,7,48,43,3,2,0,8
E33021769,296,206,89,117,0,18,16,2,69,64,0,5,0,3
E33021770,420,289,95,194,6,53,8,45,70,58,3,6,3,2
E33021771,296,231,93,138,1,18,5,13,42,39,1,1,1,4
E33021772,279,192,60,132,0,25,5,20,60,55,0,4,1,2
E33021773,428,335,131,204,2,24,11,13,63,59,2,2,0,4
E33021774,685,488,156,332,7,71,13,58,114,104,6,3,1,5
E33021775,281,207,67,140,1,22,0,22,50,45,0,4,1,1
E33021776,634,487,170,317,0,60,21,39,84,75,3,4,2,3
E33021777,511,400,149,251,5,28,6,22,65,53,3,8,1,13
E33021778,489,365,134,231,3,37,9,28,77,67,2,7,1,7
E33021779,269,209,73,136,1,11,3,8,44,40,2,2,0,4
E33021780,443,307,119,188,3,55,26,29,66,58,4,3,1,12
E33021781,404,277,118,159,1,38,8,30,79,71,4,2,2,9
E33021782,342,209,79,130,2,12,3,9,103,80,16,4,3,16
E33021783,645,496,185,311,4,50,10,40,84,73,2,9,0,11
E33021784,314,222,99,123,2,18,5,13,64,45,12,6,1,8
E33021785,324,251,96,155,1,31,22,9,39,38,0,0,1,2
E33021786,346,279,100,179,8,16,6,10,41,35,2,4,0,2
E33021787,602,384,133,251,2,71,33,38,135,121,3,7,4,10
E33021788,359,257,86,171,1,36,10,26,58,56,0,0,2,7
E33021789,485,372,135,237,5,43,18,25,58,53,1,4,0,7
E33021790,1223,646,207,439,4,74,38,36,451,427,8,14,2,48
E33021791,546,413,136,277,4,46,14,32,73,66,1,6,0,10
E33021792,1144,766,255,511,2,184,48,136,185,164,6,9,6,7
E33021793,367,291,88,203,2,32,7,25,35,30,0,4,1,7
E33021794,344,233,61,172,0,30,1,29,74,64,2,7,1,7
E33021795,387,325,107,218,4,21,7,14,36,33,0,2,1,1
E33021796,1591,1220,284,936,6,94,25,69,266,246,3,15,2,5
E33021797,324,233,94,139,1,21,7,14,62,53,2,4,3,7
E33021798,355,287,98,189,2,20,1,19,43,39,1,3,0,3
E33021799,596,423,141,282,6,57,12,45,107,87,7,7,6,3
E33021800,405,276,105,171,2,40,10,30,86,77,3,4,2,1
E33021801,264,199,68,131,2,18,2,16,42,37,1,3,1,3
E33021802,305,215,64,151,2,33,6,27,55,47,1,7,0,0
E33021803,306,221,88,133,1,29,16,13,52,48,2,2,0,3
E33021804,291,217,76,141,0,26,11,15,42,37,1,2,2,6
E33021805,445,320,121,199,3,29,5,24,79,65,8,5,1,14
E33021806,266,194,86,108,2,26,7,19,43,40,1,1,1,1
E33021807,333,175,55,120,2,40,5,35,112,55,31,3,23,4
E33021808,640,511,134,377,4,40,7,33,84,78,2,2,2,1
E33021809,445,382,112,270,2,18,6,12,41,35,2,3,1,2
E33021810,354,252,86,166,1,28,7,21,68,54,5,6,3,5
E33021811,391,294,120,174,2,32,17,15,47,39,4,4,0,16
E33021812,316,256,106,150,1,13,2,11,42,36,2,4,0,4
E33021813,249,203,79,124,2,15,5,10,26,17,0,8,1,3
E33021814,734,512,180,332,11,73,17,56,132,119,3,9,1,6
E33021815,370,260,91,169,5,47,16,31,52,48,2,2,0,6
E33021816,352,271,108,163,0,13,2,11,68,59,8,1,0,0
E33021817,504,357,129,228,4,54,14,40,81,72,4,2,3,8
E33021818,264,181,72,109,3,21,4,17,50,44,1,2,3,9
E33021819,527,345,106,239,5,21,5,16,143,133,5,5,0,13
E33021820,1235,853,222,631,2,95,13,82,279,112,112,7,48,6
E33021821,350,256,100,156,1,20,14,6,63,46,13,4,0,10
E33021822,450,310,77,233,4,77,57,20,50,45,0,2,3,9
E33021823,557,445,157,288,0,60,45,15,46,38,0,6,2,6
E33021824,351,278,118,160,1,25,20,5,41,34,0,7,0,6
E33021825,567,403,143,260,3,77,62,15,76,71,0,3,2,8
E33021826,455,361,108,253,3,34,17,17,57,52,0,2,3,0
E33021827,617,470,148,322,1,69,52,17,70,66,0,4,0,7
E33021828,618,459,148,311,5,80,60,20,70,62,1,7,0,4
E33021829,337,261,87,174,2,29,17,12,43,41,0,2,0,2
E33021830,360,296,115,181,0,19,12,7,45,35,2,4,4,0
E33021831,386,254,83,171,1,43,27,16,82,78,1,3,0,6
E33021832,316,212,76,136,6,46,30,16,49,42,2,3,2,3
E33021833,396,286,86,200,0,33,20,13,68,66,0,2,0,9
E33021834,329,235,72,163,2,23,18,5,64,52,0,8,4,5
E33021835,252,185,46,139,1,22,9,13,43,34,1,5,3,1
E33021836,312,223,64,159,3,20,13,7,58,54,3,1,0,8
E33021837,328,266,129,137,2,18,6,12,40,34,2,4,0,2
E33021838,504,421,118,303,3,22,17,5,57,53,1,3,0,1
E33021839,247,180,78,102,1,24,13,11,39,36,1,2,0,3
E33021840,314,234,110,124,1,27,22,5,48,37,0,8,3,4
E33021841,372,274,111,163,4,16,9,7,59,44,6,8,1,19
E33021842,305,239,98,141,0,29,21,8,32,28,0,4,0,5
E33021843,252,214,110,104,1,5,4,1,32,32,0,0,0,0
E33021844,359,289,112,177,3,22,16,6,39,32,0,6,1,6
E33021845,310,254,99,155,5,20,11,9,30,29,0,1,0,1
E33021846,306,239,108,131,0,18,11,7,48,40,5,2,1,1
E33021847,292,213,67,146,1,18,4,14,56,47,6,3,0,4
E33021848,288,143,31,112,3,17,5,12,121,112,3,6,0,4
E33021849,407,288,98,190,4,28,14,14,80,72,3,5,0,7
E33021850,626,430,134,296,6,54,17,37,129,121,2,6,0,7
E33021851,410,318,121,197,2,31,9,22,51,42,2,3,4,8
E33021852,392,324,156,168,0,21,4,17,30,26,0,1,3,17
E33021853,438,317,112,205,3,44,15,29,66,55,2,8,1,8
E33021854,745,483,136,347,6,145,60,85,107,97,2,7,1,4
E33021855,506,347,97,250,3,89,31,58,60,49,2,6,3,7
E33021856,371,248,64,184,3,70,22,48,50,44,0,5,1,0
E33021857,320,228,64,164,1,31,8,23,56,47,1,8,0,4
E33021858,346,225,68,157,2,56,21,35,58,45,1,12,0,5
E33021859,376,308,73,235,1,35,9,26,29,25,1,3,0,3
E33021860,473,362,88,274,1,32,14,18,74,64,1,3,6,4
E33021861,313,217,79,138,2,52,14,38,41,37,0,4,0,1
E33021862,306,225,52,173,2,24,5,19,54,47,2,1,4,1
E33021863,360,220,56,164,4,48,24,24,84,70,2,10,2,4
E33021864,349,249,67,182,9,51,22,29,38,34,1,2,1,2
E33021865,574,407,118,289,1,78,31,47,84,75,1,8,0,4
E33021866,661,487,111,376,7,78,26,52,85,79,2,4,0,4
E33021867,594,418,126,292,3,83,25,58,86,80,0,5,1,4
E33021868,335,274,98,176,2,25,9,16,30,30,0,0,0,4
E33021869,712,532,180,352,4,31,3,28,139,89,29,4,17,6
E33021870,488,336,94,242,2,37,8,29,107,99,1,7,0,6
E33021871,374,245,69,176,1,40,10,30,85,76,0,6,3,3
E33021872,442,296,101,195,3,43,15,28,91,86,0,3,2,9
E33021873,391,283,89,194,4,29,3,26,71,64,0,5,2,4
E33021874,701,529,174,355,4,42,7,35,119,97,3,6,13,7
E33021875,349,274,99,175,1,30,8,22,41,30,5,1,5,3
E33021876,213,167,68,99,0,11,3,8,28,18,7,3,0,7
E33021877,355,271,74,197,1,36,16,20,43,40,0,3,0,4
E33021878,249,200,83,117,0,17,4,13,29,27,2,0,0,3
E33021879,339,269,95,174,0,14,3,11,52,50,1,1,0,4
E33021880,310,239,76,163,3,23,8,15,41,36,0,5,0,4
E33021881,400,288,82,206,1,25,4,21,77,73,0,4,0,9
E33021882,500,380,128,252,1,41,12,29,74,58,2,11,3,4
E33021883,363,296,81,215,0,16,8,8,50,40,0,9,1,1
E33021884,264,166,53,113,4,39,16,23,51,43,1,6,1,4
E33021885,1002,703,203,500,3,141,54,87,151,130,1,19,1,4
E33021886,621,455,152,303,0,41,12,29,104,67,29,5,3,21
E33021887,527,401,139,262,4,46,10,36,72,65,0,6,1,4
E33021888,276,207,84,123,0,29,7,22,38,32,2,3,1,2
E33021889,268,213,60,153,0,10,0,10,42,40,0,2,0,3
E33021890,429,340,116,224,0,20,7,13,66,57,6,3,0,3
E33021891,259,214,73,141,1,8,2,6,33,27,5,1,0,3
E33021892,226,151,53,98,1,40,8,32,27,26,0,0,1,7
E33021893,522,442,157,285,1,21,6,15,53,45,2,6,0,5
E33021894,408,250,99,151,6,32,11,21,104,96,2,5,1,16
E33021895,360,263,116,147,1,38,13,25,57,51,2,4,0,1
E33021896,246,181,61,120,0,21,7,14,42,38,0,1,3,2
E33021897,318,219,80,139,4,26,7,19,65,60,1,1,3,4
E33021898,311,246,103,143,2,26,10,16,33,28,1,4,0,4
E33021899,891,580,195,385,7,90,35,55,202,192,0,7,3,12
E33021900,328,260,99,161,3,24,9,15,39,35,0,1,3,2
E33021901,258,194,86,108,1,19,6,13,40,34,1,3,2,4
E33021902,406,314,129,185,3,25,4,21,60,49,2,6,3,4
E33021903,440,346,137,209,0,20,10,10,68,54,5,7,2,6
E33021904,391,289,118,171,5,28,8,20,65,55,1,3,6,4
E33021905,248,201,94,107,0,18,6,12,22,21,0,1,0,7
E33021906,313,247,143,104,3,14,2,12,41,37,2,2,0,8
E33021907,426,309,135,174,1,26,3,23,77,67,4,4,2,13
E33021908,370,268,122,146,0,20,11,9,57,51,0,5,1,25
E33021909,321,232,102,130,2,23,9,14,57,51,1,5,0,7
E33021910,332,233,77,156,2,41,12,29,51,47,1,3,0,5
E33021911,387,310,138,172,1,20,9,11,52,44,2,6,0,4
E33021912,385,283,111,172,2,27,7,20,60,57,1,2,0,13
E33021913,268,211,85,126,1,11,5,6,39,36,2,1,0,6
E33021914,271,144,71,73,4,33,10,23,74,67,3,4,0,16
E33021915,482,295,155,140,4,60,16,44,120,107,5,7,1,3
E33021916,281,196,97,99,4,38,6,32,40,35,0,5,0,3
E33021917,275,172,68,104,3,30,8,22,57,49,1,7,0,13
E33021918,268,184,76,108,1,18,2,16,48,40,3,4,1,17
E33021919,366,301,163,138,1,8,6,2,47,40,2,5,0,9
E33021920,375,254,117,137,4,14,6,8,85,73,5,3,4,18
E33021921,407,266,113,153,2,68,32,36,63,58,0,5,0,8
E33021922,433,336,125,211,1,30,4,26,58,50,1,7,0,8
E33021923,293,218,115,103,8,27,5,22,36,31,4,1,0,4
E33021924,263,203,97,106,4,20,3,17,35,29,4,1,1,1
E33021925,377,286,145,141,5,26,6,20,49,45,3,1,0,11
E33021926,682,475,194,281,9,79,18,61,102,95,1,3,3,17
E33021927,380,245,96,149,6,51,9,42,74,67,0,6,1,4
E33021928,260,200,108,92,3,9,0,9,45,40,2,2,1,3
E33021929,322,182,102,80,2,15,1,14,106,97,6,3,0,17
E33021930,450,305,101,204,9,48,5,43,84,77,1,4,2,4
E33021931,445,261,113,148,7,61,9,52,101,73,24,4,0,15
E33021932,400,277,145,132,4,24,6,18,81,74,4,3,0,14
E33021933,431,287,181,106,2,18,2,16,100,83,12,4,1,24
E33021934,219,177,105,72,4,8,0,8,21,17,0,4,0,9
E33021935,267,167,93,74,0,12,0,12,73,71,0,2,0,15
E33021936,455,299,125,174,8,44,9,35,91,86,3,2,0,13
E33021937,283,223,150,73,3,14,5,9,40,35,4,1,0,3
E33021938,401,285,158,127,2,28,3,25,74,68,1,3,2,12
E33021939,277,186,105,81,1,25,3,22,47,45,0,1,1,18
E33021940,380,269,168,101,7,29,8,21,72,65,3,3,1,3
E33021941,265,190,104,86,5,21,3,18,48,44,0,3,1,1
E33021942,414,284,113,171,5,40,4,36,80,73,2,5,0,5
E33021943,630,385,154,231,20,74,6,68,144,125,6,12,1,7
E33021944,429,282,119,163,9,47,3,44,85,80,1,4,0,6
E33021945,366,252,135,117,4,55,2,53,48,48,0,0,0,7
E33021946,298,217,84,133,6,29,4,25,43,38,0,5,0,3
E33021947,473,350,145,205,7,36,3,33,75,66,6,3,0,5
E33021948,530,342,130,212,9,72,8,64,102,86,5,10,1,5
E33021949,722,497,193,304,15,73,9,64,132,113,0,16,3,5
E33021950,397,280,141,139,6,29,5,24,72,61,2,9,0,10
E33021951,856,567,236,331,6,100,3,97,178,160,4,12,2,5
E33021952,283,218,100,118,2,20,3,17,40,39,0,1,0,3
E33021953,364,298,130,168,3,29,7,22,33,28,1,4,0,1
E33021954,472,328,125,203,8,47,4,43,83,70,1,10,2,6
E33021955,319,240,134,106,4,8,0,8,55,49,2,4,0,12
E33021956,362,285,106,179,3,35,2,33,37,34,2,1,0,2
E33021957,254,203,112,91,1,14,7,7,24,22,2,0,0,12
E33021958,365,338,101,237,1,2,1,1,23,20,1,1,1,1
E33021959,343,268,73,195,5,30,25,5,36,32,0,4,0,4
E33021960,408,345,109,236,2,13,5,8,44,41,2,1,0,4
E33021961,264,189,61,128,1,34,29,5,38,34,1,2,1,2
E33021962,356,272,73,199,1,34,22,12,44,38,1,5,0,5
E33021963,393,303,93,210,1,39,27,12,50,45,3,1,1,0
E33021964,354,284,73,211,0,33,17,16,35,32,0,3,0,2
E33021965,361,277,68,209,1,43,36,7,39,35,0,4,0,1
E33021966,309,216,50,166,1,46,20,26,44,42,0,2,0,2
E33021967,432,341,85,256,2,25,12,13,63,53,0,10,0,1
E33021968,385,303,89,214,3,32,24,8,44,40,0,4,0,3
E33021969,521,406,111,295,3,25,16,9,85,81,0,4,0,2
E33021970,420,374,111,263,0,17,10,7,25,21,0,4,0,4
E33021971,481,345,86,259,4,54,46,8,76,65,1,9,1,2
E33021972,344,283,73,210,0,26,26,0,35,28,2,4,1,0
E33021973,375,305,81,224,2,26,17,9,38,36,0,2,0,4
E33021974,372,305,87,218,2,16,9,7,48,42,0,6,0,1
E33021975,415,312,75,237,2,49,42,7,52,48,0,4,0,0
E33021976,818,677,174,503,1,69,31,38,64,54,0,10,0,7
E33021977,759,525,153,372,15,148,92,56,68,62,2,4,0,3
E33021978,347,282,75,207,3,20,12,8,35,30,2,3,0,7
E33021979,347,256,84,172,1,59,53,6,27,23,1,3,0,4
E33021980,472,342,112,230,3,63,39,24,57,54,1,2,0,7
E33021981,355,318,65,253,1,15,13,2,21,19,0,2,0,0
E33021982,472,398,84,314,0,33,19,14,40,33,0,7,0,1
E33021983,337,258,89,169,1,39,31,8,38,35,0,2,1,1
E33021984,335,266,82,184,1,26,15,11,39,35,0,3,1,3
E33021985,373,302,92,210,2,35,30,5,33,28,0,5,0,1
E33021986,357,324,66,258,2,5,2,3,22,17,0,4,1,4
E33021987,312,267,59,208,1,17,10,7,26,24,0,2,0,1
E33021988,353,293,49,244,1,18,7,11,39,35,0,4,0,2
E33021989,486,387,104,283,6,51,26,25,40,37,1,2,0,2
E33021990,580,484,154,330,1,41,22,19,51,42,0,8,1,3
E33021991,401,313,108,205,1,30,21,9,54,52,0,2,0,3
E33021992,778,632,182,450,3,74,42,32,65,57,2,4,2,4
E33021993,329,264,79,185,2,25,13,12,38,34,0,3,1,0
E33021994,511,437,164,273,1,30,14,16,38,36,0,2,0,5
E33021995,428,350,105,245,1,35,17,18,39,35,0,4,0,3
E33021996,137,108,32,76,2,11,6,5,14,13,0,1,0,2
E33021997,257,195,50,145,1,21,11,10,37,33,1,2,1,3
E33021998,383,273,81,192,1,58,45,13,49,42,0,6,1,2
E33021999,918,610,162,448,4,169,98,71,131,119,0,9,3,4
E33022000,603,439,131,308,3,97,54,43,62,60,0,2,0,2
E33022001,687,557,162,395,2,49,25,24,77,67,2,8,0,2
E33022002,269,205,51,154,1,33,25,8,30,29,0,1,0,0
E33022003,302,258,96,162,2,12,8,4,27,25,0,2,0,3
E33022004,274,243,77,166,0,15,14,1,15,14,0,1,0,1
E33022005,314,267,105,162,3,12,7,5,31,28,0,3,0,1
E33022006,546,422,94,328,1,70,51,19,51,50,0,1,0,2
E33022007,231,179,42,137,5,21,6,15,23,20,0,3,0,3
E33022008,310,226,111,115,1,27,13,14,51,43,3,5,0,5
E33022009,272,215,100,115,3,21,7,14,29,26,2,1,0,4
E33022010,224,171,81,90,3,12,8,4,33,31,1,1,0,5
E33022011,271,213,101,112,3,20,16,4,28,26,1,1,0,7
E33022012,629,507,190,317,4,33,10,23,61,56,2,3,0,24
E33022013,261,208,94,114,6,16,12,4,29,24,2,2,1,2
E33022014,269,203,64,139,0,33,16,17,29,25,1,2,1,4
E33022015,623,503,147,356,10,61,35,26,48,43,1,4,0,1
E33022016,396,298,97,201,1,33,9,24,62,52,7,2,1,2
E33022017,537,427,132,295,3,46,21,25,55,40,2,13,0,6
E33022018,365,287,81,206,2,23,9,14,52,48,1,3,0,1
E33022019,414,317,106,211,1,31,12,19,59,53,0,6,0,6
E33022020,396,321,95,226,2,17,6,11,49,40,5,4,0,7
E33022021,405,344,116,228,0,20,12,8,38,37,1,0,0,3
E33022022,286,231,83,148,0,12,5,7,34,27,0,1,6,9
E33022023,320,282,78,204,0,11,6,5,26,23,1,0,2,1
E33022024,339,271,105,166,1,34,10,24,30,28,0,2,0,3
E33022025,329,259,63,196,1,26,11,15,39,37,0,1,1,4
E33022026,254,220,66,154,0,9,2,7,22,22,0,0,0,3
E33022027,379,342,112,230,1,10,3,7,24,23,0,1,0,2
E33022028,284,240,63,177,4,14,5,9,26,25,0,1,0,0
E33022029,398,331,184,147,1,15,9,6,40,29,5,6,0,11
E33022030,513,387,105,282,4,20,11,9,95,80,2,6,7,7
E33022031,472,366,129,237,3,39,15,24,53,47,0,3,3,11
E33022032,522,417,142,275,3,39,21,18,58,48,2,6,2,5
E33022033,472,367,114,253,3,28,9,19,60,46,4,3,7,14
E33022034,622,445,183,262,6,40,12,28,124,101,9,7,7,7
E33022035,1042,774,191,583,8,83,49,34,166,147,0,12,7,11
E33022036,303,252,87,165,1,14,7,7,35,31,0,2,2,1
E33022037,3568,2800,724,2076,20,209,79,130,518,477,14,27,0,21
E33022038,311,241,81,160,0,27,8,19,40,35,0,5,0,3
E33022039,483,338,87,251,2,76,30,46,59,51,4,2,2,8
E33022040,315,220,91,129,3,37,10,27,50,46,0,1,3,5
E33022041,294,214,62,152,0,34,12,22,46,39,0,7,0,0
E33022042,568,432,132,300,1,49,19,30,84,73,0,11,0,2
E33022043,271,200,74,126,2,24,13,11,45,44,0,1,0,0
E33022044,240,172,57,115,2,34,14,20,30,30,0,0,0,2
E33022045,319,253,70,183,4,12,4,8,50,41,1,7,1,0
E33022046,340,268,79,189,1,25,8,17,45,37,4,3,1,1
E33022047,305,235,89,146,1,30,11,19,39,34,0,4,1,0
E33022048,274,209,53,156,0,23,8,15,40,35,0,5,0,2
E33022049,659,464,137,327,5,78,29,49,107,98,0,9,0,5
E33022050,270,193,66,127,1,52,21,31,22,19,1,2,0,2
E33022051,1274,711,199,512,9,196,77,119,345,332,2,9,2,13
E33022052,816,655,168,487,2,65,24,41,90,81,2,7,0,4
E33022053,306,234,56,178,2,19,6,13,49,43,0,4,2,2
E33022054,269,176,56,120,1,19,7,12,71,61,2,4,4,2
E33022055,590,419,135,284,0,69,27,42,100,88,3,7,2,2
E33022056,258,198,62,136,1,11,4,7,47,44,0,3,0,1
E33022057,604,442,123,319,2,54,23,31,104,100,0,3,1,2
E33022058,251,154,41,113,3,17,5,12,67,62,1,1,3,10
E33022059,237,193,42,151,0,12,6,6,32,27,0,5,0,0
E33022060,509,353,126,227,3,44,23,21,106,97,0,9,0,3
E33022061,353,239,69,170,3,33,19,14,74,68,1,3,2,4
E33022062,305,256,70,186,2,11,9,2,31,27,0,4,0,5
E33022063,370,319,83,236,0,7,2,5,40,35,2,3,0,4
E33022064,621,414,125,289,7,74,33,41,124,118,1,4,1,2
E33022065,270,187,52,135,3,18,3,15,59,58,0,0,1,3
E33022066,1925,1414,343,1071,16,122,44,78,356,317,6,30,3,17
E33022067,305,249,72,177,0,16,8,8,39,35,0,4,0,1
E33022068,453,311,44,267,6,42,19,23,93,89,0,3,1,1
E33022069,329,271,66,205,1,17,14,3,34,26,4,4,0,6
E33022070,333,213,68,145,1,68,35,33,45,41,0,4,0,6
E33022071,568,437,138,299,1,76,33,43,51,44,0,7,0,3
E33022072,372,282,83,199,2,29,6,23,54,47,3,3,1,5
E33022073,321,283,103,180,0,9,2,7,29,26,0,1,2,0
E33022074,556,472,155,317,0,26,10,16,57,54,0,2,1,1
E33022075,275,236,82,154,0,2,0,2,36,31,0,3,2,1
E33022076,231,179,57,122,1,19,6,13,31,25,4,2,0,1
E33022077,333,279,81,198,0,24,4,20,29,27,0,2,0,1
E33022078,628,528,152,376,4,31,9,22,63,60,0,2,1,2
E33022079,653,528,169,359,5,45,24,21,66,57,3,6,0,9
E33022080,346,257,102,155,3,20,7,13,64,52,1,8,3,2
E33022081,449,348,127,221,4,40,28,12,55,53,1,1,0,2
E33022082,253,205,98,107,0,26,7,19,22,19,2,1,0,0
E33022083,250,202,64,138,3,18,3,15,25,24,1,0,0,2
E33022084,282,236,90,146,1,21,1,20,22,18,2,1,1,2
E33022085,314,255,87,168,1,25,7,18,27,20,0,7,0,6
E33022086,364,298,70,228,2,14,1,13,48,45,0,3,0,2
E33022087,346,288,102,186,2,16,2,14,36,33,1,2,0,4
E33022088,449,397,134,263,0,20,4,16,28,22,0,5,1,4
E33022089,348,289,108,181,3,17,8,9,34,29,2,3,0,5
E33022090,271,209,44,165,1,22,3,19,36,29,2,5,0,3
E33022091,592,457,125,332,4,73,10,63,57,51,0,6,0,1
E33022092,332,263,72,191,2,36,5,31,25,24,0,1,0,6
E33022093,459,319,81,238,1,107,11,96,25,23,1,1,0,7
E33022094,582,466,125,341,2,41,7,34,47,37,3,3,4,26
E33022095,838,605,143,462,3,69,9,60,152,139,4,8,1,9
E33022096,559,419,124,295,1,78,24,54,57,48,0,8,1,4
E33022097,279,251,96,155,0,9,0,9,17,13,0,4,0,2
E33022098,710,590,166,424,2,50,12,38,65,62,0,3,0,3
E33022099,350,258,77,181,2,46,7,39,39,36,1,2,0,5
E33022100,427,366,104,262,2,29,7,22,26,24,0,2,0,4
E33022101,329,256,99,157,5,43,6,37,22,21,0,1,0,3
E33022102,499,387,102,285,2,57,11,46,49,45,0,2,2,4
E33022103,387,316,131,185,6,19,1,18,37,37,0,0,0,9
E33022104,627,523,178,345,7,61,16,45,30,26,0,4,0,6
E33022105,701,549,154,395,3,68,15,53,72,62,4,6,0,9
E33022106,345,275,83,192,2,29,12,17,39,38,0,1,0,0
E33022107,252,206,58,148,3,13,2,11,27,21,0,6,0,3
E33022108,714,562,169,393,0,76,27,49,75,72,1,1,1,1
E33022109,539,408,111,297,6,64,17,47,57,49,0,8,0,4
E33022110,336,244,67,177,0,40,15,25,50,45,0,5,0,2
E33022111,339,258,78,180,0,40,7,33,37,31,0,6,0,4
E33022112,377,307,68,239,2,24,8,16,42,40,0,2,0,2
E33022113,350,265,85,180,3,40,8,32,40,34,0,3,3,2
E33022114,465,376,106,270,2,42,14,28,41,39,0,2,0,4
E33022115,279,204,39,165,2,31,5,26,40,38,0,2,0,2
E33022116,398,306,81,225,2,29,8,21,59,51,4,4,0,2
E33022117,296,241,78,163,1,19,4,15,31,28,0,2,1,4
E33022118,605,479,156,323,6,45,8,37,73,69,0,4,0,2
E33022119,359,227,78,149,0,45,21,24,79,64,7,4,4,8
E33022120,774,559,154,405,4,55,18,37,145,101,25,7,12,11
E33022121,465,403,147,256,3,21,8,13,33,28,1,2,2,5
E33022122,240,180,71,109,0,16,6,10,42,35,2,3,2,2
E33022123,483,389,111,278,2,30,16,14,62,55,1,5,1,0
E33022124,268,214,59,155,2,22,12,10,30,28,0,1,1,0
E33022125,457,372,119,253,2,34,5,29,48,39,1,8,0,1
E33022126,422,360,149,211,4,23,8,15,35,33,0,2,0,0
E33022127,277,236,73,163,1,13,3,10,25,22,0,3,0,2
E33022128,377,337,91,246,3,15,4,11,20,14,2,3,1,2
E33022129,315,266,86,180,1,16,5,11,28,27,1,0,0,4
E33022130,319,269,58,211,2,24,1,23,24,20,1,3,0,0
E33022131,341,252,90,162,1,35,12,23,52,51,0,0,1,1
E33022132,388,293,80,213,0,43,12,31,50,46,0,4,0,2
E33022133,433,310,95,215,3,77,17,60,41,38,0,3,0,2
E33022134,445,357,118,239,3,27,14,13,54,51,1,2,0,4
E33022135,401,328,120,208,3,25,16,9,41,39,0,2,0,4
E33022136,551,398,114,284,4,50,22,28,91,79,7,1,4,8
E33022137,270,242,69,173,0,14,4,10,13,11,0,0,2,1
E33022138,269,202,68,134,1,33,7,26,29,26,1,2,0,4
E33022139,292,237,80,157,1,14,7,7,38,29,3,6,0,2
E33022140,641,496,145,351,2,32,11,21,109,99,1,3,6,2
E33022141,725,577,159,418,4,73,29,44,69,64,1,4,0,2
E33022142,755,547,144,403,7,83,41,42,112,94,4,11,3,6
E33022143,396,317,108,209,3,21,9,12,49,39,8,2,0,6
E33022144,561,408,138,270,2,68,34,34,79,72,3,4,0,4
E33022145,261,213,53,160,0,18,9,9,28,24,2,1,1,2
E33022146,276,218,80,138,3,22,13,9,31,27,1,2,1,2
E33022147,348,307,60,247,0,7,3,4,32,29,2,1,0,2
E33022148,388,302,95,207,1,30,12,18,53,48,1,4,0,2
E33022149,495,429,168,261,0,19,5,14,44,36,0,5,3,3
E33022150,576,437,144,293,1,62,30,32,73,69,0,1,3,3
E33022151,442,323,102,221,0,56,29,27,61,57,1,3,0,2
E33022152,273,227,70,157,1,29,8,21,15,14,0,1,0,1
E33022153,374,312,101,211,4,37,10,27,20,18,0,2,0,1
E33022154,356,264,84,180,1,42,15,27,44,37,0,6,1,5
E33022155,316,246,77,169,1,43,14,29,22,21,0,1,0,4
E33022156,297,241,75,166,0,33,12,21,23,18,0,5,0,0
E33022157,744,583,149,434,3,77,35,42,81,75,0,4,2,0
E33022158,584,439,149,290,1,78,34,44,60,53,0,6,1,6
E33022159,678,481,133,348,1,61,23,38,131,116,0,15,0,4
E33022160,715,560,153,407,0,57,31,26,94,88,2,3,1,4
E33022161,474,351,98,253,0,55,25,30,59,58,0,0,1,9
E33022162,265,210,56,154,1,24,16,8,29,24,0,2,3,1
E33022163,268,226,51,175,1,12,9,3,25,19,0,3,3,4
E33022164,821,663,177,486,1,68,41,27,85,73,0,11,1,4
E33022165,320,266,68,198,1,23,13,10,29,26,0,3,0,1
E33022166,276,225,80,145,2,32,13,19,16,15,0,1,0,1
E33022167,252,187,69,118,3,18,9,9,39,30,2,5,2,5
E33022168,295,211,49,162,0,45,21,24,37,36,1,0,0,2
E33022169,275,220,66,154,0,27,10,17,25,20,0,4,1,3
E33022170,241,193,62,131,4,19,9,10,20,17,0,3,0,5
E33022171,332,283,110,173,0,20,9,11,26,24,0,1,1,3
E33022172,263,184,60,124,0,53,24,29,26,23,1,2,0,0
E33022173,300,214,61,153,1,57,27,30,22,16,0,6,0,6
E33022174,253,176,52,124,0,51,19,32,26,23,0,3,0,0
E33022175,446,383,93,290,0,44,21,23,19,17,0,2,0,0
E33022176,290,237,73,164,0,27,13,14,26,23,1,2,0,0
E33022177,289,206,55,151,1,42,18,24,39,39,0,0,0,1
E33022178,649,482,123,359,1,89,41,48,72,68,1,2,1,5
E33022179,632,489,146,343,2,78,40,38,58,47,2,9,0,5
E33022180,316,250,65,185,2,44,16,28,20,17,0,2,1,0
E33022181,1769,1253,315,938,6,226,116,110,277,255,2,18,2,7
E33022182,546,407,114,293,3,61,35,26,69,46,0,10,13,6
E33022183,277,218,70,148,0,24,9,15,34,32,0,2,0,1
E33022184,236,189,62,127,0,25,15,10,22,21,0,1,0,0
E33022185,1295,938,282,656,3,185,97,88,157,138,0,19,0,12
E33022186,318,257,69,188,0,23,9,14,33,31,0,1,1,5
E33022187,317,260,71,189,1,21,12,9,34,32,0,2,0,1
E33022188,330,272,97,175,2,12,5,7,40,36,0,3,1,4
E33022189,551,464,125,339,1,30,19,11,52,44,0,7,1,4
E33022190,301,248,73,175,0,25,9,16,27,26,0,1,0,1
E33022191,254,199,58,141,0,21,11,10,29,28,0,0,1,5
E33022192,286,228,63,165,0,25,10,15,27,25,0,2,0,6
E33022193,357,247,68,179,2,53,28,25,48,42,1,4,1,7
E33022194,474,342,90,252,0,73,41,32,56,48,4,3,1,3
E33022195,369,285,77,208,0,52,30,22,29,22,0,5,2,3
E33022196,248,191,49,142,1,35,19,16,18,14,0,1,3,3
E33022197,398,258,93,165,2,87,38,49,50,42,0,8,0,1
E33022198,717,536,153,383,5,73,25,48,98,85,0,11,2,5
E33022199,238,167,47,120,1,29,19,10,39,34,0,5,0,2
E33022200,709,561,136,425,1,91,41,50,53,46,0,7,0,3
E33022201,487,342,117,225,1,91,42,49,52,48,0,3,1,1
E33022202,552,416,156,260,2,67,36,31,64,57,0,7,0,3
E33022203,229,175,48,127,0,30,16,14,23,22,0,1,0,1
E33022204,702,569,184,385,2,60,23,37,66,56,0,8,2,5
E33022205,524,401,118,283,2,34,19,15,79,75,1,3,0,8
E33022206,276,193,55,138,0,28,16,12,51,38,4,6,3,4
E33022207,469,379,137,242,0,36,17,19,50,44,0,6,0,4
E33022208,317,234,76,158,1,29,14,15,51,44,0,3,4,2
E33022209,381,295,74,221,0,18,12,6,66,60,0,2,4,2
E33022210,374,267,54,213,1,44,18,26,60,49,3,8,0,2
E33022211,292,243,105,138,2,24,10,14,21,16,0,5,0,2
E33022212,648,426,152,274,2,90,43,47,120,102,4,6,8,10
E33022213,286,234,79,155,0,21,9,12,27,25,0,1,1,4
E33022214,370,306,103,203,2,27,7,20,33,32,0,1,0,2
E33022215,374,292,127,165,2,26,15,11,48,40,2,6,0,6
E33022216,291,204,72,132,1,52,25,27,32,28,1,2,1,2
E33022217,313,235,68,167,0,45,17,28,25,20,0,4,1,8
E33022218,422,351,116,235,0,28,13,15,42,41,0,0,1,1
E33022219,313,250,104,146,0,29,13,16,33,30,0,1,2,1
E33022220,340,257,69,188,3,32,13,19,48,43,0,5,0,0
E33022221,294,237,76,161,0,36,16,20,16,16,0,0,0,5
E33022222,273,243,102,141,0,11,4,7,16,16,0,0,0,3
E33022223,299,267,112,155,2,12,6,6,18,16,0,2,0,0
E33022224,315,233,75,158,3,38,19,19,36,27,3,3,3,5
E33022225,350,293,97,196,1,31,18,13,24,21,0,2,1,1
E33022226,326,281,96,185,2,21,5,16,21,19,0,1,1,1
E33022227,517,378,139,239,2,26,12,14,101,87,6,6,2,10
E33022228,307,239,96,143,0,20,10,10,40,33,2,2,3,8
E33022229,334,242,110,132,2,33,14,19,49,42,3,4,0,8
E33022230,259,220,86,134,1,18,8,10,18,16,0,2,0,2
E33022231,448,348,109,239,3,29,14,15,65,61,1,3,0,3
E33022232,576,408,126,282,3,68,24,44,92,80,7,4,1,5
E33022233,435,380,143,237,0,19,6,13,34,32,1,1,0,2
E33022234,643,499,180,319,5,69,38,31,66,60,1,5,0,4
E33022235,328,260,67,193,3,21,11,10,42,38,3,1,0,2
E33022236,324,258,86,172,1,33,9,24,29,29,0,0,0,3
E33022237,340,263,83,180,2,22,9,13,47,42,0,5,0,6
E33022238,339,242,52,190,1,48,5,43,46,31,4,5,6,2
E33022239,582,426,113,313,10,81,19,62,62,52,6,4,0,3
E33022240,885,701,219,482,9,87,25,62,78,69,0,9,0,10
E33022241,406,297,93,204,3,39,17,22,61,46,3,5,7,6
E33022242,278,222,64,158,1,28,1,27,24,23,0,1,0,3
E33022243,355,273,106,167,1,28,5,23,49,36,5,4,4,4
E33022244,297,215,85,130,0,26,17,9,49,41,5,0,3,7
E33022245,406,247,91,156,6,56,26,30,86,75,4,5,2,11
E33022246,480,376,144,232,2,30,6,24,68,61,2,5,0,4
E33022247,297,175,66,109,0,12,5,7,85,70,11,1,3,25
E33022248,324,255,72,183,1,26,7,19,39,35,0,2,2,3
E33022249,328,280,89,191,0,26,5,21,18,17,0,1,0,4
E33022250,315,263,80,183,0,23,7,16,28,22,0,6,0,1
E33022251,530,393,153,240,2,61,40,21,71,60,8,3,0,3
E33022252,433,349,114,235,1,38,12,26,42,36,0,6,0,3
E33022253,355,307,96,211,4,15,5,10,29,25,0,4,0,0
E33022254,390,297,90,207,1,52,11,41,39,34,1,3,1,1
E33022255,437,350,88,262,0,44,19,25,41,34,0,3,4,2
E33022256,439,342,102,240,0,56,5,51,40,33,0,7,0,1
E33022257,330,255,77,178,1,39,10,29,33,28,0,4,1,2
E33022258,322,255,78,177,0,30,12,18,34,31,0,1,2,3
E33022259,668,521,138,383,3,74,40,34,65,57,0,8,0,5
E33022260,377,326,123,203,0,19,8,11,30,27,3,0,0,2
E33022261,459,328,110,218,1,79,26,53,46,44,0,2,0,5
E33022262,259,194,66,128,2,41,13,28,22,19,0,3,0,0
E33022263,650,482,137,345,2,81,32,49,74,63,1,9,1,11
E33022264,481,408,135,273,1,39,11,28,28,25,0,3,0,5
E33022265,262,187,56,131,1,43,8,35,30,25,0,3,2,1
E33022266,300,224,68,156,3,48,6,42,23,18,1,4,0,2
E33022267,444,315,109,206,1,70,28,42,51,47,2,2,0,7
E33022268,258,203,74,129,0,31,12,19,22,17,1,3,1,2
E33022269,341,305,111,194,0,12,6,6,19,15,2,0,2,5
E33022270,624,458,151,307,2,67,28,39,90,80,3,7,0,7
E33022271,403,347,125,222,1,24,9,15,25,22,1,2,0,6
E33022272,372,293,86,207,1,29,16,13,48,44,2,1,1,1
E33022273,270,224,82,142,0,25,2,23,16,13,1,1,1,5
E33022274,235,175,53,122,1,15,8,7,38,29,2,4,3,6
E33022275,496,391,130,261,6,29,17,12,67,61,0,6,0,3
E33022276,769,586,187,399,3,100,16,84,77,68,1,7,1,3
E33022277,349,294,86,208,0,15,4,11,39,32,0,7,0,1
E33022278,336,268,96,172,1,33,8,25,28,24,3,1,0,6
E33022279,250,190,53,137,2,28,20,8,26,19,2,5,0,4
E33022280,226,165,64,101,0,23,10,13,36,31,3,1,1,2
E33022281,472,351,119,232,2,66,16,50,53,51,0,2,0,0
E33022282,513,347,94,253,2,101,77,24,56,49,1,5,1,7
E33022283,307,247,87,160,3,23,7,16,27,21,3,3,0,7
E33022284,315,272,93,179,0,25,2,23,17,17,0,0,0,1
E33022285,314,272,77,195,2,22,11,11,17,15,0,2,0,1
E33022286,729,596,189,407,3,57,32,25,69,60,2,5,2,4
E33022287,396,323,103,220,0,32,20,12,34,28,0,6,0,7
E33022288,525,368,139,229,3,30,12,18,114,99,7,6,2,10
E33022289,300,237,109,128,3,27,8,19,24,18,0,5,1,9
E33022290,681,530,225,305,4,59,38,21,78,70,4,2,2,10
E33022291,550,430,158,272,1,50,20,30,59,53,1,4,1,10
E33022292,427,341,132,209,0,44,5,39,38,30,4,4,0,4
E33022293,276,244,82,162,1,10,6,4,18,16,0,2,0,3
E33022294,299,255,93,162,0,13,5,8,27,23,1,3,0,4
E33022295,583,456,154,302,2,69,43,26,50,39,4,6,1,6
E33022296,269,232,58,174,0,13,9,4,21,20,0,1,0,3
E33022297,369,291,81,210,2,44,36,8,30,26,1,3,0,2
E33022298,235,171,62,109,0,22,13,9,37,27,7,3,0,5
E33022299,403,309,117,192,1,25,11,14,57,52,0,4,1,11
E33022300,351,271,99,172,3,22,10,12,51,48,1,2,0,4
E33022301,384,309,95,214,0,25,11,14,48,44,0,2,2,2
E33022302,480,374,140,234,0,46,24,22,56,52,1,1,2,4
E33022303,582,452,112,340,1,26,15,11,100,96,0,3,1,3
E33022304,299,223,73,150,1,34,11,23,38,34,1,2,1,3
E33022305,280,228,69,159,2,18,6,12,31,26,3,0,2,1
E33022306,441,323,107,216,0,63,25,38,52,46,0,6,0,3
E33022307,315,238,68,170,2,34,16,18,37,35,0,2,0,4
E33022308,427,293,93,200,2,59,21,38,71,64,1,5,1,2
E33022309,584,454,118,336,1,59,25,34,70,63,0,7,0,0
E33022310,677,524,163,361,1,56,28,28,90,82,0,6,2,6
E33022311,335,294,91,203,2,12,4,8,26,24,1,1,0,1
E33022312,663,496,171,325,4,38,23,15,104,89,6,8,1,21
E33022313,293,241,73,168,1,15,11,4,32,29,0,3,0,4
E33022314,419,335,108,227,1,28,13,15,51,45,0,5,1,4
E33022315,431,352,163,189,1,29,9,20,49,45,0,4,0,0
E33022316,635,509,198,311,1,39,14,25,83,73,4,6,0,3
E33022317,504,350,89,261,0,42,13,29,104,97,4,2,1,8
E33022318,287,227,86,141,3,23,16,7,32,28,0,4,0,2
E33022319,660,567,181,386,2,35,19,16,54,45,2,7,0,2
E33022320,368,280,99,181,1,36,17,19,46,33,8,4,1,5
E33022321,441,302,123,179,1,30,12,18,98,82,11,4,1,10
E33022322,294,250,59,191,1,16,6,10,25,21,0,4,0,2
E33022323,1510,953,237,716,10,178,81,97,350,331,3,13,3,19
E33022324,265,197,77,120,1,38,34,4,21,19,2,0,0,8
E33022325,1110,853,256,597,5,114,51,63,134,123,0,10,1,4
E33022326,995,749,207,542,4,90,27,63,150,138,1,10,1,2
E33022327,521,365,115,250,2,76,37,39,76,68,2,6,0,2
E33022328,419,303,87,216,7,61,18,43,44,44,0,0,0,4
E33022329,304,218,71,147,0,32,14,18,51,46,3,2,0,3
E33022330,263,210,71,139,1,21,2,19,29,28,0,0,1,2
E33022331,809,622,177,445,4,72,28,44,105,90,2,12,1,6
E33022332,246,204,77,127,1,12,6,6,27,25,0,2,0,2
E33022333,382,301,102,199,2,41,20,21,35,31,3,1,0,3
E33022334,230,189,82,107,1,7,2,5,31,29,0,2,0,2
E33022335,352,284,99,185,0,10,2,8,48,38,4,5,1,10
E33022336,429,291,74,217,2,59,23,36,70,63,3,3,1,7
E33022337,2178,1677,447,1230,5,152,54,98,332,258,19,31,24,12
E33022338,419,334,103,231,1,28,9,19,55,52,0,2,1,1
E33022339,838,672,205,467,7,55,24,31,101,96,1,4,0,3
E33022340,291,200,60,140,2,30,13,17,52,50,0,2,0,7
E33022341,527,374,127,247,3,55,28,27,93,80,2,11,0,2
E33022342,356,254,66,188,2,44,18,26,53,49,0,3,1,3
E33022343,367,284,76,208,3,21,1,20,57,51,2,4,0,2
E33022344,424,308,97,211,2,42,13,29,71,64,1,6,0,1
E33022345,493,373,84,289,6,32,14,18,78,72,1,5,0,4
E33022346,465,344,113,231,9,40,12,28,68,64,0,4,0,4
E33022347,372,284,108,176,3,15,7,8,64,54,3,3,4,6
E33022348,1124,925,239,686,9,64,28,36,118,102,5,9,2,8
E33022349,298,222,69,153,4,24,11,13,46,45,1,0,0,2
E33022350,1359,1023,301,722,4,66,30,36,260,246,0,6,8,6
E33022351,1012,775,197,578,3,96,39,57,136,123,1,11,1,2
E33022352,320,257,94,163,2,20,10,10,39,33,3,3,0,2
E33022353,259,203,54,149,0,28,11,17,24,22,1,1,0,4
E33022354,735,564,186,378,4,58,32,26,101,87,5,7,2,8
E33022355,487,386,119,267,0,52,18,34,46,42,0,2,2,3
E33022356,348,307,89,218,0,16,7,9,23,23,0,0,0,2
E33022357,310,216,41,175,2,63,13,50,27,25,0,2,0,2
E33022358,316,223,53,170,1,68,27,41,23,18,0,5,0,1
E33022359,632,485,129,356,7,67,20,47,67,65,1,1,0,6
E33022360,444,424,91,333,3,6,2,4,10,9,1,0,0,1
E33022361,426,346,111,235,1,23,8,15,51,45,0,5,1,5
E33022362,320,285,83,202,0,1,1,0,28,26,0,2,0,6
E33022363,487,430,125,305,3,11,4,7,40,31,1,8,0,3
E33022364,331,298,109,189,2,5,3,2,23,20,0,3,0,3
E33022365,268,214,82,132,2,18,4,14,27,24,2,1,0,7
E33022366,320,261,84,177,2,9,3,6,46,44,0,2,0,2
E33022367,307,254,85,169,0,20,9,11,29,21,3,3,2,4
E33022368,297,229,86,143,1,26,11,15,38,34,1,3,0,3
E33022369,305,223,113,110,2,21,12,9,48,36,4,3,5,11
E33022370,273,223,93,130,0,29,21,8,19,17,0,0,2,2
E33022371,329,252,82,170,0,19,10,9,49,43,3,2,1,9
E33022372,523,419,153,266,3,25,13,12,69,52,5,11,1,7
E33022373,452,336,100,236,2,71,35,36,40,38,0,2,0,3
E33022374,491,372,98,274,6,50,14,36,63,57,2,4,0,0
E33022375,247,180,51,129,2,37,18,19,23,21,0,2,0,5
E33022376,410,326,107,219,1,30,12,18,48,40,0,8,0,5
E33022377,390,317,171,146,3,17,6,11,45,36,2,3,4,8
E33022378,445,332,115,217,1,51,22,29,59,52,1,6,0,2
E33022379,262,198,96,102,1,11,4,7,43,40,0,2,1,9
E33022380,376,316,136,180,3,26,12,14,29,26,0,1,2,2
E33022381,430,336,118,218,2,57,21,36,32,31,0,1,0,3
E33022382,319,275,104,171,0,18,14,4,24,17,0,3,4,2
E33022383,256,217,111,106,2,13,2,11,23,20,0,2,1,1
E33022384,286,250,80,170,1,4,0,4,30,30,0,0,0,1
E33022385,563,480,194,286,1,17,8,9,62,54,3,5,0,3
E33022386,330,285,121,164,1,15,6,9,26,24,0,2,0,3
E33022387,303,244,82,162,0,21,11,10,37,31,2,3,1,1
E33022388,452,345,99,246,1,55,21,34,49,40,1,7,1,2
E33022389,387,301,87,214,0,44,21,23,37,33,0,3,1,5
E33022390,560,470,160,310,3,38,17,21,39,35,0,4,0,10
E33022391,282,240,110,130,2,11,6,5,26,21,0,5,0,3
E33022392,497,404,119,285,2,45,28,17,45,34,4,5,2,1
E33022393,254,207,78,129,1,22,13,9,21,20,0,1,0,3
E33022394,578,454,131,323,2,44,26,18,72,60,0,12,0,6
E33022395,319,221,77,144,0,42,13,29,50,42,2,5,1,6
E33022396,297,233,87,146,3,19,4,15,40,34,1,4,1,2
E33022397,461,400,102,298,0,21,10,11,35,29,0,6,0,5
E33022398,262,207,76,131,0,27,8,19,25,24,0,1,0,3
E33022399,382,304,91,213,0,25,12,13,45,42,0,1,2,8
E33022400,341,267,82,185,0,17,10,7,56,54,1,1,0,1
E33022401,233,187,67,120,2,11,3,8,28,25,0,3,0,5
E33022402,300,232,85,147,1,30,21,9,33,31,0,2,0,4
E33022403,307,255,92,163,1,10,6,4,37,33,0,4,0,4
E33022404,519,427,142,285,2,30,12,18,58,53,2,3,0,2
E33022405,480,390,115,275,2,27,11,16,58,53,1,4,0,3
E33022406,933,775,227,548,0,47,19,28,106,94,0,12,0,5
E33022407,331,270,89,181,0,20,9,11,35,32,0,3,0,6
E33022408,356,286,97,189,0,24,10,14,42,39,0,3,0,4
E33022409,468,407,137,270,0,19,11,8,39,31,4,4,0,3
E33022410,967,727,259,468,3,97,58,39,135,129,0,5,1,5
E33022411,427,314,153,161,2,22,9,13,70,48,3,14,5,19
E33022412,413,324,114,210,3,14,9,5,65,54,2,6,3,7
E33022413,308,213,136,77,1,14,2,12,76,57,1,11,7,4
E33022414,274,225,123,102,0,14,6,8,31,23,1,2,5,4
E33022415,244,193,79,114,3,18,8,10,22,19,0,1,2,8
E33022416,630,517,247,270,2,36,13,23,67,56,0,10,1,8
E33022417,363,305,124,181,1,16,15,1,33,32,1,0,0,8
E33022418,380,316,121,195,0,22,15,7,39,35,0,3,1,3
E33022419,243,207,89,118,0,14,9,5,21,16,3,1,1,1
E33022420,262,221,72,149,1,14,11,3,26,23,1,2,0,0
E33022421,455,397,151,246,0,28,14,14,28,22,1,4,1,2
E33022422,334,254,95,159,0,24,13,11,52,41,9,2,0,4
E33022423,602,500,147,353,0,43,32,11,58,51,4,3,0,1
E33022424,329,288,105,183,0,23,10,13,17,13,0,4,0,1
E33022425,250,196,61,135,0,27,21,6,24,22,1,1,0,3
E33022426,394,348,126,222,0,18,12,6,25,23,0,2,0,3
E33022427,420,334,118,216,0,35,20,15,47,45,1,1,0,4
E33022428,244,205,79,126,0,8,4,4,26,24,1,1,0,5
E33022429,384,300,89,211,4,28,15,13,46,39,0,4,3,6
E33022430,314,267,118,149,3,9,3,6,35,25,0,4,6,0
E33022431,300,251,95,156,1,20,12,8,24,20,0,4,0,4
E33022432,787,615,150,465,5,66,38,28,97,83,6,8,0,4
E33022433,530,432,168,264,3,31,13,18,56,53,0,3,0,8
E33022434,339,279,80,199,1,24,13,11,32,31,0,1,0,3
E33022435,427,344,96,248,1,44,32,12,37,31,1,5,0,1
E33022436,642,519,176,343,4,42,12,30,72,59,3,9,1,5
E33022437,328,274,112,162,0,28,22,6,25,21,3,1,0,1
E33022438,327,283,113,170,1,14,5,9,26,24,0,1,1,3
E33022439,457,388,136,252,3,27,16,11,35,34,0,1,0,4
E33022440,491,431,142,289,0,13,10,3,44,31,0,13,0,3
E33022441,610,514,177,337,3,23,13,10,62,54,1,7,0,8
E33022442,652,526,174,352,6,46,21,25,67,56,5,5,1,7
E33022443,379,327,133,194,0,22,13,9,25,22,0,2,1,5
E33022444,1078,890,269,621,6,78,45,33,98,89,0,9,0,6
E33022445,288,237,98,139,2,8,5,3,34,30,2,2,0,7
E33022446,256,213,69,144,0,26,22,4,17,14,0,1,2,0
E33022447,364,301,114,187,0,35,30,5,24,19,0,4,1,4
E33022448,374,306,71,235,2,22,19,3,43,38,0,2,3,1
E33022449,492,365,108,257,0,73,51,22,51,49,0,1,1,3
E33022450,304,225,56,169,0,39,26,13,37,31,1,5,0,3
E33022451,769,632,184,448,7,44,31,13,82,78,0,4,0,4
E33022452,266,199,43,156,3,34,13,21,27,22,0,5,0,3
E33022453,327,227,65,162,0,33,19,14,64,61,0,3,0,3
E33022454,345,273,66,207,1,39,28,11,29,25,2,2,0,3
E33022455,663,522,106,416,4,67,49,18,69,63,0,5,1,1
E33022456,511,437,100,337,2,28,13,15,39,32,3,4,0,5
E33022457,1554,1244,313,931,7,127,82,45,172,151,3,17,1,4
E33022458,461,363,95,268,2,43,29,14,49,46,0,3,0,4
E33022459,392,289,93,196,0,43,33,10,56,51,1,4,0,4
E33022460,508,416,110,306,1,36,27,9,51,48,0,2,1,4
E33022461,360,284,72,212,2,35,23,12,39,35,0,4,0,0
E33022462,292,234,50,184,0,33,25,8,22,17,0,5,0,3
E33022463,303,242,48,194,1,16,9,7,44,39,0,5,0,0
E33022464,437,335,85,250,6,47,26,21,48,39,0,6,3,1
E33022465,510,368,88,280,1,81,68,13,58,54,0,4,0,2
E33022466,274,185,46,139,0,34,25,9,50,44,0,6,0,5
E33022467,514,382,90,292,1,94,74,20,36,33,0,3,0,1
E33022468,295,182,43,139,2,84,40,44,25,21,0,4,0,2
E33022469,353,294,65,229,0,26,12,14,30,28,0,2,0,3
E33022470,325,249,60,189,0,37,31,6,35,34,0,1,0,4
E33022471,1400,1014,205,809,13,113,62,51,256,245,1,10,0,4
E33022472,339,301,81,220,0,12,5,7,24,22,1,1,0,2
E33022473,302,245,74,171,0,25,14,11,32,28,0,4,0,0
E33022474,415,346,80,266,2,19,9,10,47,46,0,1,0,1
E33022475,942,718,174,544,4,94,58,36,118,114,0,4,0,8
E33022476,391,339,75,264,1,34,29,5,15,15,0,0,0,2
E33022477,535,397,107,290,5,52,39,13,78,65,6,7,0,3
E33022478,401,287,74,213,0,63,38,25,48,42,0,5,1,3
E33022479,563,445,137,308,4,53,33,20,61,55,1,4,1,0
E33022480,703,556,157,399,3,66,50,16,75,69,0,5,1,3
E33022481,283,211,77,134,2,29,25,4,41,28,6,7,0,0
E33022482,293,217,62,155,3,16,12,4,53,45,5,3,0,4
E33022483,320,260,66,194,0,26,13,13,32,28,0,4,0,2
E33022484,272,225,76,149,0,17,15,2,28,26,0,2,0,2
E33022485,481,410,140,270,0,32,23,9,38,35,0,3,0,1
E33022486,400,323,105,218,0,39,35,4,37,30,1,4,2,1
E33022487,348,242,96,146,2,53,43,10,48,42,1,3,2,3
E33022488,420,302,96,206,3,67,30,37,46,45,0,1,0,2
E33022489,623,465,135,330,9,66,45,21,79,70,1,2,6,4
E33022490,516,416,130,286,3,48,34,14,46,45,0,1,0,3
E33022491,285,241,70,171,3,14,12,2,26,26,0,0,0,1
E33022492,329,252,84,168,2,32,24,8,39,31,3,2,3,4
E33022493,444,315,94,221,5,57,36,21,63,60,0,3,0,4
E33022494,407,302,86,216,2,47,31,16,51,44,0,6,1,5
E33022495,251,190,49,141,1,27,18,9,31,28,0,3,0,2
E33022496,313,270,90,180,3,28,13,15,12,10,0,2,0,0
E33022497,267,212,62,150,1,25,15,10,28,26,1,1,0,1
E33022498,295,235,75,160,3,12,7,5,39,36,1,2,0,6
E33022499,267,213,82,131,2,20,11,9,28,24,2,0,2,4
E33022500,831,627,182,445,5,74,46,28,119,105,7,6,1,6
E33022501,869,696,174,522,13,45,26,19,108,101,1,6,0,7
E33022502,298,204,66,138,4,27,19,8,56,53,2,0,1,7
E33022503,340,277,103,174,1,22,14,8,32,26,1,3,2,8
E33022504,643,476,128,348,2,74,48,26,88,80,2,5,1,3
E33022505,363,254,77,177,5,39,25,14,62,56,2,3,1,3
E33022506,427,331,98,233,4,42,34,8,47,43,0,3,1,3
E33022507,344,287,107,180,4,20,12,8,33,29,0,4,0,0
E33022508,266,222,74,148,1,21,15,6,21,21,0,0,0,1
E33022509,562,425,116,309,2,53,40,13,77,67,4,6,0,5
E33022510,591,439,130,309,3,63,44,19,83,76,0,6,1,3
E33022511,403,311,101,210,1,35,18,17,53,47,1,3,2,3
E33022512,888,676,172,504,7,71,43,28,130,120,2,8,0,4
E33022513,548,412,114,298,3,52,37,15,77,70,0,6,1,4
E33022514,260,215,57,158,2,14,10,4,29,26,0,2,1,0
E33022515,474,382,93,289,3,31,22,9,50,43,3,4,0,8
E33022516,345,257,92,165,0,23,11,12,61,51,0,5,5,4
E33022517,396,296,94,202,4,35,22,13,53,48,1,4,0,8
E33022518,924,803,251,552,0,48,38,10,73,68,0,3,2,0
E33022519,621,479,136,343,7,62,45,17,70,65,0,4,1,3
E33022520,538,398,117,281,6,49,29,20,76,62,1,4,9,9
E33022521,325,257,73,184,3,25,17,8,39,32,1,4,2,1
E33022522,343,293,96,197,3,13,12,1,33,29,0,2,2,1
E33022523,308,270,83,187,1,7,3,4,30,29,0,1,0,0
E33022524,414,336,111,225,0,31,22,9,41,35,0,5,1,6
E33022525,288,249,71,178,1,17,12,5,20,14,0,6,0,1
E33022526,425,305,80,225,6,71,55,16,42,37,2,3,0,1
E33022527,590,461,96,365,2,53,45,8,73,67,0,6,0,1
E33022528,351,260,84,176,2,33,24,9,55,48,3,3,1,1
E33022529,256,207,57,150,0,11,7,4,37,26,0,9,2,1
E33022530,363,300,85,215,2,18,13,5,42,35,3,4,0,1
E33022531,798,700,232,468,6,28,16,12,61,55,0,6,0,3
E33022532,294,250,70,180,5,8,4,4,29,27,0,2,0,2
E33022533,322,266,102,164,0,22,13,9,33,30,2,1,0,1
E33022534,694,547,163,384,7,57,43,14,82,72,0,9,1,1
E33022535,324,274,67,207,0,19,14,5,27,21,1,3,2,4
E33022536,316,257,67,190,6,17,9,8,36,32,0,3,1,0
E33022537,385,314,63,251,2,18,6,12,51,51,0,0,0,0
E33022538,240,181,46,135,3,14,9,5,40,33,1,6,0,2
E33022539,460,340,94,246,3,48,35,13,66,58,1,6,1,3
E33022540,350,265,81,184,2,35,24,11,44,40,0,3,1,4
E33022541,319,234,69,165,0,28,20,8,49,42,0,5,2,8
E33022542,458,348,87,261,3,28,18,10,77,68,0,6,3,2
E33022543,262,195,70,125,2,8,4,4,54,49,0,1,4,3
E33022544,374,259,75,184,0,62,54,8,53,48,0,3,2,0
E33022545,348,292,83,209,0,16,10,6,37,33,0,2,2,3
E33022546,300,243,74,169,1,14,11,3,38,35,0,3,0,4
E33022547,315,262,59,203,0,28,24,4,25,19,0,5,1,0
E33022548,284,222,57,165,1,16,10,6,40,34,0,5,1,5
E33022549,295,215,47,168,3,30,22,8,43,36,1,6,0,4
E33022550,396,306,84,222,3,17,9,8,64,56,1,5,2,6
E33022551,338,260,79,181,4,24,16,8,50,44,0,4,2,0
E33022552,436,354,99,255,5,24,19,5,53,46,0,7,0,0
E33022553,294,241,81,160,1,15,11,4,35,35,0,0,0,2
E33022554,250,176,47,129,1,32,25,7,40,37,0,3,0,1
E33022555,649,496,131,365,2,70,50,20,75,70,0,5,0,6
E33022556,587,415,120,295,4,70,48,22,98,84,1,9,4,0
E33022557,302,256,83,173,1,19,12,7,22,21,0,1,0,4
E33022558,288,217,89,128,3,16,11,5,50,44,0,4,2,2
E33022559,482,366,88,278,3,40,24,16,68,57,0,7,4,5
E33022560,303,255,66,189,0,17,7,10,29,26,1,2,0,2
E33022561,654,491,133,358,6,48,29,19,106,100,1,5,0,3
E33022562,332,233,60,173,2,40,35,5,55,50,0,4,1,2
E33022563,413,373,112,261,2,13,6,7,22,18,0,4,0,3
E33022564,445,386,119,267,0,21,18,3,36,35,1,0,0,2
E33022565,328,272,70,202,3,21,15,6,32,25,4,1,2,0
E33022566,294,244,67,177,2,9,4,5,36,31,0,5,0,3
E33022567,359,294,105,189,3,26,16,10,32,30,0,2,0,4
E33022568,860,653,162,491,9,113,83,30,82,77,0,5,0,3
E33022569,432,346,113,233,1,49,33,16,31,30,0,1,0,5
E33022570,342,284,102,182,2,18,15,3,34,26,5,1,2,4
E33022571,391,334,118,216,0,15,12,3,36,32,0,2,2,6
E33022572,273,196,69,127,1,20,16,4,51,47,1,3,0,5
E33022573,410,308,84,224,4,46,42,4,49,42,0,6,1,3
E33022574,389,298,82,216,1,28,21,7,58,51,2,5,0,4
E33022575,499,349,93,256,5,43,24,19,101,89,1,11,0,1
E33022576,409,308,81,227,8,28,21,7,64,60,0,1,3,1
E33022577,259,178,61,117,0,32,23,9,49,41,0,8,0,0
E33022578,358,293,88,205,1,28,24,4,35,33,1,1,0,1
E33022579,308,256,67,189,3,11,6,5,35,33,0,2,0,3
E33022580,792,608,123,485,9,38,18,20,136,118,0,12,6,1
E33022581,287,225,91,134,2,17,10,7,41,28,5,6,2,2
E33022582,610,469,100,369,5,49,31,18,84,80,3,1,0,3
E33022583,370,308,90,218,4,13,8,5,43,37,0,5,1,2
E33022584,352,286,100,186,1,29,16,13,33,30,1,1,1,3
E33022585,332,239,80,159,2,42,27,15,44,41,0,3,0,5
E33022586,398,316,104,212,3,30,19,11,41,36,1,2,2,8
E33022587,234,189,79,110,1,21,13,8,19,15,2,0,2,4
E33022588,591,489,145,344,6,35,22,13,56,47,2,4,3,5
E33022589,594,260,63,197,5,64,25,39,257,66,102,5,84,8
E33022590,318,243,78,165,2,26,7,19,46,42,0,1,3,1
E33022591,540,448,99,349,2,42,27,15,47,45,0,2,0,1
E33022592,293,202,43,159,1,35,22,13,53,48,1,2,2,2
E33022593,400,268,60,208,6,58,38,20,60,47,0,11,2,8
E33022594,668,497,138,359,4,59,26,33,108,101,1,5,1,0
E33022595,1458,1174,369,805,7,94,58,36,178,165,0,12,1,5
E33022596,890,650,169,481,13,98,53,45,126,116,1,9,0,3
E33022597,331,255,76,179,3,34,21,13,37,34,0,3,0,2
E33022598,293,250,71,179,1,9,5,4,32,30,0,2,0,1
E33022599,615,447,139,308,6,51,27,24,108,91,4,12,1,3
E33022600,218,156,53,103,1,18,9,9,43,33,2,0,8,0
E33022601,415,319,82,237,6,22,9,13,64,53,3,5,3,4
E33022602,440,327,91,236,8,43,26,17,60,53,1,2,4,2
E33022603,294,177,58,119,4,22,11,11,88,82,2,3,1,3
E33022604,515,399,112,287,5,43,22,21,68,58,1,8,1,0
E33022605,311,209,55,154,2,26,19,7,74,73,1,0,0,0
E33022606,537,365,96,269,3,54,30,24,112,102,0,9,1,3
E33022607,356,268,80,188,6,37,24,13,42,39,0,3,0,3
E33022608,240,180,56,124,1,36,20,16,22,19,1,2,0,1
E33022609,300,194,49,145,2,27,14,13,72,65,1,4,2,5
E33022610,312,221,48,173,5,28,14,14,54,54,0,0,0,4
E33022611,586,378,140,238,7,65,37,28,134,126,3,3,2,2
E33022612,293,216,52,164,4,29,18,11,40,38,1,1,0,4
E33022613,320,215,47,168,6,56,11,45,42,38,0,4,0,1
E33022614,450,363,66,297,13,29,11,18,44,43,0,1,0,1
E33022615,301,250,61,189,2,12,4,8,36,35,0,1,0,1
E33022616,417,345,105,240,3,26,9,17,39,35,0,4,0,4
E33022617,459,381,118,263,3,22,11,11,49,47,1,1,0,4
E33022618,285,246,76,170,0,15,9,6,21,15,2,4,0,3
E33022619,654,480,148,332,2,66,42,24,104,99,1,3,1,2
E33022620,784,613,169,444,10,41,19,22,114,101,1,12,0,6
E33022621,348,223,59,164,4,51,19,32,64,57,4,2,1,6
E33022622,290,221,67,154,0,36,25,11,30,26,1,1,2,3
E33022623,334,253,70,183,2,25,19,6,50,42,4,4,0,4
E33022624,515,409,122,287,1,31,21,10,70,63,2,4,1,4
E33022625,412,329,98,231,2,24,13,11,52,43,1,7,1,5
E33022626,244,219,84,135,1,7,3,4,17,14,0,3,0,0
E33022627,263,207,54,153,5,20,14,6,29,27,0,2,0,2
E33022628,379,261,68,193,6,53,38,15,57,54,3,0,0,2
E33022629,356,264,82,182,2,50,42,8,39,36,2,0,1,1
E33022630,303,259,77,182,1,13,5,8,28,25,2,1,0,2
E33022631,285,251,94,157,0,11,9,2,22,17,3,2,0,1
E33022632,484,343,105,238,4,35,23,12,91,82,3,5,1,11
E33022633,438,345,101,244,4,36,25,11,40,32,4,4,0,13
E33022634,307,257,108,149,1,9,4,5,36,33,1,2,0,4
E33022635,323,280,94,186,2,16,13,3,23,17,1,3,2,2
E33022636,366,312,121,191,5,14,7,7,32,28,1,3,0,3
E33022637,258,191,67,124,1,28,14,14,35,30,1,3,1,3
E33022638,291,235,98,137,1,15,9,6,30,24,2,2,2,10
E33022639,463,348,115,233,3,39,25,14,64,59,1,3,1,9
E33022640,476,361,95,266,4,38,20,18,70,60,4,6,0,3
E33022641,259,195,58,137,1,7,4,3,48,45,0,1,2,8
E33022642,224,170,54,116,2,26,11,15,22,20,1,1,0,4
E33022643,251,182,85,97,0,29,9,20,35,33,0,2,0,5
E33022644,347,266,101,165,0,35,23,12,40,31,5,3,1,6
E33022645,244,194,56,138,1,16,4,12,32,29,0,3,0,1
E33022646,393,288,121,167,3,45,10,35,53,47,0,5,1,4
E33022647,435,341,131,210,5,23,6,17,58,54,0,2,2,8
E33022648,376,291,86,205,2,23,6,17,56,46,1,9,0,4
E33022649,373,285,92,193,3,27,5,22,53,50,0,3,0,5
E33022650,232,173,58,115,4,17,5,12,31,25,2,4,0,7
E33022651,456,323,107,216,3,58,12,46,68,64,0,4,0,4
E33022652,234,176,55,121,4,14,5,9,39,35,0,3,1,1
E33022653,333,260,76,184,1,44,14,30,27,25,0,2,0,1
E33022654,493,394,117,277,5,44,18,26,43,40,0,2,1,7
E33022655,352,269,88,181,0,47,21,26,34,32,0,2,0,2
E33022656,319,248,90,158,5,31,7,24,32,26,0,4,2,3
E33022657,508,411,129,282,5,44,3,41,44,42,0,2,0,4
E33022658,688,551,172,379,7,64,10,54,65,58,1,4,2,1
E33022659,461,330,121,209,11,40,7,33,74,60,4,8,2,6
E33022660,473,357,104,253,5,54,8,46,57,46,2,8,1,0
E33022661,560,412,147,265,4,65,11,54,68,57,3,4,4,11
E33022662,540,395,139,256,9,65,12,53,57,49,0,5,3,14
E33022663,317,258,84,174,4,22,2,20,29,23,2,1,3,4
E33022664,515,309,92,217,3,53,17,36,141,123,1,11,6,9
E33022665,644,513,180,333,5,50,15,35,70,63,0,3,4,6
E33022666,371,268,113,155,0,23,6,17,66,55,2,6,3,14
E33022667,292,228,66,162,3,16,2,14,45,40,0,5,0,0
E33022668,566,399,111,288,5,45,11,34,100,86,10,3,1,17
E33022669,434,327,91,236,6,58,8,50,34,31,0,3,0,9
E33022670,436,310,86,224,2,36,7,29,86,83,1,2,0,2
E33022671,490,299,109,190,4,86,25,61,94,90,2,2,0,7
E33022672,326,231,77,154,3,46,8,38,44,42,0,2,0,2
E33022673,312,260,100,160,1,14,1,13,31,26,4,1,0,6
E33022674,265,197,67,130,2,25,8,17,35,33,0,1,1,6
E33022675,559,390,135,255,4,44,9,35,115,102,5,8,0,6
E33022676,259,189,93,96,1,10,0,10,58,50,2,5,1,1
E33022677,457,340,141,199,8,45,5,40,59,55,0,2,2,5
E33022678,285,238,65,173,4,15,3,12,26,22,2,2,0,2
E33022679,250,175,69,106,2,33,8,25,37,27,3,5,2,3
E33022680,253,195,68,127,5,26,5,21,25,25,0,0,0,2
E33022681,310,223,98,125,4,42,3,39,41,40,0,0,1,0
E33022682,424,316,100,216,4,33,13,20,67,64,1,2,0,4
E33022683,381,258,76,182,1,50,11,39,69,65,1,3,0,3
E33022684,385,291,97,194,3,35,14,21,48,44,0,3,1,8
E33022685,493,329,107,222,13,47,7,40,92,73,13,5,1,12
E33022686,237,160,69,91,0,14,5,9,62,56,2,4,0,1
E33022687,362,274,97,177,2,42,3,39,38,36,0,2,0,6
E33022688,415,252,78,174,3,82,13,69,74,70,1,3,0,4
E33022689,1167,771,234,537,17,167,24,143,202,188,3,10,1,10
E33022690,521,408,118,290,5,26,3,23,78,72,1,5,0,4
E33022691,267,176,59,117,3,41,4,37,45,44,0,1,0,2
E33022692,367,217,81,136,13,74,19,55,62,58,0,4,0,1
E33022693,480,338,127,211,4,29,0,29,108,99,7,2,0,1
E33022694,499,341,97,244,12,37,7,30,104,98,2,4,0,5
E33022695,355,223,70,153,2,69,13,56,60,57,0,3,0,1
E33022696,564,347,99,248,7,40,7,33,168,157,1,10,0,2
E33022697,1059,689,218,471,13,156,28,128,197,186,0,9,2,4
E33022698,254,218,69,149,3,8,0,8,22,20,0,2,0,3
E33022699,341,245,56,189,11,17,2,15,63,57,0,4,2,5
E33022700,278,211,68,143,6,24,3,21,33,30,0,0,3,4
E33022701,1068,867,212,655,17,33,6,27,147,134,2,9,2,4
E33022702,227,166,75,91,2,21,2,19,32,26,2,0,4,6
E33022703,638,487,174,313,16,40,4,36,95,90,0,5,0,0
E33022704,391,271,92,179,6,27,0,27,82,78,1,2,1,5
E33022705,292,233,63,170,3,22,0,22,31,29,0,2,0,3
E33022706,652,439,158,281,10,42,2,40,156,143,4,7,2,5
E33022707,273,211,99,112,4,17,2,15,38,34,3,1,0,3
E33022708,305,233,81,152,3,15,3,12,54,51,1,1,1,0
E33022709,356,277,84,193,2,26,2,24,46,45,1,0,0,5
E33022710,278,202,68,134,3,23,5,18,48,42,5,1,0,2
E33022711,358,282,121,161,4,20,5,15,43,35,3,3,2,9
E33022712,245,195,76,119,2,22,3,19,21,18,0,1,2,5
E33022713,304,233,81,152,3,28,10,18,39,34,0,2,3,1
E33022714,320,252,91,161,5,21,4,17,39,35,1,2,1,3
E33022715,422,253,84,169,9,76,11,65,81,76,2,3,0,3
E33022716,502,361,125,236,2,39,6,33,96,84,4,4,4,4
E33022717,281,233,71,162,3,13,1,12,28,25,0,1,2,4
E33022718,660,422,120,302,7,72,11,61,159,67,61,7,24,0
E33022719,378,265,120,145,1,24,6,18,73,57,3,9,4,15
E33022720,366,280,122,158,4,17,5,12,53,46,1,4,2,12
E33022721,498,344,128,216,1,70,25,45,77,71,3,2,1,6
E33022722,295,218,70,148,2,33,8,25,33,28,3,2,0,9
E33022723,529,410,153,257,5,35,9,26,76,67,0,8,1,3
E33022724,252,171,74,97,5,21,2,19,47,44,1,0,2,8
E33022725,276,196,75,121,3,32,3,29,39,33,6,0,0,6
E33022726,240,182,68,114,1,26,5,21,30,25,0,4,1,1
E33022727,674,482,164,318,8,69,12,57,105,96,2,5,2,10
E33022728,431,304,118,186,3,34,7,27,87,75,2,8,2,3
E33022729,353,239,75,164,9,37,2,35,61,49,5,7,0,7
E33022730,287,207,82,125,3,24,1,23,45,41,0,3,1,8
E33022731,377,270,84,186,0,16,2,14,88,82,2,2,2,3
E33022732,669,353,115,238,7,45,9,36,256,229,8,15,4,8
E33022733,388,282,96,186,3,38,7,31,51,39,5,2,5,14
E33022734,328,256,88,168,4,27,2,25,34,33,0,1,0,7
E33022735,443,303,116,187,8,74,9,65,52,46,4,2,0,6
E33022736,417,294,122,172,3,42,7,35,60,55,4,1,0,18
E33022737,570,381,130,251,4,70,7,63,106,93,1,7,5,9
E33022738,303,233,99,134,3,21,3,18,40,32,4,4,0,6
E33022739,234,168,89,79,2,23,3,20,32,30,1,1,0,9
E33022740,311,222,99,123,4,23,5,18,47,43,1,1,2,15
E33022741,393,295,97,198,5,41,9,32,49,40,0,7,2,3
E33022742,318,260,94,166,2,15,11,4,39,37,0,2,0,2
E33022743,248,177,57,120,2,14,13,1,52,47,0,2,3,3
E33022744,387,295,116,179,2,28,19,9,56,51,0,4,1,6
E33022745,575,441,141,300,3,39,27,12,87,78,0,9,0,5
E33022746,387,294,105,189,2,32,19,13,57,53,0,4,0,2
E33022747,395,321,109,212,4,21,10,11,45,38,2,4,1,4
E33022748,258,213,80,133,7,14,5,9,16,16,0,0,0,8
E33022749,423,342,108,234,2,17,11,6,57,49,0,6,2,5
E33022750,678,520,153,367,10,44,29,15,101,93,4,3,1,3
E33022751,364,289,85,204,1,24,18,6,44,42,0,1,1,6
E33022752,229,186,71,115,3,18,12,6,21,20,0,1,0,1
E33022753,380,310,108,202,3,18,13,5,48,44,0,4,0,1
E33022754,324,262,85,177,0,35,32,3,27,24,0,3,0,0
E33022755,233,163,50,113,3,27,24,3,36,35,1,0,0,4
E33022756,376,288,128,160,4,25,13,12,52,45,2,5,0,7
E33022757,224,170,56,114,1,13,7,6,37,35,0,2,0,3
E33022758,235,186,65,121,2,12,9,3,25,24,1,0,0,10
E33022759,259,209,89,120,1,16,8,8,29,28,0,0,1,4
E33022760,268,219,85,134,1,12,11,1,30,24,1,5,0,6
E33022761,540,389,153,236,10,38,28,10,96,89,3,4,0,7
E33022762,398,324,112,212,5,31,13,18,36,33,2,1,0,2
E33022763,599,486,130,356,2,20,11,9,86,83,1,1,1,5
E33022764,639,437,111,326,5,50,19,31,144,105,25,7,7,3
E33022765,464,345,112,233,5,28,10,18,83,77,2,4,0,3
E33022766,349,269,87,182,2,37,21,16,37,30,0,5,2,4
E33022767,332,233,72,161,1,49,34,15,48,43,0,5,0,1
E33022768,285,237,92,145,4,12,9,3,28,24,1,1,2,4
E33022769,471,342,110,232,3,49,25,24,72,66,0,3,3,5
E33022770,391,304,118,186,2,23,15,8,60,58,1,1,0,2
E33022771,273,189,80,109,10,19,12,7,44,36,3,3,2,11
E33022772,256,188,71,117,1,23,8,15,35,25,4,3,3,9
E33022773,449,294,108,186,1,107,90,17,42,39,0,3,0,5
E33022774,308,193,60,133,0,75,61,14,38,36,0,2,0,2
E33022775,297,222,73,149,2,32,20,12,37,31,1,5,0,4
E33022776,257,212,69,143,2,18,13,5,20,19,0,1,0,5
E33022777,624,431,126,305,9,44,25,19,137,130,1,5,1,3
E33022778,410,307,76,231,4,18,14,4,77,73,0,2,2,4
E33022779,284,171,52,119,5,41,28,13,66,59,3,2,2,1
E33022780,268,191,65,126,1,30,18,12,42,38,0,4,0,4
E33022781,499,359,105,254,5,37,23,14,95,83,2,10,0,3
E33022782,252,209,82,127,0,21,13,8,18,17,0,1,0,4
E33022783,327,209,58,151,2,27,14,13,86,76,3,7,0,3
E33022784,251,192,70,122,1,18,9,9,37,34,2,1,0,3
E33022785,263,175,61,114,2,48,41,7,38,33,0,4,1,0
E33022786,448,375,102,273,0,25,14,11,44,41,0,3,0,4
E33022787,269,214,85,129,1,17,7,10,35,34,0,1,0,2
E33022788,652,485,155,330,6,98,63,35,57,53,0,3,1,6
E33022789,266,208,54,154,1,17,12,5,37,32,0,5,0,3
E33022790,400,264,84,180,3,74,50,24,56,52,0,2,2,3
E33022791,474,328,80,248,2,51,27,24,90,83,4,1,2,3
E33022792,261,169,49,120,4,22,9,13,65,60,1,4,0,1
E33022793,293,219,50,169,3,25,13,12,43,41,0,2,0,3
E33022794,264,200,73,127,3,26,17,9,34,34,0,0,0,1
E33022795,283,212,66,146,0,24,12,12,43,39,0,4,0,4
E33022796,342,275,97,178,3,16,10,6,46,44,0,2,0,2
E33022797,391,273,82,191,5,42,23,19,69,63,0,6,0,2
E33022798,1138,689,192,497,20,118,69,49,309,295,2,9,3,2
E33022799,342,253,78,175,2,23,11,12,64,60,0,3,1,0
E33022800,471,270,90,180,8,102,54,48,88,81,0,2,5,3
E33022801,323,186,57,129,4,42,24,18,86,80,2,3,1,5
E33022802,392,275,94,181,3,46,18,28,67,63,0,4,0,1
E33022803,243,164,59,105,4,26,17,9,49,48,0,1,0,0
E33022804,317,211,67,144,2,41,28,13,61,51,1,5,4,2
E33022805,484,330,97,233,5,89,72,17,59,53,1,5,0,1
E33022806,536,403,103,300,4,46,28,18,82,73,2,6,1,1
E33022807,444,311,107,204,6,48,26,22,75,69,1,2,3,4
E33022808,858,619,168,451,13,83,53,30,139,124,1,11,3,4
E33022809,305,218,49,169,19,15,9,6,49,48,0,1,0,4
E33022810,264,177,57,120,3,45,39,6,37,33,0,3,1,2
E33022811,508,338,99,239,1,63,46,17,103,87,9,7,0,3
E33022812,2399,1806,513,1293,30,186,103,83,367,335,12,17,3,10
E33022813,320,223,64,159,6,28,10,18,59,53,1,3,2,4
E33022814,484,362,131,231,1,25,15,10,93,80,2,11,0,3
E33022815,458,357,129,228,4,42,23,19,52,44,5,3,0,3
E33022816,335,269,68,201,2,9,6,3,54,53,0,1,0,1
E33022817,312,212,58,154,2,49,22,27,43,40,1,2,0,6
E33022818,612,458,154,304,4,51,36,15,91,83,3,4,1,8
E33022819,503,397,124,273,2,51,17,34,52,46,1,5,0,1
E33022820,416,313,101,212,4,38,22,16,59,54,0,4,1,2
E33022821,402,305,90,215,7,42,26,16,42,37,3,2,0,6
E33022822,312,196,63,133,0,45,38,7,70,64,0,4,2,1
E33022823,410,282,97,185,4,49,36,13,73,64,1,7,1,2
E33022824,347,204,54,150,4,50,33,17,84,81,0,3,0,5
E33022825,596,416,131,285,4,85,54,31,88,87,0,1,0,3
E33022826,547,352,113,239,3,69,39,30,119,114,1,4,0,4
E33022827,394,312,112,200,6,20,10,10,54,51,1,0,2,2
E33022828,270,225,54,171,1,17,13,4,21,16,0,5,0,6
E33022829,282,218,65,153,3,20,3,17,38,37,0,1,0,3
E33022830,247,178,61,117,1,12,5,7,49,41,1,5,2,7
E33022831,562,430,119,311,3,44,28,16,77,66,9,2,0,8
E33022832,286,212,84,128,3,23,11,12,46,34,4,6,2,2
E33022833,411,330,93,237,5,23,10,13,49,46,0,3,0,4
E33022834,316,243,72,171,2,35,14,21,33,29,1,3,0,3
E33022835,356,278,87,191,3,31,21,10,42,39,2,1,0,2
E33022836,267,202,48,154,1,18,11,7,41,39,0,2,0,5
E33022837,394,325,117,208,1,16,9,7,49,46,1,2,0,3
E33022838,437,318,95,223,3,38,24,14,72,62,2,7,1,6
E33022839,482,423,137,286,1,16,8,8,41,37,3,0,1,1
E33022840,713,629,189,440,3,16,7,9,61,57,2,2,0,4
E33022841,319,251,85,166,1,32,15,17,31,27,1,1,2,4
E33022842,359,270,94,176,3,25,15,10,51,48,1,1,1,10
E33022843,301,223,91,132,3,28,10,18,38,28,2,5,3,9
E33022844,303,250,83,167,4,13,10,3,35,27,0,8,0,1
E33022845,419,335,127,208,4,27,10,17,46,39,3,4,0,7
E33022846,396,300,111,189,4,24,12,12,60,51,1,4,4,8
E33022847,273,216,68,148,3,19,12,7,32,30,2,0,0,3
E33022848,443,317,110,207,3,57,50,7,60,50,6,3,1,6
E33022849,478,361,101,260,5,50,32,18,52,47,3,2,0,10
E33022850,357,288,106,182,4,28,13,15,34,30,0,4,0,3
E33022851,489,374,110,264,3,62,39,23,49,44,1,4,0,1
E33022852,302,239,76,163,3,21,14,7,33,29,1,3,0,6
E33022853,533,455,164,291,6,26,23,3,40,35,0,5,0,6
E33022854,570,470,122,348,3,35,12,23,59,54,1,4,0,3
E33022855,281,232,86,146,0,20,8,12,25,21,0,4,0,4
E33022856,398,322,107,215,2,30,18,12,37,29,1,7,0,7
E33022857,455,318,91,227,2,65,41,24,68,63,2,3,0,2
E33022858,342,274,92,182,2,31,24,7,32,28,0,3,1,3
E33022859,541,425,115,310,4,46,27,19,61,54,5,2,0,5
E33022860,356,313,82,231,2,13,12,1,27,25,2,0,0,1
E33022861,381,299,103,196,2,23,11,12,51,48,2,1,0,6
E33022862,250,217,73,144,0,17,12,5,14,12,0,2,0,2
E33022863,277,227,76,151,1,11,6,5,35,32,0,2,1,3
E33022864,430,339,93,246,2,28,25,3,55,54,0,1,0,6
E33022865,261,200,62,138,1,30,5,25,30,28,1,1,0,0
E33022866,329,234,70,164,8,40,16,24,42,38,0,4,0,5
E33022867,631,499,170,329,4,60,22,38,61,54,0,6,1,7
E33022868,303,284,83,201,2,5,2,3,12,11,0,1,0,0
E33022869,279,237,72,165,2,19,6,13,21,17,2,2,0,0
E33022870,299,265,90,175,1,10,3,7,19,19,0,0,0,4
E33022871,342,273,87,186,1,27,12,15,37,35,1,1,0,4
E33022872,450,366,104,262,4,37,12,25,41,35,2,4,0,2
E33022873,463,366,114,252,1,35,16,19,59,56,0,2,1,2
E33022874,456,308,83,225,1,60,33,27,80,78,1,1,0,7
E33022875,504,406,122,284,3,43,28,15,48,45,0,3,0,4
E33022876,288,240,68,172,4,21,14,7,22,20,0,1,1,1
E33022877,269,208,80,128,1,16,11,5,39,36,0,3,0,5
E33022878,356,236,67,169,5,59,16,43,56,51,1,4,0,0
E33022879,235,170,47,123,1,30,14,16,32,28,2,2,0,2
E33022880,845,698,208,490,2,61,17,44,76,70,2,3,1,8
E33022881,354,275,85,190,1,22,12,10,54,41,2,11,0,2
E33022882,369,280,74,206,3,26,12,14,58,55,1,2,0,2
E33022883,541,440,123,317,5,38,16,22,55,48,3,4,0,3
E33022884,372,299,106,193,1,32,8,24,38,31,0,7,0,2
E33022885,649,474,154,320,11,74,33,41,84,77,0,5,2,6
E33022886,679,581,210,371,0,32,16,16,64,58,0,6,0,2
E33022887,263,221,50,171,2,19,6,13,20,16,0,4,0,1
E33022888,305,269,54,215,2,9,3,6,25,23,0,2,0,0
E33022889,324,253,58,195,7,27,9,18,36,33,0,3,0,1
E33022890,643,467,132,335,7,117,39,78,48,42,2,3,1,4
E33022891,951,742,215,527,12,102,40,62,89,80,1,8,0,6
E33022892,368,286,110,176,0,21,10,11,58,56,0,2,0,3
E33022893,422,359,114,245,2,18,5,13,37,31,2,3,1,6
E33022894,367,280,83,197,9,27,10,17,51,45,1,4,1,0
E33022895,326,245,139,106,1,17,3,14,56,49,1,4,2,7
E33022896,259,194,89,105,1,18,3,15,36,35,1,0,0,10
E33022897,337,262,91,171,2,29,10,19,39,34,1,4,0,5
E33022898,258,185,77,108,6,16,2,14,49,41,2,5,1,2
E33022899,483,343,144,199,1,38,4,34,94,84,1,7,2,7
E33022900,299,235,117,118,1,21,0,21,33,33,0,0,0,9
E33022901,239,140,46,94,2,35,1,34,56,50,1,2,3,6
E33022902,479,335,142,193,3,65,3,62,66,54,3,8,1,10
E33022903,318,240,104,136,2,29,6,23,43,38,2,1,2,4
E33022904,301,250,114,136,0,7,5,2,39,36,0,2,1,5
E33022905,395,308,117,191,2,16,3,13,48,40,0,6,2,21
E33022906,315,237,75,162,2,20,3,17,50,45,3,2,0,6
E33022907,385,304,112,192,8,19,7,12,49,31,7,9,2,5
E33022908,230,169,77,92,1,29,11,18,28,28,0,0,0,3
E33022909,379,304,124,180,1,33,13,20,36,31,1,4,0,5
E33022910,311,245,99,146,2,21,4,17,37,34,1,2,0,6
E33022911,420,314,133,181,1,41,10,31,55,53,0,2,0,9
E33022912,292,243,78,165,0,10,1,9,35,30,0,5,0,4
E33022913,260,208,85,123,4,16,2,14,24,21,0,3,0,8
E33022914,273,206,84,122,5,15,1,14,43,35,1,6,1,4
E33022915,303,236,90,146,3,18,5,13,43,38,2,3,0,3
E33022916,268,198,68,130,0,25,5,20,40,35,0,3,2,5
E33022917,268,221,74,147,5,12,2,10,29,25,0,2,2,1
E33022918,315,219,73,146,3,27,5,22,59,50,0,9,0,7
E33022919,290,191,88,103,12,54,5,49,30,30,0,0,0,3
E33022920,418,299,89,210,5,51,8,43,61,48,0,5,8,2
E33022921,650,438,133,305,8,85,13,72,113,105,1,4,3,6
E33022922,479,359,121,238,7,55,12,43,53,50,1,2,0,5
E33022923,429,330,120,210,3,16,4,12,68,56,3,7,2,12
E33022924,618,461,162,299,6,55,10,45,90,80,5,3,2,6
E33022925,572,362,139,223,8,42,9,33,143,129,2,7,5,17
E33022926,433,309,105,204,2,27,6,21,93,82,6,5,0,2
E33022927,293,224,66,158,0,23,5,18,44,42,0,2,0,2
E33022928,277,219,87,132,4,26,4,22,27,23,1,3,0,1
E33022929,240,167,64,103,1,21,4,17,48,43,0,4,1,3
E33022930,302,237,85,152,1,34,8,26,28,27,0,1,0,2
E33022931,247,194,67,127,3,11,4,7,38,33,0,5,0,1
E33022932,352,264,81,183,7,45,11,34,35,28,3,3,1,1
E33022933,891,628,217,411,13,160,27,133,86,73,1,9,3,4
E33022934,291,245,90,155,4,20,1,19,17,15,2,0,0,5
E33022935,756,488,153,335,12,75,13,62,172,158,4,7,3,9
E33022936,444,328,107,221,1,35,6,29,76,74,1,1,0,4
E33022937,309,223,80,143,3,22,3,19,52,46,1,5,0,9
E33022938,525,386,160,226,9,67,4,63,59,54,0,5,0,4
E33022939,334,212,66,146,11,66,11,55,42,40,1,1,0,3
E33022940,361,283,86,197,3,25,3,22,48,46,0,1,1,2
E33022941,1636,1325,356,969,11,65,9,56,232,221,2,8,1,3
E33022942,476,331,133,198,3,37,6,31,80,61,11,8,0,25
E33022943,585,425,143,282,6,55,11,44,92,81,4,6,1,7
E33022944,637,478,143,335,12,52,8,44,93,83,2,8,0,2
E33022945,368,288,97,191,0,11,2,9,64,58,1,1,4,5
E33022946,630,436,143,293,6,73,16,57,106,101,0,5,0,9
E33022947,277,172,64,108,3,33,4,29,68,62,0,6,0,1
E33022948,305,237,99,138,5,17,2,15,37,31,0,6,0,9
E33022949,563,386,154,232,3,48,5,43,111,100,6,5,0,15
E33022950,300,227,105,122,2,28,6,22,37,33,0,4,0,6
E33022951,244,169,50,119,4,43,9,34,28,24,3,1,0,0
E33022952,339,246,80,166,5,13,2,11,55,50,1,4,0,20
E33022953,241,184,74,110,2,17,1,16,35,28,3,4,0,3
E33022954,240,181,76,105,2,19,7,12,34,31,2,1,0,4
E33022955,292,230,103,127,2,16,5,11,38,35,1,2,0,6
E33022956,299,265,75,190,2,15,9,6,16,15,0,1,0,1
E33022957,387,334,119,215,1,21,11,10,22,19,0,3,0,9
E33022958,356,264,76,188,1,43,26,17,46,41,0,5,0,2
E33022959,1281,990,279,711,4,154,106,48,130,117,3,9,1,3
E33022960,327,249,56,193,1,39,29,10,37,31,1,4,1,1
E33022961,452,289,74,215,6,94,75,19,60,56,0,4,0,3
E33022962,370,226,47,179,0,89,72,17,51,48,0,2,1,4
E33022963,495,354,82,272,1,99,81,18,37,32,0,5,0,4
E33022964,328,234,43,191,0,53,36,17,40,37,0,2,1,1
E33022965,240,166,34,132,1,36,28,8,37,35,0,2,0,0
E33022966,400,315,69,246,0,36,25,11,46,43,0,3,0,3
E33022967,376,242,67,175,4,58,40,18,69,63,2,4,0,3
E33022968,272,190,49,141,2,20,16,4,54,47,1,3,3,6
E33022969,420,321,92,229,2,30,24,6,64,59,0,4,1,3
E33022970,573,383,116,267,5,91,67,24,84,75,0,9,0,10
E33022971,677,469,121,348,7,105,68,37,92,86,0,6,0,4
E33022972,384,265,83,182,1,62,50,12,53,49,1,3,0,3
E33022973,326,237,67,170,0,57,48,9,30,22,2,5,1,2
E33022974,1477,972,271,701,9,231,175,56,260,236,6,17,1,5
E33022975,287,231,53,178,2,25,19,6,26,22,1,3,0,3
E33022976,648,451,113,338,0,96,60,36,98,92,0,6,0,3
E33022977,306,211,64,147,2,47,35,12,41,36,4,1,0,5
E33022978,316,216,54,162,1,45,24,21,51,43,1,6,1,3
E33022979,468,381,92,289,3,40,28,12,43,38,0,5,0,1
E33022980,1170,920,209,711,4,60,37,23,177,165,2,9,1,9
E33022981,308,226,59,167,2,38,25,13,39,35,0,3,1,3
E33022982,540,433,110,323,7,56,34,22,43,38,0,3,2,1
E33022983,330,279,74,205,0,15,9,6,35,35,0,0,0,1
E33022984,237,191,52,139,4,16,11,5,25,23,0,2,0,1
E33022985,336,278,95,183,0,23,13,10,33,29,0,4,0,2
E33022986,421,314,103,211,2,56,41,15,49,41,1,3,4,0
E33022987,962,747,176,571,9,79,40,39,126,108,0,18,0,1
E33022988,2336,1789,414,1375,19,232,148,84,291,265,2,23,1,5
E33022989,913,655,194,461,3,126,90,36,128,115,2,10,1,1
E33022990,292,239,68,171,3,16,14,2,33,30,0,3,0,1
E33022991,310,216,61,155,2,48,34,14,44,39,2,3,0,0
E33022992,524,356,94,262,2,98,80,18,67,61,2,4,0,1
E33022993,677,542,135,407,3,40,22,18,86,78,2,5,1,6
E33022994,947,684,183,501,6,140,94,46,114,106,0,8,0,3
E33022995,416,354,82,272,3,28,11,17,31,27,0,4,0,0
E33022996,323,273,65,208,0,15,7,8,31,27,0,4,0,4
E33022997,360,288,72,216,0,29,17,12,42,39,0,3,0,1
E33022998,223,183,56,127,1,12,9,3,23,21,0,2,0,4
E33022999,378,334,98,236,2,17,11,6,24,23,0,0,1,1
E33023000,266,227,76,151,2,15,10,5,20,16,2,2,0,2
E33023001,437,319,101,218,0,48,32,16,70,61,1,4,4,0
E33023002,268,234,65,169,1,10,7,3,22,22,0,0,0,1
E33023003,251,196,74,122,0,12,6,6,41,32,1,6,2,2
E33023004,353,277,102,175,1,27,13,14,46,42,2,1,1,2
E33023005,348,258,72,186,1,38,14,24,49,44,0,5,0,2
E33023006,468,355,127,228,4,36,10,26,70,62,1,7,0,3
E33023007,335,269,81,188,6,20,8,12,37,33,1,2,1,3
E33023008,446,358,126,232,3,22,9,13,61,54,0,5,2,2
E33023009,679,410,87,323,6,188,79,109,70,60,1,5,4,5
E33023010,1160,786,215,571,17,128,44,84,224,204,2,18,0,5
E33023011,1651,1194,316,878,27,155,65,90,262,244,3,13,2,13
E33023012,314,274,42,232,0,6,3,3,33,30,0,3,0,1
E33023013,830,659,141,518,10,21,10,11,134,125,1,8,0,6
E33023014,2275,1687,410,1277,25,217,99,118,337,316,1,18,2,9
E33023015,1269,838,212,626,17,187,57,130,215,199,1,12,3,12
E33023016,480,365,102,263,2,29,15,14,80,73,0,6,1,4
E33023017,297,238,66,172,2,9,4,5,44,42,2,0,0,4
E33023018,403,315,67,248,4,38,14,24,46,41,1,4,0,0
E33023019,624,471,163,308,6,62,23,39,82,73,0,7,2,3
E33023020,384,225,47,178,5,82,42,40,72,67,0,4,1,0
E33023021,347,232,51,181,1,61,34,27,47,38,1,8,0,6
E33023022,698,477,139,338,24,131,56,75,64,62,0,1,1,2
E33023023,364,255,84,171,3,18,4,14,84,77,1,6,0,4
E33023024,819,578,182,396,9,67,25,42,159,150,1,6,2,6
E33023025,403,277,77,200,4,23,5,18,96,91,3,2,0,3
E33023026,454,359,113,246,1,20,8,12,71,68,0,3,0,3
E33023027,426,308,91,217,5,27,10,17,84,73,0,9,2,2
E33023028,317,249,81,168,1,19,3,16,44,41,1,2,0,4
E33023029,506,351,94,257,1,37,8,29,103,97,0,6,0,14
E33023030,588,442,118,324,2,60,23,37,82,76,2,4,0,2
E33023031,411,316,58,258,1,28,7,21,61,58,0,3,0,5
E33023032,298,232,48,184,2,13,0,13,50,44,1,5,0,1
E33023033,380,254,63,191,4,78,36,42,41,33,2,5,1,3
E33023034,521,398,141,257,4,44,21,23,72,65,0,5,2,3
E33023035,463,292,111,181,7,50,11,39,110,94,4,7,5,4
E33023036,424,321,101,220,2,33,10,23,68,63,0,3,2,0
E33023037,527,365,96,269,6,80,38,42,74,67,3,3,1,2
E33023038,275,204,58,146,2,42,28,14,25,21,0,2,2,2
E33023039,523,411,130,281,7,48,17,31,55,54,0,1,0,2
E33023040,637,477,130,347,9,52,15,37,96,87,0,6,3,3
E33023041,359,216,72,144,4,44,5,39,92,81,0,11,0,3
E33023042,616,424,125,299,9,49,14,35,129,123,2,4,0,5
E33023043,370,273,75,198,5,18,6,12,72,65,0,7,0,2
E33023044,255,185,56,129,3,19,7,12,47,42,0,5,0,1
E33023045,837,567,200,367,10,79,24,55,179,166,3,8,2,2
E33023046,515,328,89,239,11,41,11,30,133,125,1,7,0,2
E33023047,403,313,103,210,0,24,5,19,60,56,0,4,0,6
E33023048,239,214,79,135,2,4,2,2,16,13,1,2,0,3
E33023049,251,188,63,125,2,27,12,15,32,24,1,3,4,2
E33023050,578,424,133,291,3,47,15,32,100,89,0,8,3,4
E33023051,308,232,61,171,2,24,16,8,49,43,1,5,0,1
E33023052,394,299,94,205,0,32,5,27,61,54,0,7,0,2
E33023053,628,477,159,318,3,50,17,33,97,86,4,6,1,1
E33023054,619,455,125,330,9,37,15,22,116,105,4,5,2,2
E33023055,270,207,67,140,6,13,3,10,41,36,0,5,0,3
E33023056,729,602,172,430,6,21,6,15,98,81,0,17,0,2
E33023057,722,585,178,407,1,42,11,31,88,76,4,7,1,6
E33023058,296,197,46,151,12,17,2,15,68,64,0,4,0,2
E33023059,343,279,83,196,3,16,3,13,40,38,0,2,0,5
E33023060,669,522,145,377,3,35,12,23,105,93,0,11,1,4
E33023061,324,260,90,170,1,22,8,14,40,31,0,6,3,1
E33023062,886,598,156,442,18,104,33,71,152,145,0,6,1,14
E33023063,247,187,63,124,1,13,5,8,43,35,5,2,1,3
E33023064,349,282,102,180,3,14,9,5,38,30,2,3,3,12
E33023065,340,218,57,161,1,51,13,38,66,57,1,3,5,4
E33023066,419,299,97,202,1,58,8,50,54,47,0,6,1,7
E33023067,591,480,148,332,6,39,16,23,62,53,3,6,0,4
E33023068,2167,1488,406,1082,9,245,108,137,409,384,3,20,2,16
E33023069,305,191,49,142,2,73,12,61,35,27,2,6,0,4
E33023070,485,399,102,297,0,40,6,34,43,40,0,3,0,3
E33023071,307,242,92,150,0,22,2,20,39,34,0,3,2,4
E33023072,606,417,125,292,2,79,16,63,101,90,4,5,2,7
E33023073,393,288,87,201,2,66,13,53,35,31,3,1,0,2
E33023074,272,207,79,128,1,31,4,27,30,25,2,2,1,3
E33023075,423,315,87,228,1,62,8,54,36,31,1,3,1,9
E33023076,359,272,95,177,2,43,6,37,42,39,0,3,0,0
E33023077,417,295,92,203,2,51,12,39,60,48,1,6,5,9
E33023078,366,308,113,195,3,29,6,23,23,19,0,1,3,3
E33023079,398,352,93,259,0,18,2,16,24,19,0,3,2,4
E33023080,293,243,71,172,0,21,9,12,28,27,0,1,0,1
E33023081,331,273,125,148,1,18,5,13,37,32,1,3,1,2
E33023082,371,282,98,184,3,30,6,24,50,45,1,2,2,6
E33023083,277,244,73,171,3,10,2,8,18,17,0,1,0,2
E33023084,416,307,100,207,3,39,11,28,58,53,1,4,0,9
E33023085,254,209,106,103,0,9,4,5,34,29,2,3,0,2
E33023086,333,240,98,142,0,32,5,27,50,42,1,6,1,11
E33023087,340,219,72,147,3,32,6,26,71,60,5,3,3,15
E33023088,234,188,81,107,1,10,1,9,32,26,2,1,3,3
E33023089,267,226,100,126,2,11,2,9,24,21,0,1,2,4
E33023090,231,186,77,109,2,18,3,15,24,23,0,0,1,1
E33023091,239,192,70,122,4,9,0,9,31,26,2,3,0,3
E33023092,228,172,65,107,2,24,8,16,28,24,0,4,0,2
E33023093,365,309,116,193,0,21,5,16,34,25,3,4,2,1
E33023094,354,272,120,152,3,18,3,15,53,41,11,1,0,8
E33023095,343,282,100,182,3,22,5,17,34,30,2,2,0,2
E33023096,362,307,88,219,3,15,3,12,34,32,0,2,0,3
E33023097,424,310,98,212,4,43,7,36,65,59,0,3,3,2
E33023098,647,523,178,345,1,45,10,35,70,62,1,5,2,8
E33023099,345,264,81,183,1,21,3,18,53,40,1,4,8,6
E33023100,435,311,112,199,2,36,8,28,69,63,2,4,0,17
E33023101,328,242,96,146,1,28,5,23,49,27,17,4,1,8
E33023102,308,233,91,142,1,26,6,20,45,37,0,7,1,3
E33023103,323,254,87,167,0,23,2,21,43,39,3,1,0,3
E33023104,384,287,88,199,3,44,9,35,42,36,0,3,3,8
E33023105,264,209,61,148,2,15,2,13,35,32,0,1,2,3
E33023106,1261,523,162,361,13,118,31,87,594,574,8,8,4,13
E33023107,263,223,68,155,2,14,4,10,22,18,2,0,2,2
E33023108,931,701,140,561,5,80,13,67,140,128,1,9,2,5
E33023109,379,264,79,185,5,38,6,32,62,54,3,4,1,10
E33023110,259,165,45,120,3,38,7,31,51,47,1,3,0,2
E33023111,433,293,90,203,1,60,7,53,75,70,0,4,1,4
E33023112,418,328,135,193,5,28,1,27,52,46,3,3,0,5
E33023113,674,545,151,394,4,58,6,52,61,55,0,5,1,6
E33023114,367,291,113,178,1,33,2,31,40,30,4,6,0,2
E33023115,270,211,74,137,2,16,4,12,39,33,0,6,0,2
E33023116,469,335,119,216,2,65,4,61,65,56,2,3,4,2
E33023117,287,222,80,142,2,21,1,20,40,28,5,5,2,2
E33023118,310,224,99,125,2,26,3,23,52,49,0,3,0,6
E33023119,311,223,77,146,3,40,7,33,41,37,1,3,0,4
E33023120,652,403,122,281,10,65,16,49,172,141,23,7,1,2
E33023121,251,192,70,122,0,19,1,18,36,29,0,7,0,4
E33023122,590,423,112,311,6,57,4,53,101,89,6,4,2,3
E33023123,362,233,54,179,2,51,6,45,74,68,1,5,0,2
E33023124,343,251,79,172,3,30,7,23,50,47,2,1,0,9
E33023125,252,155,64,91,1,42,6,36,51,48,1,2,0,3
E33023126,323,196,66,130,2,67,8,59,56,51,1,3,1,2
E33023127,381,238,70,168,2,66,10,56,67,60,2,4,1,8
E33023128,318,233,98,135,2,49,3,46,31,28,0,3,0,3
E33023129,529,409,123,286,3,47,5,42,62,56,3,3,0,8
E33023130,493,351,93,258,6,44,5,39,90,85,0,3,2,2
E33023131,320,235,75,160,3,29,6,23,51,50,0,1,0,2
E33023132,254,187,72,115,5,19,4,15,41,38,1,2,0,2
E33023133,327,243,66,177,1,38,3,35,43,40,0,3,0,2
E33023134,322,244,89,155,1,34,6,28,40,33,0,7,0,3
E33023135,606,408,105,303,6,104,13,91,83,77,3,3,0,5
E33023136,487,390,121,269,0,43,8,35,51,48,0,3,0,3
E33023137,521,405,115,290,5,60,6,54,48,39,6,3,0,3
E33023138,522,386,101,285,0,59,7,52,73,67,0,6,0,4
E33023139,422,300,98,202,1,68,9,59,50,48,0,2,0,3
E33023140,636,422,141,281,3,57,5,52,145,117,15,9,4,9
E33023141,391,282,107,175,4,49,10,39,48,45,1,1,1,8
E33023142,266,200,80,120,0,21,2,19,40,37,1,1,1,5
E33023143,279,204,73,131,4,33,2,31,30,21,2,1,6,8
E33023144,317,233,78,155,2,27,5,22,48,39,4,5,0,7
E33023145,552,412,148,264,6,48,15,33,77,73,1,3,0,9
E33023146,553,462,145,317,3,14,2,12,70,67,0,3,0,4
E33023147,255,131,51,80,0,4,1,3,98,80,10,1,7,22
E33023148,372,283,105,178,0,37,9,28,47,43,1,3,0,5
E33023149,244,185,77,108,1,17,5,12,38,34,1,1,2,3
E33023150,349,264,87,177,2,29,5,24,52,46,0,6,0,2
E33023151,404,310,121,189,1,17,2,15,67,49,15,1,2,9
E33023152,298,239,104,135,2,15,2,13,40,33,4,2,1,2
E33023153,525,409,137,272,5,58,43,15,49,41,1,6,1,4
E33023154,406,314,116,198,1,21,9,12,66,58,0,7,1,4
E33023155,324,239,76,163,0,37,22,15,38,30,2,4,2,10
E33023156,293,251,91,160,2,9,2,7,28,25,2,1,0,3
E33023157,412,300,116,184,3,37,10,27,62,55,2,2,3,10
E33023158,522,376,119,257,3,48,17,31,88,79,0,6,3,7
E33023159,536,441,145,296,5,27,12,15,60,47,0,10,3,3
E33023160,503,410,131,279,4,39,25,14,47,41,0,6,0,3
E33023161,310,266,81,185,3,8,6,2,31,24,0,5,2,2
E33023162,266,211,67,144,0,16,6,10,36,33,0,3,0,3
E33023163,455,382,122,260,2,17,11,6,48,40,2,6,0,6
E33023164,543,417,128,289,1,26,15,11,90,79,3,8,0,9
E33023165,333,291,90,201,0,6,1,5,35,32,2,0,1,1
E33023166,375,246,94,152,1,37,21,16,87,82,1,4,0,4
E33023167,310,231,75,156,2,22,12,10,52,46,1,5,0,3
E33023168,308,210,42,168,1,44,32,12,49,46,0,3,0,4
E33023169,353,234,66,168,1,53,20,33,61,56,0,3,2,4
E33023170,410,315,94,221,0,34,16,18,56,51,0,5,0,5
E33023171,444,338,163,175,1,34,10,24,52,48,0,3,1,19
E33023172,480,387,120,267,1,18,9,9,64,60,0,4,0,10
E33023173,453,376,134,242,1,28,13,15,45,40,1,4,0,3
E33023174,470,399,101,298,6,30,16,14,33,31,0,2,0,2
E33023175,271,215,65,150,4,20,8,12,31,27,0,4,0,1
E33023176,455,360,100,260,3,50,30,20,40,37,1,2,0,2
E33023177,415,326,102,224,1,31,17,14,57,51,1,4,1,0
E33023178,461,317,92,225,2,49,26,23,88,76,3,9,0,5
E33023179,360,265,94,171,5,55,26,29,34,32,0,1,1,1
E33023180,717,586,199,387,9,32,15,17,84,69,4,9,2,6
E33023181,345,259,82,177,1,19,7,12,63,59,0,4,0,3
E33023182,262,219,87,132,1,18,7,11,21,19,0,2,0,3
E33023183,345,242,78,164,1,36,20,16,61,56,0,5,0,5
E33023184,298,187,61,126,1,45,21,24,65,61,0,4,0,0
E33023185,961,799,245,554,6,51,33,18,103,98,0,3,2,2
E33023186,553,384,117,267,2,91,52,39,73,66,1,6,0,3
E33023187,788,526,139,387,5,90,55,35,162,150,2,7,3,5
E33023188,495,383,117,266,13,44,20,24,53,50,0,3,0,2
E33023189,331,294,98,196,1,14,7,7,22,20,0,2,0,0
E33023190,302,211,60,151,1,46,12,34,41,38,0,3,0,3
E33023191,301,240,114,126,2,14,4,10,41,33,1,7,0,4
E33023192,388,315,127,188,1,24,5,19,44,43,0,1,0,4
E33023193,585,435,161,274,3,34,15,19,110,96,0,12,2,3
E33023194,605,496,196,300,3,32,18,14,70,61,2,5,2,4
E33023195,355,257,98,159,1,38,15,23,49,43,1,4,1,10
E33023196,557,472,156,316,5,36,17,19,41,38,0,3,0,3
E33023197,796,614,195,419,2,71,38,33,101,94,1,6,0,8
E33023198,304,246,79,167,1,27,8,19,29,25,1,3,0,1
E33023199,328,278,99,179,1,11,5,6,38,35,0,3,0,0
E33023200,207,159,44,115,1,8,3,5,34,31,1,1,1,5
E33023201,287,223,55,168,2,13,5,8,47,40,0,4,3,2
E33023202,218,174,86,88,0,22,10,12,21,18,1,2,0,1
E33023203,407,314,107,207,3,29,19,10,59,52,0,7,0,2
E33023204,311,262,85,177,4,17,5,12,28,26,0,2,0,0
E33023205,319,239,86,153,3,46,28,18,27,22,0,5,0,4
E33023206,382,327,113,214,3,15,7,8,32,27,1,0,4,5
E33023207,334,232,68,164,3,34,12,22,63,55,0,7,1,2
E33023208,589,411,145,266,4,63,22,41,106,91,2,12,1,5
E33023209,594,407,103,304,1,108,72,36,77,74,0,3,0,1
E33023210,501,379,120,259,0,58,42,16,62,54,0,7,1,2
E33023211,211,170,55,115,0,9,7,2,30,28,0,1,1,2
E33023212,581,453,103,350,4,49,27,22,69,60,1,8,0,6
E33023213,648,525,158,367,3,27,21,6,86,82,0,3,1,7
E33023214,494,416,112,304,1,10,10,0,64,58,2,3,1,3
E33023215,295,246,79,167,0,17,11,6,29,27,0,1,1,3
E33023216,304,256,67,189,1,9,6,3,37,31,0,6,0,1
E33023217,353,277,81,196,0,23,17,6,48,42,0,4,2,5
E33023218,290,247,87,160,1,13,3,10,24,24,0,0,0,5
E33023219,683,501,158,343,3,60,44,16,116,101,0,13,2,3
E33023220,266,197,84,113,1,23,9,14,39,38,1,0,0,6
E33023221,305,248,78,170,0,13,8,5,40,40,0,0,0,4
E33023222,351,269,72,197,2,24,12,12,52,51,0,1,0,4
E33023223,332,256,73,183,2,47,37,10,27,26,0,1,0,0
E33023224,414,306,128,178,2,48,45,3,53,47,2,3,1,5
E33023225,315,230,85,145,0,43,39,4,40,36,0,3,1,2
E33023226,509,395,132,263,1,61,56,5,43,38,1,4,0,9
E33023227,256,162,47,115,4,47,31,16,40,32,1,1,6,3
E33023228,387,296,112,184,1,27,15,12,56,51,0,3,2,7
E33023229,409,314,107,207,2,41,32,9,48,44,1,1,2,4
E33023230,334,215,72,143,2,64,38,26,51,48,1,2,0,2
E33023231,339,214,81,133,4,64,54,10,52,46,0,5,1,5
E33023232,581,442,168,274,2,67,52,15,60,58,0,1,1,10
E33023233,414,307,114,193,0,62,52,10,45,43,0,2,0,0
E33023234,298,202,65,137,1,39,30,9,53,47,0,1,5,3
E33023235,271,169,81,88,0,18,6,12,73,57,2,5,9,11
E33023236,407,273,81,192,0,33,20,13,101,95,0,4,2,0
E33023237,823,476,131,345,4,74,51,23,254,231,4,6,13,15
E33023238,627,411,89,322,6,37,21,16,172,163,0,8,1,1
E33023239,636,412,120,292,6,118,90,28,95,87,2,6,0,5
E33023240,487,311,99,212,11,101,25,76,59,53,0,6,0,5
E33023241,342,182,45,137,4,105,34,71,48,43,2,2,1,3
E33023242,871,518,115,403,20,146,55,91,178,167,0,10,1,9
E33023243,318,218,54,164,7,14,13,1,75,67,0,5,3,4
E33023244,263,129,23,106,3,43,19,24,86,80,0,4,2,2
E33023245,319,233,71,162,2,32,22,10,50,50,0,0,0,2
E33023246,726,333,85,248,14,109,76,33,261,249,2,6,4,9
E33023247,227,158,42,116,3,25,17,8,41,38,0,3,0,0
E33023248,349,256,102,154,3,45,31,14,42,37,0,5,0,3
E33023249,492,302,74,228,4,47,22,25,133,127,0,6,0,6
E33023250,364,184,60,124,6,55,25,30,110,105,0,5,0,9
E33023251,306,162,37,125,8,51,21,30,83,80,0,1,2,2
E33023252,416,242,83,159,2,63,39,24,101,99,0,2,0,8
E33023253,459,271,74,197,3,90,28,62,92,86,1,5,0,3
E33023254,452,272,53,219,3,99,63,36,76,74,2,0,0,2
E33023255,477,363,125,238,2,72,57,15,39,38,0,0,1,1
E33023256,1104,815,232,583,7,102,66,36,172,163,1,8,0,8
E33023257,475,317,68,249,4,41,20,21,111,105,1,5,0,2
E33023258,417,278,87,191,5,35,19,16,98,94,1,3,0,1
E33023259,340,219,60,159,3,83,59,24,34,31,1,2,0,1
E33023260,462,298,84,214,13,51,27,24,98,94,1,2,1,2
E33023261,277,133,35,98,0,38,31,7,103,99,0,2,2,3
E33023262,318,189,58,131,4,58,43,15,63,58,0,4,1,4
E33023263,506,355,98,257,1,51,30,21,95,92,0,2,1,4
E33023264,474,323,75,248,9,36,20,16,104,100,0,3,1,2
E33023265,247,175,52,123,2,13,7,6,51,48,1,2,0,6
E33023266,264,187,78,109,2,25,14,11,49,45,0,4,0,1
E33023267,448,280,78,202,5,68,39,29,87,79,0,4,4,8
E33023268,311,193,87,106,2,44,29,15,66,59,0,4,3,6
E33023269,411,282,101,181,2,68,34,34,51,45,2,3,1,8
E33023270,303,195,72,123,4,44,21,23,58,49,0,8,1,2
E33023271,371,285,138,147,2,14,2,12,57,55,0,0,2,13
E33023272,614,408,143,265,2,104,64,40,89,82,1,2,4,11
E33023273,325,236,62,174,2,17,8,9,65,59,0,6,0,5
E33023274,384,268,89,179,3,33,23,10,75,69,0,5,1,5
E33023275,300,221,70,151,1,14,9,5,60,57,1,2,0,4
E33023276,378,256,95,161,4,49,27,22,60,51,0,8,1,9
E33023277,251,193,62,131,0,19,6,13,31,29,0,2,0,8
E33023278,304,210,84,126,4,28,17,11,59,55,0,4,0,3
E33023279,310,222,94,128,1,33,21,12,48,42,0,6,0,6
E33023280,284,188,79,109,3,32,19,13,58,55,0,1,2,3
E33023281,1501,1086,215,871,17,100,37,63,290,268,3,18,1,8
E33023282,485,312,85,227,5,93,28,65,74,64,0,9,1,1
E33023283,472,378,81,297,7,14,4,10,73,68,1,4,0,0
E33023284,420,259,52,207,2,52,19,33,107,96,1,10,0,0
E33023285,470,342,97,245,3,30,12,18,87,82,0,5,0,8
E33023286,555,448,146,302,4,31,9,22,69,64,0,4,1,3
E33023287,671,579,150,429,2,26,8,18,62,54,3,4,1,2
E33023288,246,199,53,146,2,16,6,10,28,27,0,1,0,1
E33023289,384,266,68,198,4,43,22,21,64,57,1,5,1,7
E33023290,515,365,96,269,5,55,18,37,89,86,1,2,0,1
E33023291,338,241,49,192,1,24,7,17,66,65,0,1,0,6
E33023292,602,443,104,339,7,43,14,29,106,98,1,6,1,3
E33023293,461,341,82,259,4,30,15,15,85,79,4,2,0,1
E33023294,360,222,57,165,1,63,30,33,72,68,1,2,1,2
E33023295,479,317,67,250,1,46,24,22,113,106,0,6,1,2
E33023296,1905,1265,342,923,16,226,104,122,387,357,3,22,5,11
E33023297,389,255,42,213,4,41,9,32,83,79,0,4,0,6
E33023298,637,311,72,239,7,37,16,21,277,262,2,11,2,5
E33023299,280,171,46,125,4,57,16,41,46,40,1,3,2,2
E33023300,589,396,77,319,8,65,24,41,117,103,2,9,3,3
E33023301,315,203,57,146,3,30,10,20,69,57,5,5,2,10
E33023302,1524,1183,285,898,20,113,39,74,201,177,10,9,5,7
E33023303,345,263,62,201,2,35,10,25,43,42,0,1,0,2
E33023304,309,211,57,154,1,29,8,21,67,63,0,3,1,1
E33023305,2287,1639,417,1222,13,191,75,116,441,422,4,13,2,3
E33023306,513,376,81,295,0,65,25,40,70,63,0,6,1,2
E33023307,310,228,53,175,2,31,12,19,47,46,0,0,1,2
E33023308,338,238,66,172,8,30,10,20,59,57,0,2,0,3
E33023309,667,491,146,345,5,58,20,38,111,105,0,6,0,2
E33023310,310,226,56,170,5,25,13,12,54,45,0,8,1,0
E33023311,676,423,83,340,8,45,11,34,194,184,1,9,0,6
E33023312,772,575,136,439,8,67,26,41,117,107,0,9,1,5
E33023313,342,255,64,191,7,23,6,17,55,54,0,0,1,2
E33023314,266,204,53,151,1,28,10,18,31,28,1,2,0,2
E33023315,688,476,131,345,6,100,36,64,102,92,1,7,2,4
E33023316,449,302,95,207,6,56,20,36,84,80,0,3,1,1
E33023317,291,200,60,140,6,36,14,22,48,43,0,5,0,1
E33023318,429,295,86,209,4,52,25,27,76,76,0,0,0,2
E33023319,652,437,135,302,6,71,24,47,135,125,1,9,0,3
E33023320,257,191,50,141,1,23,7,16,42,38,0,2,2,0
E33023321,625,426,103,323,3,65,25,40,122,111,1,8,2,9
E33023322,703,524,131,393,13,51,22,29,112,100,1,7,4,3
E33023323,774,440,97,343,11,104,33,71,217,206,2,8,1,2
E33023324,1465,1126,216,910,14,64,22,42,253,236,2,14,1,8
E33023325,307,213,47,166,5,34,12,22,53,50,0,3,0,2
E33023326,378,241,54,187,6,36,13,23,93,86,0,7,0,2
E33023327,823,626,154,472,4,77,27,50,109,98,2,7,2,7
E33023328,580,332,91,241,3,63,31,32,182,173,0,8,1,0
E33023329,2363,1807,423,1384,26,110,33,77,411,370,6,30,5,9
E33023330,492,377,106,271,1,34,9,25,78,72,0,5,1,2
E33023331,199,149,30,119,0,17,6,11,32,32,0,0,0,1
E33023332,665,542,156,386,5,46,29,17,70,65,1,4,0,2
E33023333,990,651,159,492,11,96,39,57,229,215,4,10,0,3
E33023334,1064,611,135,476,13,111,35,76,326,311,3,9,3,3
E33023335,1453,1113,289,824,21,118,51,67,196,183,1,8,4,5
E33023336,265,187,34,153,0,25,9,16,53,51,2,0,0,0
E33023337,442,335,81,254,4,38,16,22,65,58,0,6,1,0
E33023338,2360,1763,405,1358,28,111,38,73,449,410,3,31,5,9
E33023339,639,520,108,412,6,33,8,25,77,68,1,5,3,3
E33023340,136,93,29,64,0,13,6,7,29,27,0,1,1,1
E33023341,4235,3106,693,2413,53,273,103,170,793,703,41,32,17,10
E33023342,598,446,124,322,5,49,20,29,91,86,0,5,0,7
E33023343,249,192,55,137,3,19,8,11,34,30,1,0,3,1
E33023344,298,247,61,186,0,14,8,6,35,34,0,1,0,2
E33023345,509,327,85,242,5,76,37,39,100,93,1,4,2,1
E33023346,3162,2238,556,1682,32,268,128,140,615,590,3,20,2,9
E33023347,467,380,96,284,4,35,26,9,47,42,0,5,0,1
E33023348,443,357,103,254,2,43,30,13,41,39,0,2,0,0
E33023349,331,274,79,195,1,27,16,11,29,25,0,4,0,0
E33023350,920,436,127,309,9,78,31,47,393,377,5,7,4,4
E33023351,317,211,68,143,1,37,28,9,61,56,1,3,1,7
E33023352,679,450,127,323,7,94,60,34,125,120,0,5,0,3
E33023353,145,109,31,78,0,12,8,4,23,22,0,1,0,1
E33023354,819,494,143,351,6,161,102,59,156,147,0,5,4,2
E33023355,816,595,159,436,4,106,52,54,106,98,1,4,3,5
E33023356,4052,2997,561,2436,37,172,98,74,832,776,5,45,6,14
E33023357,1772,1470,383,1087,13,48,24,24,240,229,1,10,0,1
E33023358,429,328,83,245,2,24,12,12,74,70,0,4,0,1
E33023359,1490,523,132,391,18,146,83,63,795,766,7,8,14,8
E33023360,321,223,72,151,0,33,22,11,64,62,0,1,1,1
E33023361,371,231,50,181,4,51,35,16,84,78,2,3,1,1
E33023362,1015,720,170,550,11,103,55,48,176,161,5,9,1,5
E33023363,895,727,177,550,9,58,37,21,98,88,0,10,0,3
E33023364,460,240,70,170,0,60,36,24,157,152,0,5,0,3
E33023365,201,141,26,115,0,13,5,8,45,44,0,0,1,2
E33023366,495,353,96,257,1,37,27,10,103,98,0,2,3,1
E33023367,418,274,81,193,3,47,36,11,87,81,0,4,2,7
E33023368,495,337,98,239,4,36,19,17,114,111,0,3,0,4
E33023369,392,270,64,206,3,51,26,25,67,61,3,3,0,1
E33023370,267,149,36,113,1,36,25,11,78,69,1,7,1,3
E33023371,291,187,43,144,4,25,15,10,73,72,0,1,0,2
E33023372,663,442,86,356,3,69,49,20,146,143,0,3,0,3
E33023373,250,142,37,105,1,24,14,10,82,79,0,3,0,1
E33023374,293,170,50,120,0,31,18,13,92,88,0,2,2,0
E33023375,395,261,69,192,1,60,42,18,73,63,0,5,5,0
E33023376,266,164,47,117,2,43,24,19,55,54,1,0,0,2
E33023377,410,265,80,185,1,64,41,23,78,74,0,4,0,2
E33023378,468,304,61,243,2,48,25,23,110,106,1,3,0,4
E33023379,200,147,48,99,1,18,11,7,33,31,0,2,0,1
E33023380,1155,785,233,552,4,72,38,34,286,265,3,11,7,8
E33023381,243,167,37,130,3,22,17,5,49,46,0,3,0,2
E33023382,303,234,85,149,1,26,13,13,40,38,0,2,0,2
E33023383,1567,1113,213,900,20,104,59,45,325,303,0,20,2,5
E33023384,482,342,79,263,6,41,24,17,90,78,0,10,2,3
E33023385,1131,834,136,698,18,50,33,17,224,210,1,10,3,5
E33023386,1080,717,136,581,12,61,34,27,285,269,2,14,0,5
E33023387,773,531,108,423,7,52,29,23,179,175,0,4,0,4
E33023388,1251,969,173,796,9,49,28,21,223,196,4,18,5,1
E33023389,1365,972,235,737,12,98,50,48,281,263,2,15,1,2
E33023390,272,182,39,143,1,22,13,9,65,61,0,4,0,2
E33023391,488,340,78,262,4,44,28,16,100,94,0,4,2,0
E33023392,1389,912,197,715,13,111,47,64,349,333,2,14,0,4
E33023393,1105,683,185,498,10,89,47,42,321,310,3,7,1,2
E33023394,852,657,153,504,12,46,33,13,135,126,0,9,0,2
E33023395,950,695,189,506,5,75,37,38,174,162,1,11,0,1
E33023396,348,252,85,167,3,16,10,6,74,71,0,3,0,3
E33023397,1061,644,182,462,5,77,30,47,328,312,2,13,1,7
E33023398,446,304,97,207,0,42,18,24,95,88,1,6,0,5
E33023399,342,238,74,164,1,25,15,10,77,72,0,5,0,1
E33023400,472,312,96,216,4,60,19,41,94,92,0,2,0,2
E33023401,225,142,40,102,2,13,11,2,66,65,0,1,0,2
E33023402,536,354,90,264,6,36,18,18,132,124,0,8,0,8
E33023403,226,166,49,117,3,8,4,4,46,43,1,2,0,3
E33023404,201,131,26,105,1,18,6,12,50,50,0,0,0,1
E33023405,763,503,105,398,2,45,15,30,209,197,0,10,2,4
E33023406,265,160,36,124,3,27,20,7,72,68,2,2,0,3
E33023407,593,368,88,280,5,56,24,32,162,151,3,6,2,2
E33023408,296,201,59,142,2,16,2,14,75,75,0,0,0,2
E33023409,299,247,75,172,1,9,4,5,37,31,0,6,0,5
E33023410,242,159,49,110,0,20,9,11,61,59,2,0,0,2
E33023411,821,626,178,448,10,44,17,27,139,123,9,4,3,2
E33023412,316,242,62,180,2,24,18,6,48,41,0,7,0,0
E33023413,363,279,70,209,2,25,12,13,51,47,0,3,1,6
E33023414,2038,1632,309,1323,18,91,45,46,289,252,3,33,1,8
E33023415,313,214,58,156,1,30,16,14,66,59,0,7,0,2
E33023416,307,231,80,151,2,26,10,16,47,43,0,3,1,1
E33023417,255,197,50,147,3,18,14,4,36,33,0,2,1,1
E33023418,1272,957,221,736,9,77,39,38,224,209,0,14,1,5
E33023419,472,361,88,273,1,34,16,18,75,70,0,4,1,1
E33023420,453,303,83,220,4,42,20,22,95,93,0,1,1,9
E33023421,490,290,78,212,5,75,44,31,116,110,1,4,1,4
E33023422,367,261,72,189,0,44,18,26,59,57,0,2,0,3
E33023423,342,262,71,191,0,24,14,10,55,48,2,4,1,1
E33023424,987,722,185,537,4,70,44,26,186,164,3,12,7,5
E33023425,455,320,89,231,0,51,15,36,81,77,1,3,0,3
E33023426,587,485,131,354,6,23,8,15,72,70,0,2,0,1
E33023427,278,209,69,140,1,13,3,10,53,47,0,6,0,2
E33023428,566,404,100,304,4,40,21,19,112,104,1,6,1,6
E33023429,1394,1101,302,799,5,61,34,27,219,207,1,11,0,8
E33023430,419,336,86,250,2,15,4,11,65,63,0,2,0,1
E33023431,609,416,87,329,5,34,23,11,150,139,0,9,2,4
E33023432,512,315,68,247,2,64,31,33,124,113,0,9,2,7
E33023433,604,465,120,345,2,48,28,20,86,82,0,4,0,3
E33023434,304,228,51,177,1,38,28,10,35,34,0,0,1,2
E33023435,976,683,168,515,7,142,97,45,143,133,2,8,0,1
E33023436,225,186,54,132,1,16,10,6,21,21,0,0,0,1
E33023437,275,203,53,150,1,29,19,10,39,38,0,1,0,3
E33023438,1118,953,237,716,0,59,36,23,97,91,0,5,1,9
E33023439,467,287,78,209,0,117,90,27,62,59,0,3,0,1
E33023440,677,500,113,387,2,84,68,16,89,86,0,2,1,2
E33023441,234,175,43,132,2,28,25,3,28,24,1,2,1,1
E33023442,283,163,32,131,0,65,54,11,54,51,0,3,0,1
E33023443,238,163,42,121,1,31,26,5,42,40,0,2,0,1
E33023444,1412,1078,264,814,7,174,136,38,145,135,1,9,0,8
E33023445,497,360,103,257,3,63,49,14,67,60,1,3,3,4
E33023446,655,442,104,338,4,100,85,15,100,94,0,6,0,9
E33023447,529,389,101,288,1,71,41,30,66,62,2,2,0,2
E33023448,255,195,62,133,4,16,10,6,40,38,0,2,0,0
E33023449,250,214,76,138,1,18,14,4,17,15,0,1,1,0
E33023450,331,242,56,186,0,41,32,9,46,44,1,1,0,2
E33023451,535,374,117,257,3,94,79,15,64,63,0,1,0,0
E33023452,199,148,35,113,0,29,25,4,21,21,0,0,0,1
E33023453,257,211,59,152,1,13,10,3,31,31,0,0,0,1
E33023454,373,285,81,204,1,50,39,11,34,34,0,0,0,3
E33023455,229,168,43,125,2,35,16,19,24,22,0,2,0,0
E33023456,334,207,43,164,3,51,40,11,72,69,0,3,0,1
E33023457,580,424,118,306,5,61,49,12,88,84,1,3,0,2
E33023458,249,134,22,112,3,24,19,5,86,84,0,2,0,2
E33023459,299,201,43,158,0,34,22,12,63,61,0,2,0,1
E33023460,199,135,36,99,0,24,20,4,37,34,1,2,0,3
E33023461,1216,786,202,584,6,167,127,40,252,232,0,16,4,5
E33023462,534,371,104,267,3,63,49,14,94,88,0,5,1,3
E33023463,886,607,151,456,5,108,96,12,164,157,0,4,3,2
E33023464,457,314,53,261,8,70,50,20,60,54,1,4,1,5
E33023465,257,190,48,142,0,26,17,9,41,37,0,4,0,0
E33023466,1519,919,183,736,17,184,135,49,391,375,1,13,2,8
E33023467,323,216,51,165,2,37,31,6,66,59,0,7,0,2
E33023468,513,314,84,230,3,84,69,15,110,108,0,1,1,2
E33023469,419,176,44,132,3,58,50,8,181,176,1,4,0,1
E33023470,714,497,113,384,5,99,78,21,111,101,1,9,0,2
E33023471,1535,1036,226,810,14,196,146,50,279,252,2,19,6,10
E33023472,1888,1293,321,972,12,277,212,65,298,283,1,11,3,8
E33023473,734,520,133,387,5,92,65,27,115,107,2,6,0,2
E33023474,3022,2207,530,1677,19,346,251,95,434,413,1,15,5,16
E33023475,335,248,79,169,4,36,11,25,46,44,1,1,0,1
E33023476,550,448,102,346,7,32,8,24,61,56,2,2,1,2
E33023477,239,167,35,132,2,26,2,24,42,36,1,4,1,2
E33023478,261,153,46,107,8,39,8,31,56,53,0,2,1,5
E33023479,218,168,49,119,2,24,3,21,24,21,0,3,0,0
E33023480,1440,1026,283,743,17,182,51,131,208,200,1,7,0,7
E33023481,1394,633,136,497,33,141,58,83,577,554,2,11,10,10
E33023482,1676,1233,361,872,24,75,16,59,339,287,22,9,21,5
E33023483,502,385,91,294,13,20,6,14,79,73,0,6,0,5
E33023484,217,139,42,97,3,9,2,7,59,57,0,2,0,7
E33023485,585,399,116,283,5,94,16,78,84,76,1,6,1,3
E33023486,211,132,30,102,3,48,9,39,28,24,1,2,1,0
E33023487,267,164,49,115,3,36,3,33,59,51,5,3,0,5
E33023488,254,176,55,121,3,47,10,37,28,28,0,0,0,0
E33023489,337,250,64,186,3,45,10,35,37,36,0,1,0,2
E33023490,558,371,102,269,8,101,18,83,76,74,1,1,0,2
E33023491,1291,710,171,539,11,109,19,90,457,202,145,5,105,4
E33023492,1356,883,237,646,16,125,26,99,325,110,142,7,66,7
E33023493,263,210,62,148,1,17,2,15,31,28,0,3,0,4
E33023494,753,566,140,426,12,57,19,38,114,107,0,7,0,4
E33023495,400,297,90,207,5,31,8,23,62,60,0,0,2,5
E33023496,363,273,55,218,6,24,5,19,59,53,0,6,0,1
E33023497,407,250,72,178,6,57,5,52,93,88,0,4,1,1
E33023498,253,168,45,123,2,24,3,21,58,43,0,1,14,1
E33023499,411,288,74,214,6,52,10,42,62,51,4,3,4,3
E33023500,2944,2104,606,1498,47,329,44,285,452,396,27,18,11,12
E33023501,1768,1393,423,970,24,129,12,117,217,199,4,11,3,5
E33023502,298,209,49,160,4,32,7,25,50,44,0,4,2,3
E33023503,774,596,149,447,11,58,11,47,105,95,2,7,1,4
E33023504,215,146,51,95,2,24,5,19,43,36,5,1,1,0
E33023505,668,519,148,371,12,48,7,41,85,80,1,4,0,4
E33023506,282,193,53,140,4,20,6,14,61,53,1,6,1,4
E33023507,385,286,93,193,3,19,4,15,56,48,1,7,0,21
E33023508,298,253,66,187,0,20,4,16,24,22,0,2,0,1
E33023509,160,98,37,61,3,17,4,13,41,40,0,0,1,1
E33023510,528,370,87,283,8,67,11,56,81,73,2,5,1,2
E33023511,423,275,81,194,5,36,4,32,106,102,0,4,0,1
E33023512,232,140,46,94,2,39,6,33,48,46,0,1,1,3
E33023513,310,204,61,143,7,44,8,36,55,50,0,4,1,0
E33023514,252,174,43,131,6,30,3,27,41,39,0,2,0,1
E33023515,224,162,49,113,4,23,5,18,33,32,0,0,1,2
E33023516,283,155,51,104,1,49,4,45,75,75,0,0,0,3
E33023517,400,310,76,234,1,47,6,41,40,36,2,2,0,2
E33023518,451,316,98,218,1,45,7,38,86,80,3,2,1,3
E33023519,268,205,59,146,2,18,2,16,41,40,0,0,1,2
E33023520,237,199,73,126,0,11,4,7,25,23,0,2,0,2
E33023521,650,488,149,339,7,48,7,41,100,87,3,8,2,7
E33023522,743,585,155,430,4,49,7,42,93,89,0,4,0,12
E33023523,602,417,142,275,2,59,11,48,113,99,1,12,1,11
E33023524,348,271,59,212,5,28,3,25,39,37,1,1,0,5
E33023525,245,189,60,129,0,24,2,22,32,28,2,2,0,0
E33023526,404,309,88,221,14,30,3,27,48,44,0,4,0,3
E33023527,230,161,51,110,5,28,1,27,34,32,1,1,0,2
E33023528,1332,786,186,600,12,233,44,189,298,289,0,9,0,3
E33023529,395,310,81,229,3,28,5,23,53,47,0,6,0,1
E33023530,159,120,49,71,0,14,2,12,25,23,2,0,0,0
E33023531,378,287,96,191,3,28,5,23,57,49,3,4,1,3
E33023532,437,322,79,243,8,42,9,33,63,55,0,6,2,2
E33023533,578,445,99,346,12,45,10,35,75,71,0,4,0,1
E33023534,1357,1045,203,842,18,86,9,77,202,195,1,6,0,6
E33023535,123,86,29,57,0,14,3,11,22,22,0,0,0,1
E33023536,381,203,50,153,6,42,13,29,130,118,0,8,4,0
E33023537,1251,876,218,658,26,138,21,117,205,191,2,11,1,6
E33023538,682,406,127,279,10,114,19,95,147,143,0,3,1,5
E33023539,367,249,82,167,8,64,11,53,45,42,0,3,0,1
E33023540,396,292,69,223,5,27,8,19,67,62,0,4,1,5
E33023541,203,154,33,121,4,16,6,10,26,23,1,2,0,3
E33023542,251,186,32,154,5,15,3,12,41,40,1,0,0,4
E33023543,706,523,115,408,13,74,18,56,94,81,1,12,0,2
E33023544,491,347,87,260,2,37,10,27,104,100,0,2,2,1
E33023545,1019,786,211,575,7,42,10,32,176,156,6,11,3,8
E33023546,662,434,116,318,12,81,16,65,131,120,1,10,0,4
E33023547,357,283,71,212,4,34,8,26,36,29,1,6,0,0
E33023548,558,402,125,277,11,71,39,32,69,59,1,5,4,5
E33023549,358,245,56,189,8,42,26,16,57,49,2,6,0,6
E33023550,329,238,74,164,4,44,30,14,36,33,0,2,1,7
E33023551,387,285,81,204,9,30,15,15,62,58,0,0,4,1
E33023552,343,249,69,180,2,41,21,20,50,45,0,5,0,1
E33023553,471,356,110,246,15,44,24,20,52,48,0,4,0,4
E33023554,377,281,83,198,6,32,11,21,57,46,5,6,0,1
E33023555,340,245,71,174,5,34,18,16,51,43,1,3,4,5
E33023556,401,246,52,194,2,25,13,12,119,107,4,7,1,9
E33023557,218,158,29,129,2,16,13,3,42,40,0,2,0,0
E33023558,405,311,88,223,10,29,19,10,55,50,1,2,2,0
E33023559,219,164,41,123,3,23,17,6,28,27,0,1,0,1
E33023560,252,183,47,136,2,25,14,11,41,38,0,3,0,1
E33023561,250,193,57,136,5,22,10,12,29,29,0,0,0,1
E33023562,242,175,38,137,3,21,16,5,38,35,1,1,1,5
E33023563,351,243,59,184,4,48,34,14,54,51,0,3,0,2
E33023564,283,208,62,146,6,31,20,11,38,34,0,3,1,0
E33023565,295,197,49,148,5,45,26,19,45,44,0,1,0,3
E33023566,239,183,56,127,5,22,14,8,29,26,0,2,1,0
E33023567,787,537,132,405,13,115,81,34,121,115,0,6,0,1
E33023568,302,205,52,153,6,39,24,15,49,42,3,3,1,3
E33023569,225,151,38,113,1,25,13,12,47,41,2,4,0,1
E33023570,557,395,87,308,4,75,48,27,81,79,0,2,0,2
E33023571,487,383,93,290,5,39,21,18,58,56,0,2,0,2
E33023572,382,270,62,208,6,40,27,13,63,56,0,5,2,3
E33023573,674,520,116,404,9,25,15,10,118,111,0,7,0,2
E33023574,616,424,113,311,7,51,28,23,132,122,0,9,1,2
E33023575,402,258,67,191,4,51,37,14,86,80,1,4,1,3
E33023576,574,367,91,276,4,86,55,31,116,103,0,13,0,1
E33023577,230,172,44,128,1,28,16,12,29,29,0,0,0,0
E33023578,2122,1016,258,758,17,245,159,86,829,794,4,21,10,15
E33023579,329,181,50,131,5,81,43,38,60,58,0,2,0,2
E33023580,748,396,106,290,6,148,84,64,186,174,4,8,0,12
E33023581,381,254,78,176,9,42,26,16,76,73,0,3,0,0
E33023582,386,255,78,177,11,67,32,35,51,49,1,1,0,2
E33023583,245,169,61,108,5,51,33,18,20,17,1,1,1,0
E33023584,257,141,50,91,3,38,22,16,73,71,0,0,2,2
E33023585,396,268,70,198,6,33,17,16,87,81,0,5,1,2
E33023586,338,198,56,142,3,8,5,3,127,122,0,3,2,2
E33023587,423,258,82,176,1,23,15,8,136,120,5,7,4,5
E33023588,331,212,51,161,5,21,4,17,91,88,0,1,2,2
E33023589,330,269,68,201,4,4,1,3,53,51,0,2,0,0
E33023590,1796,1370,388,982,40,128,62,66,230,211,3,10,6,28
E33023591,1069,666,211,455,10,39,25,14,350,338,1,8,3,4
E33023592,287,212,68,144,6,20,13,7,47,47,0,0,0,2
E33023593,354,244,61,183,4,50,34,16,55,53,1,1,0,1
E33023594,354,268,81,187,3,27,14,13,54,49,1,4,0,2
E33023595,1550,1003,267,736,26,166,73,93,348,328,4,14,2,7
E33023596,2775,1899,414,1485,37,115,57,58,714,690,0,20,4,10
E33023597,117,76,23,53,1,26,10,16,13,12,0,1,0,1
E33023598,443,311,84,227,10,47,22,25,71,66,0,3,2,4
E33023599,568,414,106,308,4,52,29,23,92,88,1,3,0,6
E33023600,1497,765,187,578,21,256,130,126,447,422,3,17,5,8
E33023601,478,306,136,170,6,20,10,10,141,130,7,2,2,5
E33023602,968,598,237,361,14,37,17,20,311,281,17,5,8,8
E33023603,343,192,80,112,6,47,27,20,93,88,3,0,2,5
E33023604,285,121,44,77,6,27,16,11,128,121,3,4,0,3
E33023605,508,288,89,199,13,74,32,42,131,122,1,6,2,2
E33023606,592,301,82,219,6,23,13,10,257,246,5,2,4,5
E33023607,494,257,73,184,7,85,47,38,143,134,2,4,3,2
E33023608,326,151,45,106,7,50,24,26,114,108,1,3,2,4
E33023609,286,160,49,111,4,28,19,9,86,80,0,5,1,8
E33023610,480,279,85,194,7,19,6,13,171,156,4,7,4,4
E33023611,749,450,173,277,9,54,32,22,233,213,9,8,3,3
E33023612,351,254,91,163,4,25,13,12,60,49,4,4,3,8
E33023613,237,106,31,75,5,31,16,15,91,84,0,4,3,4
E33023614,474,305,113,192,13,38,23,15,113,107,2,1,3,5
E33023615,248,186,58,128,2,13,9,4,46,43,0,2,1,1
E33023616,244,109,28,81,5,23,11,12,105,94,1,6,4,2
E33023617,758,492,147,345,12,114,61,53,135,123,4,6,2,5
E33023618,244,142,63,79,5,24,14,10,70,63,7,0,0,3
E33023619,511,323,116,207,11,43,28,15,126,115,1,6,4,8
E33023620,292,164,74,90,4,69,46,23,51,48,0,3,0,4
E33023621,207,127,40,87,3,24,14,10,52,48,0,4,0,1
E33023622,335,181,26,155,9,20,7,13,124,118,1,3,2,1
E33023623,622,334,114,220,12,103,58,45,168,153,0,15,0,5
E33023624,286,156,56,100,4,34,19,15,88,83,4,1,0,4
E33023625,234,127,42,85,3,23,12,11,75,68,3,2,2,6
E33023626,347,183,43,140,5,38,20,18,117,111,1,5,0,4
E33023627,215,132,51,81,10,10,6,4,55,45,5,2,3,8
E33023628,424,259,119,140,10,67,42,25,80,72,2,3,3,8
E33023629,432,307,131,176,6,29,15,14,88,77,4,5,2,2
E33023630,519,314,79,235,7,46,22,24,143,131,8,3,1,9
E33023631,1201,785,260,525,19,93,41,52,298,279,7,6,6,6
E33023632,481,278,73,205,9,105,65,40,87,81,1,4,1,2
E33023633,219,173,49,124,3,14,5,9,29,28,0,1,0,0
E33023634,331,217,81,136,2,25,13,12,87,85,1,1,0,0
E33023635,290,192,59,133,3,14,4,10,79,75,1,3,0,2
E33023636,3177,2070,481,1589,74,434,199,235,584,547,11,20,6,15
E33023637,283,189,48,141,5,23,9,14,62,56,1,5,0,4
E33023638,7231,4524,1198,3326,156,762,340,422,1735,1634,27,54,20,54
E33023639,863,643,149,494,12,42,23,19,162,146,6,9,1,4
E33023640,1492,986,245,741,30,84,46,38,385,357,6,21,1,7
E33023641,239,169,51,118,3,26,11,15,40,37,0,2,1,1
E33023642,410,240,72,168,6,47,29,18,111,106,4,1,0,6
E33023643,266,197,73,124,3,20,8,12,45,41,0,3,1,1
E33023644,864,636,185,451,18,98,54,44,103,95,0,8,0,9
E33023645,1008,618,148,470,15,101,55,46,267,251,2,8,6,7
E33023646,265,184,50,134,6,42,22,20,29,27,0,2,0,4
E33023647,587,416,107,309,5,81,10,71,78,72,0,6,0,7
E33023648,302,207,46,161,8,20,4,16,60,59,0,1,0,7
E33023649,214,128,39,89,5,22,3,19,56,53,1,1,1,3
E33023650,823,618,170,448,10,57,8,49,133,121,0,11,1,5
E33023651,657,471,149,322,9,102,15,87,69,65,1,1,2,6
E33023652,348,268,80,188,6,27,4,23,42,35,2,5,0,5
E33023653,213,170,52,118,3,14,0,14,25,25,0,0,0,1
E33023654,201,142,37,105,2,21,4,17,34,31,0,3,0,2
E33023655,494,308,92,216,10,55,7,48,105,94,0,5,6,16
E33023656,337,217,46,171,4,24,6,18,87,84,2,1,0,5
E33023657,1801,948,234,714,35,190,74,116,619,589,8,20,2,9
E33023658,652,493,147,346,12,61,15,46,78,71,0,6,1,8
E33023659,351,194,58,136,8,23,9,14,118,105,6,7,0,8
E33023660,342,197,61,136,5,36,6,30,93,84,9,0,0,11
E33023661,444,345,104,241,3,37,9,28,56,46,0,6,4,3
E33023662,673,408,115,293,5,46,10,36,211,199,3,8,1,3
E33023663,889,574,164,410,6,102,32,70,203,199,3,1,0,4
E33023664,867,601,145,456,11,82,19,63,165,154,4,5,2,8
E33023665,1006,753,141,612,7,40,8,32,201,186,3,12,0,5
E33023666,546,363,90,273,2,52,14,38,124,112,6,5,1,5
E33023667,386,245,64,181,10,41,13,28,88,77,0,10,1,2
E33023668,300,228,79,149,2,19,3,16,51,40,1,9,1,0
E33023669,337,237,81,156,3,21,8,13,65,58,1,3,3,11
E33023670,214,163,39,124,1,15,1,14,34,27,2,5,0,1
E33023671,217,162,65,97,1,26,5,21,26,23,0,1,2,2
E33023672,209,150,53,97,1,11,3,8,45,41,0,3,1,2
E33023673,621,335,110,225,5,79,20,59,197,186,3,6,2,5
E33023674,759,576,133,443,7,44,9,35,129,121,0,7,1,3
E33023675,228,182,65,117,1,6,2,4,37,31,1,3,2,2
E33023676,703,555,152,403,1,31,13,18,113,109,0,4,0,3
E33023677,472,350,99,251,1,24,6,18,93,87,0,5,1,4
E33023678,647,380,110,270,2,34,8,26,227,184,20,6,17,4
E33023679,551,407,80,327,12,33,11,22,96,85,2,8,1,3
E33023680,717,541,111,430,8,32,4,28,130,121,1,7,1,6
E33023681,1565,554,144,410,6,49,11,38,948,911,20,3,14,8
E33023682,432,296,90,206,7,41,4,37,82,73,0,9,0,6
E33023683,585,389,79,310,8,42,13,29,143,138,1,2,2,3
E33023684,256,163,48,115,3,34,9,25,56,55,0,1,0,0
E33023685,375,179,42,137,3,67,27,40,125,117,2,3,3,1
E33023686,360,234,72,162,6,48,9,39,68,63,0,5,0,4
E33023687,310,220,52,168,1,42,9,33,43,39,1,2,1,4
E33023688,892,545,104,441,9,117,37,80,216,209,0,4,3,5
E33023689,262,165,43,122,0,47,11,36,49,46,0,3,0,1
E33023690,590,449,96,353,4,37,8,29,99,92,2,5,0,1
E33023691,592,383,66,317,7,103,23,80,98,89,3,4,2,1
E33023692,392,313,67,246,7,27,4,23,44,37,3,4,0,1
E33023693,297,193,39,154,7,16,3,13,78,71,1,5,1,3
E33023694,212,177,44,133,2,14,3,11,18,15,3,0,0,1
E33023695,617,457,103,354,3,62,24,38,92,81,1,6,4,3
E33023696,408,267,67,200,2,57,18,39,79,69,5,4,1,3
E33023697,566,441,112,329,7,46,11,35,72,66,1,4,1,0
E33023698,230,163,42,121,5,23,5,18,39,38,0,1,0,0
E33023699,235,145,33,112,1,28,6,22,59,41,12,4,2,2
E33023700,264,182,43,139,1,50,11,39,27,24,1,2,0,4
E33023701,244,166,50,116,9,31,9,22,38,38,0,0,0,0
E33023702,414,315,106,209,6,21,5,16,61,47,8,6,0,11
E33023703,223,151,38,113,3,14,5,9,49,43,0,5,1,6
E33023704,287,232,72,160,5,12,7,5,37,34,1,0,2,1
E33023705,260,170,42,128,5,20,4,16,61,47,5,6,3,4
E33023706,237,178,48,130,4,18,5,13,36,31,3,2,0,1
E33023707,212,165,48,117,2,15,4,11,30,28,1,1,0,0
E33023708,238,179,35,144,0,18,3,15,38,35,0,3,0,3
E33023709,385,288,67,221,2,46,11,35,48,43,0,2,3,1
E33023710,339,280,81,199,2,14,4,10,41,36,2,2,1,2
E33023711,756,558,147,411,10,75,23,52,110,100,0,8,2,3
E33023712,894,476,125,351,10,103,25,78,305,292,1,8,4,0
E33023713,396,256,64,192,8,50,15,35,76,72,1,2,1,6
E33023714,101,84,17,67,1,4,2,2,12,12,0,0,0,0
E33023715,1089,780,217,563,9,105,34,71,190,177,0,11,2,5
E33023716,544,357,95,262,4,53,19,34,126,120,1,3,2,4
E33023717,756,537,120,417,12,110,20,90,91,87,0,4,0,6
E33023718,206,144,37,107,1,25,8,17,35,32,0,3,0,1
E33023719,439,329,81,248,6,50,13,37,52,45,3,2,2,2
E33023720,245,174,39,135,0,21,1,20,49,39,1,9,0,1
E33023721,221,155,50,105,4,37,5,32,23,20,1,2,0,2
E33023722,258,183,53,130,5,28,5,23,40,39,0,1,0,2
E33023723,215,142,25,117,1,29,5,24,42,39,1,2,0,1
E33023724,252,184,66,118,2,20,6,14,39,28,4,7,0,7
E33023725,864,595,170,425,21,130,62,68,114,104,0,8,2,4
E33023726,1187,843,196,647,16,112,57,55,210,197,0,11,2,6
E33023727,768,564,193,371,8,86,53,33,99,89,4,3,3,11
E33023728,325,265,73,192,3,12,2,10,45,44,1,0,0,0
E33023729,762,620,140,480,10,25,13,12,104,99,0,4,1,3
E33023730,772,446,137,309,14,154,93,61,152,138,7,5,2,6
E33023731,641,481,129,352,11,44,22,22,102,100,0,2,0,3
E33023732,1464,1014,219,795,32,118,52,66,286,260,1,24,1,14
E33023733,753,474,139,335,15,111,61,50,148,141,2,3,2,5
E33023734,655,517,162,355,5,57,26,31,69,63,2,3,1,7
E33023735,383,257,82,175,10,53,33,20,60,52,4,2,2,3
E33023736,803,611,175,436,12,64,38,26,111,97,0,10,4,5
E33023737,400,269,66,203,6,19,6,13,103,96,1,5,1,3
E33023738,1180,776,172,604,18,52,26,26,326,320,1,5,0,8
E33023739,508,389,70,319,11,24,6,18,84,80,1,3,0,0
E33023740,666,471,89,382,6,37,13,24,150,137,1,11,1,2
E33023741,381,162,27,135,4,19,10,9,195,190,1,3,1,1
E33023742,372,274,77,197,4,16,8,8,78,76,2,0,0,0
E33023743,292,203,54,149,5,18,10,8,66,62,2,2,0,0
E33023744,773,492,108,384,7,34,17,17,236,229,4,3,0,4
E33023745,1184,845,233,612,21,127,61,66,185,172,5,6,2,6
E33023746,434,301,81,220,7,59,35,24,62,54,3,5,0,5
E33023747,273,168,59,109,2,64,44,20,37,35,0,2,0,2
E33023748,665,456,113,343,11,85,58,27,106,95,1,10,0,7
E33023749,731,476,133,343,20,123,77,46,111,104,2,5,0,1
E33023750,280,218,62,156,6,7,2,5,47,43,1,3,0,2
E33023751,675,488,126,362,11,64,29,35,107,95,3,8,1,5
E33023752,310,235,49,186,1,11,3,8,62,57,0,3,2,1
E33023753,1200,836,207,629,21,64,31,33,274,259,4,7,4,5
E33023754,1514,931,199,732,21,77,43,34,479,460,6,12,1,6
E33023755,440,303,105,198,3,64,46,18,64,59,4,1,0,6
E33023756,2429,1790,478,1312,43,194,106,88,387,358,6,19,4,15
E33023757,312,200,53,147,7,29,12,17,69,66,2,1,0,7
E33023758,662,449,119,330,14,88,47,41,99,92,2,5,0,12
E33023759,804,514,171,343,13,128,64,64,140,123,3,11,3,9
E33023760,769,422,101,321,4,81,24,57,256,76,109,2,69,6
E33023761,303,234,96,138,2,28,14,14,37,26,2,9,0,2
E33023762,401,319,88,231,2,25,12,13,52,49,0,3,0,3
E33023763,321,218,77,141,1,41,22,19,59,54,0,5,0,2
E33023764,136,109,33,76,1,4,1,3,21,19,2,0,0,1
E33023765,329,273,100,173,0,19,13,6,37,34,0,3,0,0
E33023766,432,353,96,257,1,32,21,11,44,39,0,4,1,2
E33023767,307,247,73,174,1,28,10,18,28,27,1,0,0,3
E33023768,385,315,90,225,1,32,21,11,35,34,0,1,0,2
E33023769,742,511,100,411,11,83,38,45,136,124,0,12,0,1
E33023770,267,222,77,145,1,18,10,8,26,24,0,2,0,0
E33023771,782,650,159,491,8,40,27,13,82,78,0,4,0,2
E33023772,485,368,88,280,2,39,22,17,75,69,0,5,1,1
E33023773,167,117,27,90,1,15,9,6,34,30,0,4,0,0
E33023774,342,271,75,196,3,28,18,10,38,33,0,5,0,2
E33023775,405,282,76,206,2,65,45,20,53,52,1,0,0,3
E33023776,1946,1577,511,1066,8,138,89,49,213,198,0,14,1,10
E33023777,385,286,95,191,4,40,32,8,53,49,0,4,0,2
E33023778,346,264,59,205,2,39,26,13,39,38,0,1,0,2
E33023779,218,167,46,121,6,18,11,7,25,23,1,1,0,2
E33023780,915,618,159,459,13,181,106,75,100,87,2,10,1,3
E33023781,218,171,32,139,1,17,10,7,28,24,1,2,1,1
E33023782,430,293,72,221,7,69,47,22,60,57,0,3,0,1
E33023783,346,271,85,186,4,32,19,13,37,29,3,5,0,2
E33023784,1133,751,209,542,18,210,133,77,149,140,1,8,0,5
E33023785,1008,642,154,488,11,201,119,82,150,141,0,8,1,4
E33023786,463,297,62,235,5,62,39,23,96,88,0,7,1,3
E33023787,632,396,87,309,10,134,89,45,91,85,1,5,0,1
E33023788,594,401,97,304,6,97,53,44,90,83,0,7,0,0
E33023789,539,318,83,235,8,119,77,42,83,72,5,6,0,11
E33023790,464,343,110,233,8,54,34,20,56,51,1,4,0,3
E33023791,772,555,137,418,15,100,56,44,101,98,0,3,0,1
E33023792,362,248,61,187,3,62,37,25,49,43,2,3,1,0
E33023793,1546,1208,268,940,5,103,58,45,229,212,1,16,0,1
E33023794,3110,2661,648,2013,14,98,53,45,331,314,3,12,2,6
E33023795,278,209,63,146,1,41,22,19,25,24,1,0,0,2
E33023796,666,510,116,394,5,44,30,14,100,94,1,4,1,7
E33023797,426,345,102,243,5,30,17,13,44,38,1,5,0,2
E33023798,286,228,47,181,1,25,19,6,32,32,0,0,0,0
E33023799,710,505,116,389,10,62,31,31,131,124,0,7,0,2
E33023800,663,491,104,387,8,54,28,26,110,103,0,7,0,0
E33023801,310,199,46,153,4,50,36,14,55,48,0,7,0,2
E33023802,509,381,97,284,3,72,48,24,52,52,0,0,0,1
E33023803,261,196,39,157,3,16,12,4,44,41,0,3,0,2
E33023804,429,340,111,229,5,45,29,16,37,32,1,4,0,2
E33023805,4965,3454,869,2585,42,565,344,221,889,809,26,42,12,15
E33023806,296,197,49,148,5,42,25,17,52,48,0,4,0,0
E33023807,690,457,103,354,6,99,59,40,127,121,0,5,1,1
E33023808,271,188,48,140,1,40,23,17,41,38,0,3,0,1
E33023809,330,248,56,192,3,44,24,20,34,29,1,4,0,1
E33023810,421,298,98,200,6,67,52,15,47,46,0,1,0,3
E33023811,578,378,85,293,5,117,77,40,74,63,6,5,0,4
E33023812,525,366,91,275,8,85,59,26,65,63,1,1,0,1
E33023813,374,273,91,182,4,47,32,15,47,45,0,2,0,3
E33023814,476,324,75,249,8,57,36,21,84,78,2,4,0,3
E33023815,251,170,40,130,1,42,32,10,36,31,0,4,1,2
E33023816,288,197,44,153,2,30,16,14,58,56,0,2,0,1
E33023817,399,302,79,223,2,66,35,31,28,27,0,0,1,1
E33023818,875,555,144,411,6,174,120,54,135,127,1,7,0,5
E33023819,562,353,95,258,4,128,85,43,74,67,0,6,1,3
E33023820,431,299,71,228,8,48,25,23,75,73,0,2,0,1
E33023821,199,144,29,115,3,33,20,13,19,17,0,2,0,0
E33023822,219,159,25,134,4,27,16,11,27,26,0,1,0,2
E33023823,1184,786,179,607,9,227,146,81,158,147,0,9,2,4
E33023824,1134,860,244,616,17,144,93,51,106,99,0,7,0,7
E33023825,258,157,40,117,2,60,29,31,39,36,0,2,1,0
E33023826,845,649,175,474,16,105,60,45,71,66,0,5,0,4
E33023827,226,127,29,98,4,57,33,24,36,30,4,1,1,2
E33023828,186,110,26,84,1,40,22,18,34,33,0,1,0,1
E33023829,384,251,45,206,10,51,28,23,68,64,1,2,1,4
E33023830,282,181,50,131,5,70,45,25,25,25,0,0,0,1
E33023831,383,312,61,251,8,33,19,14,27,25,2,0,0,3
E33023832,350,224,50,174,5,80,43,37,39,37,0,1,1,2
E33023833,292,227,52,175,2,19,9,10,42,41,0,1,0,2
E33023834,325,273,77,196,2,25,18,7,24,21,0,3,0,1
E33023835,363,294,99,195,4,32,16,16,31,28,0,3,0,2
E33023836,212,178,56,122,2,15,11,4,17,17,0,0,0,0
E33023837,532,411,118,293,1,55,31,24,65,59,1,3,2,0
E33023838,127,94,33,61,0,16,7,9,16,16,0,0,0,1
E33023839,141,105,25,80,0,15,4,11,20,18,0,2,0,1
E33023840,762,606,173,433,7,66,42,24,81,75,2,4,0,2
E33023841,797,647,161,486,5,60,34,26,82,75,1,4,2,3
E33023842,303,239,76,163,0,24,16,8,35,32,2,1,0,5
E33023843,677,441,116,325,2,61,21,40,168,160,2,6,0,5
E33023844,706,545,158,387,6,67,14,53,84,75,2,6,1,4
E33023845,422,336,78,258,5,27,10,17,53,51,0,2,0,1
E33023846,257,187,52,135,9,14,4,10,46,45,0,1,0,1
E33023847,435,287,64,223,3,52,10,42,91,80,0,9,2,2
E33023848,220,171,46,125,0,30,3,27,18,17,0,1,0,1
E33023849,597,398,103,295,4,83,15,68,107,92,3,6,6,5
E33023850,273,192,45,147,3,26,8,18,50,47,0,3,0,2
E33023851,458,330,112,218,5,69,19,50,52,47,1,4,0,2
E33023852,312,232,49,183,3,36,8,28,39,35,1,2,1,2
E33023853,1088,723,159,564,3,155,31,124,200,180,3,16,1,7
E33023854,514,358,73,285,4,64,24,40,85,82,1,2,0,3
E33023855,159,128,34,94,2,14,6,8,15,13,0,2,0,0
E33023856,288,206,62,144,3,25,6,19,47,41,0,6,0,7
E33023857,222,176,67,109,0,24,12,12,20,17,0,2,1,2
E33023858,628,438,145,293,2,75,27,48,110,100,2,7,1,3
E33023859,417,296,71,225,5,55,28,27,61,54,4,3,0,0
E33023860,237,175,64,111,0,24,6,18,36,32,0,3,1,2
E33023861,727,342,80,262,4,116,50,66,261,249,0,7,5,4
E33023862,556,440,109,331,3,39,14,25,66,55,0,8,3,8
E33023863,204,161,29,132,3,10,3,7,23,20,0,1,2,7
E33023864,388,276,69,207,0,69,18,51,41,36,1,3,1,2
E33023865,279,189,46,143,0,36,16,20,52,46,1,3,2,2
E33023866,446,329,73,256,3,58,17,41,55,53,0,2,0,1
E33023867,536,386,105,281,5,75,27,48,69,59,1,7,2,1
E33023868,223,161,51,110,1,30,9,21,31,28,0,2,1,0
E33023869,616,444,123,321,6,60,14,46,106,102,1,3,0,0
E33023870,824,568,198,370,6,114,40,74,133,130,1,2,0,3
E33023871,276,219,38,181,0,22,5,17,34,31,0,3,0,1
E33023872,178,144,36,108,2,18,6,12,13,11,0,2,0,1
E33023873,264,153,47,106,0,60,12,48,49,47,0,2,0,2
E33023874,404,311,86,225,6,29,18,11,53,49,0,4,0,5
E33023875,887,564,139,425,4,98,31,67,220,210,1,8,1,1
E33023876,485,356,91,265,4,58,42,16,65,55,3,6,1,2
E33023877,349,226,58,168,1,51,35,16,70,60,5,2,3,1
E33023878,255,189,57,132,2,34,23,11,26,23,0,3,0,4
E33023879,332,261,70,191,3,28,21,7,39,35,1,1,2,1
E33023880,580,468,146,322,4,34,18,16,69,63,1,5,0,5
E33023881,481,390,121,269,4,36,26,10,49,46,0,3,0,2
E33023882,464,366,127,239,3,29,22,7,58,39,17,1,1,8
E33023883,843,682,175,507,7,48,33,15,103,92,1,9,1,3
E33023884,307,218,65,153,2,47,35,12,39,37,1,1,0,1
E33023885,616,451,96,355,9,51,31,20,102,100,0,2,0,3
E33023886,663,470,145,325,3,95,69,26,89,81,0,7,1,6
E33023887,327,237,81,156,3,33,21,12,54,53,1,0,0,0
E33023888,346,250,66,184,4,30,14,16,60,56,1,3,0,2
E33023889,1101,899,226,673,11,76,49,27,111,104,0,7,0,4
E33023890,267,188,76,112,6,33,25,8,39,33,1,1,4,1
E33023891,954,692,226,466,3,125,84,41,130,116,1,10,3,4
E33023892,446,303,79,224,3,63,47,16,75,71,0,4,0,2
E33023893,313,211,58,153,2,61,49,12,37,33,0,4,0,2
E33023894,927,783,249,534,8,60,36,24,73,65,1,5,2,3
E33023895,1089,699,196,503,8,196,126,70,180,168,3,9,0,6
E33023896,214,155,55,100,2,34,28,6,21,18,3,0,0,2
E33023897,523,344,76,268,4,75,47,28,99,94,1,3,1,1
E33023898,609,419,118,301,10,59,41,18,117,111,2,4,0,4
E33023899,2352,2000,490,1510,8,94,64,30,244,230,3,11,0,6
E33023900,212,175,53,122,2,11,7,4,22,20,0,2,0,2
E33023901,248,192,50,142,0,28,15,13,28,22,2,4,0,0
E33023902,350,268,92,176,1,24,16,8,55,51,0,3,1,2
E33023903,228,188,53,135,0,11,7,4,27,24,0,3,0,2
E33023904,574,446,133,313,2,46,32,14,78,73,0,5,0,2
E33023905,260,196,61,135,1,21,11,10,41,38,0,3,0,1
E33023906,247,197,43,154,0,20,16,4,30,26,0,4,0,0
E33023907,546,405,124,281,4,48,31,17,89,82,0,6,1,0
E33023908,553,441,148,293,1,29,22,7,81,73,2,6,0,1
E33023909,845,666,224,442,2,78,44,34,98,88,0,10,0,1
E33023910,210,172,54,118,2,7,5,2,25,21,0,3,1,4
E33023911,584,458,135,323,2,33,21,12,89,82,0,7,0,2
E33023912,1344,1083,273,810,8,67,28,39,177,160,1,15,1,9
E33023913,438,365,100,265,0,23,5,18,49,41,2,6,0,1
E33023914,234,201,66,135,0,11,3,8,21,20,0,1,0,1
E33023915,235,176,41,135,8,17,7,10,34,32,0,2,0,0
E33023916,533,425,126,299,3,47,16,31,58,50,0,7,1,0
E33023917,215,160,35,125,0,21,5,16,34,33,0,1,0,0
E33023918,981,710,220,490,9,107,30,77,153,149,3,1,0,2
E33023919,258,194,64,130,0,21,8,13,43,38,1,3,1,0
E33023920,258,207,53,154,4,21,8,13,25,24,0,1,0,1
E33023921,216,171,41,130,0,21,7,14,22,18,3,1,0,2
E33023922,218,166,51,115,2,16,3,13,29,29,0,0,0,5
E33023923,468,394,139,255,0,27,5,22,46,44,0,1,1,1
E33023924,333,253,81,172,4,29,7,22,44,41,0,3,0,3
E33023925,604,415,114,301,7,59,19,40,118,109,4,5,0,5
E33023926,221,147,51,96,2,27,9,18,32,29,1,1,1,13
E33023927,462,371,105,266,3,22,2,20,64,61,0,3,0,2
E33023928,235,188,58,130,6,11,2,9,30,27,0,3,0,0
E33023929,284,198,51,147,3,28,4,24,54,52,0,2,0,1
E33023930,627,523,158,365,4,27,8,19,67,63,1,2,1,6
E33023931,1358,1080,281,799,10,69,21,48,194,172,6,15,1,5
E33023932,470,319,86,233,7,63,15,48,80,74,0,5,1,1
E33023933,497,372,88,284,5,39,8,31,77,71,0,4,2,4
E33023934,518,386,92,294,6,28,6,22,95,88,2,5,0,3
E33023935,465,347,88,259,4,30,8,22,82,73,0,9,0,2
E33023936,713,507,131,376,5,57,12,45,140,128,5,6,1,4
E33023937,687,541,112,429,8,30,6,24,101,96,0,4,1,7
E33023938,586,460,112,348,7,17,4,13,95,87,1,6,1,7
E33023939,908,706,192,514,5,50,19,31,133,124,2,6,1,14
E33023940,589,444,119,325,2,52,14,38,80,65,1,10,4,11
E33023941,594,442,85,357,9,49,17,32,89,79,0,7,3,5
E33023942,324,240,80,160,3,35,12,23,45,42,1,2,0,1
E33023943,517,375,101,274,2,54,21,33,86,79,1,6,0,0
E33023944,412,256,69,187,0,51,15,36,103,94,1,7,1,2
E33023945,269,184,67,117,0,31,8,23,53,49,1,3,0,1
E33023946,578,443,116,327,3,56,19,37,74,71,0,3,0,2
E33023947,707,487,122,365,5,92,25,67,122,113,0,9,0,1
E33023948,910,725,160,565,12,40,13,27,132,122,0,10,0,1
E33023949,457,343,101,242,3,49,21,28,60,50,2,6,2,2
E33023950,216,147,38,109,2,13,5,8,52,45,0,5,2,2
E33023951,220,160,56,104,2,14,8,6,42,40,0,2,0,2
E33023952,322,191,46,145,2,34,20,14,91,86,2,3,0,4
E33023953,402,299,68,231,4,26,11,15,70,66,0,3,1,3
E33023954,207,112,41,71,1,35,25,10,58,55,0,2,1,1
E33023955,621,372,110,262,1,117,71,46,127,111,5,9,2,4
E33023956,205,172,59,113,1,4,1,3,27,22,1,4,0,1
E33023957,402,290,82,208,2,37,21,16,72,58,2,11,1,1
E33023958,462,348,118,230,1,24,15,9,85,69,7,3,6,4
E33023959,747,480,126,354,9,95,49,46,158,149,3,3,3,5
E33023960,203,182,29,153,2,6,5,1,13,11,1,1,0,0
E33023961,405,247,69,178,2,54,33,21,97,84,2,6,5,5
E33023962,227,190,53,137,2,10,5,5,25,23,0,2,0,0
E33023963,631,457,128,329,2,35,17,18,130,121,1,5,3,7
E33023964,714,469,117,352,1,72,29,43,168,143,4,13,8,4
E33023965,1047,727,195,532,6,120,64,56,189,159,11,14,5,5
E33023966,577,364,86,278,1,66,38,28,142,132,3,5,2,4
E33023967,306,188,56,132,1,45,21,24,72,63,1,7,1,0
E33023968,300,197,47,150,0,20,11,9,83,75,1,7,0,0
E33023969,266,171,59,112,1,35,22,13,56,52,1,3,0,3
E33023970,441,294,81,213,2,31,16,15,110,97,3,7,3,4
E33023971,440,298,72,226,3,43,20,23,96,88,1,7,0,0
E33023972,877,640,144,496,7,59,27,32,163,153,1,7,2,8
E33023973,859,673,211,462,4,46,24,22,134,117,6,7,4,2
E33023974,271,196,60,136,1,21,14,7,45,40,3,1,1,8
E33023975,1151,816,231,585,4,133,76,57,190,164,6,15,5,8
E33023976,352,268,67,201,0,25,16,9,58,53,2,3,0,1
E33023977,467,354,103,251,5,34,16,18,72,66,0,6,0,2
E33023978,311,226,75,151,0,26,16,10,58,55,0,2,1,1
E33023979,818,587,124,463,4,80,43,37,141,127,4,10,0,6
E33023980,266,180,61,119,1,32,17,15,52,50,0,2,0,1
E33023981,378,277,56,221,3,27,15,12,67,59,1,6,1,4
E33023982,1390,1035,238,797,16,83,36,47,246,218,7,18,3,10
E33023983,467,302,73,229,2,33,15,18,129,124,1,3,1,1
E33023984,493,371,101,270,1,32,18,14,86,80,0,6,0,3
E33023985,259,206,59,147,0,12,4,8,38,34,1,2,1,3
E33023986,385,284,65,219,2,22,11,11,72,65,0,6,1,5
E33023987,271,201,60,141,0,15,11,4,51,46,1,3,1,4
E33023988,265,169,41,128,4,29,13,16,62,57,0,3,2,1
E33023989,3722,2648,720,1928,14,238,118,120,804,712,31,43,18,18
E33023990,690,472,97,375,7,46,26,20,164,148,1,15,0,1
E33023991,243,185,58,127,1,14,7,7,43,40,2,0,1,0
E33023992,588,473,145,328,3,44,16,28,65,60,2,2,1,3
E33023993,554,377,117,260,4,50,33,17,111,103,0,6,2,12
E33023994,499,309,98,211,5,116,79,37,65,59,0,6,0,4
E33023995,214,162,61,101,1,21,13,8,29,27,0,2,0,1
E33023996,772,639,202,437,5,69,45,24,55,50,0,5,0,4
E33023997,296,209,68,141,1,51,42,9,35,33,0,1,1,0
E33023998,523,355,103,252,8,92,76,16,64,50,4,9,1,4
E33023999,1345,1004,237,767,17,126,74,52,186,180,0,6,0,12
E33024000,654,457,130,327,6,102,71,31,86,79,1,5,1,3
E33024001,697,460,140,320,5,116,83,33,111,106,0,5,0,5
E33024002,772,543,149,394,5,58,41,17,157,139,0,18,0,9
E33024003,343,252,90,162,2,38,27,11,49,45,3,1,0,2
E33024004,351,235,60,175,0,56,35,21,58,52,1,4,1,2
E33024005,522,333,99,234,3,96,75,21,86,80,2,4,0,4
E33024006,264,158,49,109,0,41,22,19,62,48,9,4,1,3
E33024007,755,495,133,362,8,133,84,49,117,110,1,6,0,2
E33024008,328,256,69,187,0,42,21,21,28,28,0,0,0,2
E33024009,664,469,106,363,8,87,51,36,97,92,0,5,0,3
E33024010,3448,2206,527,1679,35,676,460,216,522,488,5,24,5,9
E33024011,304,239,54,185,3,40,30,10,22,18,1,3,0,0
E33024012,335,256,60,196,3,36,27,9,40,40,0,0,0,0
E33024013,830,576,138,438,9,115,87,28,128,122,0,5,1,2
E33024014,757,588,132,456,8,63,28,35,98,88,1,9,0,0
E33024015,595,417,86,331,8,75,52,23,91,83,1,5,2,4
E33024016,429,304,67,237,6,58,45,13,60,57,1,2,0,1
E33024017,441,274,71,203,6,87,69,18,72,68,0,3,1,2
E33024018,363,269,66,203,4,36,28,8,54,51,0,3,0,0
E33024019,504,331,97,234,4,101,79,22,68,66,0,2,0,0
E33024020,1100,774,196,578,12,176,144,32,130,120,2,8,0,8
E33024021,748,522,96,426,7,96,72,24,117,108,1,8,0,6
E33024022,254,177,47,130,2,59,48,11,16,16,0,0,0,0
E33024023,228,161,40,121,0,35,29,6,31,29,0,2,0,1
E33024024,492,311,77,234,6,96,76,20,77,70,0,5,2,2
E33024025,321,230,65,165,5,49,42,7,35,30,2,3,0,2
E33024026,230,128,26,102,2,44,32,12,56,53,0,3,0,0
E33024027,511,247,51,196,10,129,87,42,124,113,0,8,3,1
E33024028,409,277,66,211,5,61,51,10,62,59,0,3,0,4
E33024029,502,331,68,263,5,82,65,17,82,79,1,0,2,2
E33024030,285,180,40,140,3,56,46,10,45,43,0,1,1,1
E33024031,385,244,64,180,5,85,69,16,51,47,0,3,1,0
E33024032,300,177,50,127,2,78,67,11,43,42,0,1,0,0
E33024033,320,226,49,177,5,55,43,12,34,30,0,4,0,0
E33024034,279,193,39,154,3,46,41,5,37,36,0,1,0,0
E33024035,383,278,64,214,2,44,34,10,57,53,0,4,0,2
E33024036,270,188,46,142,3,45,29,16,31,30,0,1,0,3
E33024037,375,259,73,186,7,33,23,10,72,65,1,5,1,4
E33024038,295,180,31,149,1,49,35,14,64,62,0,2,0,1
E33024039,789,505,155,350,8,184,151,33,89,84,0,5,0,3
E33024040,503,303,71,232,3,121,98,23,76,65,2,9,0,0
E33024041,1030,736,175,561,8,91,65,26,185,169,1,14,1,10
E33024042,344,255,63,192,6,32,21,11,51,44,1,4,2,0
E33024043,579,408,102,306,6,101,84,17,61,58,0,3,0,3
E33024044,377,280,72,208,6,43,34,9,46,43,0,2,1,2
E33024045,382,243,61,182,7,67,54,13,62,56,0,4,2,3
E33024046,268,187,36,151,3,59,54,5,18,18,0,0,0,1
E33024047,242,125,24,101,6,55,39,16,55,48,2,5,0,1
E33024048,696,370,90,280,3,229,195,34,91,90,0,1,0,3
E33024049,299,162,49,113,1,84,60,24,51,47,0,4,0,1
E33024050,566,372,97,275,9,116,90,26,68,63,1,4,0,1
E33024051,680,440,104,336,13,153,118,35,69,68,0,1,0,5
E33024052,237,144,28,116,1,60,49,11,32,29,1,1,1,0
E33024053,288,204,78,126,0,36,8,28,48,45,2,1,0,0
E33024054,439,348,112,236,1,30,7,23,58,47,1,4,6,2
E33024055,207,153,33,120,1,30,10,20,23,23,0,0,0,0
E33024056,506,392,87,305,0,57,8,49,56,53,0,3,0,1
E33024057,378,323,106,217,2,22,2,20,28,24,1,3,0,3
E33024058,1047,771,230,541,11,124,13,111,137,127,1,8,1,4
E33024059,490,353,112,241,2,53,8,45,81,74,2,5,0,1
E33024060,758,571,156,415,6,63,18,45,110,99,3,8,0,8
E33024061,266,189,49,140,2,22,4,18,50,48,0,2,0,3
E33024062,212,177,72,105,1,16,2,14,17,16,0,1,0,1
E33024063,531,412,121,291,4,34,2,32,77,75,0,2,0,4
E33024064,257,214,53,161,0,12,1,11,30,26,3,1,0,1
E33024065,354,303,74,229,1,17,4,13,31,30,0,1,0,2
E33024066,305,232,83,149,1,38,4,34,33,33,0,0,0,1
E33024067,247,201,52,149,1,21,13,8,22,22,0,0,0,2
E33024068,1136,762,239,523,6,119,58,61,246,235,1,9,1,3
E33024069,239,176,56,120,2,26,4,22,31,26,2,3,0,4
E33024070,421,338,95,243,6,17,5,12,57,48,0,9,0,3
E33024071,388,292,81,211,0,29,7,22,65,60,0,5,0,2
E33024072,224,184,39,145,0,9,3,6,31,30,0,1,0,0
E33024073,329,279,76,203,0,12,5,7,38,37,0,1,0,0
E33024074,308,242,71,171,0,18,6,12,43,40,0,3,0,5
E33024075,399,319,107,212,2,30,7,23,45,43,0,2,0,3
E33024076,824,702,147,555,6,19,10,9,96,90,0,5,1,1
E33024077,262,203,80,123,1,21,13,8,36,29,2,4,1,1
E33024078,404,290,95,195,2,32,15,17,74,69,0,5,0,6
E33024079,539,376,108,268,4,45,25,20,112,103,2,7,0,2
E33024080,877,620,201,419,2,46,29,17,208,200,0,8,0,1
E33024081,339,252,65,187,1,26,12,14,55,52,0,3,0,5
E33024082,573,440,151,289,2,18,14,4,107,101,0,5,1,6
E33024083,325,235,88,147,0,26,19,7,55,45,2,8,0,9
E33024084,274,186,55,131,0,17,9,8,70,56,10,4,0,1
E33024085,236,190,53,137,0,5,2,3,40,38,0,2,0,1
E33024086,286,201,54,147,0,19,7,12,65,62,0,3,0,1
E33024087,426,356,112,244,0,15,10,5,53,51,0,2,0,2
E33024088,247,186,56,130,0,5,1,4,53,44,2,6,1,3
E33024089,405,263,78,185,1,26,11,15,112,103,0,8,1,3
E33024090,381,279,68,211,3,18,8,10,80,72,0,6,2,1
E33024091,461,343,110,233,1,26,11,15,90,79,1,8,2,1
E33024092,720,590,215,375,5,39,31,8,83,75,1,6,1,3
E33024093,966,701,243,458,10,70,35,35,180,163,1,10,6,5
E33024094,511,344,83,261,4,60,38,22,96,90,0,6,0,7
E33024095,368,283,83,200,2,48,28,20,35,27,2,3,3,0
E33024096,482,375,118,257,4,20,6,14,76,68,5,2,1,7
E33024097,417,321,115,206,4,27,17,10,64,58,3,1,2,1
E33024098,252,161,47,114,2,23,12,11,66,62,0,3,1,0
E33024099,260,182,56,126,4,36,24,12,37,34,0,1,2,1
E33024100,311,221,66,155,2,33,14,19,55,48,1,6,0,0
E33024101,207,125,54,71,4,18,13,5,59,57,1,0,1,1
E33024102,263,208,62,146,4,21,14,7,29,24,1,4,0,1
E33024103,229,152,53,99,0,16,11,5,59,59,0,0,0,2
E33024104,324,234,49,185,3,27,12,15,59,56,2,1,0,1
E33024105,199,136,34,102,1,10,3,7,50,48,0,2,0,2
E33024106,515,367,106,261,3,55,34,21,83,79,0,4,0,7
E33024107,661,441,108,333,15,77,42,35,128,118,0,10,0,0
E33024108,5793,3763,903,2860,73,535,246,289,1393,1320,9,51,13,29
E33024109,555,361,79,282,9,35,13,22,145,140,0,5,0,5
E33024110,429,301,74,227,5,27,9,18,94,87,2,4,1,2
E33024111,240,180,55,125,3,23,8,15,28,25,1,1,1,6
E33024112,433,355,115,240,4,37,16,21,33,29,0,3,1,4
E33024113,3130,2201,466,1735,32,205,98,107,675,641,2,31,1,17
E33024114,227,177,57,120,0,22,11,11,28,25,3,0,0,0
E33024115,376,277,88,189,5,45,11,34,47,41,3,0,3,2
E33024116,519,398,93,305,7,66,19,47,45,44,0,1,0,3
E33024117,988,755,258,497,6,120,46,74,104,99,1,4,0,3
E33024118,1474,1150,236,914,11,79,45,34,225,211,0,13,1,9
E33024119,466,342,99,243,4,47,16,31,71,68,0,3,0,2
E33024120,458,324,99,225,5,61,21,40,67,62,0,5,0,1
E33024121,259,169,53,116,9,20,9,11,59,53,0,6,0,2
E33024122,320,218,59,159,7,55,27,28,39,34,0,5,0,1
E33024123,608,367,132,235,10,114,46,68,113,111,0,0,2,4
E33024124,301,214,67,147,3,52,22,30,30,24,0,5,1,2
E33024125,363,258,69,189,3,59,28,31,41,38,2,1,0,2
E33024126,295,167,39,128,4,46,24,22,78,76,0,2,0,0
E33024127,929,559,137,422,15,108,48,60,242,227,1,11,3,5
E33024128,870,594,184,410,13,138,88,50,125,114,0,11,0,0
E33024129,226,150,35,115,5,34,14,20,37,37,0,0,0,0
E33024130,551,376,119,257,6,80,42,38,85,83,0,2,0,4
E33024131,247,162,40,122,2,27,13,14,53,49,1,1,2,3
E33024132,340,226,73,153,5,62,23,39,47,42,0,4,1,0
E33024133,636,362,91,271,6,110,57,53,155,149,0,3,3,3
E33024134,382,275,89,186,3,53,27,26,48,44,0,3,1,3
E33024135,466,357,77,280,4,49,29,20,54,52,0,1,1,2
E33024136,655,508,118,390,5,54,40,14,87,84,0,3,0,1
E33024137,329,190,35,155,3,60,41,19,74,72,2,0,0,2
E33024138,596,479,103,376,4,28,16,12,84,82,0,2,0,1
E33024139,235,157,41,116,1,25,20,5,51,43,0,7,1,1
E33024140,324,221,58,163,1,44,28,16,58,57,0,1,0,0
E33024141,1254,885,160,725,14,81,43,38,266,256,0,10,0,8
E33024142,206,146,33,113,1,19,10,9,39,35,0,4,0,1
E33024143,416,300,83,217,5,52,38,14,57,54,1,2,0,2
E33024144,869,683,170,513,4,52,31,21,127,113,0,12,2,3
E33024145,401,268,68,200,4,47,39,8,82,76,0,4,2,0
E33024146,577,427,101,326,1,71,47,24,74,69,1,3,1,4
E33024147,1378,702,170,532,8,184,127,57,479,464,2,8,5,5
E33024148,450,282,53,229,8,87,53,34,71,70,0,1,0,2
E33024149,350,242,64,178,2,51,30,21,53,51,1,0,1,2
E33024150,247,141,36,105,3,41,30,11,60,55,0,5,0,2
E33024151,360,290,58,232,1,24,16,8,42,41,0,1,0,3
E33024152,357,212,69,143,4,91,58,33,50,48,0,2,0,0
E33024153,252,163,35,128,2,57,44,13,30,28,0,2,0,0
E33024154,1035,544,137,407,8,235,174,61,242,229,0,13,0,6
E33024155,546,389,80,309,14,71,54,17,71,65,0,6,0,1
E33024156,505,340,60,280,7,62,47,15,96,87,1,7,1,0
E33024157,1146,798,203,595,12,144,101,43,185,174,1,8,2,7
E33024158,797,518,103,415,9,128,86,42,139,125,2,11,1,3
E33024159,398,292,72,220,2,59,43,16,43,42,0,1,0,2
E33024160,399,244,80,164,6,83,51,32,65,57,0,7,1,1
E33024161,288,187,41,146,4,35,26,9,58,58,0,0,0,4
E33024162,483,345,95,250,5,52,35,17,78,75,0,3,0,3
E33024163,430,292,84,208,4,59,49,10,70,58,6,6,0,5
E33024164,249,169,51,118,3,36,29,7,40,37,3,0,0,1
E33024165,438,318,108,210,2,67,53,14,47,40,1,3,3,4
E33024166,458,326,98,228,3,57,42,15,70,67,2,1,0,2
E33024167,555,408,123,285,4,51,41,10,85,77,2,5,1,7
E33024168,294,227,57,170,1,11,7,4,54,50,0,3,1,1
E33024169,205,137,48,89,4,24,17,7,36,36,0,0,0,4
E33024170,842,587,199,388,6,160,111,49,86,83,0,2,1,3
E33024171,947,698,189,509,10,135,97,38,99,91,0,7,1,5
E33024172,1119,841,233,608,19,122,66,56,135,128,2,4,1,2
E33024173,339,259,90,169,1,37,27,10,37,30,1,6,0,5
E33024174,584,426,113,313,1,75,61,14,79,67,0,8,4,3
E33024175,502,345,119,226,3,63,50,13,84,76,2,6,0,7
E33024176,394,297,81,216,4,33,23,10,58,52,3,3,0,2
E33024177,217,133,40,93,1,27,15,12,53,49,1,2,1,3
E33024178,318,223,53,170,3,34,20,14,56,53,0,3,0,2
E33024179,735,528,132,396,7,57,30,27,139,134,1,4,0,4
E33024180,225,167,45,122,3,19,13,6,36,32,0,3,1,0
E33024181,261,179,37,142,4,27,11,16,50,46,1,3,0,1
E33024182,247,193,46,147,1,26,6,20,26,25,0,1,0,1
E33024183,350,265,70,195,5,27,8,19,52,46,0,5,1,1
E33024184,304,243,63,180,5,15,6,9,39,34,0,5,0,2
E33024185,233,179,38,141,7,9,1,8,37,32,1,4,0,1
E33024186,226,176,66,110,4,19,6,13,25,25,0,0,0,2
E33024187,711,459,120,339,9,132,48,84,107,100,0,7,0,4
E33024188,225,171,41,130,5,11,5,6,36,33,1,2,0,2
E33024189,457,336,89,247,2,62,21,41,54,54,0,0,0,3
E33024190,245,177,48,129,3,32,6,26,29,24,3,2,0,4
E33024191,414,310,80,230,5,34,14,20,61,51,2,8,0,4
E33024192,2289,1868,548,1320,27,192,65,127,195,185,2,8,0,7
E33024193,256,179,47,132,2,27,7,20,44,41,0,3,0,4
E33024194,398,261,75,186,4,49,16,33,81,77,0,2,2,3
E33024195,331,242,76,166,2,30,12,18,50,47,1,2,0,7
E33024196,201,158,44,114,0,19,5,14,22,16,3,3,0,2
E33024197,349,209,55,154,5,43,12,31,79,68,5,5,1,13
E33024198,208,155,25,130,6,24,8,16,23,22,0,1,0,0
E33024199,505,339,89,250,2,93,31,62,62,59,1,1,1,9
E33024200,393,307,89,218,4,21,9,12,59,54,1,3,1,2
E33024201,193,144,53,91,3,25,8,17,18,17,0,1,0,3
E33024202,255,193,52,141,6,24,7,17,31,28,1,2,0,1
E33024203,431,306,64,242,6,50,17,33,68,63,2,3,0,1
E33024204,280,204,72,132,9,31,15,16,35,33,0,2,0,1
E33024205,327,254,60,194,3,27,14,13,42,38,1,3,0,1
E33024206,379,300,58,242,2,35,15,20,42,40,1,1,0,0
E33024207,796,471,140,331,18,133,60,73,167,139,14,13,1,7
E33024208,379,276,82,194,2,53,28,25,46,41,1,1,3,2
E33024209,535,417,93,324,4,46,22,24,62,50,4,7,1,6
E33024210,331,240,78,162,5,27,14,13,52,41,3,8,0,7
E33024211,454,295,85,210,6,89,27,62,60,55,1,4,0,4
E33024212,313,221,64,157,5,32,8,24,51,46,0,5,0,4
E33024213,214,154,35,119,0,27,4,23,30,29,0,1,0,3
E33024214,722,533,139,394,13,100,27,73,71,64,5,2,0,5
E33024215,1367,1076,248,828,10,111,44,67,161,154,2,2,3,9
E33024216,284,177,63,114,5,31,7,24,49,37,10,0,2,22
E33024217,1204,859,257,602,18,95,36,59,205,172,22,9,2,27
E33024218,259,179,64,115,1,26,4,22,47,40,7,0,0,6
E33024219,203,129,37,92,4,36,14,22,34,32,1,1,0,0
E33024220,882,503,116,387,28,170,43,127,169,158,1,8,2,12
E33024221,390,274,69,205,5,38,12,26,73,69,1,1,2,0
E33024222,293,197,52,145,4,39,8,31,50,45,0,5,0,3
E33024223,587,408,121,287,11,101,31,70,66,63,0,2,1,1
E33024224,560,380,109,271,5,71,14,57,94,88,0,5,1,10
E33024225,423,279,68,211,12,68,27,41,62,56,2,4,0,2
E33024226,1563,1031,240,791,23,215,58,157,290,275,3,10,2,4
E33024227,362,203,75,128,9,72,21,51,77,73,2,2,0,1
E33024228,518,389,106,283,9,52,14,38,66,60,2,4,0,2
E33024229,504,292,73,219,11,67,24,43,133,128,1,2,2,1
E33024230,222,147,42,105,7,41,7,34,24,24,0,0,0,3
E33024231,622,408,89,319,9,79,31,48,120,112,2,2,4,6
E33024232,386,271,59,212,3,45,18,27,65,62,0,2,1,2
E33024233,357,243,84,159,1,21,10,11,89,82,5,1,1,3
E33024234,480,310,84,226,7,54,23,31,108,103,0,4,1,1
E33024235,257,150,37,113,5,31,10,21,70,64,2,4,0,1
E33024236,449,328,90,238,10,49,16,33,62,60,1,0,1,0
E33024237,1097,684,186,498,17,159,62,97,224,206,3,7,8,13
E33024238,288,206,56,150,3,27,6,21,44,41,0,3,0,8
E33024239,209,113,31,82,6,15,5,10,74,71,0,2,1,1
E33024240,282,195,53,142,1,30,10,20,51,49,1,1,0,5
E33024241,554,387,105,282,7,39,21,18,118,107,4,5,2,3
E33024242,370,257,65,192,2,29,13,16,79,72,0,7,0,3
E33024243,353,228,65,163,9,51,18,33,63,61,0,0,2,2
E33024244,783,536,177,359,12,101,42,59,130,124,1,3,2,4
E33024245,276,175,49,126,1,32,15,17,64,58,0,6,0,4
E33024246,235,161,37,124,3,40,19,21,29,27,0,2,0,2
E33024247,224,148,49,99,2,41,17,24,31,30,1,0,0,2
E33024248,236,180,62,118,1,24,10,14,29,25,2,2,0,2
E33024249,236,155,41,114,1,37,9,28,40,36,1,3,0,3
E33024250,324,222,64,158,3,39,19,20,59,54,0,5,0,1
E33024251,1194,869,220,649,14,93,33,60,216,195,2,15,4,2
E33024252,430,286,75,211,4,56,28,28,78,70,2,6,0,6
E33024253,370,202,56,146,6,69,32,37,91,89,0,2,0,2
E33024254,688,482,151,331,8,47,22,25,150,144,1,3,2,1
E33024255,612,391,115,276,7,76,26,50,129,121,4,2,2,9
E33024256,436,296,73,223,8,70,28,42,60,53,0,5,2,2
E33024257,240,145,41,104,2,35,17,18,58,52,2,3,1,0
E33024258,329,231,63,168,2,54,14,40,41,37,0,3,1,1
E33024259,362,252,51,201,4,49,24,25,53,51,0,1,1,4
E33024260,725,501,145,356,9,105,50,55,109,103,1,4,1,1
E33024261,704,467,132,335,6,112,50,62,117,111,1,5,0,2
E33024262,334,246,76,170,4,50,25,25,33,30,0,3,0,1
E33024263,296,168,44,124,1,67,37,30,58,51,2,3,2,2
E33024264,262,178,48,130,1,29,14,15,49,43,0,5,1,5
E33024265,1604,1178,237,941,23,149,73,76,246,226,3,17,0,8
E33024266,240,177,71,106,3,14,10,4,37,32,3,1,1,9
E33024267,693,399,100,299,17,186,66,120,90,83,1,6,0,1
E33024268,325,219,62,157,7,47,20,27,51,48,1,2,0,1
E33024269,713,520,124,396,7,106,42,64,75,69,0,4,2,5
E33024270,198,123,32,91,5,37,16,21,32,31,0,1,0,1
E33024271,204,115,37,78,2,61,29,32,25,22,0,3,0,1
E33024272,397,275,76,199,8,46,21,25,68,61,0,6,1,0
E33024273,206,130,36,94,3,50,19,31,23,19,0,4,0,0
E33024274,337,222,74,148,4,73,28,45,36,32,0,4,0,2
E33024275,376,249,50,199,8,79,24,55,40,36,0,4,0,0
E33024276,1031,711,186,525,12,161,65,96,139,129,0,8,2,8
E33024277,330,223,52,171,1,53,24,29,52,51,1,0,0,1
E33024278,513,329,98,231,7,110,45,65,65,62,1,2,0,2
E33024279,258,196,47,149,2,29,10,19,30,29,1,0,0,1
E33024280,466,302,89,213,8,72,29,43,80,71,0,8,1,4
E33024281,391,257,90,167,4,73,23,50,56,53,0,3,0,1
E33024282,293,196,47,149,3,60,28,32,34,32,2,0,0,0
E33024283,371,238,57,181,4,77,36,41,48,45,0,2,1,4
E33024284,225,149,46,103,3,42,15,27,29,26,0,2,1,2
E33024285,201,145,36,109,2,30,7,23,24,22,0,2,0,0
E33024286,199,116,37,79,3,56,15,41,22,20,0,1,1,2
E33024287,238,138,39,99,4,55,12,43,40,39,0,0,1,1
E33024288,528,274,76,198,5,168,47,121,79,67,1,3,8,2
E33024289,217,164,37,127,3,18,8,10,31,27,0,3,1,1
E33024290,375,210,65,145,5,120,37,83,39,36,1,1,1,1
E33024291,586,439,138,301,7,72,24,48,66,65,0,1,0,2
E33024292,1056,714,219,495,19,166,91,75,151,137,3,10,1,6
E33024293,286,188,44,144,4,42,18,24,51,44,1,6,0,1
E33024294,395,294,78,216,4,46,21,25,50,46,0,4,0,1
E33024295,2005,1408,337,1071,26,218,115,103,343,330,3,7,3,10
E33024296,207,151,50,101,2,28,12,16,23,23,0,0,0,3
E33024297,251,183,53,130,3,27,15,12,37,35,0,2,0,1
E33024298,281,209,65,144,2,36,15,21,30,28,2,0,0,4
E33024299,257,211,85,126,2,18,12,6,22,20,0,2,0,4
E33024300,635,427,133,294,7,90,62,28,108,100,0,8,0,3
E33024301,249,194,47,147,1,18,8,10,33,30,1,2,0,3
E33024302,1133,747,201,546,17,192,117,75,173,166,3,3,1,4
E33024303,1058,639,196,443,7,186,110,76,223,208,2,12,1,3
E33024304,313,241,70,171,1,28,24,4,40,39,0,1,0,3
E33024305,231,169,45,124,0,23,16,7,39,36,2,0,1,0
E33024306,445,311,98,213,3,46,33,13,80,76,1,2,1,5
E33024307,312,224,72,152,0,32,21,11,55,48,2,3,2,1
E33024308,276,200,73,127,4,17,12,5,53,48,1,4,0,2
E33024309,214,163,39,124,2,15,8,7,32,32,0,0,0,2
E33024310,239,168,63,105,2,15,8,7,53,49,1,3,0,1
E33024311,263,205,60,145,0,18,14,4,32,29,0,3,0,8
E33024312,257,202,56,146,0,10,8,2,43,43,0,0,0,2
E33024313,822,442,105,337,10,135,78,57,226,211,4,10,1,9
E33024314,271,205,63,142,3,30,19,11,33,27,0,3,3,0
E33024315,288,229,61,168,2,23,14,9,32,31,0,1,0,2
E33024316,437,317,79,238,8,37,24,13,73,66,2,4,1,2
E33024317,288,184,41,143,2,19,11,8,83,73,2,8,0,0
E33024318,330,192,67,125,1,80,45,35,56,48,2,6,0,1
E33024319,560,397,99,298,6,76,38,38,78,69,5,4,0,3
E33024320,971,603,152,451,10,145,68,77,209,199,2,7,1,4
E33024321,352,199,50,149,2,64,37,27,85,79,1,4,1,2
E33024322,483,361,93,268,5,48,26,22,68,61,1,5,1,1
E33024323,280,198,49,149,2,23,13,10,55,51,0,1,3,2
E33024324,343,267,71,196,4,17,12,5,55,50,0,4,1,0
E33024325,269,195,48,147,0,23,17,6,51,45,0,5,1,0
E33024326,398,300,83,217,9,41,29,12,47,45,0,2,0,1
E33024327,358,217,63,154,0,92,60,32,44,40,2,2,0,5
E33024328,753,531,135,396,7,83,55,28,126,117,0,6,3,6
E33024329,224,162,48,114,0,31,21,10,31,29,0,2,0,0
E33024330,302,188,63,125,3,47,28,19,63,56,1,6,0,1
E33024331,342,196,52,144,2,46,29,17,96,89,2,3,2,2
E33024332,655,431,131,300,6,109,68,41,103,98,0,4,1,6
E33024333,198,152,30,122,1,12,3,9,33,30,0,2,1,0
E33024334,205,129,31,98,2,22,16,6,48,45,0,3,0,4
E33024335,226,158,56,102,1,14,6,8,48,42,4,2,0,5
E33024336,363,191,49,142,2,47,24,23,118,110,1,5,2,5
E33024337,321,212,57,155,2,34,25,9,68,66,0,2,0,5
E33024338,260,194,65,129,3,25,14,11,37,37,0,0,0,1
E33024339,538,397,114,283,5,15,8,7,118,107,5,6,0,3
E33024340,515,361,116,245,8,52,34,18,92,88,0,4,0,2
E33024341,786,579,157,422,10,57,36,21,135,122,0,11,2,5
E33024342,772,552,151,401,4,48,30,18,163,157,1,3,2,5
E33024343,943,736,245,491,8,50,19,31,146,139,0,6,1,3
E33024344,261,156,51,105,1,50,31,19,54,53,0,0,1,0
E33024345,356,244,59,185,3,50,39,11,57,54,0,3,0,2
E33024346,749,533,138,395,5,96,59,37,112,105,0,7,0,3
E33024347,797,646,138,508,4,24,13,11,118,115,0,3,0,5
E33024348,313,204,57,147,3,28,16,12,78,69,0,7,2,0
E33024349,602,381,118,263,3,54,40,14,143,128,12,1,2,21
E33024350,222,156,32,124,5,36,23,13,25,20,0,5,0,0
E33024351,598,344,73,271,9,146,104,42,98,93,1,4,0,1
E33024352,374,226,44,182,4,92,63,29,52,45,1,6,0,0
E33024353,1578,1023,274,749,17,225,162,63,298,274,4,18,2,15
E33024354,2133,1594,463,1131,17,158,93,65,356,339,1,16,0,8
E33024355,324,232,80,152,9,58,35,23,24,15,0,9,0,1
E33024356,320,181,34,147,1,78,61,17,58,53,0,5,0,2
E33024357,235,136,36,100,2,48,39,9,47,46,0,1,0,2
E33024358,855,508,122,386,14,225,167,58,100,84,0,14,2,8
E33024359,713,505,115,390,8,119,76,43,77,69,1,6,1,4
E33024360,314,187,41,146,9,50,40,10,66,64,0,2,0,2
E33024361,354,252,33,219,11,58,44,14,31,25,1,5,0,2
E33024362,322,215,45,170,3,46,35,11,58,53,0,2,3,0
E33024363,380,253,80,173,3,72,53,19,48,44,1,3,0,4
E33024364,710,430,77,353,10,176,141,35,92,87,1,3,1,2
E33024365,347,177,43,134,4,111,80,31,54,48,1,5,0,1
E33024366,435,296,66,230,7,70,45,25,59,54,0,5,0,3
E33024367,432,198,40,158,3,160,122,38,71,66,0,5,0,0
E33024368,632,384,109,275,15,123,97,26,109,97,0,7,5,1
E33024369,649,396,99,297,7,133,84,49,108,103,0,3,2,5
E33024370,2303,1834,614,1220,14,170,109,61,279,267,0,12,0,6
E33024371,638,446,126,320,8,103,73,30,78,72,0,4,2,3
E33024372,675,399,114,285,9,168,115,53,99,92,0,6,1,0
E33024373,324,229,60,169,2,52,39,13,41,39,0,1,1,0
E33024374,510,368,105,263,2,83,59,24,56,51,0,4,1,1
E33024375,323,225,56,169,3,55,37,18,40,36,0,4,0,0
E33024376,475,301,89,212,5,101,61,40,64,55,0,7,2,4
E33024377,400,266,75,191,1,72,47,25,59,54,0,4,1,2
E33024378,355,222,51,171,6,72,49,23,54,50,0,4,0,1
E33024379,1612,1231,316,915,18,170,83,87,183,163,4,16,0,10
E33024380,378,226,50,176,5,59,41,18,88,82,2,4,0,0
E33024381,337,211,55,156,2,76,53,23,45,41,0,4,0,3
E33024382,760,564,139,425,2,75,49,26,116,108,1,7,0,3
E33024383,1524,1031,234,797,19,259,147,112,208,192,3,13,0,7
E33024384,441,270,73,197,6,101,75,26,59,54,2,3,0,5
E33024385,795,455,119,336,8,98,61,37,231,219,1,11,0,3
E33024386,393,208,38,170,5,88,53,35,91,85,0,5,1,1
E33024387,3424,2345,585,1760,50,502,297,205,514,480,10,22,2,13
E33024388,1106,672,153,519,7,75,45,30,350,337,0,12,1,2
E33024389,995,703,124,579,10,59,22,37,217,205,2,9,1,6
E33024390,333,250,55,195,3,15,5,10,62,59,0,3,0,3
E33024391,378,295,51,244,3,27,10,17,52,46,1,2,3,1
E33024392,366,258,83,175,3,45,13,32,57,54,0,3,0,3
E33024393,302,228,78,150,4,26,9,17,39,33,4,2,0,5
E33024394,1279,976,232,744,14,87,41,46,199,187,0,11,1,3
E33024395,633,495,98,397,4,29,14,15,101,96,0,5,0,4
E33024396,792,553,137,416,9,114,67,47,113,107,0,4,2,3
E33024397,1548,821,198,623,9,148,59,89,560,270,183,6,101,10
E33024398,461,277,73,204,4,92,47,45,83,75,1,5,2,5
E33024399,502,322,102,220,11,84,35,49,81,75,1,4,1,4
E33024400,201,163,43,120,0,19,7,12,18,17,0,0,1,1
E33024401,232,176,57,119,1,19,9,10,33,29,2,2,0,3
E33024402,260,181,50,131,5,29,13,16,43,40,1,2,0,2
E33024403,634,459,91,368,11,41,12,29,120,108,2,9,1,3
E33024404,601,412,132,280,11,39,13,26,127,73,45,4,5,12
E33024405,264,180,60,120,2,36,18,18,45,44,1,0,0,1
E33024406,209,156,55,101,2,11,5,6,38,33,1,4,0,2
E33024407,247,189,56,133,2,18,9,9,36,35,1,0,0,2
E33024408,620,450,137,313,6,51,16,35,106,98,0,8,0,7
E33024409,477,355,94,261,3,34,10,24,82,74,0,6,2,3
E33024410,216,155,58,97,1,24,11,13,32,27,4,1,0,4
E33024411,1164,840,215,625,8,91,34,57,222,210,1,7,4,3
E33024412,581,443,145,298,6,54,19,35,75,73,1,1,0,3
E33024413,272,170,40,130,3,35,10,25,63,60,1,2,0,1
E33024414,217,109,33,76,2,51,23,28,50,47,1,0,2,5
E33024415,578,351,96,255,9,112,39,73,105,97,2,5,1,1
E33024416,299,173,47,126,0,48,21,27,77,73,0,4,0,1
E33024417,539,334,105,229,8,89,35,54,104,88,2,12,2,4
E33024418,429,310,64,246,5,21,5,16,91,87,0,4,0,2
E33024419,531,362,90,272,8,57,16,41,98,94,1,2,1,6
E33024420,357,287,65,222,6,19,7,12,45,39,0,5,1,0
E33024421,325,241,55,186,2,24,12,12,57,56,0,1,0,1
E33024422,889,569,117,452,7,48,17,31,262,251,0,11,0,3
E33024423,428,271,95,176,2,79,29,50,75,70,1,3,1,1
E33024424,247,147,37,110,4,35,11,24,61,60,0,0,1,0
E33024425,224,143,49,94,4,18,8,10,55,54,0,1,0,4
E33024426,279,180,58,122,4,23,13,10,71,67,1,3,0,1
E33024427,241,184,51,133,1,14,3,11,40,40,0,0,0,2
E33024428,215,161,45,116,2,15,3,12,37,35,0,1,1,0
E33024429,286,190,66,124,4,23,10,13,65,58,2,5,0,4
E33024430,293,204,66,138,2,33,17,16,53,52,0,1,0,1
E33024431,239,149,35,114,4,33,12,21,49,44,0,5,0,4
E33024432,287,195,69,126,4,37,12,25,50,47,1,1,1,1
E33024433,297,177,41,136,4,47,12,35,63,59,1,3,0,6
E33024434,586,366,116,250,16,109,38,71,91,84,1,5,1,4
E33024435,250,159,37,122,3,22,7,15,63,58,0,4,1,3
E33024436,257,155,39,116,2,51,13,38,48,47,0,1,0,1
E33024437,268,166,58,108,3,56,20,36,41,40,1,0,0,2
E33024438,1221,892,200,692,21,58,26,32,247,231,3,11,2,3
E33024439,310,238,67,171,2,25,9,16,43,42,0,1,0,2
E33024440,303,205,41,164,12,22,11,11,59,51,0,7,1,5
E33024441,575,376,83,293,9,62,25,37,125,115,2,6,2,3
E33024442,329,240,65,175,2,35,13,22,48,44,0,3,1,4
E33024443,339,208,48,160,11,48,18,30,71,69,0,2,0,1
E33024444,246,184,53,131,2,32,10,22,28,27,0,0,1,0
E33024445,452,327,80,247,7,43,17,26,73,71,1,1,0,2
E33024446,226,156,41,115,1,19,10,9,47,43,0,1,3,3
E33024447,456,297,91,206,7,64,27,37,87,79,4,3,1,1
E33024448,466,312,102,210,4,69,24,45,76,69,0,7,0,5
E33024449,342,262,76,186,2,22,8,14,52,51,0,1,0,4
E33024450,1088,756,200,556,18,179,63,116,133,118,1,12,2,2
E33024451,413,266,76,190,10,29,14,15,107,97,0,10,0,1
E33024452,844,601,182,419,10,110,31,79,118,110,3,5,0,5
E33024453,346,268,88,180,4,35,13,22,36,32,0,4,0,3
E33024454,431,336,117,219,6,47,19,28,40,35,1,4,0,2
E33024455,530,376,108,268,7,77,32,45,62,58,1,2,1,8
E33024456,528,324,95,229,6,112,30,82,82,78,2,2,0,4
E33024457,228,171,44,127,0,18,8,10,38,33,0,5,0,1
E33024458,282,188,51,137,7,42,13,29,42,38,0,4,0,3
E33024459,521,373,106,267,6,65,31,34,74,68,1,5,0,3
E33024460,614,422,108,314,8,44,21,23,136,127,0,9,0,4
E33024461,546,395,85,310,5,48,23,25,96,93,0,3,0,2
E33024462,281,229,59,170,0,9,2,7,42,41,0,1,0,1
E33024463,222,159,42,117,4,14,4,10,42,37,0,3,2,3
E33024464,727,515,131,384,6,56,23,33,149,140,4,4,1,1
E33024465,3411,2283,604,1679,47,425,154,271,639,591,9,22,17,17
E33024466,1649,1154,233,921,20,106,69,37,357,346,0,11,0,12
E33024467,4188,2987,589,2398,45,242,154,88,900,858,6,34,2,14
E33024468,526,356,116,240,6,105,70,35,58,51,4,3,0,1
E33024469,225,158,45,113,1,47,35,12,19,17,0,2,0,0
E33024470,405,293,68,225,5,57,41,16,49,45,0,4,0,1
E33024471,389,279,84,195,3,69,39,30,38,37,0,1,0,0
E33024472,234,159,27,132,2,45,32,13,28,24,0,4,0,0
E33024473,303,193,58,135,3,60,39,21,44,39,0,5,0,3
E33024474,716,477,158,319,12,135,88,47,90,83,0,6,1,2
E33024475,208,131,18,113,1,37,26,11,39,38,1,0,0,0
E33024476,298,204,57,147,2,48,40,8,44,42,0,2,0,0
E33024477,203,126,28,98,2,34,27,7,40,39,0,1,0,1
E33024478,197,116,17,99,3,41,30,11,36,34,1,1,0,1
E33024479,1238,919,255,664,17,179,120,59,112,105,5,2,0,11
E33024480,369,278,88,190,12,46,31,15,32,30,1,1,0,1
E33024481,934,586,139,447,7,224,160,64,113,110,0,2,1,4
E33024482,933,691,178,513,9,122,76,46,106,97,2,6,1,5
E33024483,263,159,32,127,1,46,36,10,54,52,0,2,0,3
E33024484,2158,1707,280,1427,52,176,114,62,205,178,4,21,2,18
E33024485,706,259,59,200,9,121,84,37,309,303,1,4,1,8
E33024486,212,123,42,81,4,47,36,11,38,36,0,2,0,0
E33024487,823,343,94,249,9,296,235,61,171,166,0,4,1,4
E33024488,626,395,74,321,12,93,58,35,126,118,2,5,1,0
E33024489,207,134,35,99,2,35,30,5,34,31,0,3,0,2
E33024490,469,304,76,228,3,109,66,43,51,47,0,2,2,2
E33024491,967,553,153,400,9,237,159,78,164,154,4,6,0,4
E33024492,2983,2100,694,1406,23,220,140,80,626,598,8,18,2,14
E33024493,725,541,160,381,8,56,37,19,113,107,0,6,0,7
E33024494,357,221,65,156,4,85,58,27,44,41,0,3,0,3
E33024495,499,241,62,179,4,147,99,48,103,97,0,3,3,4
E33024496,309,186,37,149,5,59,46,13,59,58,0,1,0,0
E33024497,557,415,111,304,5,67,47,20,69,60,0,9,0,1
E33024498,607,408,89,319,9,53,29,24,132,122,0,6,4,5
E33024499,310,159,40,119,3,113,85,28,33,26,1,5,1,2
E33024500,692,436,98,338,8,149,90,59,95,91,0,2,2,4
E33024501,725,492,123,369,7,113,78,35,111,106,1,4,0,2
E33024502,809,483,119,364,4,201,128,73,118,114,1,2,1,3
E33024503,213,134,42,92,1,50,31,19,26,26,0,0,0,2
E33024504,207,142,39,103,1,31,17,14,33,33,0,0,0,0
E33024505,489,290,77,213,1,98,56,42,92,90,0,2,0,8
E33024506,898,585,137,448,8,158,108,50,143,138,1,4,0,4
E33024507,923,508,163,345,16,86,28,58,301,290,1,10,0,12
E33024508,916,697,217,480,5,76,15,61,135,123,2,8,2,3
E33024509,539,376,121,255,6,59,13,46,95,85,3,7,0,3
E33024510,314,208,67,141,2,36,9,27,67,56,4,5,2,1
E33024511,325,250,83,167,5,18,5,13,49,42,1,3,3,3
E33024512,335,251,80,171,3,10,3,7,62,55,5,2,0,9
E33024513,690,474,159,315,9,73,17,56,124,105,9,9,1,10
E33024514,340,254,100,154,1,34,9,25,48,43,2,1,2,3
E33024515,550,398,103,295,5,57,19,38,86,70,6,9,1,4
E33024516,540,367,129,238,3,64,9,55,100,82,10,8,0,6
E33024517,225,93,17,76,1,30,12,18,101,96,2,3,0,0
E33024518,212,127,31,96,6,24,8,16,55,51,0,3,1,0
E33024519,250,169,30,139,0,41,7,34,38,33,4,0,1,2
E33024520,378,243,51,192,3,57,10,47,72,59,6,5,2,3
E33024521,177,137,33,104,0,19,4,15,21,20,0,1,0,0
E33024522,531,344,94,250,3,57,12,45,126,118,0,8,0,1
E33024523,924,535,130,405,15,157,30,127,205,193,7,5,0,12
E33024524,1074,687,171,516,18,132,38,94,236,222,1,9,4,1
E33024525,374,293,105,188,4,26,9,17,43,38,0,5,0,8
E33024526,398,275,82,193,5,37,12,25,75,66,2,6,1,6
E33024527,223,120,36,84,2,22,7,15,66,47,17,1,1,13
E33024528,602,308,90,218,1,35,5,30,237,202,19,6,10,21
E33024529,235,164,64,100,1,22,3,19,46,43,1,2,0,2
E33024530,395,263,76,187,5,72,39,33,54,48,4,2,0,1
E33024531,3109,2197,537,1660,22,256,136,120,610,558,5,40,7,24
E33024532,250,206,55,151,0,15,0,15,28,26,2,0,0,1
E33024533,1149,722,216,506,11,127,54,73,277,255,11,7,4,12
E33024534,1117,828,224,604,10,90,49,41,185,174,1,10,0,4
E33024535,886,639,195,444,11,112,68,44,119,108,0,11,0,5
E33024536,206,133,28,105,2,27,19,8,44,39,2,3,0,0
E33024537,682,501,161,340,8,74,40,34,92,84,0,7,1,7
E33024538,414,294,89,205,7,67,43,24,46,45,0,1,0,0
E33024539,843,633,155,478,6,89,49,40,112,99,1,10,2,3
E33024540,399,265,72,193,8,66,37,29,59,48,0,11,0,1
E33024541,367,286,90,196,3,34,16,18,43,38,0,5,0,1
E33024542,772,546,161,385,8,103,61,42,111,104,0,7,0,4
E33024543,466,358,92,266,6,27,8,19,74,69,2,3,0,1
E33024544,579,399,123,276,3,84,37,47,90,80,1,9,0,3
E33024545,356,266,78,188,5,40,21,19,41,38,0,3,0,4
E33024546,215,176,51,125,1,13,6,7,22,21,0,1,0,3
E33024547,733,555,167,388,3,44,30,14,126,120,0,6,0,5
E33024548,403,317,72,245,3,32,24,8,48,41,2,4,1,3
E33024549,815,689,207,482,2,34,26,8,89,85,0,2,2,1
E33024550,876,678,188,490,3,56,39,17,138,122,2,10,4,1
E33024551,205,134,31,103,1,34,19,15,36,34,0,1,1,0
E33024552,255,162,44,118,1,31,19,12,61,53,1,6,1,0
E33024553,818,560,208,352,8,101,77,24,147,135,2,7,3,2
E33024554,189,131,27,104,1,15,11,4,41,38,0,3,0,1
E33024555,565,408,134,274,1,64,47,17,85,77,1,6,1,7
E33024556,342,268,65,203,2,21,13,8,47,44,0,3,0,4
E33024557,604,452,149,303,2,51,39,12,94,91,0,3,0,5
E33024558,478,282,83,199,2,51,42,9,140,130,0,9,1,3
E33024559,218,135,47,88,0,19,12,7,62,60,0,2,0,2
E33024560,318,258,73,185,1,19,11,8,39,37,0,1,1,1
E33024561,474,357,115,242,0,40,27,13,76,58,4,14,0,1
E33024562,200,163,51,112,1,16,13,3,19,15,0,1,3,1
E33024563,617,444,108,336,0,46,34,12,123,116,0,7,0,4
E33024564,232,181,47,134,0,20,16,4,30,28,0,2,0,1
E33024565,260,214,61,153,0,14,12,2,32,28,0,3,1,0
E33024566,306,238,83,155,0,29,22,7,37,36,0,1,0,2
E33024567,458,324,102,222,3,63,52,11,68,66,0,2,0,0
E33024568,193,130,30,100,0,24,14,10,39,33,1,5,0,0
E33024569,443,327,80,247,1,42,33,9,72,68,2,2,0,1
E33024570,506,325,99,226,5,87,68,19,85,78,1,6,0,4
E33024571,221,160,57,103,0,24,21,3,36,32,3,1,0,1
E33024572,292,204,47,157,0,29,17,12,57,51,0,1,5,2
E33024573,1562,1165,315,850,5,131,95,36,253,228,1,19,5,8
E33024574,707,544,155,389,4,43,9,34,107,96,4,6,1,9
E33024575,211,146,41,105,0,15,5,10,49,45,1,0,3,1
E33024576,276,202,82,120,0,21,8,13,49,43,0,5,1,4
E33024577,331,245,85,160,2,33,14,19,47,32,8,6,1,4
E33024578,1058,787,207,580,7,90,18,72,158,137,6,7,8,16
E33024579,689,560,174,386,4,36,10,26,85,75,0,7,3,4
E33024580,227,168,67,101,1,24,6,18,34,29,0,5,0,0
E33024581,926,728,182,546,3,57,11,46,134,119,3,10,2,4
E33024582,960,741,205,536,11,66,20,46,134,118,5,10,1,8
E33024583,268,181,45,136,2,19,4,15,64,60,1,2,1,2
E33024584,700,455,123,332,6,78,20,58,152,128,9,12,3,9
E33024585,269,188,49,139,0,24,6,18,55,48,0,6,1,2
E33024586,208,149,39,110,2,17,2,15,37,36,0,1,0,3
E33024587,326,251,73,178,3,23,5,18,47,44,1,2,0,2
E33024588,968,710,200,510,6,75,17,58,168,143,4,14,7,9
E33024589,334,272,80,192,3,14,3,11,45,38,0,6,1,0
E33024590,234,167,43,124,2,22,6,16,36,32,0,4,0,7
E33024591,601,400,126,274,3,85,20,65,106,93,3,8,2,7
E33024592,452,325,88,237,5,45,12,33,73,64,0,8,1,4
E33024593,349,252,55,197,4,17,3,14,70,65,1,3,1,6
E33024594,232,196,58,138,0,5,1,4,29,25,0,4,0,2
E33024595,264,194,52,142,5,20,8,12,40,35,3,2,0,5
E33024596,722,551,139,412,6,40,10,30,120,114,2,2,2,5
E33024597,548,401,129,272,1,51,11,40,93,83,1,7,2,2
E33024598,838,599,152,447,3,73,21,52,158,135,10,10,3,5
E33024599,301,244,75,169,0,15,7,8,42,42,0,0,0,0
E33024600,852,616,199,417,10,83,15,68,133,125,1,5,2,10
E33024601,363,284,79,205,2,26,4,22,50,48,1,1,0,1
E33024602,210,162,54,108,3,17,5,12,27,22,3,1,1,1
E33024603,340,259,58,201,0,26,6,20,53,50,1,1,1,2
E33024604,825,385,89,296,10,147,67,80,278,267,2,5,4,5
E33024605,242,170,44,126,1,25,7,18,45,41,0,4,0,1
E33024606,244,182,43,139,4,18,4,14,38,36,1,0,1,2
E33024607,408,308,84,224,3,22,6,16,72,70,0,1,1,3
E33024608,397,283,101,182,4,37,12,25,69,64,1,4,0,4
E33024609,817,623,173,450,11,65,14,51,116,107,1,8,0,2
E33024610,2742,2091,563,1528,18,135,21,114,478,428,16,30,4,20
E33024611,338,228,95,133,7,43,15,28,57,55,1,1,0,3
E33024612,347,236,89,147,2,35,3,32,73,69,0,4,0,1
E33024613,361,292,85,207,3,16,3,13,48,44,0,4,0,2
E33024614,399,300,108,192,1,25,6,19,68,64,1,3,0,5
E33024615,322,221,84,137,1,40,11,29,59,53,2,4,0,1
E33024616,558,392,175,217,4,56,11,45,98,92,2,4,0,8
E33024617,225,167,75,92,0,16,2,14,41,36,0,5,0,1
E33024618,833,474,152,322,7,102,27,75,241,225,1,13,2,9
E33024619,259,144,64,80,1,52,20,32,57,53,2,1,1,5
E33024620,372,261,87,174,1,40,9,31,66,60,1,5,0,4
E33024621,245,171,60,111,1,30,8,22,40,39,0,1,0,3
E33024622,269,168,69,99,0,39,6,33,61,58,1,2,0,1
E33024623,227,171,67,104,1,11,2,9,38,26,1,10,1,6
E33024624,390,260,80,180,1,39,10,29,86,78,2,6,0,4
E33024625,240,173,60,113,1,17,4,13,46,42,3,1,0,3
E33024626,382,275,105,170,2,46,8,38,58,54,0,4,0,1
E33024627,174,120,41,79,0,30,12,18,21,19,1,1,0,3
E33024628,800,572,175,397,4,93,16,77,130,114,4,12,0,1
E33024629,122,73,18,55,1,38,14,24,9,7,0,1,1,1
E33024630,1347,887,242,645,15,206,126,80,234,214,3,13,4,5
E33024631,200,139,43,96,0,33,19,14,27,25,0,2,0,1
E33024632,378,257,85,172,8,63,45,18,49,45,0,4,0,1
E33024633,1184,481,120,361,12,180,122,58,508,494,2,12,0,3
E33024634,431,305,72,233,2,46,26,20,78,72,2,4,0,0
E33024635,229,162,52,110,2,33,21,12,28,25,1,1,1,4
E33024636,423,298,94,204,7,62,38,24,54,43,0,11,0,2
E33024637,575,408,82,326,4,53,36,17,110,100,2,7,1,0
E33024638,305,190,61,129,2,64,47,17,48,41,0,7,0,1
E33024639,941,629,188,441,13,141,83,58,151,136,1,11,3,7
E33024640,2513,2057,634,1423,18,133,77,56,294,273,1,15,5,11
E33024641,222,161,42,119,2,15,6,9,43,39,0,4,0,1
E33024642,253,166,38,128,2,20,16,4,64,62,0,2,0,1
E33024643,1306,923,228,695,17,72,37,35,287,262,1,22,2,7
E33024644,509,279,62,217,5,91,58,33,130,121,1,7,1,4
E33024645,229,152,37,115,2,38,26,12,36,35,0,1,0,1
E33024646,487,335,96,239,5,60,41,19,83,76,0,7,0,4
E33024647,414,251,76,175,1,63,41,22,97,86,4,6,1,2
E33024648,799,583,158,425,5,49,27,22,158,146,0,12,0,4
E33024649,370,239,55,184,5,44,23,21,80,74,1,5,0,2
E33024650,211,171,51,120,3,7,2,5,29,26,1,1,1,1
E33024651,255,151,35,116,4,32,18,14,67,59,7,1,0,1
E33024652,3691,2874,545,2329,32,156,85,71,612,560,1,48,3,17
E33024653,337,225,75,150,4,31,17,14,72,69,0,3,0,5
E33024654,344,217,73,144,2,42,19,23,80,72,0,8,0,3
E33024655,253,139,33,106,2,33,18,15,76,68,1,7,0,3
E33024656,1057,587,164,423,13,173,109,64,274,262,3,9,0,10
E33024657,278,219,61,158,2,6,3,3,50,46,0,3,1,1
E33024658,421,246,78,168,6,78,49,29,87,80,0,7,0,4
E33024659,321,216,67,149,2,51,29,22,49,40,2,6,1,3
E33024660,438,231,60,171,4,68,40,28,130,125,1,3,1,5
E33024661,1151,873,198,675,4,87,42,45,186,165,3,18,0,1
E33024662,234,144,32,112,4,28,13,15,58,52,1,5,0,0
E33024663,288,177,63,114,5,36,23,13,70,59,1,10,0,0
E33024664,261,152,52,100,5,34,20,14,69,56,0,11,2,1
E33024665,248,157,50,107,2,31,20,11,57,54,0,2,1,1
E33024666,277,168,45,123,2,58,34,24,48,46,1,1,0,1
E33024667,209,137,33,104,0,50,40,10,22,20,0,2,0,0
E33024668,234,117,32,85,1,72,60,12,44,42,1,1,0,0
E33024669,750,522,145,377,13,110,63,47,105,97,1,7,0,0
E33024670,434,301,87,214,3,60,34,26,69,61,0,8,0,1
E33024671,272,195,51,144,4,26,18,8,39,37,1,0,1,8
E33024672,271,201,52,149,2,19,9,10,47,44,0,2,1,2
E33024673,263,181,58,123,2,37,21,16,41,32,1,8,0,2
E33024674,344,247,61,186,3,21,10,11,72,65,2,5,0,1
E33024675,926,614,171,443,5,104,69,35,198,188,1,7,2,5
E33024676,383,283,83,200,4,19,10,9,73,65,0,8,0,4
E33024677,302,233,74,159,3,16,8,8,49,45,1,3,0,1
E33024678,771,575,195,380,4,112,73,39,76,72,0,4,0,4
E33024679,306,214,44,170,2,23,10,13,66,56,2,7,1,1
E33024680,310,175,56,119,2,51,32,19,82,80,0,1,1,0
E33024681,233,155,48,107,5,20,11,9,52,45,1,6,0,1
E33024682,563,412,124,288,5,44,24,20,100,95,0,5,0,2
E33024683,286,155,43,112,0,36,21,15,95,88,1,4,2,0
E33024684,208,143,37,106,0,21,12,9,44,34,2,7,1,0
E33024685,199,116,35,81,1,16,10,6,56,46,3,3,4,10
E33024686,503,356,112,244,5,30,21,9,99,77,5,8,9,13
E33024687,387,290,57,233,6,15,8,7,74,62,1,11,0,2
E33024688,150,83,13,70,1,10,7,3,56,50,0,5,1,0
E33024689,552,421,132,289,5,38,20,18,85,78,2,5,0,3
E33024690,387,272,67,205,3,30,17,13,78,68,1,9,0,4
E33024691,544,350,90,260,3,29,15,14,156,144,0,11,1,6
E33024692,197,128,40,88,0,10,9,1,59,47,2,7,3,0
E33024693,234,170,48,122,0,8,5,3,51,42,0,9,0,5
E33024694,358,241,86,155,3,16,8,8,97,90,0,7,0,1
E33024695,631,486,165,321,5,60,34,26,77,73,1,2,1,3
E33024696,694,464,161,303,1,27,17,10,201,195,1,5,0,1
E33024697,6773,4995,1278,3717,72,540,285,255,1123,1016,15,82,10,43
E33024698,241,179,62,117,2,22,9,13,38,34,1,3,0,0
E33024699,323,209,83,126,3,40,10,30,63,58,0,5,0,8
E33024700,423,289,98,191,4,36,14,22,89,78,2,6,3,5
E33024701,395,292,108,184,5,25,12,13,65,56,2,3,4,8
E33024702,253,182,58,124,1,29,12,17,39,36,0,3,0,2
E33024703,396,287,49,238,10,24,6,18,73,67,0,6,0,2
E33024704,525,348,113,235,4,42,20,22,124,119,1,4,0,7
E33024705,1455,1120,306,814,17,81,41,40,232,214,2,15,1,5
E33024706,241,167,58,109,1,21,10,11,48,45,1,2,0,4
E33024707,800,588,145,443,2,73,40,33,133,127,1,5,0,4
E33024708,1032,760,243,517,3,100,59,41,165,149,4,11,1,4
E33024709,726,576,161,415,3,52,31,21,91,81,6,3,1,4
E33024710,248,168,44,124,0,23,11,12,54,45,2,7,0,3
E33024711,400,277,102,175,0,49,29,20,74,63,5,5,1,0
E33024712,291,230,68,162,2,21,15,6,31,28,1,1,1,7
E33024713,357,231,93,138,1,56,42,14,64,57,2,2,3,5
E33024714,550,387,108,279,3,72,49,23,85,75,2,8,0,3
E33024715,925,669,193,476,4,125,78,47,123,114,1,8,0,4
E33024716,306,228,76,152,4,33,20,13,36,35,0,1,0,5
E33024717,1314,920,279,641,12,168,107,61,206,187,0,19,0,8
E33024718,442,324,120,204,0,59,44,15,55,50,0,5,0,4
E33024719,297,206,50,156,3,26,14,12,58,56,2,0,0,4
E33024720,278,206,75,131,1,34,17,17,32,30,0,2,0,5
E33024721,355,247,66,181,2,42,26,16,64,60,0,3,1,0
E33024722,315,224,59,165,1,32,17,15,57,55,0,2,0,1
E33024723,439,261,62,199,4,80,40,40,91,83,1,4,3,3
E33024724,228,159,59,100,1,27,18,9,39,35,1,1,2,2
E33024725,351,231,69,162,9,44,24,20,62,54,2,5,1,5
E33024726,334,228,61,167,4,21,7,14,67,58,5,2,2,14
E33024727,323,240,81,159,5,23,6,17,46,41,2,3,0,9
E33024728,1618,960,283,677,15,197,57,140,383,321,35,24,3,63
E33024729,195,114,47,67,2,28,10,18,40,37,3,0,0,11
E33024730,558,383,111,272,9,64,25,39,95,78,6,10,1,7
E33024731,346,191,59,132,8,37,15,22,90,79,6,5,0,20
E33024732,264,152,49,103,4,43,15,28,64,56,3,3,2,1
E33024733,871,592,181,411,14,94,39,55,164,158,1,3,2,7
E33024734,219,134,37,97,3,33,8,25,48,48,0,0,0,1
E33024735,222,168,49,119,1,17,8,9,34,26,1,3,4,2
E33024736,527,344,126,218,2,82,25,57,90,85,1,4,0,9
E33024737,719,474,143,331,6,79,34,45,155,135,6,7,7,5
E33024738,215,156,44,112,1,23,8,15,33,30,0,2,1,2
E33024739,409,220,67,153,3,79,35,44,102,94,0,8,0,5
E33024740,650,326,95,231,19,69,25,44,163,138,21,3,1,73
E33024741,216,142,45,97,4,33,10,23,36,34,0,2,0,1
E33024742,249,171,39,132,4,13,5,8,56,45,1,9,1,5
E33024743,489,322,66,256,2,48,16,32,107,99,3,3,2,10
E33024744,982,645,170,475,22,130,54,76,165,151,4,10,0,20
E33024745,444,293,98,195,12,60,22,38,71,62,3,5,1,8
E33024746,211,131,37,94,4,32,13,19,42,40,0,1,1,2
E33024747,611,348,108,240,11,115,48,67,112,96,4,10,2,25
E33024748,320,230,80,150,2,28,7,21,53,46,2,4,1,7
E33024749,254,137,39,98,0,54,40,14,53,50,1,1,1,10
E33024750,400,244,61,183,2,45,30,15,107,104,0,3,0,2
E33024751,293,180,44,136,5,27,16,11,79,73,2,3,1,2
E33024752,330,206,56,150,4,55,25,30,62,55,2,5,0,3
E33024753,299,176,48,128,3,55,31,24,65,62,0,3,0,0
E33024754,213,148,26,122,1,18,12,6,42,38,0,4,0,4
E33024755,207,137,43,94,1,25,12,13,43,43,0,0,0,1
E33024756,304,143,33,110,1,38,21,17,118,112,0,5,1,4
E33024757,469,274,67,207,0,101,65,36,93,89,0,4,0,1
E33024758,326,213,55,158,5,65,41,24,43,40,1,2,0,0
E33024759,503,365,94,271,2,57,37,20,79,74,1,4,0,0
E33024760,288,211,40,171,4,27,19,8,45,41,0,1,3,1
E33024761,233,178,55,123,3,14,9,5,37,34,1,2,0,1
E33024762,973,724,212,512,2,97,58,39,148,140,3,5,0,2
E33024763,420,263,66,197,6,59,34,25,91,84,2,5,0,1
E33024764,319,262,75,187,0,14,10,4,38,36,0,2,0,5
E33024765,1903,1540,472,1068,8,95,55,40,251,228,6,14,3,9
E33024766,1727,1301,247,1054,21,97,50,47,300,271,3,26,0,8
E33024767,519,402,126,276,8,33,20,13,74,67,0,7,0,2
E33024768,335,232,80,152,0,48,34,14,51,42,5,3,1,4
E33024769,1014,683,160,523,13,59,37,22,252,221,1,20,10,7
E33024770,254,164,56,108,2,25,12,13,62,59,1,2,0,1
E33024771,917,621,175,446,10,124,83,41,159,151,3,5,0,3
E33024772,361,255,83,172,0,34,26,8,69,53,9,5,2,3
E33024773,649,472,113,359,8,41,23,18,124,114,3,6,1,4
E33024774,817,591,168,423,6,75,48,27,141,127,1,13,0,4
E33024775,442,309,83,226,1,73,40,33,57,54,0,3,0,2
E33024776,260,184,61,123,0,43,33,10,31,29,0,2,0,2
E33024777,356,260,54,206,0,19,6,13,75,68,0,7,0,2
E33024778,707,568,163,405,3,50,26,24,83,79,1,3,0,3
E33024779,375,268,81,187,2,28,18,10,74,72,1,1,0,3
E33024780,554,392,138,254,7,48,26,22,97,90,2,5,0,10
E33024781,278,245,84,161,0,9,6,3,23,23,0,0,0,1
E33024782,368,182,79,103,6,39,26,13,134,131,0,3,0,7
E33024783,647,311,127,184,11,104,81,23,213,205,1,2,5,8
E33024784,506,362,137,225,10,63,46,17,68,62,2,4,0,3
E33024785,280,192,54,138,7,25,18,7,53,52,0,1,0,3
E33024786,204,161,48,113,5,10,10,0,28,25,1,2,0,0
E33024787,197,154,40,114,1,20,13,7,22,21,0,1,0,0
E33024788,626,414,133,281,6,78,61,17,121,112,1,7,1,7
E33024789,773,612,176,436,8,67,50,17,82,73,3,6,0,4
E33024790,333,273,101,172,0,20,14,6,34,30,0,4,0,6
E33024791,389,305,86,219,3,33,23,10,47,42,0,5,0,1
E33024792,246,175,47,128,4,20,9,11,45,43,2,0,0,2
E33024793,637,455,144,311,4,63,29,34,109,97,2,8,2,6
E33024794,788,557,117,440,12,71,29,42,139,125,5,7,2,9
E33024795,478,350,115,235,3,51,22,29,69,67,0,2,0,5
E33024796,374,271,63,208,2,30,7,23,71,61,2,8,0,0
E33024797,369,270,90,180,4,25,6,19,67,55,3,3,6,3
E33024798,271,171,55,116,5,38,15,23,53,46,0,5,2,4
E33024799,273,194,49,145,0,21,9,12,56,50,3,2,1,2
E33024800,194,152,39,113,5,7,4,3,30,25,0,5,0,0
E33024801,475,302,98,204,1,32,16,16,129,123,1,5,0,11
E33024802,345,262,83,179,1,30,11,19,47,44,1,2,0,5
E33024803,660,436,126,310,9,67,25,42,140,132,3,4,1,8
E33024804,215,153,39,114,4,18,9,9,38,32,0,2,4,2
E33024805,330,243,51,192,2,17,8,9,65,60,0,4,1,3
E33024806,211,133,24,109,4,25,11,14,49,47,1,1,0,0
E33024807,340,225,58,167,5,43,24,19,61,56,2,3,0,6
E33024808,778,348,100,248,17,64,24,40,344,329,4,10,1,5
E33024809,399,248,75,173,1,58,22,36,84,74,2,8,0,8
E33024810,505,356,103,253,5,33,16,17,106,96,1,7,2,5
E33024811,473,336,92,244,5,36,17,19,92,81,3,7,1,4
E33024812,441,305,71,234,8,46,20,26,78,75,0,2,1,4
E33024813,1181,730,193,537,11,132,61,71,302,280,1,17,4,6
E33024814,985,727,220,507,20,112,47,65,120,110,1,9,0,6
E33024815,549,249,46,203,1,86,39,47,212,199,5,7,1,1
E33024816,565,404,93,311,4,93,42,51,63,58,1,4,0,1
E33024817,338,244,57,187,3,43,18,25,47,44,1,1,1,1
E33024818,315,228,52,176,5,35,24,11,46,44,1,1,0,1
E33024819,426,286,89,197,2,64,26,38,71,65,1,1,4,3
E33024820,488,364,92,272,0,58,33,25,63,59,0,4,0,3
E33024821,1200,812,200,612,6,175,96,79,207,195,0,8,4,0
E33024822,208,152,36,116,2,22,11,11,32,31,0,1,0,0
E33024823,1241,919,194,725,12,122,53,69,182,164,1,15,2,6
E33024824,404,296,86,210,3,33,13,20,68,61,1,6,0,4
E33024825,273,177,42,135,3,28,17,11,61,50,2,5,4,4
E33024826,433,334,112,222,7,32,10,22,58,54,0,4,0,2
E33024827,1917,1373,424,949,16,203,90,113,318,281,9,23,5,7
E33024828,923,640,155,485,15,104,49,55,159,146,5,8,0,5
E33024829,255,188,54,134,2,18,6,12,45,38,5,0,2,2
E33024830,720,501,148,353,5,66,17,49,139,130,3,5,1,9
E33024831,779,565,153,412,7,69,25,44,127,111,7,7,2,11
E33024832,3137,2329,624,1705,42,208,92,116,527,464,18,37,8,31
E33024833,295,202,67,135,5,22,1,21,62,55,1,5,1,4
E33024834,218,124,63,61,1,22,3,19,65,52,11,0,2,6
E33024835,381,311,75,236,1,19,3,16,46,43,1,2,0,4
E33024836,2421,1893,388,1505,25,172,79,93,323,305,2,14,2,8
E33024837,224,156,57,99,0,20,2,18,48,41,1,6,0,0
E33024838,387,273,76,197,2,43,8,35,68,61,3,4,0,1
E33024839,204,156,51,105,0,15,5,10,32,30,1,1,0,1
E33024840,604,361,105,256,0,86,31,55,153,145,2,5,1,4
E33024841,421,298,62,236,5,36,10,26,81,73,1,7,0,1
E33024842,611,433,92,341,3,53,20,33,121,115,0,6,0,1
E33024843,419,281,77,204,2,40,25,15,93,84,0,9,0,3
E33024844,229,168,37,131,2,21,8,13,37,29,1,5,2,1
E33024845,311,207,52,155,0,36,10,26,67,60,3,4,0,1
E33024846,527,345,94,251,2,58,16,42,120,110,3,6,1,2
E33024847,1402,1140,299,841,5,66,8,58,178,164,1,12,1,13
E33024848,427,327,96,231,3,27,14,13,70,68,0,2,0,0
E33024849,350,265,60,205,1,18,5,13,61,55,1,5,0,5
E33024850,288,227,91,136,1,12,0,12,43,40,1,2,0,5
E33024851,239,170,45,125,3,21,4,17,42,36,1,3,2,3
E33024852,228,175,71,104,0,13,5,8,38,35,1,2,0,2
E33024853,580,468,159,309,4,32,4,28,63,57,2,2,2,13
E33024854,373,254,67,187,0,34,13,21,81,77,0,4,0,4
E33024855,271,184,45,139,1,30,4,26,54,51,1,2,0,2
E33024856,461,355,126,229,4,37,22,15,62,61,1,0,0,3
E33024857,294,210,87,123,3,24,17,7,51,45,0,5,1,6
E33024858,206,146,54,92,3,17,6,11,37,34,1,1,1,3
E33024859,236,148,42,106,3,25,12,13,56,52,1,3,0,4
E33024860,249,182,54,128,1,25,12,13,40,34,1,5,0,1
E33024861,219,156,67,89,1,13,4,9,44,43,1,0,0,5
E33024862,348,255,82,173,3,28,14,14,57,52,0,3,2,5
E33024863,931,492,162,330,8,113,72,41,316,306,3,4,3,2
E33024864,229,175,66,109,1,15,8,7,36,33,0,3,0,2
E33024865,218,154,62,92,1,18,8,10,41,33,6,2,0,4
E33024866,804,639,180,459,10,51,27,24,98,83,0,15,0,6
E33024867,249,167,65,102,1,33,25,8,44,41,0,3,0,4
E33024868,513,379,143,236,1,37,22,15,91,86,1,3,1,5
E33024869,237,194,59,135,2,13,6,7,28,26,0,2,0,0
E33024870,207,133,31,102,1,21,11,10,46,44,0,2,0,6
E33024871,627,478,165,313,2,51,27,24,88,84,0,4,0,8
E33024872,125,81,30,51,2,21,14,7,20,18,0,2,0,1
E33024873,258,188,44,144,0,21,14,7,47,42,0,4,1,2
E33024874,227,180,60,120,1,16,7,9,28,21,0,7,0,2
E33024875,230,168,61,107,0,25,16,9,35,33,0,2,0,2
E33024876,399,295,106,189,2,33,15,18,66,62,0,3,1,3
E33024877,433,308,93,215,3,41,15,26,78,65,0,13,0,3
E33024878,345,247,73,174,1,32,19,13,63,59,0,3,1,2
E33024879,235,167,39,128,0,19,9,10,47,42,0,5,0,2
E33024880,252,189,51,138,1,11,4,7,48,42,0,3,3,3
E33024881,263,192,48,144,1,32,19,13,37,33,2,2,0,1
E33024882,347,313,72,241,2,4,1,3,27,24,0,3,0,1
E33024883,399,320,112,208,5,21,12,9,51,46,0,5,0,2
E33024884,249,179,50,129,2,25,16,9,42,35,0,7,0,1
E33024885,428,343,90,253,0,24,14,10,58,55,2,1,0,3
E33024886,325,245,80,165,2,20,12,8,56,52,0,4,0,2
E33024887,918,604,160,444,2,75,40,35,223,204,7,7,5,14
E33024888,770,609,192,417,1,59,24,35,99,86,2,11,0,2
E33024889,301,183,76,107,0,45,18,27,71,53,13,3,2,2
E33024890,569,391,155,236,9,50,30,20,111,100,3,8,0,8
E33024891,457,279,54,225,4,19,14,5,153,143,0,7,3,2
E33024892,549,422,99,323,8,14,6,8,104,95,2,4,3,1
E33024893,555,398,132,266,7,15,7,8,133,122,3,7,1,2
E33024894,629,458,115,343,6,33,16,17,129,118,1,8,2,3
E33024895,498,319,65,254,4,24,11,13,149,142,1,5,1,2
E33024896,335,188,71,117,7,11,4,7,129,121,4,3,1,0
E33024897,374,239,79,160,4,13,8,5,115,101,5,6,3,3
E33024898,397,245,89,156,6,24,16,8,121,110,3,3,5,1
E33024899,912,643,180,463,11,34,17,17,220,205,7,4,4,4
E33024900,599,365,146,219,12,90,54,36,126,109,5,7,5,6
E33024901,330,219,89,130,2,34,20,14,67,61,1,2,3,8
E33024902,574,386,129,257,11,31,19,12,142,122,9,6,5,4
E33024903,568,350,132,218,21,60,37,23,126,109,6,5,6,11
E33024904,243,148,49,99,8,24,14,10,61,60,1,0,0,2
E33024905,529,372,67,305,21,60,25,35,69,60,2,4,3,7
E33024906,361,232,79,153,8,53,33,20,64,58,0,6,0,4
E33024907,362,250,74,176,12,29,14,15,69,60,1,4,4,2
E33024908,311,173,43,130,4,38,14,24,91,87,2,2,0,5
E33024909,1771,1132,306,826,25,207,118,89,387,350,8,17,12,20
E33024910,766,459,124,335,12,64,33,31,227,217,1,6,3,4
E33024911,384,286,105,181,3,33,25,8,49,37,10,2,0,13
E33024912,331,227,87,140,2,24,15,9,72,67,2,2,1,6
E33024913,646,344,103,241,12,106,67,39,176,167,0,7,2,8
E33024914,439,283,84,199,6,46,24,22,103,98,2,3,0,1
E33024915,465,378,120,258,10,21,6,15,53,49,1,3,0,3
E33024916,971,642,153,489,16,48,21,27,263,246,5,11,1,2
E33024917,228,156,53,103,4,30,20,10,38,34,1,1,2,0
E33024918,756,463,117,346,7,171,136,35,111,105,0,6,0,4
E33024919,1002,595,165,430,9,276,204,72,120,110,2,6,2,2
E33024920,493,291,84,207,5,95,65,30,96,85,6,5,0,6
E33024921,401,297,76,221,4,46,34,12,53,52,0,1,0,1
E33024922,313,164,42,122,1,70,59,11,78,77,0,1,0,0
E33024923,229,143,27,116,1,43,30,13,40,39,0,1,0,2
E33024924,1198,773,167,606,22,220,168,52,179,171,2,5,1,4
E33024925,646,379,94,285,11,151,100,51,96,92,2,2,0,9
E33024926,265,181,40,141,2,44,12,32,34,30,0,2,2,4
E33024927,257,199,49,150,2,21,10,11,29,27,1,1,0,6
E33024928,370,275,75,200,3,42,18,24,49,46,0,2,1,1
E33024929,378,248,55,193,5,68,29,39,56,50,1,4,1,1
E33024930,319,228,63,165,2,59,26,33,29,27,0,2,0,1
E33024931,198,130,26,104,2,30,18,12,34,33,0,1,0,2
E33024932,403,297,96,201,7,29,12,17,66,61,2,3,0,4
E33024933,351,221,62,159,2,45,17,28,75,63,3,9,0,8
E33024934,282,203,55,148,1,45,28,17,31,28,0,3,0,2
E33024935,229,133,39,94,1,44,30,14,50,46,1,3,0,1
E33024936,816,572,126,446,7,108,59,49,126,117,0,9,0,3
E33024937,1050,656,162,494,16,175,65,110,192,173,4,13,2,11
E33024938,354,261,57,204,3,20,10,10,69,62,3,4,0,1
E33024939,607,432,129,303,5,88,19,69,81,73,2,5,1,1
E33024940,208,155,38,117,4,26,7,19,18,17,0,1,0,5
E33024941,277,212,60,152,0,25,15,10,40,37,0,3,0,0
E33024942,255,190,44,146,5,28,9,19,32,29,0,3,0,0
E33024943,271,216,80,136,2,15,5,10,34,32,1,1,0,4
E33024944,250,175,56,119,5,40,19,21,30,27,0,2,1,0
E33024945,521,316,86,230,13,111,39,72,79,71,0,7,1,2
E33024946,246,151,49,102,5,37,8,29,53,50,1,1,1,0
E33024947,430,309,92,217,6,55,17,38,53,48,3,2,0,7
E33024948,1330,1020,269,751,17,84,32,52,204,191,1,10,2,5
E33024949,1741,1348,348,1000,14,109,56,53,260,237,1,18,4,10
E33024950,255,191,53,138,3,17,4,13,43,42,0,1,0,1
E33024951,741,566,132,434,15,36,3,33,121,107,3,11,0,3
E33024952,304,196,40,156,4,38,28,10,64,59,2,1,2,2
E33024953,754,488,157,331,9,106,77,29,147,129,6,6,6,4
E33024954,591,395,123,272,6,90,43,47,97,91,0,5,1,3
E33024955,871,629,181,448,12,135,95,40,91,84,1,4,2,4
E33024956,242,173,64,109,2,25,17,8,41,35,2,2,2,1
E33024957,260,208,60,148,3,12,2,10,36,32,1,3,0,1
E33024958,238,184,44,140,2,19,7,12,30,24,1,5,0,3
E33024959,356,237,51,186,4,31,4,27,83,77,0,6,0,1
E33024960,368,272,82,190,2,31,2,29,63,58,0,4,1,0
E33024961,1840,1067,302,765,13,199,43,156,542,513,1,25,3,19
E33024962,361,267,71,196,11,16,4,12,64,60,2,2,0,3
E33024963,1176,865,188,677,15,101,17,84,192,173,10,7,2,3
E33024964,851,605,155,450,16,95,21,74,127,107,12,8,0,8
E33024965,639,472,107,365,7,24,12,12,134,128,2,2,2,2
E33024966,593,351,119,232,3,135,95,40,102,95,2,4,1,2
E33024967,362,275,77,198,3,40,17,23,44,38,1,5,0,0
E33024968,776,569,141,428,3,71,46,25,129,118,0,9,2,4
E33024969,504,379,111,268,0,65,35,30,58,53,1,4,0,2
E33024970,404,268,47,221,2,24,10,14,108,104,0,4,0,2
E33024971,588,422,128,294,4,25,13,12,136,132,1,3,0,1
E33024972,743,577,156,421,6,26,18,8,124,113,0,11,0,10
E33024973,682,464,99,365,3,95,64,31,117,110,1,4,2,3
E33024974,349,284,65,219,0,20,8,12,43,41,0,2,0,2
E33024975,551,419,100,319,6,23,11,12,101,96,3,1,1,2
E33024976,358,164,42,122,2,50,26,24,137,133,2,1,1,5
E33024977,766,602,141,461,4,33,13,20,124,118,1,4,1,3
E33024978,215,131,34,97,0,28,17,11,51,43,0,8,0,5
E33024979,454,321,99,222,3,34,21,13,95,87,2,5,1,1
E33024980,287,177,54,123,1,56,31,25,52,50,0,2,0,1
E33024981,783,571,122,449,11,30,15,15,168,152,0,15,1,3
E33024982,342,218,51,167,4,24,11,13,95,86,0,8,1,1
E33024983,292,158,45,113,2,32,17,15,99,92,2,5,0,1
E33024984,283,186,73,113,1,48,34,14,46,42,0,3,1,2
E33024985,366,217,55,162,1,55,41,14,90,78,3,8,1,3
E33024986,367,231,40,191,3,37,18,19,95,81,2,12,0,1
E33024987,219,139,28,111,3,19,12,7,58,55,0,3,0,0
E33024988,952,772,205,567,3,67,36,31,106,102,1,2,1,4
E33024989,408,289,82,207,4,43,30,13,69,68,1,0,0,3
E33024990,209,159,27,132,0,17,9,8,33,33,0,0,0,0
E33024991,379,280,64,216,3,29,15,14,66,58,4,4,0,1
E33024992,373,294,66,228,3,22,12,10,53,49,0,4,0,1
E33024993,390,229,60,169,6,64,41,23,88,83,0,4,1,3
E33024994,860,624,176,448,1,86,51,35,140,125,4,8,3,9
E33024995,1117,719,192,527,10,119,70,49,266,243,5,14,4,3
E33024996,1777,1278,308,970,11,125,58,67,351,321,4,24,2,12
E33024997,1021,699,206,493,5,152,92,60,159,152,1,5,1,6
E33024998,415,336,86,250,3,14,8,6,59,55,0,3,1,3
E33024999,250,182,57,125,0,27,10,17,40,37,0,0,3,1
E33025000,320,212,61,151,2,21,14,7,81,75,0,6,0,4
E33025001,448,286,82,204,6,67,48,19,86,83,0,2,1,3
E33025002,624,472,106,366,2,36,18,18,108,95,4,7,2,6
E33025003,224,117,43,74,2,43,26,17,62,59,0,3,0,0
E33025004,490,340,101,239,3,66,39,27,78,68,2,8,0,3
E33025005,219,177,42,135,1,12,6,6,28,27,0,1,0,1
E33025006,1345,1021,302,719,10,84,54,30,224,210,5,6,3,6
E33025007,315,251,59,192,0,9,2,7,55,48,1,6,0,0
E33025008,363,220,52,168,5,52,22,30,72,65,5,2,0,14
E33025009,324,225,69,156,1,26,5,21,69,67,0,2,0,3
E33025010,958,755,174,581,8,52,11,41,138,128,2,7,1,5
E33025011,789,586,145,441,8,97,31,66,92,89,0,3,0,6
E33025012,591,426,100,326,5,55,6,49,104,93,3,6,2,1
E33025013,597,408,98,310,6,67,12,55,114,109,1,4,0,2
E33025014,291,197,47,150,4,25,10,15,63,62,0,1,0,2
E33025015,444,323,77,246,2,55,14,41,63,61,0,2,0,1
E33025016,845,624,192,432,4,109,25,84,104,99,1,2,2,4
E33025017,233,168,48,120,5,21,3,18,34,30,0,4,0,5
E33025018,361,260,83,177,4,39,6,33,56,51,0,3,2,2
E33025019,284,203,39,164,5,15,6,9,60,58,1,1,0,1
E33025020,1073,772,200,572,6,116,32,84,172,159,5,8,0,7
E33025021,226,183,50,133,2,9,5,4,25,20,2,3,0,7
E33025022,254,202,37,165,0,20,8,12,29,25,1,3,0,3
E33025023,482,385,103,282,3,30,5,25,64,58,0,6,0,0
E33025024,232,171,48,123,0,11,3,8,48,40,2,6,0,2
E33025025,251,217,58,159,0,3,1,2,29,24,1,4,0,2
E33025026,560,485,135,350,3,18,5,13,52,42,4,5,1,2
E33025027,447,362,108,254,2,28,11,17,53,46,3,4,0,2
E33025028,290,219,50,169,3,35,15,20,32,29,1,2,0,1
E33025029,497,373,91,282,5,38,20,18,79,71,2,3,3,2
E33025030,285,209,53,156,1,21,6,15,52,48,2,2,0,2
E33025031,1298,1022,223,799,12,99,37,62,160,150,1,7,2,5
E33025032,535,454,99,355,2,16,5,11,62,55,0,6,1,1
E33025033,4917,3579,965,2614,41,523,103,420,744,687,10,38,9,30
E33025034,718,555,125,430,9,38,18,20,112,96,3,13,0,4
E33025035,419,300,50,250,6,19,4,15,91,83,2,6,0,3
E33025036,543,354,80,274,5,39,22,17,141,133,1,5,2,4
E33025037,374,284,46,238,5,15,6,9,66,58,2,4,2,4
E33025038,797,581,125,456,9,54,12,42,150,138,2,10,0,3
E33025039,290,194,48,146,3,30,10,20,61,57,0,4,0,2
E33025040,345,193,40,153,0,53,18,35,93,81,1,9,2,6
E33025041,336,128,33,95,7,38,23,15,160,153,0,5,2,3
E33025042,382,257,72,185,2,67,24,43,54,45,2,7,0,2
E33025043,257,190,55,135,2,28,6,22,36,35,0,0,1,1
E33025044,519,412,84,328,6,45,16,29,56,48,0,5,3,0
E33025045,216,162,48,114,3,15,2,13,36,34,0,2,0,0
E33025046,261,158,43,115,6,24,10,14,72,70,1,1,0,1
E33025047,341,217,49,168,2,42,10,32,77,74,0,3,0,3
E33025048,266,196,49,147,2,14,5,9,53,50,1,2,0,1
E33025049,400,239,67,172,4,46,15,31,110,102,1,6,1,1
E33025050,604,485,133,352,3,51,13,38,64,55,3,5,1,1
E33025051,450,295,63,232,10,48,19,29,94,87,0,5,2,3
E33025052,420,287,67,220,3,45,19,26,85,77,0,6,2,0
E33025053,941,688,204,484,15,125,72,53,110,101,0,5,4,3
E33025054,837,612,160,452,15,84,48,36,122,109,3,7,3,4
E33025055,1937,964,235,729,22,243,150,93,692,674,2,12,4,16
E33025056,465,308,75,233,10,48,26,22,95,89,0,4,2,4
E33025057,2467,1801,311,1490,23,128,65,63,503,482,1,17,3,12
E33025058,1393,706,168,538,21,277,173,104,383,375,0,7,1,6
E33025059,1031,655,140,515,12,144,103,41,212,192,9,9,2,8
E33025060,206,123,26,97,5,33,25,8,44,42,1,1,0,1
E33025061,1745,1218,235,983,41,221,147,74,257,243,5,8,1,8
E33025062,2363,941,233,708,33,425,276,149,960,933,4,22,1,4
E33025063,631,449,84,365,14,68,42,26,98,92,0,6,0,2
E33025064,552,396,102,294,4,32,17,15,115,106,2,5,2,5
E33025065,1226,879,222,657,13,105,71,34,225,212,4,7,2,4
E33025066,340,232,62,170,2,43,24,19,60,56,0,4,0,3
E33025067,747,577,110,467,16,43,28,15,105,99,1,5,0,6
E33025068,419,250,75,175,5,30,17,13,132,129,0,3,0,2
E33025069,317,237,65,172,0,31,16,15,47,44,0,3,0,2
E33025070,253,140,28,112,0,36,20,16,76,74,0,1,1,1
E33025071,516,392,109,283,2,25,12,13,95,89,0,6,0,2
E33025072,944,646,193,453,15,111,21,90,163,151,4,7,1,9
E33025073,268,177,45,132,3,27,3,24,58,54,1,3,0,3
E33025074,205,148,38,110,5,20,3,17,32,26,0,4,2,0
E33025075,660,402,120,282,5,65,15,50,184,172,1,4,7,4
E33025076,296,195,52,143,4,37,5,32,60,55,0,5,0,0
E33025077,264,151,47,104,1,32,5,27,77,65,3,9,0,3
E33025078,256,169,48,121,1,27,4,23,58,54,0,3,1,1
E33025079,222,155,38,117,2,17,2,15,48,46,0,2,0,0
E33025080,279,159,36,123,3,48,14,34,67,61,0,6,0,2
E33025081,240,111,21,90,2,54,13,41,67,62,2,1,2,6
E33025082,249,166,36,130,8,20,5,15,54,50,0,4,0,1
E33025083,297,217,76,141,4,32,7,25,42,38,0,3,1,2
E33025084,371,230,62,168,2,71,9,62,66,62,0,4,0,2
E33025085,977,722,203,519,12,82,9,73,156,142,4,9,1,5
E33025086,424,314,79,235,7,49,5,44,53,48,1,4,0,1
E33025087,637,442,111,331,10,54,6,48,122,113,4,4,1,9
E33025088,241,161,34,127,2,30,8,22,48,45,0,0,3,0
E33025089,518,361,78,283,10,31,9,22,112,107,0,3,2,4
E33025090,424,297,79,218,14,34,9,25,79,73,1,5,0,0
E33025091,883,445,61,384,11,82,20,62,341,325,1,13,2,4
E33025092,198,139,41,98,4,8,1,7,46,42,2,2,0,1
E33025093,487,376,97,279,3,30,9,21,75,69,0,5,1,3
E33025094,240,176,34,142,2,18,7,11,44,38,2,3,1,0
E33025095,289,214,49,165,2,19,4,15,51,43,0,8,0,3
E33025096,299,206,33,173,4,25,7,18,64,61,0,3,0,0
E33025097,885,757,121,636,13,25,5,20,88,73,3,8,4,2
E33025098,2737,2104,520,1584,47,166,30,136,401,323,53,12,13,19
E33025099,200,140,44,96,0,24,4,20,31,28,1,0,2,5
E33025100,596,494,136,358,6,43,9,34,49,40,2,5,2,4
E33025101,487,332,75,257,5,56,12,44,92,83,3,6,0,2
E33025102,231,158,41,117,4,26,6,20,40,34,0,5,1,3
E33025103,206,149,44,105,0,11,5,6,43,39,0,4,0,3
E33025104,329,201,68,133,2,35,22,13,87,80,0,5,2,4
E33025105,380,204,63,141,1,79,52,27,92,87,0,5,0,4
E33025106,230,137,46,91,0,28,17,11,65,59,1,4,1,0
E33025107,229,158,47,111,3,19,12,7,46,42,2,2,0,3
E33025108,211,141,35,106,1,19,10,9,46,42,0,4,0,4
E33025109,443,325,83,242,3,47,29,18,67,61,0,6,0,1
E33025110,658,429,152,277,11,74,48,26,139,132,0,7,0,5
E33025111,230,130,45,85,1,26,12,14,70,65,0,3,2,3
E33025112,386,233,58,175,3,41,25,16,106,93,1,12,0,3
E33025113,219,163,41,122,1,15,8,7,40,37,1,2,0,0
E33025114,669,359,113,246,10,157,105,52,138,122,3,11,2,5
E33025115,572,375,119,256,5,84,47,37,105,94,0,11,0,3
E33025116,1230,617,129,488,12,159,86,73,432,400,3,27,2,10
E33025117,285,226,57,169,3,18,12,6,37,35,0,2,0,1
E33025118,1488,1125,325,800,6,152,90,62,197,185,6,6,0,8
E33025119,557,396,118,278,6,72,45,27,81,75,0,5,1,2
E33025120,1284,806,279,527,6,258,169,89,206,188,3,14,1,8
E33025121,489,332,86,246,7,49,25,24,98,92,2,2,2,3
E33025122,218,143,58,85,3,38,22,16,33,30,0,3,0,1
E33025123,1146,868,190,678,7,76,39,37,189,169,2,18,0,6
E33025124,3922,2497,832,1665,27,227,150,77,1156,1083,4,67,2,15
E33025125,247,178,45,133,2,9,6,3,57,56,1,0,0,1
E33025126,814,586,167,419,8,71,48,23,147,136,0,11,0,2
E33025127,242,169,38,131,2,17,11,6,53,49,0,4,0,1
E33025128,923,676,183,493,16,93,56,37,134,118,2,12,2,4
E33025129,669,386,97,289,6,90,55,35,181,174,1,5,1,6
E33025130,746,457,108,349,12,109,68,41,162,152,0,8,2,6
E33025131,439,297,82,215,5,46,24,22,86,79,0,7,0,5
E33025132,273,192,78,114,0,21,11,10,59,50,1,8,0,1
E33025133,691,342,105,237,14,111,73,38,220,202,1,15,2,4
E33025134,2127,646,191,455,9,123,23,100,1242,1129,62,13,38,107
E33025135,3539,979,257,722,14,221,65,156,2084,1903,105,17,59,241
E33025136,372,254,88,166,5,52,19,33,58,53,0,4,1,3
E33025137,301,215,54,161,3,27,5,22,53,51,1,1,0,3
E33025138,719,515,131,384,8,92,27,65,99,95,1,3,0,5
E33025139,451,308,93,215,5,67,19,48,71,65,1,5,0,0
E33025140,209,147,43,104,3,22,5,17,37,32,2,2,1,0
E33025141,230,123,46,77,0,31,10,21,76,72,0,4,0,0
E33025142,404,299,71,228,0,44,5,39,60,52,1,7,0,1
E33025143,706,499,138,361,8,103,35,68,94,87,0,7,0,2
E33025144,212,153,39,114,1,31,15,16,24,22,0,2,0,3
E33025145,1270,854,248,606,19,212,107,105,178,164,1,13,0,7
E33025146,245,176,55,121,4,25,9,16,36,34,0,2,0,4
E33025147,2185,1784,401,1383,25,112,49,63,256,231,3,22,0,8
E33025148,293,233,78,155,2,21,11,10,36,34,0,2,0,1
E33025149,729,576,133,443,5,75,61,14,69,64,0,2,3,4
E33025150,365,268,68,200,6,40,32,8,51,49,0,2,0,0
E33025151,1237,684,169,515,14,165,120,45,372,367,1,2,2,2
E33025152,531,395,84,311,5,53,46,7,76,68,0,8,0,2
E33025153,687,485,124,361,3,78,43,35,121,112,1,8,0,0
E33025154,1420,1132,321,811,6,72,30,42,206,187,1,13,5,4
E33025155,255,160,52,108,3,16,9,7,74,66,2,3,3,2
E33025156,668,530,156,374,5,43,18,25,85,76,0,5,4,5
E33025157,601,412,116,296,6,72,47,25,107,102,2,3,0,4
E33025158,469,345,57,288,3,13,6,7,108,88,2,17,1,0
E33025159,647,350,92,258,3,68,31,37,217,64,80,3,70,9
E33025160,343,249,64,185,2,30,16,14,62,57,1,3,1,0
E33025161,540,372,82,290,4,41,24,17,121,101,5,8,7,2
E33025162,214,152,49,103,0,16,6,10,46,43,1,1,1,0
E33025163,729,549,146,403,7,55,32,23,118,109,0,6,3,0
E33025164,420,305,95,210,3,49,30,19,60,51,0,9,0,3
E33025165,427,328,88,240,4,33,17,16,58,47,4,5,2,4
E33025166,260,191,48,143,3,13,4,9,49,44,1,4,0,4
E33025167,230,186,40,146,2,13,7,6,27,24,1,1,1,2
E33025168,308,258,91,167,0,19,11,8,28,25,1,2,0,3
E33025169,305,252,65,187,4,13,9,4,32,28,0,4,0,4
E33025170,558,437,96,341,8,34,13,21,77,69,1,5,2,2
E33025171,777,589,142,447,5,72,23,49,106,100,1,5,0,5
E33025172,566,456,136,320,3,29,15,14,76,69,1,4,2,2
E33025173,247,201,59,142,1,15,14,1,30,27,1,2,0,0
E33025174,497,372,122,250,8,44,22,22,64,56,3,4,1,9
E33025175,204,134,67,67,2,16,5,11,38,29,7,1,1,14
E33025176,230,167,69,98,2,16,1,15,40,38,1,1,0,5
E33025177,1818,1060,205,855,14,145,55,90,590,191,231,17,151,9
E33025178,402,323,123,200,0,17,9,8,55,52,0,2,1,7
E33025179,289,236,74,162,1,17,7,10,33,30,2,1,0,2
E33025180,246,178,60,118,3,14,11,3,40,33,6,1,0,11
E33025181,312,232,65,167,2,28,16,12,49,43,0,4,2,1
E33025182,317,222,59,163,7,45,16,29,39,32,3,1,3,4
E33025183,459,350,99,251,7,37,9,28,52,51,0,1,0,13
E33025184,475,291,71,220,3,53,22,31,127,123,0,3,1,1
E33025185,250,210,54,156,1,17,2,15,20,17,1,2,0,2
E33025186,726,520,114,406,8,76,23,53,119,101,1,16,1,3
E33025187,311,238,73,165,1,22,10,12,48,44,2,2,0,2
E33025188,354,263,70,193,3,47,24,23,39,33,1,5,0,2
E33025189,359,198,56,142,1,87,35,52,72,59,0,6,7,1
E33025190,368,244,59,185,4,68,28,40,49,44,0,4,1,3
E33025191,363,189,52,137,3,96,41,55,73,68,2,3,0,2
E33025192,539,352,84,268,1,105,46,59,74,66,1,5,2,7
E33025193,400,220,67,153,5,72,29,43,97,88,0,8,1,6
E33025194,690,221,51,170,1,87,46,41,370,361,2,4,3,11
E33025195,457,316,75,241,5,52,18,34,83,73,2,8,0,1
E33025196,740,460,102,358,6,85,24,61,187,165,1,19,2,2
E33025197,451,280,64,216,4,61,21,40,100,87,2,11,0,6
E33025198,726,434,118,316,6,91,37,54,190,179,1,10,0,5
E33025199,331,225,54,171,3,17,8,9,84,76,2,4,2,2
E33025200,484,306,79,227,9,48,26,22,116,103,4,7,2,5
E33025201,874,579,119,460,4,130,50,80,161,158,1,1,1,0
E33025202,782,562,125,437,13,58,23,35,145,134,0,8,3,4
E33025203,428,310,99,211,2,40,15,25,71,64,1,5,1,5
E33025204,396,247,61,186,1,80,23,57,65,62,1,2,0,3
E33025205,862,638,186,452,13,60,21,39,148,135,2,8,3,3
E33025206,250,135,45,90,1,26,11,15,85,81,0,2,2,3
E33025207,293,223,50,173,2,9,2,7,59,52,0,6,1,0
E33025208,388,258,68,190,1,32,11,21,92,85,2,5,0,5
E33025209,593,364,98,266,4,55,20,35,166,156,1,4,5,4
E33025210,733,239,70,169,6,59,25,34,416,406,2,5,3,13
E33025211,771,561,161,400,10,79,29,50,117,112,0,5,0,4
E33025212,268,165,44,121,11,43,23,20,46,43,0,3,0,3
E33025213,260,155,53,102,1,42,16,26,53,49,0,3,1,9
E33025214,1516,867,194,673,14,200,76,124,430,411,2,15,2,5
E33025215,299,208,52,156,0,37,8,29,50,46,1,3,0,4
E33025216,377,232,55,177,7,65,36,29,72,66,1,5,0,1
E33025217,267,158,40,118,2,31,12,19,75,67,7,1,0,1
E33025218,358,266,65,201,4,22,10,12,57,53,0,2,2,9
E33025219,261,157,54,103,3,31,7,24,63,61,1,1,0,7
E33025220,483,341,107,234,4,39,9,30,93,85,0,6,2,6
E33025221,257,167,55,112,2,20,6,14,65,61,0,3,1,3
E33025222,400,237,72,165,1,29,7,22,122,113,0,2,7,11
E33025223,505,381,103,278,7,25,5,20,79,67,10,2,0,13
E33025224,639,413,115,298,12,66,19,47,139,126,0,12,1,9
E33025225,334,280,97,183,1,19,6,13,30,25,1,2,2,4
E33025226,476,363,120,243,3,24,6,18,80,74,2,3,1,6
E33025227,379,298,86,212,3,16,8,8,50,42,1,3,4,12
E33025228,677,553,180,373,7,26,10,16,84,81,1,2,0,7
E33025229,274,195,35,160,2,17,6,11,57,51,0,6,0,3
E33025230,299,226,59,167,3,18,7,11,51,44,0,7,0,1
E33025231,284,161,44,117,4,24,7,17,92,87,0,4,1,3
E33025232,465,322,76,246,2,48,19,29,91,85,0,5,1,2
E33025233,347,208,54,154,6,46,20,26,83,76,1,5,1,4
E33025234,401,296,81,215,4,35,13,22,66,60,1,5,0,0
E33025235,254,169,52,117,3,21,6,15,58,46,4,4,4,3
E33025236,370,273,66,207,4,23,7,16,69,63,2,3,1,1
E33025237,349,247,65,182,6,19,6,13,74,68,3,0,3,3
E33025238,585,375,94,281,4,78,30,48,123,108,4,11,0,5
E33025239,360,259,70,189,5,27,9,18,67,62,2,3,0,2
E33025240,1141,646,147,499,11,150,51,99,322,308,2,12,0,12
E33025241,258,169,46,123,1,34,10,24,50,46,0,2,2,4
E33025242,752,648,152,496,6,16,3,13,79,73,1,5,0,3
E33025243,586,464,144,320,3,41,11,30,68,53,4,7,4,10
E33025244,504,355,120,235,8,31,9,22,84,73,4,6,1,26
E33025245,333,254,54,200,2,31,10,21,42,38,1,1,2,4
E33025246,433,317,87,230,0,42,24,18,74,67,0,3,4,0
E33025247,264,213,55,158,3,18,8,10,27,23,0,3,1,3
E33025248,264,176,47,129,1,44,16,28,42,38,1,3,0,1
E33025249,327,198,45,153,3,69,31,38,57,50,0,5,2,0
E33025250,477,296,74,222,7,54,19,35,116,113,0,3,0,4
E33025251,377,264,76,188,1,49,18,31,58,53,0,5,0,5
E33025252,305,242,63,179,1,8,4,4,53,51,0,1,1,1
E33025253,825,631,185,446,3,62,35,27,125,116,1,8,0,4
E33025254,758,619,170,449,3,45,29,16,86,83,0,3,0,5
E33025255,549,451,103,348,2,33,16,17,56,51,1,4,0,7
E33025256,1484,1134,297,837,10,133,89,44,205,192,1,11,1,2
E33025257,399,286,85,201,5,32,24,8,73,67,2,3,1,3
E33025258,355,253,69,184,1,44,36,8,55,42,3,7,3,2
E33025259,622,425,105,320,8,119,103,16,69,66,2,1,0,1
E33025260,386,248,50,198,0,63,51,12,73,69,0,3,1,2
E33025261,318,201,52,149,1,74,64,10,40,35,0,4,1,2
E33025262,332,273,90,183,1,27,25,2,30,27,0,2,1,1
E33025263,352,285,90,195,0,24,13,11,42,39,0,2,1,1
E33025264,556,440,128,312,2,49,41,8,65,56,3,5,1,0
E33025265,592,438,117,321,5,62,43,19,83,75,1,5,2,4
E33025266,324,247,59,188,0,34,21,13,41,40,1,0,0,2
E33025267,304,234,66,168,0,26,13,13,39,36,2,1,0,5
E33025268,400,219,48,171,2,121,99,22,54,51,0,3,0,4
E33025269,342,247,67,180,1,28,23,5,60,56,1,2,1,6
E33025270,577,406,123,283,3,58,40,18,105,94,2,8,1,5
E33025271,350,273,78,195,1,23,14,9,50,47,0,2,1,3
E33025272,346,246,74,172,3,23,21,2,68,64,0,4,0,6
E33025273,561,369,87,282,1,65,33,32,118,106,2,10,0,8
E33025274,362,274,73,201,3,25,18,7,59,52,0,7,0,1
E33025275,651,547,171,376,5,33,21,12,65,63,0,1,1,1
E33025276,315,276,67,209,2,7,4,3,30,28,0,2,0,0
E33025277,378,271,59,212,5,29,15,14,72,68,1,1,2,1
E33025278,721,599,173,426,5,21,9,12,94,84,4,5,1,2
E33025279,371,303,85,218,3,7,5,2,58,54,0,4,0,0
E33025280,869,640,153,487,12,60,37,23,152,134,5,9,4,5
E33025281,480,394,119,275,3,28,10,18,51,46,1,4,0,4
E33025282,675,523,122,401,3,58,37,21,86,84,0,1,1,5
E33025283,354,235,61,174,2,71,64,7,45,39,0,6,0,1
E33025284,925,642,136,506,6,134,100,34,139,126,0,13,0,4
E33025285,967,609,151,458,3,92,49,43,255,236,0,14,5,8
E33025286,483,322,88,234,3,28,11,17,126,119,1,5,1,4
E33025287,389,298,76,222,4,15,10,5,70,68,0,2,0,2
E33025288,294,226,59,167,2,20,9,11,43,42,0,1,0,3
E33025289,366,268,69,199,1,24,9,15,68,59,0,4,5,5
E33025290,332,233,61,172,1,18,7,11,80,75,0,5,0,0
E33025291,380,275,78,197,2,27,17,10,75,62,0,13,0,1
E33025292,319,217,57,160,5,27,9,18,67,63,0,3,1,3
E33025293,875,619,190,429,8,61,31,30,185,172,1,11,1,2
E33025294,365,252,78,174,1,18,10,8,90,85,0,4,1,4
E33025295,478,382,115,267,2,20,13,7,71,70,1,0,0,3
E33025296,403,296,83,213,2,30,23,7,74,69,0,5,0,1
E33025297,277,199,56,143,1,30,27,3,41,35,2,2,2,6
E33025298,283,210,55,155,3,22,11,11,47,45,0,1,1,1
E33025299,530,418,123,295,5,41,22,19,63,58,3,1,1,3
E33025300,243,163,38,125,1,23,13,10,55,50,0,4,1,1
E33025301,331,223,49,174,1,39,15,24,65,57,0,6,2,3
E33025302,370,265,61,204,3,35,19,16,63,52,2,3,6,4
E33025303,633,456,126,330,5,59,37,22,110,104,0,4,2,3
E33025304,405,314,68,246,0,17,1,16,73,69,0,4,0,1
E33025305,580,469,109,360,1,28,22,6,77,67,0,10,0,5
E33025306,350,249,79,170,3,20,16,4,68,66,1,1,0,10
E33025307,376,258,83,175,2,34,24,10,80,67,0,5,8,2
E33025308,419,276,78,198,3,44,33,11,95,90,3,2,0,1
E33025309,666,439,135,304,0,92,60,32,131,125,0,5,1,4
E33025310,691,469,128,341,6,82,54,28,130,116,1,10,3,4
E33025311,374,264,79,185,2,42,25,17,63,58,1,3,1,3
E33025312,576,435,126,309,2,53,31,22,84,81,1,2,0,2
E33025313,514,336,71,265,2,64,57,7,110,102,1,6,1,2
E33025314,393,251,62,189,0,58,50,8,84,76,1,6,1,0
E33025315,426,259,79,180,5,45,31,14,113,106,0,7,0,4
E33025316,307,172,42,130,3,32,17,15,96,89,0,3,4,4
E33025317,559,383,119,264,5,32,16,16,134,125,0,6,3,5
E33025318,399,283,73,210,2,27,10,17,86,77,1,4,4,1
E33025319,297,194,54,140,0,20,7,13,72,62,0,7,3,11
E33025320,297,158,41,117,0,27,8,19,110,103,1,5,1,2
E33025321,269,169,45,124,1,28,11,17,61,58,1,2,0,10
E33025322,1485,1105,292,813,7,70,43,27,300,277,16,5,2,3
E33025323,272,161,53,108,0,24,17,7,87,78,2,4,3,0
E33025324,317,198,58,140,0,30,15,15,84,80,0,2,2,5
E33025325,357,191,63,128,5,25,21,4,126,120,1,4,1,10
E33025326,377,209,59,150,5,29,19,10,129,124,3,2,0,5
E33025327,492,328,77,251,10,41,26,15,110,105,0,4,1,3
E33025328,361,246,58,188,2,31,18,13,81,79,0,2,0,1
E33025329,398,284,69,215,3,46,28,18,65,61,0,4,0,0
E33025330,320,160,46,114,3,67,53,14,87,82,0,1,4,3
E33025331,1094,777,217,560,8,97,56,41,208,187,2,15,4,4
E33025332,293,167,44,123,1,41,29,12,82,77,0,3,2,2
E33025333,541,294,85,209,3,50,24,26,192,183,1,7,1,2
E33025334,765,543,124,419,4,55,29,26,157,151,0,5,1,6
E33025335,1022,618,154,464,7,119,58,61,272,257,1,10,4,6
E33025336,551,320,105,215,6,69,33,36,149,142,0,6,1,7
E33025337,488,301,68,233,8,52,42,10,119,115,0,4,0,8
E33025338,940,598,152,446,4,174,129,45,156,150,0,3,3,8
E33025339,348,209,56,153,1,34,16,18,101,94,0,3,4,3
E33025340,266,190,48,142,1,26,16,10,48,40,0,5,3,1
E33025341,580,344,78,266,4,58,47,11,170,164,0,4,2,4
E33025342,366,203,61,142,2,34,23,11,125,116,2,4,3,2
E33025343,597,378,76,302,8,41,22,19,166,149,0,12,5,4
E33025344,272,162,43,119,1,34,23,11,72,66,0,5,1,3
E33025345,595,387,92,295,9,62,43,19,136,126,1,4,5,1
E33025346,295,175,36,139,1,21,13,8,97,91,3,2,1,1
E33025347,695,600,173,427,2,13,5,8,71,59,0,9,3,9
E33025348,771,583,173,410,3,47,25,22,133,120,2,10,1,5
E33025349,405,331,83,248,4,15,3,12,51,42,3,3,3,4
E33025350,542,426,92,334,8,45,23,22,61,56,0,5,0,2
E33025351,365,262,68,194,3,43,35,8,50,45,1,4,0,7
E33025352,373,313,79,234,1,13,8,5,42,38,0,4,0,4
E33025353,850,614,185,429,11,60,33,27,161,155,1,5,0,4
E33025354,365,283,84,199,0,15,7,8,62,56,0,4,2,5
E33025355,524,434,98,336,1,20,13,7,66,62,0,4,0,3
E33025356,256,204,54,150,0,10,5,5,42,41,0,1,0,0
E33025357,380,288,102,186,3,17,10,7,67,61,1,5,0,5
E33025358,383,306,112,194,1,20,20,0,54,49,4,1,0,2
E33025359,278,213,60,153,1,17,10,7,46,43,0,3,0,1
E33025360,368,284,72,212,0,29,20,9,51,44,0,7,0,4
E33025361,324,233,64,169,1,38,21,17,49,45,0,4,0,3
E33025362,333,290,89,201,0,9,5,4,32,30,0,1,1,2
E33025363,4508,3395,967,2428,23,236,126,110,834,751,29,43,11,20
E33025364,237,164,53,111,2,23,17,6,47,43,0,3,1,1
E33025365,346,252,77,175,1,17,8,9,74,68,2,4,0,2
E33025366,445,355,95,260,1,16,6,10,69,57,3,7,2,4
E33025367,341,236,41,195,0,46,39,7,52,46,0,6,0,7
E33025368,285,223,67,156,0,17,8,9,43,39,0,4,0,2
E33025369,302,243,68,175,3,12,9,3,43,37,0,5,1,1
E33025370,353,281,79,202,2,22,10,12,45,43,0,2,0,3
E33025371,361,264,78,186,3,42,32,10,49,45,0,3,1,3
E33025372,713,559,154,405,3,52,41,11,97,89,0,8,0,2
E33025373,415,313,64,249,0,9,5,4,88,77,1,10,0,5
E33025374,1425,1089,311,778,8,97,62,35,224,207,6,11,0,7
E33025375,316,200,56,144,2,40,20,20,73,69,0,4,0,1
E33025376,378,286,69,217,0,26,13,13,64,62,0,2,0,2
E33025377,396,280,63,217,4,56,39,17,54,51,0,3,0,2
E33025378,365,257,64,193,0,12,5,7,92,85,2,4,1,4
E33025379,475,311,86,225,2,26,15,11,127,118,1,8,0,9
E33025380,364,266,79,187,0,13,9,4,85,79,0,6,0,0
E33025381,621,420,85,335,9,40,19,21,146,140,0,6,0,6
E33025382,339,253,70,183,1,12,7,5,72,67,2,3,0,1
E33025383,467,381,121,260,3,14,8,6,64,58,1,5,0,5
E33025384,269,231,93,138,1,9,5,4,28,26,0,2,0,0
E33025385,546,441,139,302,0,13,5,8,90,83,0,7,0,2
E33025386,279,231,82,149,0,5,4,1,41,40,0,1,0,2
E33025387,355,271,95,176,1,11,5,6,69,69,0,0,0,3
E33025388,295,252,65,187,0,9,5,4,33,33,0,0,0,1
E33025389,463,280,62,218,7,104,58,46,67,65,0,1,1,5
E33025390,293,202,52,150,0,17,6,11,71,66,1,4,0,3
E33025391,293,210,71,139,0,33,15,18,46,43,0,3,0,4
E33025392,329,295,99,196,1,3,2,1,26,23,0,3,0,4
E33025393,464,362,129,233,4,28,12,16,65,64,0,1,0,5
E33025394,335,257,60,197,5,20,10,10,53,52,0,1,0,0
E33025395,333,228,68,160,0,40,23,17,64,59,1,3,1,1
E33025396,456,316,83,233,6,42,24,18,89,82,1,3,3,3
E33025397,239,160,44,116,0,31,18,13,47,41,0,6,0,1
E33025398,282,165,38,127,2,46,37,9,66,61,0,3,2,3
E33025399,306,177,36,141,0,29,15,14,95,89,0,6,0,5
E33025400,332,243,52,191,3,26,14,12,59,57,1,1,0,1
E33025401,334,251,77,174,3,33,20,13,44,37,4,2,1,3
E33025402,263,192,63,129,2,11,9,2,55,48,0,7,0,3
E33025403,445,306,68,238,3,6,3,3,127,114,2,8,3,3
E33025404,298,219,77,142,0,16,15,1,61,59,0,2,0,2
E33025405,397,308,71,237,0,7,4,3,82,79,0,2,1,0
E33025406,431,344,102,242,2,19,7,12,62,59,0,3,0,4
E33025407,342,209,60,149,1,33,22,11,96,87,3,6,0,3
E33025408,336,277,77,200,0,6,4,2,51,49,0,2,0,2
E33025409,248,180,52,128,1,4,1,3,60,57,1,2,0,3
E33025410,463,395,93,302,3,11,9,2,48,47,0,1,0,6
E33025411,478,361,107,254,1,21,12,9,92,81,1,10,0,3
E33025412,372,266,93,173,0,11,6,5,90,86,1,2,1,5
E33025413,261,202,72,130,1,12,6,6,46,44,0,2,0,0
E33025414,280,170,60,110,0,19,9,10,88,80,3,5,0,3
E33025415,410,275,81,194,1,32,17,15,100,95,2,2,1,2
E33025416,673,383,108,275,8,98,45,53,179,176,0,2,1,5
E33025417,378,269,65,204,0,13,5,8,93,87,0,6,0,3
E33025418,219,115,34,81,1,42,17,25,61,59,0,1,1,0
E33025419,396,302,95,207,4,14,7,7,74,67,1,5,1,2
E33025420,423,255,40,215,0,15,7,8,147,143,0,4,0,6
E33025421,390,267,107,160,3,18,9,9,99,90,0,9,0,3
E33025422,796,513,131,382,8,108,56,52,163,147,0,14,2,4
E33025423,325,215,53,162,1,32,15,17,70,66,0,2,2,7
E33025424,601,373,113,260,6,102,37,65,115,100,1,14,0,5
E33025425,473,355,103,252,5,30,12,18,80,69,0,6,5,3
E33025426,314,220,48,172,2,25,10,15,61,59,0,1,1,6
E33025427,627,418,114,304,3,101,42,59,99,91,1,7,0,6
E33025428,1097,765,169,596,9,86,44,42,229,218,0,10,1,8
E33025429,314,176,55,121,1,26,13,13,106,99,3,1,3,5
E33025430,306,202,52,150,2,22,15,7,78,75,0,3,0,2
E33025431,303,189,60,129,2,25,7,18,87,81,0,4,2,0
E33025432,266,108,30,78,0,80,5,75,75,75,0,0,0,3
E33025433,553,355,73,282,6,47,24,23,141,133,1,5,2,4
E33025434,591,400,123,277,5,49,19,30,134,128,0,5,1,3
E33025435,617,407,77,330,2,36,14,22,171,158,2,11,0,1
E33025436,470,303,88,215,1,32,15,17,127,123,0,3,1,7
E33025437,1601,1128,286,842,16,101,49,52,347,329,2,16,0,9
E33025438,408,264,80,184,1,17,9,8,124,121,0,3,0,2
E33025439,387,246,83,163,2,26,19,7,108,101,1,5,1,5
E33025440,303,214,45,169,3,14,7,7,70,68,0,2,0,2
E33025441,385,200,56,144,4,41,20,21,132,128,0,4,0,8
E33025442,272,163,43,120,2,18,10,8,86,82,1,3,0,3
E33025443,308,177,40,137,1,16,4,12,112,104,1,6,1,2
E33025444,340,183,61,122,2,27,15,12,125,115,2,8,0,3
E33025445,547,347,88,259,7,36,18,18,147,142,0,4,1,10
E33025446,245,207,93,114,0,9,2,7,29,27,0,2,0,0
E33025447,241,161,41,120,0,18,11,7,58,52,0,5,1,4
E33025448,278,232,71,161,1,9,3,6,34,31,0,3,0,2
E33025449,497,373,109,264,6,30,9,21,78,71,2,4,1,10
E33025450,496,394,120,274,3,14,5,9,85,80,0,5,0,0
E33025451,573,407,92,315,1,69,39,30,95,90,0,5,0,1
E33025452,330,239,82,157,0,51,36,15,38,35,0,3,0,2
E33025453,299,264,82,182,4,8,6,2,21,16,1,4,0,2
E33025454,325,265,66,199,4,14,10,4,38,36,0,2,0,4
E33025455,284,181,56,125,2,46,18,28,54,50,0,4,0,1
E33025456,289,182,45,137,0,34,21,13,68,63,0,5,0,5
E33025457,759,663,205,458,2,33,15,18,57,51,1,4,1,4
E33025458,508,428,139,289,1,33,20,13,42,40,1,1,0,4
E33025459,303,264,84,180,1,17,12,5,20,18,1,1,0,1
E33025460,530,413,118,295,1,55,42,13,60,55,0,4,1,1
E33025461,300,219,75,144,2,48,43,5,31,25,2,4,0,0
E33025462,289,256,75,181,0,21,8,13,11,9,0,2,0,1
E33025463,716,566,168,398,2,72,45,27,74,65,3,5,1,2
E33025464,482,377,117,260,3,44,37,7,54,49,1,4,0,4
E33025465,654,495,134,361,0,82,72,10,67,50,6,6,5,10
E33025466,710,540,136,404,2,57,39,18,105,88,5,6,6,6
E33025467,644,488,122,366,6,57,46,11,84,76,1,4,3,9
E33025468,427,358,85,273,2,23,16,7,44,38,0,5,1,0
E33025469,418,357,109,248,1,17,11,6,40,36,0,3,1,3
E33025470,556,421,125,296,0,64,32,32,65,63,1,1,0,6
E33025471,488,367,88,279,2,48,31,17,67,60,4,3,0,4
E33025472,310,201,54,147,0,60,55,5,44,42,0,1,1,5
E33025473,515,356,79,277,4,95,77,18,58,50,3,5,0,2
E33025474,397,295,121,174,2,51,49,2,48,42,0,5,1,1
E33025475,361,296,70,226,0,18,17,1,46,39,0,3,4,1
E33025476,660,423,93,330,6,135,105,30,92,84,0,7,1,4
E33025477,350,264,52,212,4,47,40,7,31,28,0,2,1,4
E33025478,462,316,55,261,1,97,83,14,45,45,0,0,0,3
E33025479,477,331,58,273,4,86,82,4,53,53,0,0,0,3
E33025480,442,288,76,212,3,84,71,13,63,54,2,7,0,4
E33025481,308,239,44,195,0,35,30,5,32,29,0,3,0,2
E33025482,433,300,73,227,2,62,54,8,67,62,0,5,0,2
E33025483,390,293,70,223,1,49,43,6,41,34,0,3,4,6
E33025484,378,256,60,196,0,75,65,10,46,44,0,2,0,1
E33025485,443,321,75,246,3,85,82,3,34,31,0,3,0,0
E33025486,411,343,78,265,1,28,25,3,38,38,0,0,0,1
E33025487,930,746,212,534,4,96,70,26,79,73,2,4,0,5
E33025488,672,554,145,409,6,58,53,5,48,46,1,1,0,6
E33025489,525,401,115,286,1,53,41,12,69,57,1,11,0,1
E33025490,500,342,95,247,0,112,96,16,44,40,1,2,1,2
E33025491,527,322,72,250,3,166,145,21,35,35,0,0,0,1
E33025492,337,233,50,183,2,54,48,6,48,47,0,1,0,0
E33025493,539,401,107,294,2,51,36,15,83,80,0,3,0,2
E33025494,470,364,91,273,7,40,29,11,58,54,1,2,1,1
E33025495,357,262,72,190,1,35,23,12,52,39,7,3,3,7
E33025496,457,378,92,286,0,44,35,9,33,29,0,4,0,2
E33025497,322,228,40,188,2,43,40,3,48,43,1,3,1,1
E33025498,367,270,76,194,0,42,29,13,52,47,0,5,0,3
E33025499,710,585,162,423,10,41,33,8,71,65,1,3,2,3
E33025500,341,275,77,198,4,22,17,5,36,30,0,6,0,4
E33025501,282,191,42,149,1,60,51,9,29,27,0,1,1,1
E33025502,383,263,80,183,5,47,39,8,64,59,0,5,0,4
E33025503,342,184,26,158,12,69,56,13,74,71,0,3,0,3
E33025504,608,380,63,317,4,72,53,19,152,144,0,5,3,0
E33025505,424,309,62,247,2,28,25,3,85,79,0,5,1,0
E33025506,509,334,81,253,9,66,54,12,99,88,0,6,5,1
E33025507,282,183,62,121,1,34,26,8,63,59,0,1,3,1
E33025508,728,510,106,404,4,64,48,16,149,139,2,6,2,1
E33025509,504,326,77,249,2,69,59,10,101,89,2,9,1,6
E33025510,657,489,128,361,3,81,66,15,78,69,0,9,0,6
E33025511,348,250,70,180,2,34,30,4,57,51,0,5,1,5
E33025512,368,186,44,142,9,37,16,21,135,124,2,7,2,1
E33025513,555,304,90,214,3,101,88,13,143,138,0,5,0,4
E33025514,375,236,63,173,5,50,40,10,84,77,1,4,2,0
E33025515,678,525,161,364,2,90,85,5,59,52,0,7,0,2
E33025516,566,333,83,250,8,121,114,7,101,95,0,5,1,3
E33025517,883,608,148,460,2,142,113,29,128,119,0,8,1,3
E33025518,316,223,44,179,1,66,51,15,24,20,1,3,0,2
E33025519,1416,1058,284,774,6,176,139,37,171,162,0,8,1,5
E33025520,467,303,66,237,4,98,84,14,62,58,0,4,0,0
E33025521,425,304,71,233,7,72,9,63,42,39,0,2,1,0
E33025522,675,530,118,412,12,53,8,45,79,72,1,6,0,1
E33025523,341,262,58,204,1,49,2,47,28,26,0,0,2,1
E33025524,274,220,67,153,4,24,6,18,26,24,0,1,1,0
E33025525,797,631,183,448,6,29,7,22,125,116,4,4,1,6
E33025526,629,446,134,312,6,89,17,72,83,76,1,3,3,5
E33025527,256,197,53,144,4,26,3,23,26,24,1,1,0,3
E33025528,480,360,128,232,4,54,15,39,58,55,1,1,1,4
E33025529,354,282,108,174,1,27,4,23,43,39,2,2,0,1
E33025530,587,434,121,313,3,65,5,60,77,67,0,7,3,8
E33025531,287,229,66,163,1,12,2,10,44,40,2,2,0,1
E33025532,320,223,65,158,8,45,7,38,41,38,0,2,1,3
E33025533,509,376,110,266,5,72,10,62,55,53,0,1,1,1
E33025534,285,209,80,129,2,28,6,22,41,36,2,2,1,5
E33025535,315,240,78,162,2,30,6,24,41,39,1,1,0,2
E33025536,469,343,105,238,6,73,11,62,41,35,1,4,1,6
E33025537,375,212,79,133,0,49,5,44,98,85,7,3,3,16
E33025538,1476,1042,260,782,14,115,29,86,297,277,3,14,3,8
E33025539,528,374,121,253,6,63,10,53,80,75,2,2,1,5
E33025540,516,332,87,245,4,81,19,62,99,95,0,3,1,0
E33025541,400,312,91,221,6,35,7,28,42,39,0,3,0,5
E33025542,512,324,79,245,11,99,9,90,72,60,2,8,2,6
E33025543,515,400,153,247,4,53,8,45,56,49,2,3,2,2
E33025544,377,269,79,190,5,58,13,45,43,37,0,1,5,2
E33025545,366,265,76,189,10,63,6,57,27,25,1,1,0,1
E33025546,335,247,73,174,4,41,10,31,41,37,0,3,1,2
E33025547,298,200,30,170,3,34,4,30,60,58,1,1,0,1
E33025548,490,379,112,267,1,62,7,55,44,37,4,2,1,4
E33025549,286,199,51,148,4,51,5,46,31,30,0,1,0,1
E33025550,590,460,126,334,8,24,4,20,90,78,1,10,1,8
E33025551,484,317,91,226,11,57,25,32,84,70,6,5,3,15
E33025552,326,242,84,158,5,26,5,21,52,49,0,2,1,1
E33025553,269,214,69,145,7,7,4,3,38,34,0,2,2,3
E33025554,305,215,73,142,3,36,10,26,48,43,3,1,1,3
E33025555,865,659,130,529,13,27,11,16,164,155,3,4,2,2
E33025556,416,323,84,239,3,30,2,28,55,48,2,3,2,5
E33025557,381,305,88,217,4,35,7,28,36,30,4,1,1,1
E33025558,902,702,214,488,6,38,12,26,151,136,8,6,1,5
E33025559,475,380,101,279,3,46,7,39,45,35,1,5,4,1
E33025560,381,282,102,180,4,43,6,37,48,39,0,7,2,4
E33025561,374,310,103,207,2,33,9,24,27,22,0,4,1,2
E33025562,312,227,67,160,5,32,6,26,46,43,0,3,0,2
E33025563,499,315,111,204,6,35,10,25,107,89,13,2,3,36
E33025564,526,425,131,294,10,31,7,24,59,55,2,1,1,1
E33025565,391,238,91,147,4,27,10,17,101,75,5,4,17,21
E33025566,354,242,59,183,2,44,2,42,62,57,4,1,0,4
E33025567,402,312,66,246,1,25,1,24,62,53,2,5,2,2
E33025568,381,284,80,204,4,46,8,38,43,34,4,3,2,4
E33025569,362,276,78,198,2,43,5,38,38,35,0,2,1,3
E33025570,780,532,130,402,8,113,54,59,126,114,0,9,3,1
E33025571,394,281,75,206,6,47,9,38,56,48,4,2,2,4
E33025572,404,309,86,223,1,35,6,29,56,42,11,2,1,3
E33025573,320,214,47,167,5,56,8,48,41,29,8,2,2,4
E33025574,367,293,90,203,2,30,3,27,40,32,1,5,2,2
E33025575,616,480,132,348,9,30,5,25,97,60,17,10,10,0
E33025576,605,457,109,348,4,78,10,68,62,47,3,8,4,4
E33025577,334,226,81,145,3,61,18,43,43,34,7,2,0,1
E33025578,698,459,134,325,6,125,14,111,104,92,3,3,6,4
E33025579,321,242,73,169,6,39,5,34,32,27,3,1,1,2
E33025580,334,263,72,191,2,25,3,22,44,37,4,3,0,0
E33025581,391,291,93,198,6,23,6,17,70,61,1,7,1,1
E33025582,537,442,130,312,5,33,8,25,56,50,0,6,0,1
E33025583,317,252,75,177,1,27,4,23,34,28,1,1,4,3
E33025584,551,425,116,309,5,50,6,44,69,60,1,6,2,2
E33025585,740,554,148,406,10,72,17,55,100,80,2,7,11,4
E33025586,342,301,89,212,1,10,1,9,28,26,1,0,1,2
E33025587,685,516,178,338,12,40,9,31,113,104,0,6,3,4
E33025588,453,327,72,255,4,29,5,24,93,37,38,1,17,0
E33025589,397,322,88,234,4,26,5,21,42,32,6,3,1,3
E33025590,379,285,83,202,4,37,0,37,51,36,5,3,7,2
E33025591,261,217,61,156,1,17,2,15,23,20,0,3,0,3
E33025592,664,498,116,382,6,65,8,57,92,81,7,4,0,3
E33025593,254,198,63,135,1,26,8,18,27,22,1,4,0,2
E33025594,252,198,45,153,2,22,6,16,26,25,1,0,0,4
E33025595,337,245,66,179,6,40,17,23,43,39,1,1,2,3
E33025596,375,278,30,248,6,28,1,27,63,62,0,1,0,0
E33025597,356,275,90,185,0,53,24,29,24,20,1,1,2,4
E33025598,345,266,82,184,6,53,10,43,19,15,0,3,1,1
E33025599,310,232,63,169,6,26,3,23,42,35,0,5,2,4
E33025600,360,290,65,225,2,16,0,16,50,42,0,6,2,2
E33025601,693,531,143,388,3,86,7,79,72,68,3,1,0,1
E33025602,316,268,71,197,3,14,0,14,28,25,0,3,0,3
E33025603,459,382,102,280,1,18,9,9,55,50,2,2,1,3
E33025604,292,230,78,152,0,18,9,9,41,35,3,2,1,3
E33025605,436,315,104,211,2,50,6,44,67,57,3,4,3,2
E33025606,390,312,80,232,4,17,4,13,54,46,2,6,0,3
E33025607,469,355,121,234,5,50,15,35,50,45,0,3,2,9
E33025608,554,439,127,312,7,37,7,30,69,58,1,7,3,2
E33025609,672,518,157,361,3,44,7,37,95,85,6,2,2,12
E33025610,300,256,80,176,0,21,8,13,20,17,0,3,0,3
E33025611,410,343,90,253,2,22,4,18,38,33,1,2,2,5
E33025612,452,370,113,257,6,22,4,18,52,45,3,4,0,2
E33025613,326,256,94,162,2,27,4,23,39,31,2,6,0,2
E33025614,377,285,115,170,6,27,2,25,54,41,4,8,1,5
E33025615,324,232,79,153,2,34,4,30,55,42,1,6,6,1
E33025616,320,234,85,149,1,19,4,15,54,45,0,5,4,12
E33025617,278,225,68,157,1,18,1,17,30,26,1,1,2,4
E33025618,252,185,57,128,2,7,0,7,55,44,6,5,0,3
E33025619,280,216,71,145,3,16,1,15,41,37,1,1,2,4
E33025620,273,222,55,167,1,19,8,11,29,23,2,4,0,2
E33025621,261,231,84,147,1,8,0,8,20,20,0,0,0,1
E33025622,285,217,90,127,4,19,2,17,36,29,3,2,2,9
E33025623,280,224,88,136,5,8,3,5,40,35,0,5,0,3
E33025624,225,162,48,114,2,15,5,10,40,37,1,2,0,6
E33025625,692,501,168,333,10,61,12,49,116,104,4,6,2,4
E33025626,421,361,92,269,5,15,1,14,40,40,0,0,0,0
E33025627,317,235,61,174,4,34,8,26,44,42,0,2,0,0
E33025628,272,221,80,141,2,11,0,11,36,29,0,2,5,2
E33025629,329,246,78,168,2,17,4,13,59,46,1,9,3,5
E33025630,851,647,170,477,6,51,19,32,140,123,3,12,2,7
E33025631,322,256,56,200,4,21,4,17,41,41,0,0,0,0
E33025632,354,279,86,193,9,31,10,21,31,31,0,0,0,4
E33025633,273,206,70,136,2,16,3,13,47,37,3,5,2,2
E33025634,272,198,47,151,6,20,2,18,37,35,0,2,0,11
E33025635,419,327,117,210,4,36,3,33,43,39,0,1,3,9
E33025636,311,243,88,155,5,18,5,13,41,34,3,3,1,4
E33025637,369,276,79,197,7,28,5,23,50,48,2,0,0,8
E33025638,277,177,47,130,7,41,5,36,45,42,1,2,0,7
E33025639,261,194,68,126,2,14,2,12,45,40,3,2,0,6
E33025640,328,257,90,167,3,24,5,19,43,33,2,7,1,1
E33025641,271,212,64,148,3,30,4,26,25,21,0,2,2,1
E33025642,422,340,105,235,5,28,2,26,46,45,0,1,0,3
E33025643,492,392,138,254,9,26,2,24,60,53,0,5,2,5
E33025644,316,272,110,162,2,15,3,12,27,24,0,3,0,0
E33025645,438,333,101,232,2,59,5,54,43,38,2,2,1,1
E33025646,431,358,124,234,1,25,5,20,46,41,0,4,1,1
E33025647,373,241,49,192,11,47,7,40,72,70,0,2,0,2
E33025648,310,261,71,190,2,18,4,14,25,24,0,0,1,4
E33025649,346,236,66,170,4,62,8,54,40,34,3,3,0,4
E33025650,479,324,54,270,9,53,8,45,86,81,0,5,0,7
E33025651,485,300,107,193,8,81,6,75,92,90,0,2,0,4
E33025652,513,355,106,249,5,70,10,60,82,74,2,6,0,1
E33025653,329,250,86,164,3,27,3,24,47,42,1,3,1,2
E33025654,254,223,68,155,0,3,0,3,22,21,0,1,0,6
E33025655,421,344,113,231,6,15,0,15,56,47,4,5,0,0
E33025656,323,288,101,187,3,12,4,8,20,18,0,0,2,0
E33025657,376,318,92,226,3,19,2,17,35,33,2,0,0,1
E33025658,255,183,50,133,2,18,3,15,50,45,0,4,1,2
E33025659,674,520,193,327,13,45,5,40,86,77,1,6,2,10
E33025660,447,264,93,171,4,63,13,50,112,104,3,4,1,4
E33025661,360,212,63,149,1,54,10,44,88,78,1,5,4,5
E33025662,223,142,40,102,2,26,4,22,51,46,1,4,0,2
E33025663,399,304,82,222,4,35,6,29,53,53,0,0,0,3
E33025664,315,176,60,116,4,48,5,43,84,82,0,2,0,3
E33025665,314,198,52,146,4,28,2,26,82,72,2,5,3,2
E33025666,635,461,128,333,10,57,11,46,100,79,5,11,5,7
E33025667,284,209,65,144,1,29,9,20,44,41,0,3,0,1
E33025668,419,290,89,201,3,51,9,42,71,63,1,5,2,4
E33025669,256,201,64,137,1,14,0,14,39,35,2,2,0,1
E33025670,259,194,64,130,1,11,2,9,48,48,0,0,0,5
E33025671,296,213,65,148,3,23,2,21,55,51,0,1,3,2
E33025672,324,164,53,111,4,44,10,34,108,97,3,8,0,4
E33025673,399,302,61,241,6,28,2,26,60,56,1,2,1,3
E33025674,364,241,87,154,2,45,13,32,74,68,1,4,1,2
E33025675,473,311,103,208,6,67,8,59,81,73,1,1,6,8
E33025676,293,159,62,97,4,42,6,36,86,83,0,3,0,2
E33025677,302,184,40,144,5,35,7,28,77,74,0,3,0,1
E33025678,437,239,77,162,4,49,11,38,139,130,0,8,1,6
E33025679,500,357,99,258,3,46,7,39,84,80,0,2,2,10
E33025680,475,335,88,247,14,33,6,27,82,77,3,2,0,11
E33025681,412,304,83,221,3,44,7,37,59,52,0,6,1,2
E33025682,646,388,124,264,11,147,17,130,100,93,1,6,0,0
E33025683,264,161,50,111,0,64,18,46,37,34,0,2,1,2
E33025684,499,331,75,256,5,69,12,57,92,87,0,5,0,2
E33025685,320,214,59,155,4,56,12,44,44,40,1,2,1,2
E33025686,279,182,49,133,2,40,1,39,47,40,2,3,2,8
E33025687,485,368,123,245,5,49,9,40,57,54,1,2,0,6
E33025688,253,157,38,119,6,46,10,36,43,42,0,1,0,1
E33025689,408,269,92,177,4,47,9,38,83,74,1,5,3,5
E33025690,496,313,70,243,3,82,21,61,97,89,2,5,1,1
E33025691,328,234,76,158,4,35,7,28,51,48,0,2,1,4
E33025692,385,252,64,188,7,56,10,46,69,65,2,2,0,1
E33025693,281,189,65,124,2,56,7,49,33,31,0,2,0,1
E33025694,403,282,82,200,4,58,7,51,57,50,1,6,0,2
E33025695,462,335,95,240,10,41,11,30,72,57,4,3,8,4
E33025696,274,216,62,154,0,31,1,30,25,25,0,0,0,2
E33025697,578,391,118,273,3,67,7,60,113,107,0,4,2,4
E33025698,350,256,77,179,3,30,4,26,56,50,0,4,2,5
E33025699,377,300,86,214,1,23,2,21,49,47,1,1,0,4
E33025700,260,193,68,125,0,22,1,21,38,33,1,3,1,7
E33025701,297,231,65,166,4,18,4,14,44,36,1,6,1,0
E33025702,1169,886,207,679,15,104,12,92,160,142,4,12,2,4
E33025703,321,223,59,164,2,59,7,52,35,34,0,1,0,2
E33025704,1135,947,165,782,21,74,20,54,90,74,1,9,6,3
E33025705,466,371,117,254,6,41,3,38,45,40,2,3,0,3
E33025706,518,332,97,235,14,78,10,68,91,82,1,6,2,3
E33025707,296,232,83,149,6,23,4,19,29,26,0,2,1,6
E33025708,533,343,66,277,9,74,11,63,102,93,4,2,3,5
E33025709,269,189,64,125,7,19,3,16,51,48,0,2,1,3
E33025710,313,227,52,175,0,34,4,30,46,46,0,0,0,6
E33025711,492,393,112,281,4,27,1,26,64,55,2,3,4,4
E33025712,331,283,78,205,3,12,2,10,33,32,0,1,0,0
E33025713,419,306,84,222,4,43,11,32,59,53,0,5,1,7
E33025714,292,252,77,175,4,13,9,4,20,20,0,0,0,3
E33025715,355,274,67,207,3,17,11,6,58,48,0,8,2,3
E33025716,523,414,121,293,4,31,11,20,68,62,1,5,0,6
E33025717,672,546,167,379,6,36,15,21,81,74,0,5,2,3
E33025718,795,572,141,431,11,82,54,28,126,112,2,8,4,4
E33025719,316,239,76,163,4,33,20,13,30,28,0,1,1,10
E33025720,288,240,70,170,3,16,12,4,25,22,3,0,0,4
E33025721,371,301,99,202,5,24,19,5,34,30,0,4,0,7
E33025722,409,315,76,239,2,34,24,10,58,53,1,2,2,0
E33025723,355,267,82,185,3,49,39,10,34,21,6,4,3,2
E33025724,312,230,65,165,3,12,10,2,65,59,2,4,0,2
E33025725,447,362,95,267,4,32,21,11,40,37,0,1,2,9
E33025726,257,199,58,141,1,22,18,4,32,31,0,1,0,3
E33025727,327,256,94,162,2,26,20,6,33,32,0,1,0,10
E33025728,404,327,81,246,4,38,35,3,32,28,1,3,0,3
E33025729,601,500,136,364,2,38,30,8,57,46,4,7,0,4
E33025730,468,358,97,261,3,21,14,7,77,69,3,5,0,9
E33025731,276,196,55,141,1,37,29,8,37,32,0,4,1,5
E33025732,590,448,158,290,5,63,42,21,72,59,1,12,0,2
E33025733,298,170,40,130,4,73,61,12,49,46,0,2,1,2
E33025734,489,341,93,248,5,46,25,21,90,81,2,7,0,7
E33025735,552,462,160,302,3,35,20,15,50,42,4,2,2,2
E33025736,349,296,99,197,1,21,13,8,27,19,0,7,1,4
E33025737,369,302,93,209,2,11,11,0,47,38,1,6,2,7
E33025738,390,327,74,253,0,11,5,6,51,49,1,1,0,1
E33025739,418,296,65,231,7,56,52,4,54,46,3,3,2,5
E33025740,756,532,128,404,5,122,96,26,95,90,0,4,1,2
E33025741,366,307,84,223,6,14,8,6,36,33,2,1,0,3
E33025742,339,282,64,218,2,21,10,11,32,29,1,1,1,2
E33025743,456,307,48,259,5,60,26,34,78,76,0,2,0,6
E33025744,292,212,38,174,5,25,5,20,50,39,3,5,3,0
E33025745,568,435,100,335,6,59,38,21,65,57,0,5,3,3
E33025746,549,391,73,318,9,71,33,38,75,64,1,10,0,3
E33025747,689,494,130,364,1,80,61,19,110,103,0,7,0,4
E33025748,483,334,80,254,9,77,51,26,58,52,1,5,0,5
E33025749,298,238,63,175,1,17,13,4,42,34,3,3,2,0
E33025750,288,253,86,167,1,11,5,6,22,17,0,2,3,1
E33025751,669,492,124,368,11,78,52,26,87,76,2,8,1,1
E33025752,639,499,109,390,10,53,37,16,74,68,0,5,1,3
E33025753,303,230,62,168,2,46,39,7,22,16,0,4,2,3
E33025754,258,225,77,148,1,15,12,3,17,15,0,2,0,0
E33025755,355,267,93,174,5,40,34,6,42,36,1,2,3,1
E33025756,470,341,73,268,5,46,23,23,70,66,2,2,0,8
E33025757,304,256,69,187,4,19,15,4,22,22,0,0,0,3
E33025758,528,417,114,303,6,44,28,16,60,56,0,4,0,1
E33025759,651,448,114,334,2,63,45,18,129,113,5,7,4,9
E33025760,613,365,81,284,5,119,75,44,123,109,3,10,1,1
E33025761,481,364,105,259,9,50,33,17,56,53,0,1,2,2
E33025762,475,314,83,231,3,71,40,31,86,76,0,9,1,1
E33025763,418,302,84,218,0,56,39,17,55,53,0,2,0,5
E33025764,449,351,103,248,5,35,21,14,57,52,0,5,0,1
E33025765,306,228,67,161,0,31,19,12,46,42,1,3,0,1
E33025766,373,302,58,244,3,35,22,13,33,33,0,0,0,0
E33025767,370,228,52,176,5,89,66,23,41,40,0,0,1,7
E33025768,237,188,45,143,4,14,11,3,30,25,0,3,2,1
E33025769,323,274,68,206,0,22,21,1,25,23,0,1,1,2
E33025770,478,368,84,284,12,19,14,5,76,70,1,5,0,3
E33025771,376,310,89,221,8,19,10,9,37,33,2,1,1,2
E33025772,451,332,85,247,0,30,18,12,87,81,2,4,0,2
E33025773,321,267,91,176,3,12,6,6,39,37,0,2,0,0
E33025774,363,292,102,190,2,35,23,12,28,25,0,2,1,6
E33025775,448,323,108,215,4,58,44,14,58,52,0,1,5,5
E33025776,365,270,78,192,1,41,33,8,48,39,1,8,0,5
E33025777,303,234,80,154,5,29,16,13,33,32,0,1,0,2
E33025778,395,302,93,209,0,39,36,3,48,38,3,7,0,6
E33025779,280,204,79,125,3,25,20,5,47,28,17,2,0,1
E33025780,306,238,79,159,2,19,16,3,40,38,1,1,0,7
E33025781,349,271,67,204,0,35,25,10,38,34,0,0,4,5
E33025782,557,410,95,315,12,55,37,18,78,72,2,3,1,2
E33025783,364,307,83,224,1,23,20,3,33,25,1,5,2,0
E33025784,296,117,37,80,13,104,89,15,60,59,0,1,0,2
E33025785,321,159,47,112,15,71,59,12,72,58,2,2,10,4
E33025786,404,195,49,146,12,135,93,42,57,46,4,4,3,5
E33025787,307,169,51,118,7,69,42,27,60,57,0,1,2,2
E33025788,350,202,42,160,8,51,39,12,85,70,2,3,10,4
E33025789,284,159,72,87,3,73,57,16,46,46,0,0,0,3
E33025790,299,218,72,146,3,26,18,8,49,46,1,1,1,3
E33025791,334,178,72,106,5,90,73,17,57,48,1,5,3,4
E33025792,332,182,65,117,2,68,44,24,77,70,3,4,0,3
E33025793,320,185,70,115,3,39,25,14,89,87,2,0,0,4
E33025794,323,162,63,99,7,101,63,38,53,43,3,4,3,0
E33025795,294,148,47,101,4,67,41,26,71,67,2,0,2,4
E33025796,399,205,72,133,12,112,34,78,67,62,0,5,0,3
E33025797,294,156,60,96,6,81,17,64,48,43,0,4,1,3
E33025798,801,545,174,371,14,60,30,30,179,164,4,10,1,3
E33025799,271,147,40,107,3,44,31,13,75,65,4,6,0,2
E33025800,251,170,55,115,3,29,15,14,44,42,0,1,1,5
E33025801,741,512,190,322,8,95,56,39,117,109,1,4,3,9
E33025802,243,142,71,71,2,19,7,12,78,73,4,1,0,2
E33025803,431,260,91,169,6,73,38,35,85,80,1,3,1,7
E33025804,303,192,65,127,6,25,16,9,76,71,0,4,1,4
E33025805,122,75,28,47,2,5,2,3,37,35,1,1,0,3
E33025806,429,316,129,187,2,26,17,9,78,71,3,3,1,7
E33025807,582,347,126,221,12,85,52,33,132,116,5,5,6,6
E33025808,390,227,73,154,6,67,42,25,86,82,0,4,0,4
E33025809,522,279,76,203,10,135,106,29,96,90,2,3,1,2
E33025810,405,259,69,190,6,87,64,23,50,42,1,7,0,3
E33025811,270,159,43,116,1,72,54,18,35,32,0,2,1,3
E33025812,557,357,97,260,11,56,41,15,125,115,0,9,1,8
E33025813,348,193,86,107,7,34,22,12,102,97,1,3,1,12
E33025814,217,140,69,71,3,28,20,8,42,36,2,1,3,4
E33025815,259,146,60,86,5,30,16,14,69,57,5,5,2,9
E33025816,244,176,85,91,3,18,10,8,43,41,1,1,0,4
E33025817,671,365,149,216,12,53,22,31,226,198,13,8,7,15
E33025818,429,246,96,150,7,63,42,21,99,90,5,1,3,14
E33025819,641,304,85,219,9,116,78,38,205,192,2,8,3,7
E33025820,502,236,68,168,13,74,28,46,172,147,6,12,7,7
E33025821,330,166,51,115,4,24,12,12,128,118,4,3,3,8
E33025822,369,248,100,148,8,57,38,19,47,38,3,4,2,9
E33025823,373,247,77,170,10,27,8,19,86,75,2,6,3,3
E33025824,499,325,159,166,12,20,11,9,132,104,14,6,8,10
E33025825,331,160,66,94,8,55,33,22,89,68,11,3,7,19
E33025826,425,275,93,182,1,35,18,17,109,102,1,3,3,5
E33025827,307,185,62,123,2,33,21,12,82,78,2,1,1,5
E33025828,257,140,56,84,8,38,26,12,61,47,11,1,2,10
E33025829,261,143,54,89,9,59,39,20,48,40,4,4,0,2
E33025830,255,158,46,112,3,29,15,14,59,56,0,3,0,6
E33025831,620,289,99,190,9,151,92,59,169,150,6,10,3,2
E33025832,547,360,123,237,5,41,17,24,134,128,1,3,2,7
E33025833,254,146,46,100,3,41,32,9,62,58,1,1,2,2
E33025834,381,200,67,133,3,96,68,28,80,76,3,0,1,2
E33025835,657,445,134,311,15,79,55,24,112,107,2,3,0,6
E33025836,290,144,52,92,5,37,16,21,100,94,4,1,1,4
E33025837,347,204,69,135,5,48,33,15,89,78,1,6,4,1
E33025838,367,221,78,143,6,74,44,30,65,61,0,4,0,1
E33025839,351,196,55,141,10,55,39,16,85,77,2,4,2,5
E33025840,293,196,58,138,8,27,16,11,58,56,1,0,1,4
E33025841,354,218,69,149,7,73,46,27,50,43,4,2,1,6
E33025842,416,248,84,164,5,93,67,26,69,64,0,5,0,1
E33025843,740,450,121,329,19,121,67,54,147,142,0,4,1,3
E33025844,341,194,75,119,2,58,43,15,81,79,0,1,1,6
E33025845,303,188,61,127,2,59,50,9,53,51,1,1,0,1
E33025846,533,379,131,248,7,43,22,21,98,94,0,4,0,6
E33025847,474,283,58,225,11,46,24,22,132,119,4,4,5,2
E33025848,262,162,58,104,5,41,28,13,49,41,1,4,3,5
E33025849,274,164,53,111,5,58,47,11,46,40,2,4,0,1
E33025850,921,586,182,404,16,153,57,96,161,141,9,11,0,5
E33025851,284,200,70,130,1,31,17,14,52,45,2,4,1,0
E33025852,302,207,70,137,4,33,26,7,51,47,0,4,0,7
E33025853,404,275,87,188,3,59,47,12,61,58,1,1,1,6
E33025854,631,430,153,277,14,58,28,30,109,100,6,1,2,20
E33025855,440,284,101,183,11,34,21,13,104,91,3,4,6,7
E33025856,210,133,48,85,8,18,8,10,47,43,1,3,0,4
E33025857,692,373,124,249,6,61,40,21,242,220,11,7,4,10
E33025858,607,475,154,321,5,41,17,24,77,66,6,4,1,9
E33025859,326,251,101,150,1,30,23,7,37,36,0,1,0,7
E33025860,874,632,231,401,8,67,43,24,149,132,3,12,2,18
E33025861,312,197,63,134,7,58,45,13,42,32,2,7,1,8
E33025862,268,190,91,99,2,22,15,7,52,47,4,0,1,2
E33025863,263,187,76,111,2,28,21,7,42,36,1,4,1,4
E33025864,440,238,61,177,9,49,17,32,141,131,4,3,3,3
E33025865,289,195,66,129,1,30,7,23,55,40,9,5,1,8
E33025866,306,203,47,156,7,47,1,46,44,43,1,0,0,5
E33025867,257,198,58,140,3,18,2,16,35,28,4,1,2,3
E33025868,514,338,100,238,7,88,9,79,77,69,0,6,2,4
E33025869,500,357,101,256,5,52,4,48,81,73,1,6,1,5
E33025870,319,251,82,169,2,31,9,22,27,21,2,4,0,8
E33025871,426,292,87,205,5,65,10,55,61,55,0,6,0,3
E33025872,601,461,163,298,11,52,11,41,72,63,0,6,3,5
E33025873,430,342,140,202,2,29,6,23,47,43,1,2,1,10
E33025874,319,257,88,169,2,36,5,31,23,20,0,3,0,1
E33025875,308,221,66,155,6,48,2,46,29,24,0,5,0,4
E33025876,287,210,51,159,10,16,8,8,48,46,0,2,0,3
E33025877,552,401,117,284,12,52,6,46,83,79,1,2,1,4
E33025878,499,363,120,243,7,43,7,36,80,74,1,4,1,6
E33025879,259,208,41,167,3,20,2,18,27,24,0,2,1,1
E33025880,371,257,114,143,7,47,5,42,57,44,3,7,3,3
E33025881,326,211,60,151,6,39,5,34,65,54,4,7,0,5
E33025882,400,287,95,192,10,45,8,37,53,44,0,7,2,5
E33025883,358,242,81,161,9,31,3,28,68,65,1,2,0,8
E33025884,316,240,38,202,9,24,0,24,39,39,0,0,0,4
E33025885,247,180,67,113,2,19,4,15,44,42,0,2,0,2
E33025886,528,376,133,243,6,58,8,50,78,59,16,3,0,10
E33025887,684,461,162,299,18,60,7,53,98,86,4,8,0,47
E33025888,381,293,97,196,3,44,14,30,41,40,0,0,1,0
E33025889,470,355,120,235,6,32,10,22,74,66,0,7,1,3
E33025890,432,368,121,247,3,29,9,20,31,28,2,1,0,1
E33025891,462,344,100,244,2,43,4,39,67,62,0,5,0,6
E33025892,338,253,83,170,5,44,1,43,30,26,1,3,0,6
E33025893,245,176,45,131,1,40,7,33,26,24,0,2,0,2
E33025894,285,243,104,139,1,12,10,2,21,18,0,1,2,8
E33025895,355,270,91,179,10,26,5,21,46,36,6,4,0,3
E33025896,347,266,85,181,15,29,6,23,31,29,0,2,0,6
E33025897,409,306,103,203,3,49,9,40,50,41,1,8,0,1
E33025898,539,411,131,280,1,41,2,39,83,79,0,3,1,3
E33025899,509,396,124,272,4,35,9,26,68,60,2,5,1,6
E33025900,294,204,59,145,3,35,7,28,48,39,8,1,0,4
E33025901,407,296,81,215,6,39,4,35,58,49,6,3,0,8
E33025902,719,534,156,378,12,66,15,51,104,95,2,7,0,3
E33025903,267,215,59,156,3,22,10,12,26,23,0,0,3,1
E33025904,372,248,95,153,6,36,8,28,54,47,3,2,2,28
E33025905,263,155,46,109,4,27,5,22,75,69,0,0,6,2
E33025906,400,304,116,188,0,38,6,32,52,43,3,2,4,6
E33025907,281,223,88,135,3,29,3,26,25,20,0,5,0,1
E33025908,236,169,53,116,0,29,7,22,36,28,3,5,0,2
E33025909,313,240,79,161,5,34,5,29,30,26,1,3,0,4
E33025910,427,322,98,224,6,52,8,44,40,36,2,2,0,7
E33025911,372,299,103,196,4,21,3,18,44,41,2,1,0,4
E33025912,310,247,68,179,2,22,6,16,38,30,0,6,2,1
E33025913,267,186,70,116,3,22,5,17,44,32,5,4,3,12
E33025914,310,234,96,138,0,33,13,20,27,21,2,1,3,16
E33025915,621,372,132,240,9,80,26,54,142,125,12,4,1,18
E33025916,320,245,80,165,6,22,7,15,42,35,2,3,2,5
E33025917,370,271,103,168,3,25,5,20,59,49,2,8,0,12
E33025918,265,204,56,148,1,29,8,21,30,25,1,2,2,1
E33025919,461,378,151,227,1,26,4,22,51,46,0,2,3,5
E33025920,322,267,126,141,2,15,5,10,31,28,3,0,0,7
E33025921,399,316,108,208,2,23,2,21,53,43,0,9,1,5
E33025922,355,263,80,183,0,30,11,19,60,53,0,7,0,2
E33025923,376,193,58,135,1,45,11,34,135,122,2,7,4,2
E33025924,454,255,64,191,10,62,16,46,123,115,0,7,1,4
E33025925,563,445,161,284,2,32,7,25,79,68,4,7,0,5
E33025926,577,448,132,316,2,42,14,28,81,72,0,9,0,4
E33025927,475,381,131,250,2,33,8,25,57,49,3,3,2,2
E33025928,277,171,58,113,2,24,10,14,74,71,0,2,1,6
E33025929,573,414,104,310,5,53,9,44,100,94,0,6,0,1
E33025930,410,264,83,181,2,24,6,18,116,111,0,1,4,4
E33025931,726,549,150,399,3,53,19,34,111,104,0,5,2,10
E33025932,376,303,111,192,1,21,2,19,46,43,0,3,0,5
E33025933,813,599,202,397,1,95,45,50,112,102,2,8,0,6
E33025934,400,254,80,174,2,48,18,30,95,88,0,5,2,1
E33025935,376,284,95,189,4,27,7,20,57,53,1,3,0,4
E33025936,294,230,78,152,1,20,5,15,37,28,2,6,1,6
E33025937,279,210,75,135,0,18,4,14,47,45,0,2,0,4
E33025938,375,276,85,191,0,27,9,18,68,64,1,2,1,4
E33025939,441,340,117,223,4,21,10,11,71,54,2,12,3,5
E33025940,400,306,109,197,1,25,5,20,62,57,2,3,0,6
E33025941,404,296,110,186,0,38,10,28,65,53,5,6,1,5
E33025942,479,369,107,262,1,44,15,29,60,47,0,12,1,5
E33025943,372,260,79,181,0,13,3,10,97,93,0,3,1,2
E33025944,537,439,120,319,1,36,8,28,59,54,0,5,0,2
E33025945,280,215,68,147,2,24,12,12,35,30,1,1,3,4
E33025946,407,287,68,219,3,26,6,20,89,84,2,3,0,2
E33025947,646,546,145,401,10,22,8,14,65,59,0,5,1,3
E33025948,335,244,70,174,2,18,4,14,66,63,2,1,0,5
E33025949,304,230,76,154,1,29,10,19,43,40,0,3,0,1
E33025950,463,384,100,284,4,32,9,23,41,36,1,4,0,2
E33025951,312,268,58,210,1,14,3,11,27,20,0,7,0,2
E33025952,371,297,86,211,3,21,4,17,47,38,3,4,2,3
E33025953,259,218,68,150,1,9,2,7,31,29,0,2,0,0
E33025954,299,241,75,166,1,16,3,13,39,35,0,4,0,2
E33025955,378,288,100,188,3,17,5,12,65,61,2,1,1,5
E33025956,302,212,55,157,1,18,2,16,66,62,0,4,0,5
E33025957,259,206,66,140,2,7,3,4,40,33,1,6,0,4
E33025958,669,485,161,324,9,50,9,41,120,112,2,5,1,5
E33025959,353,299,88,211,0,10,1,9,41,38,0,3,0,3
E33025960,469,274,69,205,0,59,27,32,118,111,1,4,2,18
E33025961,520,387,99,288,0,41,17,24,89,77,1,10,1,3
E33025962,354,280,94,186,4,24,13,11,44,39,2,3,0,2
E33025963,503,382,108,274,5,15,4,11,98,89,1,6,2,3
E33025964,338,245,78,167,1,17,1,16,69,64,0,5,0,6
E33025965,480,385,112,273,0,25,4,21,68,62,0,5,1,2
E33025966,291,205,69,136,0,15,3,12,70,70,0,0,0,1
E33025967,298,219,74,145,1,23,3,20,51,44,0,6,1,4
E33025968,281,201,77,124,2,21,5,16,54,40,10,3,1,3
E33025969,468,332,111,221,1,23,9,14,106,90,8,7,1,6
E33025970,351,288,69,219,4,14,6,8,40,34,2,4,0,5
E33025971,308,257,79,178,0,17,3,14,27,24,1,2,0,7
E33025972,463,366,117,249,2,20,9,11,70,56,10,3,1,5
E33025973,505,394,114,280,0,32,4,28,73,64,0,9,0,6
E33025974,479,390,107,283,1,27,5,22,58,50,0,7,1,3
E33025975,386,228,74,154,1,39,14,25,115,112,0,1,2,3
E33025976,469,376,99,277,6,31,4,27,49,45,0,3,1,7
E33025977,481,316,90,226,2,27,10,17,129,124,3,2,0,7
E33025978,510,369,92,277,1,26,3,23,110,88,1,5,16,4
E33025979,816,545,169,376,2,47,19,28,219,212,1,4,2,3
E33025980,466,283,72,211,7,61,21,40,111,101,0,10,0,4
E33025981,345,280,88,192,1,25,9,16,38,30,0,8,0,1
E33025982,405,313,79,234,6,28,6,22,57,49,0,8,0,1
E33025983,343,279,55,224,0,18,4,14,42,38,0,4,0,4
E33025984,364,279,53,226,4,45,11,34,36,33,0,2,1,0
E33025985,269,235,77,158,0,10,4,6,22,21,0,1,0,2
E33025986,389,271,94,177,1,33,15,18,81,74,4,3,0,3
E33025987,283,191,54,137,1,52,19,33,37,35,2,0,0,2
E33025988,293,246,83,163,0,6,1,5,38,32,3,3,0,3
E33025989,496,345,138,207,3,44,13,31,91,86,2,3,0,13
E33025990,649,473,116,357,5,32,14,18,133,116,4,10,3,6
E33025991,445,343,99,244,4,35,10,25,53,42,0,10,1,10
E33025992,260,195,52,143,0,19,8,11,33,28,2,3,0,13
E33025993,249,196,59,137,1,22,10,12,28,25,0,3,0,2
E33025994,281,215,54,161,1,15,4,11,45,43,0,2,0,5
E33025995,390,248,66,182,2,50,12,38,89,79,1,5,4,1
E33025996,457,364,110,254,3,31,4,27,56,50,3,1,2,3
E33025997,286,244,86,158,0,18,5,13,24,24,0,0,0,0
E33025998,391,275,62,213,2,51,15,36,60,48,1,8,3,3
E33025999,307,229,55,174,2,38,10,28,36,35,0,1,0,2
E33026000,506,413,89,324,3,25,3,22,63,51,4,6,2,2
E33026001,269,210,92,118,1,14,3,11,42,35,2,3,2,2
E33026002,334,257,72,185,2,23,5,18,50,43,0,6,1,2
E33026003,323,244,59,185,6,22,3,19,48,45,0,3,0,3
E33026004,428,335,111,224,2,36,11,25,51,45,0,5,1,4
E33026005,397,325,110,215,1,11,4,7,57,50,0,6,1,3
E33026006,334,273,80,193,0,16,3,13,40,26,1,12,1,5
E33026007,348,279,79,200,7,19,6,13,43,35,1,4,3,0
E33026008,286,223,50,173,1,31,9,22,27,26,1,0,0,4
E33026009,289,214,64,150,3,29,6,23,39,37,1,1,0,4
E33026010,326,246,90,156,1,18,6,12,58,54,3,1,0,3
E33026011,479,392,123,269,0,29,5,24,52,48,2,2,0,6
E33026012,420,348,114,234,1,27,6,21,42,40,0,1,1,2
E33026013,406,311,87,224,4,30,5,25,55,48,1,6,0,6
E33026014,306,188,58,130,4,20,11,9,75,63,7,5,0,19
E33026015,1374,1030,302,728,6,67,11,56,266,138,74,4,50,5
E33026016,321,275,77,198,0,11,0,11,34,26,5,3,0,1
E33026017,364,311,87,224,2,18,3,15,31,25,0,6,0,2
E33026018,329,269,105,164,1,17,1,16,38,38,0,0,0,4
E33026019,329,239,60,179,2,30,10,20,58,57,1,0,0,0
E33026020,516,359,90,269,4,73,22,51,78,66,5,5,2,2
E33026021,677,398,95,303,6,135,21,114,135,122,6,5,2,3
E33026022,373,232,47,185,9,68,27,41,63,54,1,3,5,1
E33026023,627,454,125,329,8,78,27,51,85,79,1,5,0,2
E33026024,507,380,117,263,4,38,8,30,82,71,5,6,0,3
E33026025,473,343,80,263,7,48,9,39,74,68,3,3,0,1
E33026026,693,510,144,366,3,62,10,52,112,106,3,1,2,6
E33026027,287,204,63,141,2,20,8,12,61,32,18,1,10,0
E33026028,367,268,78,190,3,28,5,23,62,49,1,10,2,6
E33026029,1004,652,158,494,11,108,29,79,219,208,2,6,3,14
E33026030,276,208,56,152,1,15,5,10,49,40,2,4,3,3
E33026031,849,637,155,482,14,38,15,23,156,143,3,9,1,4
E33026032,242,197,60,137,0,11,3,8,31,18,6,4,3,3
E33026033,465,350,92,258,5,34,11,23,74,71,0,3,0,2
E33026034,346,264,88,176,3,15,4,11,60,47,5,4,4,4
E33026035,1012,752,197,555,11,82,23,59,161,140,3,15,3,6
E33026036,772,547,145,402,9,63,21,42,150,137,1,11,1,3
E33026037,326,275,73,202,8,10,0,10,33,30,0,3,0,0
E33026038,1003,716,149,567,9,84,22,62,189,176,1,12,0,5
E33026039,392,333,103,230,2,13,4,9,43,40,0,3,0,1
E33026040,272,212,61,151,1,26,10,16,32,29,2,1,0,1
E33026041,650,484,111,373,7,54,9,45,98,89,2,5,2,7
E33026042,265,164,49,115,6,35,10,25,60,47,7,5,1,0
E33026043,272,177,39,138,1,15,2,13,56,51,2,3,0,23
E33026044,353,295,47,248,4,12,0,12,42,37,1,3,1,0
E33026045,397,308,55,253,15,23,3,20,47,46,0,1,0,4
E33026046,417,324,90,234,3,29,7,22,61,57,3,1,0,0
E33026047,295,249,100,149,1,6,1,5,35,32,0,2,1,4
E33026048,250,196,65,131,1,26,5,21,26,22,4,0,0,1
E33026049,421,296,91,205,5,38,8,30,76,70,2,4,0,6
E33026050,402,308,79,229,1,39,5,34,54,51,0,3,0,0
E33026051,304,257,77,180,1,15,2,13,31,30,0,1,0,0
E33026052,395,269,81,188,3,53,11,42,64,58,1,5,0,6
E33026053,334,269,63,206,2,22,5,17,40,36,1,2,1,1
E33026054,237,180,75,105,2,11,3,8,34,27,0,1,6,10
E33026055,468,354,114,240,2,41,10,31,68,66,1,1,0,3
E33026056,290,221,74,147,2,19,7,12,40,30,4,1,5,8
E33026057,246,181,58,123,1,15,4,11,44,39,1,3,1,5
E33026058,283,213,76,137,1,20,3,17,48,42,2,4,0,1
E33026059,394,300,85,215,3,40,10,30,49,44,1,3,1,2
E33026060,304,225,83,142,2,23,11,12,49,42,2,3,2,5
E33026061,311,248,96,152,1,24,6,18,38,35,0,3,0,0
E33026062,277,206,75,131,2,35,12,23,34,30,0,3,1,0
E33026063,397,284,98,186,4,37,10,27,70,65,1,4,0,2
E33026064,307,250,83,167,1,20,6,14,28,27,0,1,0,8
E33026065,325,239,102,137,2,18,4,14,56,52,2,2,0,10
E33026066,400,295,104,191,3,40,14,26,60,49,1,4,6,2
E33026067,533,387,132,255,4,52,19,33,89,83,1,2,3,1
E33026068,300,234,69,165,3,20,10,10,41,35,3,3,0,2
E33026069,319,252,85,167,0,29,2,27,38,36,1,0,1,0
E33026070,806,621,154,467,3,42,11,31,135,120,3,8,4,5
E33026071,382,297,83,214,4,27,2,25,49,45,1,2,1,5
E33026072,335,272,81,191,2,18,5,13,40,35,1,3,1,3
E33026073,711,525,169,356,9,70,30,40,95,83,5,7,0,12
E33026074,292,230,77,153,6,21,5,16,32,30,0,1,1,3
E33026075,295,238,63,175,3,21,5,16,32,29,1,2,0,1
E33026076,315,194,44,150,15,48,9,39,53,48,3,2,0,5
E33026077,307,239,81,158,1,17,5,12,48,42,3,3,0,2
E33026078,228,174,71,103,2,12,5,7,34,30,3,1,0,6
E33026079,331,250,79,171,1,41,7,34,38,35,0,2,1,1
E33026080,358,254,56,198,3,32,5,27,66,60,1,5,0,3
E33026081,272,216,50,166,4,31,7,24,21,20,1,0,0,0
E33026082,423,313,84,229,3,46,21,25,60,55,0,5,0,1
E33026083,525,373,94,279,5,40,12,28,101,93,1,7,0,6
E33026084,294,233,68,165,1,15,2,13,44,39,0,5,0,1
E33026085,406,363,92,271,0,8,2,6,35,33,0,2,0,0
E33026086,301,257,79,178,0,15,2,13,26,22,0,3,1,3
E33026087,282,224,55,169,2,22,5,17,33,27,0,6,0,1
E33026088,732,557,137,420,7,73,17,56,94,91,1,2,0,1
E33026089,284,213,35,178,1,13,2,11,56,50,4,2,0,1
E33026090,320,198,49,149,1,73,21,52,42,36,1,3,2,6
E33026091,483,383,121,262,4,46,15,31,50,45,0,2,3,0
E33026092,348,255,70,185,2,55,13,42,35,32,0,3,0,1
E33026093,306,211,61,150,2,42,15,27,46,41,1,4,0,5
E33026094,334,214,56,158,0,66,14,52,51,46,2,2,1,3
E33026095,247,196,53,143,2,15,6,9,32,27,2,1,2,2
E33026096,315,237,49,188,1,30,10,20,47,45,0,2,0,0
E33026097,288,246,101,145,4,17,11,6,19,14,1,3,1,2
E33026098,426,363,110,253,4,35,18,17,21,18,1,1,1,3
E33026099,359,265,92,173,6,38,23,15,49,44,0,4,1,1
E33026100,296,223,82,141,4,30,14,16,34,25,2,7,0,5
E33026101,272,214,98,116,5,24,15,9,25,21,0,1,3,4
E33026102,491,369,119,250,8,44,25,19,64,56,3,4,1,6
E33026103,361,280,103,177,1,37,21,16,39,33,0,3,3,4
E33026104,644,493,184,309,6,88,45,43,56,49,0,3,4,1
E33026105,419,323,97,226,5,36,21,15,50,45,2,2,1,5
E33026106,285,224,74,150,1,20,9,11,38,34,1,1,2,2
E33026107,274,213,79,134,1,19,9,10,39,34,1,4,0,2
E33026108,469,374,127,247,6,33,20,13,55,50,2,3,0,1
E33026109,291,212,86,126,3,34,23,11,40,34,6,0,0,2
E33026110,490,358,114,244,7,48,22,26,73,67,2,3,1,4
E33026111,283,213,64,149,3,22,17,5,37,32,1,4,0,8
E33026112,295,168,55,113,3,34,17,17,84,23,34,1,26,6
E33026113,562,397,160,237,2,86,55,31,73,58,6,2,7,4
E33026114,423,284,84,200,7,51,34,17,74,54,11,4,5,7
E33026115,326,257,65,192,5,16,8,8,45,43,0,2,0,3
E33026116,377,296,92,204,4,23,9,14,52,48,1,3,0,2
E33026117,211,143,50,93,2,15,4,11,48,43,1,2,2,3
E33026118,565,345,111,234,17,105,26,79,96,88,1,5,2,2
E33026119,414,283,110,173,5,39,24,15,82,69,1,11,1,5
E33026120,445,345,131,214,3,41,30,11,50,44,0,4,2,6
E33026121,421,309,109,200,8,48,28,20,53,49,2,2,0,3
E33026122,340,263,91,172,3,19,8,11,52,47,2,2,1,3
E33026123,317,193,59,134,2,58,38,20,64,57,4,2,1,0
E33026124,471,284,124,160,5,65,38,27,114,97,3,9,5,3
E33026125,258,206,58,148,3,14,8,6,33,23,9,0,1,2
E33026126,286,221,77,144,5,32,18,14,24,23,0,0,1,4
E33026127,393,283,83,200,7,30,17,13,70,61,2,6,1,3
E33026128,421,305,119,186,4,38,26,12,65,58,0,3,4,9
E33026129,374,244,87,157,3,39,22,17,84,78,3,3,0,4
E33026130,241,144,53,91,1,26,15,11,64,54,6,1,3,6
E33026131,382,256,88,168,13,46,20,26,56,49,3,2,2,11
E33026132,670,506,166,340,17,63,37,26,70,63,2,2,3,14
E33026133,295,240,84,156,5,18,8,10,28,26,2,0,0,4
E33026134,281,227,91,136,4,29,19,10,18,16,1,0,1,3
E33026135,393,283,83,200,14,41,15,26,49,46,0,3,0,6
E33026136,270,216,68,148,3,18,10,8,32,29,1,2,0,1
E33026137,506,382,128,254,9,47,31,16,61,54,1,4,2,7
E33026138,239,166,55,111,3,24,17,7,40,35,3,1,1,6
E33026139,551,383,103,280,8,73,48,25,82,75,1,6,0,5
E33026140,274,185,63,122,5,41,25,16,40,36,1,2,1,3
E33026141,276,206,83,123,4,29,15,14,30,25,3,2,0,7
E33026142,1054,709,227,482,26,133,62,71,179,170,4,4,1,7
E33026143,323,243,95,148,4,33,18,15,39,33,0,6,0,4
E33026144,440,303,91,212,5,51,28,23,80,77,1,1,1,1
E33026145,284,193,75,118,2,52,37,15,36,31,1,1,3,1
E33026146,284,198,73,125,4,41,29,12,38,35,0,3,0,3
E33026147,306,223,87,136,2,41,29,12,36,33,0,2,1,4
E33026148,339,231,72,159,6,34,31,3,65,51,3,7,4,3
E33026149,226,159,53,106,1,34,23,11,30,22,0,2,6,2
E33026150,220,170,76,94,4,19,13,6,21,19,0,2,0,6
E33026151,449,335,125,210,7,48,14,34,56,52,2,2,0,3
E33026152,472,346,128,218,0,56,24,32,67,51,7,5,4,3
E33026153,285,219,63,156,2,31,17,14,27,22,1,4,0,6
E33026154,459,354,132,222,5,47,32,15,44,38,2,4,0,9
E33026155,258,174,59,115,2,46,29,17,21,21,0,0,0,15
E33026156,349,252,84,168,4,26,11,15,52,45,3,2,2,15
E33026157,347,260,107,153,1,36,28,8,48,45,1,2,0,2
E33026158,348,253,89,164,7,40,34,6,45,41,1,2,1,3
E33026159,327,243,102,141,2,24,12,12,53,47,3,3,0,5
E33026160,247,175,67,108,3,41,26,15,26,26,0,0,0,2
E33026161,240,188,74,114,0,16,13,3,33,31,0,1,1,3
E33026162,314,240,80,160,7,41,29,12,25,25,0,0,0,1
E33026163,363,248,81,167,5,60,36,24,50,46,1,3,0,0
E33026164,460,319,112,207,10,69,51,18,58,57,1,0,0,4
E33026165,567,354,134,220,17,109,67,42,82,69,7,4,2,5
E33026166,352,255,81,174,6,34,24,10,53,51,1,0,1,4
E33026167,316,230,90,140,3,19,12,7,49,38,8,3,0,15
E33026168,275,200,76,124,3,21,13,8,38,31,4,3,0,13
E33026169,304,231,78,153,4,47,26,21,21,20,1,0,0,1
E33026170,293,198,68,130,4,51,30,21,35,29,0,2,4,5
E33026171,245,185,69,116,1,24,12,12,30,29,0,0,1,5
E33026172,537,388,130,258,10,59,41,18,73,62,3,6,2,7
E33026173,462,276,76,200,8,29,15,14,145,142,2,1,0,4
E33026174,279,169,50,119,3,46,35,11,51,45,3,3,0,10
E33026175,1041,697,188,509,13,78,46,32,241,191,34,10,6,12
E33026176,752,526,128,398,6,42,23,19,177,167,2,6,2,1
E33026177,577,418,135,283,7,77,42,35,69,60,2,5,2,6
E33026178,227,149,62,87,3,36,15,21,34,32,1,1,0,5
E33026179,248,177,55,122,7,29,21,8,35,30,0,1,4,0
E33026180,369,296,117,179,3,32,18,14,35,28,3,4,0,3
E33026181,242,180,58,122,3,21,8,13,32,28,0,2,2,6
E33026182,461,347,119,228,7,34,20,14,69,68,0,1,0,4
E33026183,606,463,138,325,5,54,32,22,77,76,0,1,0,7
E33026184,461,302,88,214,8,68,52,16,80,44,25,5,6,3
E33026185,418,308,104,204,3,60,36,24,45,32,1,4,8,2
E33026186,326,236,82,154,4,43,26,17,38,35,1,1,1,5
E33026187,588,436,131,305,6,70,41,29,68,63,4,1,0,8
E33026188,523,378,136,242,6,78,46,32,59,55,1,3,0,2
E33026189,303,229,68,161,6,47,38,9,20,18,1,1,0,1
E33026190,376,293,111,182,1,33,18,15,34,30,2,1,1,15
E33026191,248,181,64,117,3,27,19,8,34,29,1,4,0,3
E33026192,291,186,68,118,3,42,22,20,55,45,2,0,8,5
E33026193,737,404,111,293,7,76,40,36,244,102,73,4,65,6
E33026194,407,282,81,201,2,69,53,16,50,40,4,4,2,4
E33026195,372,290,104,186,8,42,21,21,27,24,1,1,1,5
E33026196,276,215,80,135,0,27,21,6,27,24,1,0,2,7
E33026197,684,457,117,340,7,77,38,39,138,122,8,4,4,5
E33026198,397,358,125,233,2,5,2,3,31,29,0,2,0,1
E33026199,868,750,216,534,5,36,22,14,71,66,1,4,0,6
E33026200,390,278,75,203,0,58,38,20,52,45,1,5,1,2
E33026201,569,474,130,344,1,37,24,13,53,51,0,1,1,4
E33026202,368,306,88,218,2,24,15,9,34,29,1,2,2,2
E33026203,340,300,100,200,1,12,9,3,23,23,0,0,0,4
E33026204,274,248,70,178,0,10,7,3,14,12,0,2,0,2
E33026205,563,451,91,360,0,51,28,23,61,57,2,1,1,0
E33026206,697,592,181,411,7,36,24,12,53,48,2,2,1,9
E33026207,417,338,110,228,3,28,17,11,41,35,1,4,1,7
E33026208,524,419,126,293,5,34,23,11,61,58,0,3,0,5
E33026209,345,273,92,181,0,42,33,9,30,27,0,3,0,0
E33026210,856,714,207,507,3,41,23,18,95,85,1,9,0,3
E33026211,334,262,69,193,3,23,11,12,41,34,0,7,0,5
E33026212,405,325,75,250,1,35,28,7,41,36,2,3,0,3
E33026213,291,217,63,154,1,40,30,10,31,26,1,3,1,2
E33026214,284,222,75,147,2,18,7,11,41,37,2,2,0,1
E33026215,446,345,90,255,2,30,18,12,68,62,1,4,1,1
E33026216,388,338,85,253,1,21,13,8,27,26,1,0,0,1
E33026217,280,259,82,177,2,11,3,8,7,7,0,0,0,1
E33026218,301,263,82,181,2,14,9,5,20,17,0,3,0,2
E33026219,575,496,159,337,2,27,16,11,49,48,1,0,0,1
E33026220,308,272,78,194,0,15,11,4,18,16,0,2,0,3
E33026221,348,292,46,246,2,23,13,10,30,29,0,1,0,1
E33026222,560,490,116,374,5,19,7,12,44,40,1,3,0,2
E33026223,466,397,105,292,3,22,8,14,44,35,0,7,2,0
E33026224,467,370,62,308,13,20,4,16,63,61,0,2,0,1
E33026225,450,366,62,304,0,39,17,22,43,40,0,3,0,2
E33026226,634,482,126,356,7,87,58,29,53,52,1,0,0,5
E33026227,336,287,78,209,1,18,13,5,29,26,0,3,0,1
E33026228,511,445,197,248,3,27,18,9,35,26,3,4,2,1
E33026229,375,291,97,194,3,26,21,5,50,41,2,7,0,5
E33026230,321,193,43,150,1,83,44,39,43,38,0,5,0,1
E33026231,368,277,66,211,1,49,36,13,40,34,2,4,0,1
E33026232,439,327,79,248,3,63,36,27,43,37,0,6,0,3
E33026233,1349,1066,238,828,15,80,21,59,178,165,1,11,1,10
E33026234,328,257,47,210,1,25,9,16,44,40,0,4,0,1
E33026235,438,309,67,242,17,54,45,9,55,47,0,8,0,3
E33026236,427,313,82,231,10,39,25,14,64,60,0,3,1,1
E33026237,261,198,66,132,2,11,7,4,44,43,0,1,0,6
E33026238,332,218,33,185,28,41,29,12,45,40,0,5,0,0
E33026239,1059,841,226,615,6,107,68,39,98,87,1,10,0,7
E33026240,303,200,52,148,2,74,50,24,25,24,0,1,0,2
E33026241,655,488,125,363,5,86,53,33,71,64,0,7,0,5
E33026242,347,238,60,178,6,66,49,17,34,29,0,4,1,3
E33026243,576,330,67,263,8,168,138,30,69,61,1,6,1,1
E33026244,548,360,99,261,4,111,70,41,69,62,1,6,0,4
E33026245,370,255,66,189,10,85,61,24,17,17,0,0,0,3
E33026246,371,223,53,170,3,95,65,30,50,48,0,2,0,0
E33026247,800,576,125,451,7,112,69,43,102,94,1,6,1,3
E33026248,355,221,65,156,8,84,53,31,38,31,3,3,1,4
E33026249,334,210,40,170,3,85,62,23,35,32,0,3,0,1
E33026250,385,278,83,195,2,71,51,20,32,29,0,2,1,2
E33026251,711,381,90,291,7,236,103,133,82,77,0,5,0,5
E33026252,669,416,96,320,4,159,81,78,88,80,1,6,1,2
E33026253,701,494,112,382,9,128,88,40,69,64,0,5,0,1
E33026254,628,437,119,318,6,101,76,25,83,75,0,8,0,1
E33026255,267,215,67,148,1,22,12,10,26,24,0,2,0,3
E33026256,331,223,49,174,2,73,44,29,31,31,0,0,0,2
E33026257,793,506,150,356,6,180,125,55,93,88,0,4,1,8
E33026258,428,212,39,173,10,151,40,111,51,47,0,2,2,4
E33026259,348,185,44,141,1,113,41,72,42,36,0,4,2,7
E33026260,367,257,54,203,1,68,47,21,39,35,0,4,0,2
E33026261,322,241,60,181,2,47,21,26,32,29,1,1,1,0
E33026262,508,401,110,291,4,55,35,20,46,38,2,3,3,2
E33026263,348,257,51,206,4,45,35,10,41,33,0,8,0,1
E33026264,506,422,127,295,1,48,37,11,34,30,4,0,0,1
E33026265,381,278,68,210,4,52,37,15,44,42,1,1,0,3
E33026266,393,293,81,212,2,71,49,22,24,21,3,0,0,3
E33026267,338,253,80,173,4,46,32,14,34,30,0,1,3,1
E33026268,258,218,54,164,2,8,5,3,29,27,1,1,0,1
E33026269,447,336,71,265,0,56,29,27,53,51,0,1,1,2
E33026270,343,261,70,191,1,33,16,17,45,43,1,1,0,3
E33026271,490,329,79,250,1,105,69,36,52,48,0,3,1,3
E33026272,439,287,61,226,1,70,44,26,79,76,0,3,0,2
E33026273,855,567,134,433,9,160,104,56,114,105,2,7,0,5
E33026274,430,325,78,247,1,57,36,21,46,41,0,5,0,1
E33026275,485,384,138,246,0,38,10,28,51,44,0,2,5,12
E33026276,300,219,58,161,1,42,11,31,34,32,0,1,1,4
E33026277,465,327,113,214,1,56,25,31,67,48,12,6,1,14
E33026278,258,200,65,135,1,22,6,16,35,28,2,5,0,0
E33026279,327,260,83,177,1,23,7,16,38,36,0,0,2,5
E33026280,257,171,61,110,6,24,11,13,47,43,1,2,1,9
E33026281,302,210,90,120,1,19,5,14,59,54,2,1,2,13
E33026282,383,300,111,189,3,18,4,14,55,49,3,1,2,7
E33026283,297,212,77,135,4,15,6,9,62,48,4,9,1,4
E33026284,274,211,88,123,0,15,3,12,43,36,1,6,0,5
E33026285,274,228,108,120,0,10,0,10,35,24,2,8,1,1
E33026286,491,345,126,219,4,55,18,37,86,80,1,4,1,1
E33026287,505,356,103,253,5,79,26,53,61,58,2,1,0,4
E33026288,269,201,75,126,1,36,11,25,26,25,0,0,1,5
E33026289,388,291,96,195,2,30,5,25,65,59,3,3,0,0
E33026290,390,264,91,173,7,34,8,26,77,73,2,1,1,8
E33026291,445,284,71,213,3,86,21,65,70,61,1,6,2,2
E33026292,285,225,61,164,4,22,9,13,33,30,0,3,0,1
E33026293,632,431,120,311,10,84,30,54,104,97,4,3,0,3
E33026294,291,198,44,154,1,55,17,38,36,34,0,1,1,1
E33026295,469,335,123,212,2,64,16,48,60,52,0,7,1,8
E33026296,253,180,72,108,3,30,10,20,36,31,2,3,0,4
E33026297,822,644,158,486,6,33,11,22,120,67,36,8,9,19
E33026298,367,292,119,173,2,26,8,18,42,37,3,0,2,5
E33026299,476,346,97,249,4,36,9,27,78,73,0,2,3,12
E33026300,334,228,59,169,1,44,20,24,58,52,0,4,2,3
E33026301,426,328,122,206,1,29,7,22,59,49,5,2,3,9
E33026302,417,304,84,220,1,55,17,38,54,49,2,3,0,3
E33026303,855,654,209,445,6,70,27,43,121,110,3,6,2,4
E33026304,370,269,95,174,0,41,17,24,51,46,1,4,0,9
E33026305,242,191,51,140,0,12,2,10,37,32,0,2,3,2
E33026306,445,333,102,231,4,39,15,24,66,63,2,1,0,3
E33026307,362,298,105,193,0,15,4,11,43,40,0,3,0,6
E33026308,606,422,119,303,3,62,17,45,112,105,0,6,1,7
E33026309,504,370,101,269,2,53,20,33,78,66,3,9,0,1
E33026310,251,194,81,113,0,13,4,9,42,39,2,0,1,2
E33026311,412,320,82,238,3,49,10,39,35,32,1,2,0,5
E33026312,248,202,67,135,2,21,8,13,22,20,0,1,1,1
E33026313,371,299,60,239,0,22,1,21,49,44,4,1,0,1
E33026314,315,274,42,232,3,8,1,7,29,28,1,0,0,1
E33026315,397,256,64,192,4,52,16,36,81,75,0,5,1,4
E33026316,265,176,65,111,3,43,11,32,41,36,0,5,0,2
E33026317,324,208,50,158,1,52,11,41,62,54,0,7,1,1
E33026318,603,408,102,306,4,123,37,86,63,59,1,3,0,5
E33026319,280,206,59,147,5,18,4,14,49,46,0,3,0,2
E33026320,310,240,60,180,2,13,4,9,50,48,1,1,0,5
E33026321,414,284,78,206,4,36,11,25,89,82,1,6,0,1
E33026322,366,284,58,226,3,16,6,10,57,52,0,5,0,6
E33026323,483,345,92,253,1,40,9,31,92,73,9,8,2,5
E33026324,327,253,63,190,1,23,3,20,46,45,0,1,0,4
E33026325,981,729,178,551,13,89,27,62,147,136,4,6,1,3
E33026326,280,197,70,127,2,27,9,18,50,46,2,1,1,4
E33026327,324,284,86,198,0,13,3,10,26,24,2,0,0,1
E33026328,530,376,88,288,9,59,12,47,85,82,0,2,1,1
E33026329,384,312,80,232,2,26,6,20,38,32,2,3,1,6
E33026330,376,266,67,199,3,61,13,48,42,35,0,7,0,4
E33026331,472,294,75,219,5,82,16,66,89,77,6,5,1,2
E33026332,436,304,72,232,1,50,17,33,78,70,0,7,1,3
E33026333,508,353,94,259,4,93,31,62,58,49,1,7,1,0
E33026334,460,320,98,222,0,94,30,64,46,40,4,1,1,0
E33026335,435,289,51,238,5,80,11,69,56,53,1,1,1,5
E33026336,276,207,70,137,0,23,5,18,39,30,2,2,5,7
E33026337,313,237,66,171,3,28,6,22,40,38,0,2,0,5
E33026338,445,278,70,208,6,100,26,74,60,56,1,2,1,1
E33026339,823,542,138,404,9,125,35,90,140,127,7,6,0,7
E33026340,437,357,87,270,3,25,3,22,49,44,0,5,0,3
E33026341,651,481,135,346,18,70,8,62,80,70,6,3,1,2
E33026342,258,182,45,137,1,23,5,18,51,39,5,7,0,1
E33026343,421,377,81,296,0,19,2,17,25,22,0,2,1,0
E33026344,493,403,117,286,3,30,11,19,55,49,3,1,2,2
E33026345,257,196,53,143,0,32,10,22,26,24,2,0,0,3
E33026346,703,580,148,432,4,26,7,19,85,77,1,7,0,8
E33026347,347,264,83,181,0,29,9,20,50,44,1,4,1,4
E33026348,341,247,88,159,3,28,8,20,60,54,0,5,1,3
E33026349,400,320,94,226,0,21,6,15,52,42,2,5,3,7
E33026350,243,191,45,146,0,14,6,8,38,37,0,1,0,0
E33026351,449,350,116,234,2,32,11,21,63,55,2,6,0,2
E33026352,349,267,95,172,0,20,5,15,53,48,0,3,2,9
E33026353,456,358,89,269,1,51,12,39,43,37,0,6,0,3
E33026354,304,234,81,153,1,27,6,21,39,37,1,1,0,3
E33026355,405,288,67,221,0,59,12,47,55,43,2,9,1,3
E33026356,361,258,65,193,4,62,20,42,34,26,3,5,0,3
E33026357,710,481,79,402,3,124,35,89,99,87,0,10,2,3
E33026358,659,476,132,344,7,75,19,56,97,94,0,3,0,4
E33026359,745,539,151,388,4,101,28,73,98,93,1,4,0,3
E33026360,821,615,148,467,7,75,14,61,114,105,4,3,2,10
E33026361,233,174,42,132,1,17,5,12,39,35,2,2,0,2
E33026362,295,195,56,139,1,46,17,29,51,46,2,2,1,2
E33026363,418,315,91,224,4,38,9,29,57,56,0,1,0,4
E33026364,353,195,70,125,1,27,9,18,94,76,14,4,0,36
E33026365,274,202,65,137,0,37,10,27,30,27,1,1,1,5
E33026366,284,217,80,137,3,32,8,24,31,28,0,1,2,1
E33026367,438,283,65,218,1,53,18,35,101,97,1,3,0,0
E33026368,371,284,71,213,6,33,12,21,47,42,0,5,0,1
E33026369,260,207,76,131,3,24,6,18,22,20,1,1,0,4
E33026370,538,392,127,265,4,75,42,33,61,53,5,3,0,6
E33026371,475,411,144,267,3,27,14,13,25,22,0,3,0,9
E33026372,301,272,90,182,1,6,5,1,16,14,1,1,0,6
E33026373,402,348,117,231,1,29,22,7,22,17,0,5,0,2
E33026374,448,382,138,244,1,32,21,11,29,23,3,2,1,4
E33026375,345,250,78,172,2,43,37,6,41,33,0,5,3,9
E33026376,508,393,118,275,3,43,27,16,62,59,0,3,0,7
E33026377,279,227,94,133,1,16,13,3,33,33,0,0,0,2
E33026378,235,175,69,106,2,14,6,8,34,29,0,3,2,10
E33026379,332,262,81,181,1,17,8,9,43,40,1,2,0,9
E33026380,386,286,102,184,3,42,37,5,54,45,1,2,6,1
E33026381,251,211,62,149,2,19,15,4,15,14,0,0,1,4
E33026382,336,282,82,200,0,25,17,8,28,26,1,1,0,1
E33026383,345,245,68,177,1,60,53,7,34,30,1,1,2,5
E33026384,290,216,59,157,3,38,25,13,32,29,0,3,0,1
E33026385,339,215,59,156,3,71,63,8,47,43,1,3,0,3
E33026386,306,237,78,159,1,28,22,6,37,30,2,5,0,3
E33026387,552,394,112,282,6,92,53,39,55,51,0,3,1,5
E33026388,598,457,137,320,5,51,37,14,77,70,0,7,0,8
E33026389,394,303,102,201,3,21,11,10,63,56,1,0,6,4
E33026390,274,214,55,159,0,22,14,8,36,32,0,3,1,2
E33026391,528,455,168,287,2,29,19,10,39,28,8,2,1,3
E33026392,547,445,146,299,2,39,31,8,58,53,3,2,0,3
E33026393,386,310,101,209,1,29,23,6,45,42,0,3,0,1
E33026394,542,425,117,308,2,23,10,13,88,77,3,5,3,4
E33026395,697,517,162,355,5,75,58,17,90,81,3,5,1,10
E33026396,468,355,105,250,6,34,26,8,61,36,20,3,2,12
E33026397,311,253,80,173,0,16,12,4,41,36,4,1,0,1
E33026398,284,238,69,169,3,11,8,3,31,31,0,0,0,1
E33026399,619,473,133,340,6,39,26,13,100,91,0,8,1,1
E33026400,326,228,46,182,1,27,12,15,67,65,0,2,0,3
E33026401,606,431,128,303,4,80,63,17,90,86,3,1,0,1
E33026402,338,247,62,185,5,24,18,6,54,46,4,0,4,8
E33026403,313,249,72,177,1,19,13,6,39,37,0,2,0,5
E33026404,381,274,59,215,10,37,25,12,59,51,2,6,0,1
E33026405,277,212,68,144,4,28,19,9,32,30,0,1,1,1
E33026406,290,208,59,149,9,35,12,23,37,35,0,2,0,1
E33026407,576,424,112,312,6,42,26,16,100,95,0,3,2,4
E33026408,259,181,49,132,0,31,13,18,42,40,0,2,0,5
E33026409,513,408,110,298,3,41,23,18,61,54,0,5,2,0
E33026410,357,241,66,175,2,70,65,5,43,39,1,3,0,1
E33026411,370,294,89,205,1,34,28,6,35,31,1,1,2,6
E33026412,741,580,167,413,5,62,41,21,92,86,0,6,0,2
E33026413,360,294,88,206,3,26,19,7,32,28,1,3,0,5
E33026414,531,390,136,254,1,54,36,18,77,72,2,3,0,9
E33026415,380,322,86,236,2,4,1,3,45,41,2,2,0,7
E33026416,663,598,222,376,2,18,11,7,44,40,0,3,1,1
E33026417,593,496,136,360,1,17,10,7,79,74,0,5,0,0
E33026418,471,405,123,282,1,16,10,6,47,45,0,2,0,2
E33026419,317,273,100,173,1,5,2,3,35,32,0,2,1,3
E33026420,312,272,88,184,1,7,2,5,31,30,0,1,0,1
E33026421,377,295,93,202,2,23,17,6,56,46,0,8,2,1
E33026422,287,218,73,145,3,22,14,8,43,40,0,3,0,1
E33026423,437,381,98,283,2,16,9,7,38,33,0,4,1,0
E33026424,370,340,92,248,0,3,2,1,26,22,0,2,2,1
E33026425,486,416,127,289,1,20,8,12,47,44,0,3,0,2
E33026426,428,343,99,244,0,25,20,5,53,45,2,6,0,7
E33026427,418,364,98,266,0,10,5,5,43,43,0,0,0,1
E33026428,591,488,135,353,6,21,15,6,73,62,0,9,2,3
E33026429,359,309,95,214,4,10,7,3,34,30,0,3,1,2
E33026430,398,344,117,227,0,7,2,5,45,44,0,1,0,2
E33026431,309,266,80,186,1,9,4,5,27,18,1,8,0,6
E33026432,301,256,75,181,1,10,8,2,32,32,0,0,0,2
E33026433,497,397,111,286,1,26,13,13,71,64,2,5,0,2
E33026434,443,406,127,279,2,4,3,1,31,27,0,4,0,0
E33026435,407,316,85,231,2,26,14,12,61,57,0,4,0,2
E33026436,413,314,91,223,1,31,27,4,66,62,2,1,1,1
E33026437,687,519,164,355,2,52,30,22,108,99,1,7,1,6
E33026438,315,248,73,175,2,16,10,6,47,42,0,5,0,2
E33026439,418,349,97,252,2,15,8,7,52,48,0,4,0,0
E33026440,405,331,85,246,4,23,16,7,44,40,0,4,0,3
E33026441,396,332,96,236,3,14,9,5,39,36,0,2,1,8
E33026442,765,611,169,442,2,60,50,10,90,80,1,7,2,2
E33026443,299,234,71,163,0,22,19,3,42,38,0,4,0,1
E33026444,552,474,133,341,1,25,6,19,47,42,1,4,0,5
E33026445,671,595,144,451,2,27,8,19,47,42,2,3,0,0
E33026446,410,357,112,245,1,5,5,0,41,36,0,5,0,6
E33026447,372,291,94,197,1,29,18,11,49,44,0,4,1,2
E33026448,373,271,76,195,0,47,38,9,52,46,1,5,0,3
E33026449,529,430,126,304,2,49,33,16,47,43,0,4,0,1
E33026450,558,422,100,322,0,59,29,30,74,68,0,6,0,3
E33026451,329,252,58,194,0,34,26,8,41,39,1,1,0,2
E33026452,499,444,153,291,1,17,10,7,36,30,1,4,1,1
E33026453,461,375,120,255,0,10,9,1,76,66,0,1,9,0
E33026454,324,266,91,175,0,12,6,6,41,33,2,5,1,5
E33026455,369,315,91,224,1,19,13,6,32,29,0,1,2,2
E33026456,275,219,65,154,1,18,13,5,35,35,0,0,0,2
E33026457,221,159,36,123,0,13,6,7,46,44,0,2,0,3
E33026458,522,448,117,331,2,8,5,3,58,54,0,4,0,6
E33026459,540,451,131,320,2,24,17,7,62,53,1,8,0,1
E33026460,257,203,80,123,3,17,1,16,30,25,0,1,4,4
E33026461,334,249,74,175,7,36,8,28,39,33,4,1,1,3
E33026462,495,358,117,241,4,61,14,47,62,50,4,7,1,10
E33026463,283,216,66,150,5,29,6,23,33,30,1,2,0,0
E33026464,321,257,78,179,1,24,3,21,32,27,3,0,2,7
E33026465,377,282,87,195,4,28,5,23,62,48,4,4,6,1
E33026466,276,204,66,138,1,28,5,23,42,41,0,1,0,1
E33026467,285,202,66,136,0,29,4,25,52,52,0,0,0,2
E33026468,320,280,100,180,0,8,0,8,31,26,0,2,3,1
E33026469,358,275,78,197,1,33,7,26,49,44,2,1,2,0
E33026470,457,323,96,227,4,50,8,42,78,73,0,5,0,2
E33026471,583,430,149,281,1,92,13,79,54,52,0,2,0,6
E33026472,403,273,76,197,2,82,18,64,43,42,0,1,0,3
E33026473,592,412,149,263,2,54,11,43,112,92,10,4,6,12
E33026474,483,390,115,275,1,36,6,30,55,52,0,3,0,1
E33026475,558,462,141,321,2,24,9,15,67,61,2,4,0,3
E33026476,344,303,77,226,0,8,1,7,27,25,0,2,0,6
E33026477,382,310,78,232,0,24,4,20,45,39,1,5,0,3
E33026478,277,227,76,151,3,27,7,20,18,16,0,2,0,2
E33026479,277,227,65,162,1,15,0,15,31,25,0,5,1,3
E33026480,806,623,185,438,4,92,13,79,83,77,0,6,0,4
E33026481,392,271,68,203,2,63,12,51,55,49,1,5,0,1
E33026482,1168,878,216,662,5,140,19,121,139,130,2,4,3,6
E33026483,716,556,178,378,4,77,20,57,66,63,0,2,1,13
E33026484,287,251,109,142,0,14,2,12,21,13,2,1,5,1
E33026485,789,557,148,409,4,130,19,111,94,81,5,7,1,4
E33026486,261,194,61,133,3,29,5,24,30,26,1,3,0,5
E33026487,414,223,53,170,3,135,24,111,50,47,0,1,2,3
E33026488,399,319,69,250,2,12,2,10,63,61,0,2,0,3
E33026489,288,248,64,184,1,11,2,9,28,23,0,2,3,0
E33026490,343,276,78,198,2,18,5,13,45,41,1,2,1,2
E33026491,389,307,82,225,2,16,3,13,58,49,1,6,2,6
E33026492,343,237,57,180,1,25,2,23,79,75,0,4,0,1
E33026493,300,258,59,199,3,12,3,9,26,25,0,1,0,1
E33026494,522,389,114,275,2,70,13,57,58,58,0,0,0,3
E33026495,615,463,98,365,5,56,10,46,84,67,4,11,2,7
E33026496,291,237,50,187,2,15,2,13,36,30,4,2,0,1
E33026497,1447,1099,349,750,8,164,32,132,172,160,2,10,0,4
E33026498,295,190,53,137,2,42,7,35,56,51,0,3,2,5
E33026499,243,162,44,118,2,42,6,36,36,33,1,0,2,1
E33026500,441,284,74,210,12,43,4,39,98,92,0,6,0,4
E33026501,313,244,80,164,0,35,11,24,33,31,1,1,0,1
E33026502,195,84,23,61,1,13,0,13,92,85,0,7,0,5
E33026503,420,300,71,229,1,48,17,31,68,63,1,4,0,3
E33026504,258,192,63,129,0,14,3,11,51,47,0,3,1,1
E33026505,280,193,64,129,7,12,3,9,61,58,2,1,0,7
E33026506,340,254,75,179,2,27,6,21,52,43,3,4,2,5
E33026507,260,217,59,158,1,12,6,6,29,25,1,2,1,1
E33026508,1602,1263,380,883,15,104,39,65,215,205,1,8,1,5
E33026509,484,358,126,232,0,48,12,36,77,73,1,3,0,1
E33026510,366,294,66,228,3,22,6,16,44,32,0,11,1,3
E33026511,282,230,79,151,3,8,2,6,38,31,0,6,1,3
E33026512,329,234,42,192,1,26,6,20,67,56,1,10,0,1
E33026513,456,355,94,261,8,28,10,18,63,57,2,4,0,2
E33026514,751,557,194,363,6,61,14,47,117,102,7,7,1,10
E33026515,484,385,148,237,2,38,8,30,59,50,3,6,0,0
E33026516,464,328,131,197,1,52,23,29,76,73,1,0,2,7
E33026517,558,453,146,307,4,48,10,38,49,42,1,6,0,4
E33026518,273,201,58,143,2,30,10,20,36,35,0,1,0,4
E33026519,632,520,149,371,1,30,5,25,73,66,0,7,0,8
E33026520,455,333,97,236,3,43,7,36,76,68,0,7,1,0
E33026521,554,426,143,283,3,73,16,57,48,42,1,5,0,4
E33026522,513,434,132,302,2,32,1,31,43,40,0,3,0,2
E33026523,298,232,60,172,1,17,9,8,48,43,0,4,1,0
E33026524,303,230,74,156,1,28,12,16,41,39,0,2,0,3
E33026525,383,296,91,205,0,31,13,18,43,37,0,6,0,13
E33026526,596,478,144,334,2,39,6,33,70,61,5,3,1,7
E33026527,291,220,86,134,6,28,5,23,36,34,0,1,1,1
E33026528,244,175,49,126,0,30,10,20,39,38,0,0,1,0
E33026529,372,272,100,172,3,45,5,40,46,44,1,1,0,6
E33026530,481,394,119,275,1,43,8,35,40,31,1,6,2,3
E33026531,563,443,118,325,4,75,7,68,40,38,0,2,0,1
E33026532,554,386,101,285,5,74,15,59,86,78,3,4,1,3
E33026533,477,334,87,247,8,65,20,45,67,61,5,1,0,3
E33026534,263,206,74,132,0,36,18,18,20,14,1,5,0,1
E33026535,438,397,135,262,3,14,7,7,22,19,2,0,1,2
E33026536,375,303,75,228,5,15,6,9,46,42,0,4,0,6
E33026537,294,216,55,161,4,32,6,26,42,42,0,0,0,0
E33026538,269,235,66,169,0,14,3,11,20,20,0,0,0,0
E33026539,540,422,136,286,1,45,9,36,69,56,0,6,7,3
E33026540,516,417,109,308,2,38,12,26,49,40,0,8,1,10
E33026541,445,355,106,249,5,34,8,26,47,42,0,5,0,4
E33026542,350,270,100,170,0,43,8,35,34,32,1,1,0,3
E33026543,574,445,125,320,2,53,11,42,71,64,1,6,0,3
E33026544,346,254,87,167,4,40,9,31,44,43,0,1,0,4
E33026545,431,332,107,225,1,47,15,32,47,41,1,4,1,4
E33026546,295,242,86,156,1,22,3,19,28,24,0,0,4,2
E33026547,299,250,95,155,1,18,4,14,29,26,2,1,0,1
E33026548,292,232,82,150,2,33,11,22,23,20,0,3,0,2
E33026549,328,272,86,186,4,21,4,17,28,23,2,3,0,3
E33026550,426,353,120,233,1,24,16,8,41,35,6,0,0,7
E33026551,512,390,138,252,5,51,21,30,59,53,2,3,1,7
E33026552,395,332,105,227,3,20,6,14,38,37,0,0,1,2
E33026553,582,455,159,296,3,43,13,30,74,62,6,4,2,7
E33026554,516,438,126,312,1,28,15,13,48,45,1,2,0,1
E33026555,521,426,103,323,2,33,12,21,54,49,1,4,0,6
E33026556,304,259,70,189,1,11,2,9,29,25,1,3,0,4
E33026557,469,412,122,290,2,17,4,13,36,30,3,3,0,2
E33026558,577,501,134,367,1,20,6,14,51,46,2,3,0,4
E33026559,404,336,76,260,0,9,2,7,55,50,0,5,0,4
E33026560,381,302,64,238,1,35,1,34,40,31,3,2,4,3
E33026561,394,368,119,249,1,6,4,2,19,12,6,1,0,0
E33026562,372,327,80,247,2,17,13,4,23,18,1,4,0,3
E33026563,568,450,167,283,1,37,9,28,69,64,0,4,1,11
E33026564,508,438,154,284,0,21,5,16,44,32,7,4,1,5
E33026565,432,324,126,198,1,47,25,22,58,51,2,4,1,2
E33026566,249,199,71,128,0,19,9,10,29,25,1,3,0,2
E33026567,422,316,98,218,2,41,25,16,56,45,0,11,0,7
E33026568,574,455,119,336,2,32,17,15,83,77,0,4,2,2
E33026569,420,306,108,198,3,34,22,12,74,65,1,7,1,3
E33026570,344,264,82,182,0,37,26,11,34,30,3,1,0,9
E33026571,337,225,80,145,2,15,8,7,86,78,6,2,0,9
E33026572,612,446,69,377,6,45,6,39,112,105,1,4,2,3
E33026573,585,441,115,326,6,37,12,25,98,87,2,7,2,3
E33026574,300,200,45,155,1,24,10,14,72,63,0,8,1,3
E33026575,868,641,201,440,6,95,42,53,119,110,1,4,4,7
E33026576,317,223,50,173,2,27,14,13,65,60,1,4,0,0
E33026577,477,358,134,224,3,29,20,9,85,67,7,5,6,2
E33026578,273,235,63,172,0,6,4,2,31,30,0,1,0,1
E33026579,295,254,97,157,1,19,17,2,18,16,0,2,0,3
E33026580,331,215,63,152,2,30,21,9,84,71,4,4,5,0
E33026581,355,246,88,158,3,29,11,18,72,63,3,5,1,5
E33026582,259,208,68,140,1,21,20,1,26,22,1,3,0,3
E33026583,679,405,108,297,2,94,40,54,176,163,1,10,2,2
E33026584,535,427,108,319,1,27,15,12,79,71,0,5,3,1
E33026585,719,529,123,406,2,45,15,30,140,125,3,9,3,3
E33026586,726,465,143,322,2,53,27,26,196,174,5,13,4,10
E33026587,647,462,142,320,5,48,22,26,128,113,1,12,2,4
E33026588,358,247,62,185,1,23,10,13,84,78,1,4,1,3
E33026589,349,246,60,186,0,27,13,14,71,63,1,6,1,5
E33026590,546,450,128,322,1,26,11,15,69,66,0,3,0,0
E33026591,556,379,81,298,2,53,32,21,119,109,4,5,1,3
E33026592,486,315,87,228,3,48,25,23,117,105,1,8,3,3
E33026593,598,435,105,330,2,27,16,11,132,123,1,7,1,2
E33026594,534,333,81,252,3,64,29,35,132,126,2,2,2,2
E33026595,308,187,68,119,2,37,16,21,79,72,4,2,1,3
E33026596,411,294,107,187,2,21,11,10,90,81,1,6,2,4
E33026597,451,243,84,159,2,116,90,26,86,76,0,5,5,4
E33026598,417,226,60,166,1,103,76,27,86,79,2,4,1,1
E33026599,1296,788,212,576,5,153,67,86,349,325,4,17,3,1
E33026600,259,209,73,136,1,17,14,3,25,23,0,2,0,7
E33026601,523,389,85,304,1,69,55,14,63,52,5,6,0,1
E33026602,389,297,73,224,0,23,16,7,67,59,2,5,1,2
E33026603,292,231,95,136,0,23,15,8,35,27,2,5,1,3
E33026604,764,595,175,420,4,52,22,30,108,94,6,8,0,5
E33026605,569,467,134,333,4,36,17,19,59,56,0,3,0,3
E33026606,528,383,109,274,2,63,37,26,79,73,2,3,1,1
E33026607,314,243,87,156,1,14,6,8,52,43,0,7,2,4
E33026608,256,212,65,147,1,12,3,9,30,26,3,1,0,1
E33026609,365,303,92,211,1,16,14,2,43,35,3,3,2,2
E33026610,393,274,70,204,2,34,15,19,78,71,0,7,0,5
E33026611,443,314,113,201,0,36,19,17,87,84,1,2,0,6
E33026612,331,216,67,149,1,30,10,20,82,76,2,3,1,2
E33026613,237,163,45,118,0,22,11,11,52,47,1,3,1,0
E33026614,243,187,60,127,0,11,8,3,45,41,0,4,0,0
E33026615,315,206,62,144,2,37,16,21,69,66,1,2,0,1
E33026616,421,227,58,169,2,72,33,39,119,102,2,13,2,1
E33026617,231,140,51,89,2,28,10,18,60,56,1,3,0,1
E33026618,336,235,63,172,0,30,13,17,65,55,3,4,3,6
E33026619,389,290,96,194,0,33,19,14,64,58,0,5,1,2
E33026620,706,516,127,389,2,70,28,42,110,105,1,3,1,8
E33026621,451,340,101,239,1,41,20,21,60,53,1,5,1,9
E33026622,265,214,72,142,1,5,3,2,44,42,0,2,0,1
E33026623,292,238,80,158,2,18,10,8,34,34,0,0,0,0
E33026624,584,471,117,354,2,44,28,16,65,57,4,2,2,2
E33026625,572,457,103,354,3,9,5,4,99,86,1,10,2,4
E33026626,427,330,102,228,3,23,14,9,68,59,2,4,3,3
E33026627,303,243,100,143,2,27,12,15,26,24,1,0,1,5
E33026628,325,223,54,169,0,15,4,11,83,39,23,3,18,4
E33026629,237,170,40,130,1,16,11,5,48,43,2,3,0,2
E33026630,327,279,86,193,2,13,8,5,28,28,0,0,0,5
E33026631,491,373,142,231,2,47,36,11,65,58,0,5,2,4
E33026632,483,372,102,270,2,45,30,15,57,50,1,2,4,7
E33026633,367,259,84,175,2,51,32,19,53,41,7,3,2,2
E33026634,416,285,81,204,5,52,31,21,73,52,10,7,4,1
E33026635,706,516,146,370,5,74,54,20,108,96,3,7,2,3
E33026636,311,137,30,107,2,33,8,25,138,35,63,2,38,1
E33026637,1566,834,191,643,10,140,56,84,571,186,200,10,175,11
E33026638,272,186,64,122,2,53,40,13,31,21,1,3,6,0
E33026639,281,204,54,150,3,15,7,8,58,51,1,5,1,1
E33026640,324,238,64,174,3,43,31,12,38,33,2,0,3,2
E33026641,339,241,49,192,1,37,27,10,59,54,0,4,1,1
E33026642,154,98,26,72,1,8,5,3,46,40,0,6,0,1
E33026643,389,256,60,196,2,68,52,16,58,54,1,3,0,5
E33026644,648,463,105,358,9,75,40,35,99,80,5,14,0,2
E33026645,374,297,94,203,1,8,3,5,66,63,1,2,0,2
E33026646,321,228,79,149,3,7,3,4,78,75,0,3,0,5
E33026647,422,326,122,204,0,15,11,4,79,65,4,7,3,2
E33026648,3052,1960,642,1318,11,106,62,44,958,903,6,35,14,17
E33026649,578,418,112,306,0,69,42,27,89,70,6,8,5,2
E33026650,470,342,90,252,2,54,32,22,67,58,2,6,1,5
E33026651,428,220,37,183,1,56,31,25,149,71,38,12,28,2
E33026652,446,387,110,277,2,10,6,4,42,37,1,3,1,5
E33026653,410,301,79,222,1,35,25,10,60,54,1,5,0,13
E33026654,370,312,116,196,1,13,11,2,40,38,1,1,0,4
E33026655,328,271,124,147,0,9,7,2,42,37,4,1,0,6
E33026656,235,196,57,139,0,16,11,5,23,17,5,0,1,0
E33026657,433,325,104,221,3,30,19,11,66,56,1,5,4,9
E33026658,254,204,65,139,1,15,12,3,32,28,0,3,1,2
E33026659,692,544,161,383,1,40,18,22,104,93,0,11,0,3
E33026660,303,256,91,165,1,12,7,5,32,27,1,4,0,2
E33026661,472,378,94,284,4,33,24,9,54,43,6,5,0,3
E33026662,409,292,102,190,3,25,13,12,78,46,31,0,1,11
E33026663,367,296,90,206,2,21,15,6,43,40,0,2,1,5
E33026664,283,228,79,149,0,5,2,3,50,37,0,9,4,0
E33026665,251,203,68,135,0,17,9,8,27,21,2,3,1,4
E33026666,731,559,198,361,2,70,38,32,95,84,1,6,4,5
E33026667,265,206,79,127,2,6,3,3,50,43,2,3,2,1
E33026668,351,283,98,185,2,19,12,7,45,42,0,3,0,2
E33026669,313,252,83,169,1,14,12,2,43,39,0,4,0,3
E33026670,286,221,63,158,2,32,22,10,28,27,0,1,0,3
E33026671,598,458,159,299,5,61,42,19,69,66,1,2,0,5
E33026672,801,591,151,440,7,65,45,20,126,117,1,8,0,12
E33026673,378,302,97,205,4,33,27,6,36,30,0,2,4,3
E33026674,542,365,106,259,1,113,70,43,60,56,1,3,0,3
E33026675,566,450,122,328,8,50,30,20,52,49,0,3,0,6
E33026676,415,315,100,215,2,53,31,22,43,37,5,1,0,2
E33026677,378,318,105,213,1,24,15,9,32,28,0,2,2,3
E33026678,286,223,62,161,1,17,13,4,40,39,0,0,1,5
E33026679,462,354,115,239,1,53,32,21,54,50,1,3,0,0
E33026680,299,229,90,139,0,25,13,12,38,37,0,1,0,7
E33026681,299,241,65,176,0,32,29,3,24,23,0,1,0,2
E33026682,354,278,83,195,2,25,17,8,42,41,0,1,0,7
E33026683,430,334,114,220,5,42,31,11,42,39,0,3,0,7
E33026684,306,225,81,144,6,35,22,13,28,26,0,2,0,12
E33026685,395,309,96,213,3,32,22,10,49,39,2,5,3,2
E33026686,410,318,103,215,2,37,25,12,50,43,1,6,0,3
E33026687,269,192,61,131,3,25,16,9,42,39,2,0,1,7
E33026688,250,173,58,115,1,26,17,9,41,36,2,1,2,9
E33026689,243,173,64,109,1,38,34,4,27,19,1,5,2,4
E33026690,341,241,76,165,2,34,28,6,54,53,1,0,0,10
E33026691,779,563,193,370,6,98,75,23,109,100,3,4,2,3
E33026692,386,287,80,207,1,43,34,9,54,51,0,1,2,1
E33026693,348,283,81,202,0,24,18,6,39,36,0,3,0,2
E33026694,562,417,109,308,2,73,56,17,64,61,1,1,1,6
E33026695,587,406,119,287,6,97,72,25,75,69,2,4,0,3
E33026696,367,275,91,184,1,39,29,10,50,41,4,1,4,2
E33026697,306,217,65,152,0,59,45,14,26,25,0,1,0,4
E33026698,405,319,100,219,2,39,31,8,41,37,3,0,1,4
E33026699,265,226,71,155,0,24,20,4,15,13,0,2,0,0
E33026700,564,397,125,272,4,68,52,16,88,82,4,2,0,7
E33026701,330,212,61,151,0,66,52,14,50,49,0,1,0,2
E33026702,584,407,118,289,5,69,46,23,99,92,1,4,2,4
E33026703,315,249,86,163,6,27,22,5,29,25,1,2,1,4
E33026704,740,479,129,350,11,178,146,32,70,62,1,2,5,2
E33026705,568,417,121,296,3,78,35,43,66,61,4,1,0,4
E33026706,459,304,90,214,2,68,50,18,83,73,1,8,1,2
E33026707,1406,894,216,678,17,221,111,110,264,248,0,12,4,10
E33026708,460,371,79,292,5,47,36,11,35,32,0,3,0,2
E33026709,363,278,74,204,4,55,47,8,23,23,0,0,0,3
E33026710,538,370,114,256,7,66,36,30,81,76,3,2,0,14
E33026711,764,501,143,358,4,128,87,41,121,110,4,6,1,10
E33026712,428,300,96,204,4,44,31,13,66,60,3,3,0,14
E33026713,548,402,138,264,2,69,42,27,69,61,6,2,0,6
E33026714,392,295,66,229,2,43,21,22,50,45,3,2,0,2
E33026715,370,276,87,189,2,41,25,16,48,44,1,3,0,3
E33026716,238,168,63,105,0,31,26,5,37,37,0,0,0,2
E33026717,419,347,100,247,1,37,30,7,33,29,2,2,0,1
E33026718,535,381,124,257,1,36,26,10,110,100,3,5,2,7
E33026719,357,296,71,225,2,37,33,4,22,19,0,2,1,0
E33026720,360,261,61,200,1,52,43,9,46,45,0,0,1,0
E33026721,367,233,60,173,2,84,74,10,47,46,0,1,0,1
E33026722,504,356,101,255,2,71,53,18,74,65,3,5,1,1
E33026723,470,317,62,255,5,88,73,15,59,56,0,2,1,1
E33026724,366,285,105,180,2,16,12,4,61,53,6,2,0,2
E33026725,774,533,166,367,13,114,83,31,111,108,0,2,1,3
E33026726,302,249,104,145,0,15,14,1,37,28,0,7,2,1
E33026727,357,292,81,211,1,21,15,6,42,39,0,3,0,1
E33026728,256,199,63,136,0,31,27,4,23,23,0,0,0,3
E33026729,371,271,81,190,2,48,40,8,48,44,0,4,0,2
E33026730,316,256,85,171,2,31,24,7,26,26,0,0,0,1
E33026731,533,427,116,311,3,38,31,7,62,54,1,6,1,3
E33026732,829,572,180,392,4,122,102,20,118,110,0,7,1,13
E33026733,304,210,47,163,1,53,48,5,40,39,0,0,1,0
E33026734,406,288,81,207,7,39,20,19,70,62,1,7,0,2
E33026735,587,438,104,334,4,58,34,24,84,77,2,2,3,3
E33026736,344,290,89,201,1,25,20,5,26,26,0,0,0,2
E33026737,397,304,118,186,0,31,23,8,43,35,8,0,0,19
E33026738,373,268,88,180,2,40,28,12,58,56,1,1,0,5
E33026739,338,226,74,152,2,38,31,7,69,65,0,4,0,3
E33026740,343,260,82,178,3,27,15,12,49,45,2,2,0,4
E33026741,263,193,78,115,0,9,7,2,59,52,6,1,0,2
E33026742,293,229,58,171,0,20,18,2,40,38,0,1,1,4
E33026743,318,247,83,164,3,26,20,6,39,38,0,1,0,3
E33026744,622,468,186,282,2,50,35,15,100,89,5,5,1,2
E33026745,360,280,75,205,0,44,36,8,35,33,0,1,1,1
E33026746,535,400,129,271,8,56,35,21,62,57,1,2,2,9
E33026747,436,333,121,212,2,34,27,7,62,40,18,2,2,5
E33026748,419,344,104,240,3,25,18,7,42,38,1,0,3,5
E33026749,455,329,115,214,3,43,34,9,59,43,14,1,1,21
E33026750,532,443,158,285,4,20,16,4,60,52,8,0,0,5
E33026751,774,510,165,345,4,125,107,18,130,124,0,6,0,5
E33026752,285,226,72,154,2,23,16,7,30,28,0,2,0,4
E33026753,540,394,77,317,14,49,31,18,83,80,0,3,0,0
E33026754,326,236,65,171,3,48,46,2,38,31,0,5,2,1
E33026755,297,218,65,153,6,41,30,11,31,26,1,2,2,1
E33026756,463,346,104,242,2,64,61,3,46,43,0,2,1,5
E33026757,514,361,102,259,4,71,54,17,70,68,0,1,1,8
E33026758,333,216,46,170,2,83,80,3,31,25,4,2,0,1
E33026759,317,188,47,141,6,85,77,8,37,34,1,2,0,1
E33026760,364,205,42,163,5,95,84,11,58,57,0,1,0,1
E33026761,323,199,35,164,2,83,80,3,37,35,0,2,0,2
E33026762,605,376,86,290,6,140,124,16,80,77,1,2,0,3
E33026763,859,576,154,422,7,152,128,24,114,106,1,7,0,10
E33026764,1311,918,176,742,10,161,126,35,218,201,4,7,6,4
E33026765,753,470,117,353,6,193,157,36,77,69,3,5,0,7
E33026766,776,481,124,357,15,200,158,42,79,73,0,6,0,1
E33026767,425,357,45,312,2,15,4,11,51,47,0,4,0,0
E33026768,558,385,73,312,9,105,77,28,58,52,2,4,0,1
E33026769,432,347,49,298,5,32,17,15,48,46,0,2,0,0
E33026770,330,192,50,142,2,93,89,4,42,39,0,2,1,1
E33026771,520,316,83,233,3,153,129,24,47,44,0,3,0,1
E33026772,352,232,50,182,0,80,74,6,38,36,1,1,0,2
E33026773,591,427,99,328,3,89,77,12,70,61,3,4,2,2
E33026774,459,271,72,199,3,126,115,11,55,54,0,1,0,4
E33026775,331,176,44,132,2,87,74,13,65,65,0,0,0,1
E33026776,620,305,69,236,5,196,169,27,113,109,2,2,0,1
E33026777,301,197,43,154,4,57,55,2,42,40,1,1,0,1
E33026778,347,209,44,165,3,99,92,7,35,30,0,5,0,1
E33026779,293,181,40,141,2,73,68,5,34,32,1,1,0,3
E33026780,347,202,48,154,0,98,85,13,45,40,0,3,2,2
E33026781,1192,908,229,679,6,159,134,25,107,100,0,6,1,12
E33026782,309,169,46,123,3,78,70,8,59,52,4,3,0,0
E33026783,355,205,46,159,6,103,65,38,39,36,0,3,0,2
E33026784,642,476,120,356,14,100,86,14,50,46,0,4,0,2
E33026785,896,606,129,477,6,171,153,18,108,97,1,9,1,5
E33026786,304,247,91,156,0,19,7,12,32,30,0,1,1,6
E33026787,616,466,163,303,7,35,6,29,102,89,5,5,3,6
E33026788,598,492,170,322,3,34,7,27,60,53,0,7,0,9
E33026789,500,408,155,253,3,28,2,26,57,48,1,5,3,4
E33026790,335,269,99,170,1,29,9,20,33,30,1,2,0,3
E33026791,278,226,69,157,0,22,1,21,28,19,6,2,1,2
E33026792,383,317,94,223,0,25,7,18,33,31,0,2,0,8
E33026793,266,207,73,134,2,21,2,19,33,29,0,2,2,3
E33026794,418,351,115,236,7,20,4,16,36,34,1,1,0,4
E33026795,220,170,66,104,4,22,3,19,23,17,2,4,0,1
E33026796,362,293,104,189,3,10,3,7,50,41,2,7,0,6
E33026797,388,288,95,193,1,31,8,23,61,57,0,4,0,7
E33026798,416,345,90,255,0,37,4,33,31,29,0,2,0,3
E33026799,304,259,86,173,0,10,2,8,33,26,0,5,2,2
E33026800,302,244,78,166,0,28,9,19,30,27,1,2,0,0
E33026801,246,164,53,111,1,30,1,29,47,43,1,1,2,4
E33026802,656,517,169,348,4,71,3,68,60,53,1,2,4,4
E33026803,483,389,121,268,3,32,3,29,53,47,4,2,0,6
E33026804,287,209,55,154,2,46,3,43,25,23,1,1,0,5
E33026805,401,320,92,228,0,27,3,24,52,50,0,2,0,2
E33026806,286,205,80,125,3,25,3,22,46,41,0,5,0,7
E33026807,425,338,110,228,0,40,1,39,46,37,0,9,0,1
E33026808,356,294,90,204,2,23,2,21,36,36,0,0,0,1
E33026809,325,285,73,212,0,16,2,14,22,21,0,1,0,2
E33026810,348,271,93,178,1,15,1,14,46,43,2,0,1,15
E33026811,400,312,105,207,2,43,5,38,38,36,0,1,1,5
E33026812,336,253,87,166,3,30,5,25,44,39,1,4,0,6
E33026813,440,373,128,245,1,21,4,17,45,37,3,4,1,0
E33026814,687,546,163,383,3,31,7,24,100,92,7,1,0,7
E33026815,323,254,60,194,1,32,6,26,33,29,1,3,0,3
E33026816,162,133,24,109,1,15,1,14,13,12,0,1,0,0
E33026817,353,288,99,189,4,16,2,14,43,33,1,9,0,2
E33026818,405,309,97,212,0,47,19,28,44,37,3,3,1,5
E33026819,300,252,60,192,1,9,0,9,35,27,0,8,0,3
E33026820,533,461,130,331,0,17,3,14,51,46,0,5,0,4
E33026821,301,241,68,173,1,10,3,7,45,35,2,4,4,4
E33026822,389,330,104,226,0,14,2,12,42,28,3,7,4,3
E33026823,305,256,87,169,0,18,5,13,26,22,2,2,0,5
E33026824,339,270,98,172,3,17,1,16,48,39,1,7,1,1
E33026825,454,357,124,233,0,42,6,36,46,43,0,2,1,9
E33026826,478,344,103,241,3,44,4,40,80,67,5,6,2,7
E33026827,572,448,138,310,4,46,4,42,71,64,3,3,1,3
E33026828,615,496,137,359,2,36,7,29,77,73,2,2,0,4
E33026829,307,262,112,150,2,10,3,7,23,20,0,2,1,10
E33026830,765,701,211,490,0,10,5,5,50,41,2,7,0,4
E33026831,621,534,146,388,3,16,0,16,63,52,2,9,0,5
E33026832,495,434,115,319,2,18,8,10,37,34,0,3,0,4
E33026833,365,329,94,235,1,7,4,3,27,24,0,2,1,1
E33026834,395,340,94,246,1,12,4,8,36,34,1,1,0,6
E33026835,268,232,90,142,0,13,7,6,22,20,0,1,1,1
E33026836,803,670,192,478,4,31,14,17,93,89,0,3,1,5
E33026837,503,443,124,319,0,12,5,7,45,41,0,4,0,3
E33026838,460,395,116,279,3,11,5,6,47,42,2,3,0,4
E33026839,282,249,67,182,0,12,3,9,20,18,1,1,0,1
E33026840,455,382,124,258,0,13,5,8,57,53,0,2,2,3
E33026841,300,268,76,192,1,1,0,1,28,22,2,4,0,2
E33026842,299,257,87,170,1,8,5,3,32,28,0,3,1,1
E33026843,266,177,51,126,1,36,6,30,52,44,3,3,2,0
E33026844,395,316,106,210,4,16,4,12,53,44,2,4,3,6
E33026845,372,245,60,185,1,70,10,60,49,47,0,2,0,7
E33026846,307,207,56,151,1,34,4,30,55,46,4,2,3,10
E33026847,325,285,92,193,1,4,0,4,31,29,0,2,0,4
E33026848,381,324,85,239,1,12,2,10,39,37,0,2,0,5
E33026849,406,357,109,248,2,10,2,8,34,32,0,2,0,3
E33026850,407,357,114,243,4,10,5,5,33,31,2,0,0,3
E33026851,361,274,49,225,2,33,5,28,51,45,0,5,1,1
E33026852,347,308,80,228,1,17,4,13,21,17,2,1,1,0
E33026853,382,332,97,235,3,16,5,11,30,22,1,7,0,1
E33026854,545,441,147,294,6,37,25,12,59,54,2,3,0,2
E33026855,1124,874,262,612,6,106,50,56,133,120,0,12,1,5
E33026856,365,305,91,214,1,13,2,11,39,32,2,5,0,7
E33026857,303,251,69,182,1,20,4,16,27,26,0,1,0,4
E33026858,383,278,63,215,1,33,7,26,70,62,1,7,0,1
E33026859,621,464,144,320,3,53,29,24,100,91,1,8,0,1
E33026860,357,260,77,183,1,29,15,14,63,61,0,2,0,4
E33026861,1920,1433,401,1032,14,134,60,74,324,299,7,15,3,15
E33026862,382,327,107,220,1,18,10,8,32,25,4,3,0,4
E33026863,433,353,107,246,1,25,13,12,49,43,1,5,0,5
E33026864,774,648,198,450,2,51,12,39,67,58,0,9,0,6
E33026865,276,227,59,168,2,13,4,9,32,30,1,1,0,2
E33026866,313,240,62,178,1,21,6,15,48,43,0,5,0,3
E33026867,354,311,91,220,0,9,2,7,33,31,0,2,0,1
E33026868,319,283,93,190,0,8,5,3,28,28,0,0,0,0
E33026869,291,245,72,173,0,10,4,6,35,33,0,2,0,1
E33026870,629,512,141,371,2,25,13,12,83,79,0,3,1,7
E33026871,757,594,203,391,0,55,33,22,101,91,1,8,1,7
E33026872,345,268,78,190,2,31,2,29,42,41,0,1,0,2
E33026873,409,315,106,209,1,14,10,4,72,60,2,6,4,7
E33026874,326,260,88,172,0,18,6,12,46,44,0,2,0,2
E33026875,290,212,85,127,1,24,18,6,50,34,1,3,12,3
E33026876,315,248,59,189,2,21,4,17,43,39,0,2,2,1
E33026877,363,290,95,195,2,18,9,9,51,44,2,4,1,2
E33026878,328,248,81,167,0,22,17,5,56,49,0,7,0,2
E33026879,486,342,102,240,2,41,25,16,97,82,4,11,0,4
E33026880,281,195,54,141,0,19,13,6,67,66,0,1,0,0
E33026881,260,205,57,148,2,9,6,3,42,42,0,0,0,2
E33026882,639,486,128,358,3,51,37,14,90,77,4,8,1,9
E33026883,279,209,68,141,3,20,12,8,45,39,1,4,1,2
E33026884,335,259,85,174,2,24,19,5,49,45,0,4,0,1
E33026885,445,351,79,272,5,17,11,6,65,60,0,5,0,7
E33026886,580,406,107,299,0,52,39,13,119,113,0,4,2,3
E33026887,668,509,139,370,5,36,25,11,116,101,0,13,2,2
E33026888,384,310,94,216,2,19,19,0,51,45,1,4,1,2
E33026889,654,506,171,335,1,53,36,17,87,80,1,6,0,7
E33026890,294,249,95,154,0,18,14,4,21,20,1,0,0,6
E33026891,612,468,180,288,0,51,32,19,88,77,1,6,4,5
E33026892,223,188,70,118,1,13,8,5,16,16,0,0,0,5
E33026893,443,345,111,234,2,35,27,8,46,43,0,3,0,15
E33026894,280,213,75,138,1,25,21,4,38,33,1,2,2,3
E33026895,250,173,66,107,5,22,17,5,48,42,0,6,0,2
E33026896,314,233,72,161,0,34,27,7,44,40,0,4,0,3
E33026897,279,223,90,133,0,12,7,5,33,25,8,0,0,11
E33026898,277,226,75,151,1,21,16,5,25,25,0,0,0,4
E33026899,361,287,112,175,2,19,14,5,47,35,1,8,3,6
E33026900,355,269,71,198,0,23,17,6,63,60,0,3,0,0
E33026901,274,225,78,147,2,15,13,2,28,26,0,2,0,4
E33026902,460,371,118,253,0,26,21,5,60,57,2,1,0,3
E33026903,298,231,82,149,1,17,13,4,41,37,0,1,3,8
E33026904,361,274,108,166,0,24,12,12,54,48,3,3,0,9
E33026905,394,317,109,208,0,27,13,14,41,32,8,1,0,9
E33026906,488,348,108,240,2,66,44,22,67,65,0,1,1,5
E33026907,286,186,60,126,2,17,14,3,79,70,4,5,0,2
E33026908,283,235,79,156,0,3,3,0,38,36,1,1,0,7
E33026909,235,167,61,106,1,4,3,1,57,46,6,5,0,6
E33026910,242,181,71,110,1,13,10,3,45,41,1,2,1,2
E33026911,288,220,64,156,1,8,3,5,52,39,2,7,4,7
E33026912,403,284,106,178,0,11,6,5,105,94,3,8,0,3
E33026913,425,311,105,206,1,16,10,6,84,74,3,7,0,13
E33026914,319,235,78,157,0,19,13,6,59,51,3,5,0,6
E33026915,669,500,151,349,1,34,22,12,129,111,2,15,1,5
E33026916,239,202,62,140,0,10,5,5,26,23,1,2,0,1
E33026917,358,282,96,186,1,18,11,7,52,40,3,8,1,5
E33026918,334,277,110,167,3,8,4,4,41,31,1,9,0,5
E33026919,328,263,82,181,0,17,12,5,46,42,1,3,0,2
E33026920,520,382,142,240,5,17,13,4,112,95,2,13,2,4
E33026921,428,339,129,210,1,18,10,8,66,62,1,3,0,4
E33026922,288,231,68,163,0,14,10,4,43,40,0,3,0,0
E33026923,303,240,81,159,1,7,5,2,52,42,4,5,1,3
E33026924,378,308,104,204,2,14,6,8,42,37,0,4,1,12
E33026925,299,238,103,135,0,7,6,1,47,44,0,3,0,7
E33026926,277,231,75,156,1,9,8,1,36,29,1,5,1,0
E33026927,683,548,180,368,1,33,22,11,98,90,1,4,3,3
E33026928,381,299,121,178,2,25,17,8,55,47,0,6,2,0
E33026929,311,243,84,159,1,9,7,2,49,43,0,4,2,9
E33026930,413,329,123,206,0,11,8,3,71,69,0,2,0,2
E33026931,559,458,147,311,2,33,22,11,61,57,0,3,1,5
E33026932,417,299,102,197,2,26,11,15,87,75,0,7,5,3
E33026933,948,763,248,515,0,50,21,29,128,113,1,11,3,7
E33026934,365,278,74,204,0,8,4,4,78,71,0,7,0,1
E33026935,501,401,131,270,2,16,12,4,79,73,0,6,0,3
E33026936,314,258,98,160,1,8,6,2,44,39,1,4,0,3
E33026937,351,277,103,174,1,16,9,7,57,52,2,3,0,0
E33026938,256,211,67,144,0,9,6,3,36,34,0,2,0,0
E33026939,344,270,102,168,0,32,22,10,41,38,0,3,0,1
E33026940,431,331,129,202,0,27,8,19,70,61,2,5,2,3
E33026941,348,285,114,171,0,12,3,9,45,44,0,1,0,6
E33026942,305,261,89,172,0,9,4,5,31,28,0,3,0,4
E33026943,268,214,66,148,0,12,9,3,40,34,0,5,1,2
E33026944,321,236,71,165,1,33,15,18,46,44,0,2,0,5
E33026945,365,290,73,217,0,22,12,10,53,48,0,5,0,0
E33026946,335,274,89,185,7,17,7,10,37,29,1,6,1,0
E33026947,575,424,142,282,2,41,22,19,108,101,0,7,0,0
E33026948,289,209,54,155,0,15,7,8,64,58,0,5,1,1
E33026949,270,197,47,150,1,20,14,6,49,42,2,5,0,3
E33026950,281,193,66,127,0,19,12,7,67,55,1,11,0,2
E33026951,665,543,143,400,4,23,9,14,90,81,0,7,2,5
E33026952,655,508,145,363,2,22,9,13,122,116,0,6,0,1
E33026953,286,204,88,116,0,16,8,8,63,58,0,5,0,3
E33026954,839,592,181,411,9,102,59,43,126,110,5,11,0,10
E33026955,254,181,52,129,2,25,16,9,41,37,0,4,0,5
E33026956,336,261,65,196,0,18,10,8,55,52,0,3,0,2
E33026957,819,568,207,361,3,54,23,31,189,171,5,13,0,5
E33026958,500,351,128,223,0,31,13,18,117,113,0,3,1,1
E33026959,381,262,82,180,1,36,21,15,81,76,0,4,1,1
E33026960,370,257,89,168,3,16,10,6,89,83,2,2,2,5
E33026961,304,244,83,161,2,18,5,13,37,32,0,5,0,3
E33026962,339,239,73,166,2,31,18,13,63,55,0,7,1,4
E33026963,508,390,112,278,3,29,14,15,79,72,0,7,0,7
E33026964,714,545,170,375,4,35,21,14,128,118,3,7,0,2
E33026965,510,384,132,252,2,7,2,5,110,99,1,7,3,7
E33026966,254,203,83,120,2,12,6,6,37,34,0,1,2,0
E33026967,302,236,76,160,0,16,5,11,47,36,0,11,0,3
E33026968,245,154,64,90,2,13,5,8,72,50,9,8,5,4
E33026969,601,439,131,308,8,54,41,13,94,84,0,9,1,6
E33026970,277,191,55,136,5,43,19,24,29,29,0,0,0,9
E33026971,358,265,99,166,1,53,36,17,37,33,1,3,0,2
E33026972,322,243,90,153,4,21,14,7,53,46,3,4,0,1
E33026973,883,648,160,488,4,29,18,11,199,189,1,6,3,3
E33026974,372,262,95,167,4,31,21,10,71,63,4,3,1,4
E33026975,293,212,62,150,5,40,27,13,34,30,0,3,1,2
E33026976,337,212,71,141,7,62,26,36,55,44,4,4,3,1
E33026977,488,357,126,231,6,53,33,20,67,61,0,3,3,5
E33026978,304,212,62,150,0,58,37,21,29,24,2,3,0,5
E33026979,286,196,71,125,0,27,7,20,59,53,1,4,1,4
E33026980,899,599,185,414,12,139,70,69,142,128,3,11,0,7
E33026981,497,335,82,253,10,77,46,31,70,60,3,2,5,5
E33026982,425,307,96,211,2,44,23,21,68,56,5,6,1,4
E33026983,380,292,78,214,1,27,15,12,60,53,1,6,0,0
E33026984,323,244,79,165,6,34,23,11,38,32,0,4,2,1
E33026985,285,220,89,131,4,29,10,19,30,30,0,0,0,2
E33026986,336,270,119,151,0,22,15,7,32,31,0,1,0,12
E33026987,443,352,118,234,8,39,24,15,43,41,0,0,2,1
E33026988,361,256,109,147,1,47,26,21,54,44,10,0,0,3
E33026989,320,250,94,156,6,10,6,4,53,48,0,3,2,1
E33026990,245,189,74,115,3,15,8,7,35,34,1,0,0,3
E33026991,432,310,115,195,7,33,22,11,71,57,7,7,0,11
E33026992,389,293,113,180,2,32,22,10,59,54,1,2,2,3
E33026993,308,243,100,143,1,21,16,5,36,33,1,2,0,7
E33026994,231,176,62,114,1,19,9,10,32,28,3,1,0,3
E33026995,370,248,84,164,9,48,29,19,60,52,1,2,5,5
E33026996,304,200,74,126,11,53,35,18,35,30,2,2,1,5
E33026997,283,221,90,131,2,25,16,9,31,23,2,3,3,4
E33026998,1128,620,183,437,12,102,47,55,376,145,147,7,77,18
E33026999,287,241,71,170,1,18,10,8,26,24,0,2,0,1
E33027000,769,547,197,350,16,89,51,38,111,100,1,8,2,6
E33027001,241,188,59,129,4,25,18,7,21,20,0,0,1,3
E33027002,273,206,80,126,1,20,14,6,36,33,1,0,2,10
E33027003,343,281,103,178,1,24,14,10,30,27,0,2,1,7
E33027004,279,211,56,155,6,14,6,8,47,42,2,2,1,1
E33027005,322,245,89,156,7,32,22,10,36,33,0,2,1,2
E33027006,398,291,73,218,2,32,10,22,72,68,0,4,0,1
E33027007,271,218,79,139,5,16,13,3,31,28,0,3,0,1
E33027008,553,410,89,321,2,36,18,18,93,90,2,0,1,12
E33027009,391,256,70,186,0,74,40,34,56,45,3,6,2,5
E33027010,275,186,65,121,6,30,16,14,53,51,1,1,0,0
E33027011,349,180,46,134,9,46,26,20,112,109,0,2,1,2
E33027012,275,222,81,141,6,15,3,12,24,22,0,2,0,8
E33027013,266,185,65,120,3,22,19,3,51,48,0,2,1,5
E33027014,263,179,41,138,11,14,6,8,56,53,0,3,0,3
E33027015,649,483,124,359,10,43,25,18,110,106,0,3,1,3
E33027016,232,180,64,116,2,8,8,0,41,40,0,1,0,1
E33027017,353,275,71,204,12,25,14,11,39,35,2,2,0,2
E33027018,442,283,75,208,6,78,56,22,72,64,1,5,2,3
E33027019,438,307,79,228,5,66,29,37,59,56,1,2,0,1
E33027020,389,288,79,209,7,38,18,20,54,50,0,4,0,2
E33027021,605,439,143,296,10,63,35,28,87,82,2,2,1,6
E33027022,442,349,98,251,8,35,20,15,45,43,0,1,1,5
E33027023,265,185,50,135,3,41,32,9,33,33,0,0,0,3
E33027024,641,486,136,350,4,57,34,23,90,84,2,4,0,4
E33027025,591,431,140,291,3,51,36,15,100,92,1,6,1,6
E33027026,502,355,118,237,3,41,20,21,85,72,7,3,3,18
E33027027,427,338,121,217,3,37,23,14,46,41,0,2,3,3
E33027028,269,216,64,152,0,24,15,9,27,23,1,2,1,2
E33027029,359,268,89,179,5,30,18,12,54,52,0,2,0,2
E33027030,381,303,42,261,2,16,10,6,57,50,0,6,1,3
E33027031,282,218,88,130,5,22,9,13,33,30,2,1,0,4
E33027032,440,345,143,202,1,40,29,11,43,39,0,4,0,11
E33027033,327,250,75,175,4,26,15,11,42,38,2,2,0,5
E33027034,402,325,92,233,0,23,13,10,52,52,0,0,0,2
E33027035,560,398,118,280,6,58,41,17,90,77,4,6,3,8
E33027036,244,164,59,105,5,33,23,10,34,31,0,3,0,8
E33027037,271,192,67,125,2,33,20,13,34,28,3,3,0,10
E33027038,266,205,71,134,2,29,19,10,28,22,4,1,1,2
E33027039,289,239,70,169,3,13,6,7,30,24,1,4,1,4
E33027040,378,305,93,212,3,38,3,35,28,25,1,2,0,4
E33027041,463,416,113,303,1,9,2,7,33,30,0,3,0,4
E33027042,441,332,89,243,0,60,19,41,45,40,2,2,1,4
E33027043,289,240,66,174,4,18,7,11,25,24,1,0,0,2
E33027044,572,416,125,291,2,59,26,33,89,80,0,9,0,6
E33027045,437,341,71,270,2,39,10,29,54,47,3,4,0,1
E33027046,657,437,118,319,3,99,42,57,115,109,0,6,0,3
E33027047,309,252,66,186,0,31,7,24,24,23,0,1,0,2
E33027048,348,247,68,179,2,39,6,33,58,53,2,3,0,2
E33027049,815,582,162,420,5,73,30,43,148,142,0,5,1,7
E33027050,369,286,72,214,3,23,9,14,53,46,0,6,1,4
E33027051,347,277,66,211,2,37,2,35,25,21,0,3,1,6
E33027052,261,227,63,164,1,12,0,12,21,19,1,1,0,0
E33027053,412,266,56,210,0,69,11,58,74,64,2,7,1,3
E33027054,363,319,106,213,1,18,5,13,24,21,1,2,0,1
E33027055,466,411,132,279,1,15,1,14,38,37,0,1,0,1
E33027056,357,299,109,190,5,26,6,20,27,27,0,0,0,0
E33027057,346,270,75,195,3,27,8,19,41,40,0,1,0,5
E33027058,737,504,104,400,8,64,24,40,159,148,3,7,1,2
E33027059,403,319,78,241,3,39,5,34,42,40,0,2,0,0
E33027060,722,523,114,409,11,105,15,90,73,63,0,9,1,10
E33027061,295,241,69,172,2,19,7,12,27,24,0,3,0,6
E33027062,754,673,210,463,4,30,19,11,45,40,2,3,0,2
E33027063,311,240,56,184,3,26,6,20,38,36,0,2,0,4
E33027064,595,473,113,360,5,57,18,39,60,56,2,2,0,0
E33027065,363,302,100,202,4,16,5,11,37,36,0,1,0,4
E33027066,418,312,68,244,12,44,16,28,41,39,1,1,0,9
E33027067,437,386,131,255,3,20,11,9,25,23,1,1,0,3
E33027068,929,740,196,544,5,79,27,52,101,98,0,3,0,4
E33027069,404,308,72,236,1,50,9,41,42,38,0,4,0,3
E33027070,254,186,77,109,0,38,16,22,30,29,0,1,0,0
E33027071,902,703,184,519,25,109,19,90,58,53,2,3,0,7
E33027072,287,232,69,163,1,27,16,11,26,24,1,1,0,1
E33027073,314,259,57,202,2,20,6,14,32,31,0,1,0,1
E33027074,328,227,65,162,2,39,11,28,56,51,0,1,4,4
E33027075,617,449,126,323,4,67,21,46,93,88,2,2,1,4
E33027076,480,335,80,255,15,69,15,54,58,57,0,0,1,3
E33027077,429,328,114,214,2,64,17,47,32,29,1,2,0,3
E33027078,400,308,77,231,7,41,14,27,41,34,5,2,0,3
E33027079,517,427,111,316,7,36,7,29,44,40,0,3,1,3
E33027080,304,209,70,139,2,34,15,19,57,53,0,3,1,2
E33027081,654,425,123,302,10,86,52,34,129,124,0,3,2,4
E33027082,338,246,61,185,5,29,11,18,52,48,2,2,0,6
E33027083,501,387,112,275,7,41,17,24,63,62,0,1,0,3
E33027084,358,276,92,184,0,29,11,18,51,46,0,4,1,2
E33027085,822,578,137,441,17,122,62,60,102,98,0,3,1,3
E33027086,287,217,56,161,8,38,17,21,23,22,0,1,0,1
E33027087,535,350,112,238,6,49,27,22,128,120,0,5,3,2
E33027088,311,162,41,121,6,64,21,43,77,73,1,2,1,2
E33027089,488,351,119,232,2,69,56,13,50,40,3,6,1,16
E33027090,387,277,78,199,1,53,44,9,51,50,0,1,0,5
E33027091,489,371,93,278,1,53,42,11,62,59,0,3,0,2
E33027092,521,363,123,240,5,57,38,19,87,76,7,2,2,9
E33027093,328,253,77,176,1,38,25,13,32,28,2,2,0,4
E33027094,459,334,110,224,3,64,50,14,54,47,4,3,0,4
E33027095,830,637,203,434,11,66,42,24,110,107,2,0,1,6
E33027096,367,281,90,191,3,33,22,11,48,43,1,4,0,2
E33027097,407,310,83,227,1,60,51,9,34,34,0,0,0,2
E33027098,183,151,52,99,0,20,19,1,12,10,0,1,1,0
E33027099,272,173,50,123,2,48,37,11,46,24,17,4,1,3
E33027100,534,424,140,284,2,61,47,14,44,39,1,3,1,3
E33027101,392,323,115,208,4,26,20,6,39,31,5,3,0,0
E33027102,395,259,82,177,2,55,42,13,60,41,13,5,1,19
E33027103,560,456,149,307,2,28,24,4,68,63,4,0,1,6
E33027104,349,279,65,214,1,20,9,11,49,48,0,1,0,0
E33027105,485,296,63,233,4,120,60,60,64,60,0,4,0,1
E33027106,706,516,173,343,5,72,61,11,96,82,8,4,2,17
E33027107,492,388,150,238,2,28,20,8,67,63,2,2,0,7
E33027108,419,314,112,202,0,51,47,4,46,44,0,2,0,8
E33027109,548,324,81,243,6,155,97,58,59,52,1,5,1,4
E33027110,749,452,125,327,1,219,175,44,73,66,2,5,0,4
E33027111,292,137,33,104,22,70,40,30,60,60,0,0,0,3
E33027112,439,225,52,173,3,168,140,28,42,39,0,3,0,1
E33027113,592,366,96,270,6,149,120,29,68,63,1,4,0,3
E33027114,259,214,84,130,1,23,17,6,19,17,0,2,0,2
E33027115,940,687,208,479,8,111,84,27,128,110,7,9,2,6
E33027116,551,392,143,249,5,29,23,6,105,90,11,2,2,20
E33027117,655,466,142,324,4,74,51,23,103,91,5,7,0,8
E33027118,336,250,54,196,1,50,35,15,35,31,0,2,2,0
E33027119,652,461,123,338,5,95,68,27,84,77,0,7,0,7
E33027120,271,165,31,134,0,78,70,8,24,18,2,3,1,4
E33027121,293,222,62,160,1,35,30,5,35,32,0,3,0,0
E33027122,333,238,60,178,5,53,42,11,34,31,2,1,0,3
E33027123,343,247,62,185,1,64,55,9,30,30,0,0,0,1
E33027124,357,211,44,167,2,115,102,13,27,24,0,3,0,2
E33027125,455,313,88,225,2,95,80,15,45,43,0,2,0,0
E33027126,363,302,95,207,0,27,25,2,33,30,0,2,1,1
E33027127,498,324,95,229,7,104,90,14,62,56,1,5,0,1
E33027128,311,235,72,163,2,33,23,10,38,35,0,3,0,3
E33027129,271,231,93,138,0,13,8,5,24,21,0,2,1,3
E33027130,577,332,84,248,3,159,132,27,81,66,5,5,5,2
E33027131,449,273,69,204,0,113,99,14,59,54,0,5,0,4
E33027132,327,267,83,184,0,19,15,4,40,36,0,4,0,1
E33027133,356,277,90,187,4,29,23,6,42,34,5,3,0,4
E33027134,472,376,107,269,2,43,31,12,48,44,2,1,1,3
E33027135,320,213,56,157,0,66,59,7,39,36,0,3,0,2
E33027136,357,233,61,172,7,48,23,25,66,60,2,4,0,3
E33027137,375,279,88,191,1,51,36,15,37,32,1,4,0,7
E33027138,312,189,44,145,1,90,79,11,31,29,0,2,0,1
E33027139,484,279,77,202,3,117,86,31,83,79,0,4,0,2
E33027140,308,213,64,149,6,41,27,14,46,44,0,2,0,2
E33027141,352,233,51,182,1,83,72,11,32,31,0,1,0,3
E33027142,750,537,139,398,0,132,117,15,75,62,4,9,0,6
E33027143,342,263,68,195,3,44,39,5,31,25,2,4,0,1
E33027144,785,574,151,423,8,104,82,22,99,97,0,2,0,0
E33027145,376,285,101,184,1,60,47,13,29,28,0,1,0,1
E33027146,294,194,53,141,1,40,34,6,52,49,1,2,0,7
E33027147,322,265,101,164,0,21,12,9,34,31,0,1,2,2
E33027148,275,202,57,145,1,31,22,9,37,35,0,2,0,4
E33027149,514,406,111,295,2,53,43,10,52,46,2,3,1,1
E33027150,729,457,123,334,4,165,116,49,96,90,0,4,2,7
E33027151,475,334,94,240,3,58,43,15,77,71,1,5,0,3
E33027152,780,471,125,346,13,165,110,55,131,119,3,7,2,0
E33027153,342,234,59,175,0,49,37,12,56,52,1,1,2,3
E33027154,323,226,60,166,0,49,34,15,42,36,0,5,1,6
E33027155,449,326,75,251,4,71,55,16,48,45,0,2,1,0
E33027156,488,326,73,253,4,79,53,26,77,70,0,7,0,2
E33027157,641,302,78,224,4,229,159,70,105,91,1,5,8,1
E33027158,291,248,81,167,0,23,19,4,16,14,1,1,0,4
E33027159,423,309,75,234,4,75,54,21,33,29,0,3,1,2
E33027160,370,245,44,201,2,78,64,14,44,43,1,0,0,1
E33027161,554,343,94,249,5,137,119,18,63,55,4,2,2,6
E33027162,320,212,51,161,1,73,55,18,25,23,1,1,0,9
E33027163,447,329,107,222,4,70,36,34,38,30,3,5,0,6
E33027164,558,394,129,265,4,61,44,17,98,92,0,5,1,1
E33027165,674,460,137,323,8,119,73,46,86,78,2,3,3,1
E33027166,472,282,90,192,3,79,57,22,105,93,3,5,4,3
E33027167,533,387,128,259,4,58,43,15,79,70,5,1,3,5
E33027168,523,388,120,268,1,63,42,21,61,53,2,6,0,10
E33027169,429,354,100,254,3,27,20,7,41,37,2,2,0,4
E33027170,281,201,72,129,0,27,19,8,51,31,17,2,1,2
E33027171,277,214,66,148,1,26,19,7,29,27,0,1,1,7
E33027172,560,395,114,281,5,73,49,24,79,75,0,3,1,8
E33027173,364,247,78,169,5,65,46,19,46,43,0,1,2,1
E33027174,364,253,78,175,2,51,14,37,54,51,0,1,2,4
E33027175,310,219,87,132,0,29,11,18,48,44,0,4,0,14
E33027176,778,592,175,417,10,79,21,58,90,86,2,1,1,7
E33027177,359,289,83,206,1,31,5,26,32,29,0,3,0,6
E33027178,493,359,121,238,5,58,21,37,62,61,0,1,0,9
E33027179,291,211,76,135,2,43,19,24,29,24,2,1,2,6
E33027180,325,246,93,153,3,38,26,12,38,31,3,3,1,0
E33027181,319,225,67,158,2,50,13,37,38,34,1,1,2,4
E33027182,394,255,109,146,6,73,21,52,50,34,5,7,4,10
E33027183,348,251,91,160,3,44,18,26,39,32,1,3,3,11
E33027184,331,246,81,165,2,35,8,27,37,33,4,0,0,11
E33027185,318,223,84,139,3,32,13,19,56,55,0,1,0,4
E33027186,698,528,172,356,4,38,15,23,99,84,13,1,1,29
E33027187,356,262,92,170,1,53,12,41,36,34,0,1,1,4
E33027188,340,288,61,227,13,5,2,3,29,24,0,2,3,5
E33027189,322,251,73,178,2,24,7,17,39,35,0,1,3,6
E33027190,423,289,91,198,8,68,16,52,55,52,0,3,0,3
E33027191,399,324,92,232,3,38,8,30,34,28,3,2,1,0
E33027192,290,202,53,149,5,22,10,12,57,49,4,2,2,4
E33027193,485,377,98,279,3,38,19,19,61,57,2,2,0,6
E33027194,300,215,68,147,6,22,8,14,56,51,1,4,0,1
E33027195,568,421,106,315,8,46,21,25,90,82,3,5,0,3
E33027196,665,499,148,351,8,70,34,36,84,77,0,7,0,4
E33027197,516,379,113,266,9,57,30,27,68,65,2,1,0,3
E33027198,568,394,93,301,6,64,39,25,101,96,2,3,0,3
E33027199,651,530,167,363,6,56,16,40,56,53,1,2,0,3
E33027200,685,501,139,362,6,48,22,26,112,89,8,11,4,18
E33027201,368,278,93,185,2,37,12,25,46,41,3,0,2,5
E33027202,472,395,129,266,2,39,6,33,30,25,2,3,0,6
E33027203,274,218,62,156,2,25,9,16,28,23,0,1,4,1
E33027204,476,341,114,227,2,47,18,29,62,50,5,3,4,24
E33027205,555,382,109,273,7,55,17,38,107,101,4,2,0,4
E33027206,530,418,121,297,8,51,14,37,50,48,0,1,1,3
E33027207,323,233,59,174,7,50,17,33,32,31,0,1,0,1
E33027208,264,141,36,105,4,76,12,64,40,37,2,1,0,3
E33027209,387,306,77,229,4,15,5,10,57,51,0,6,0,5
E33027210,757,491,126,365,10,98,43,55,152,140,1,8,3,6
E33027211,541,366,96,270,12,63,24,39,95,87,1,6,1,5
E33027212,480,408,111,297,3,13,7,6,51,47,1,3,0,5
E33027213,376,321,93,228,2,6,3,3,47,45,0,2,0,0
E33027214,452,398,89,309,2,10,4,6,42,36,4,2,0,0
E33027215,355,258,92,166,1,33,12,21,53,46,5,0,2,10
E33027216,277,175,71,104,0,40,6,34,54,52,1,1,0,8
E33027217,384,284,82,202,2,54,14,40,40,37,1,2,0,4
E33027218,555,395,106,289,7,62,33,29,79,74,0,5,0,12
E33027219,244,196,75,121,3,20,12,8,23,20,1,2,0,2
E33027220,349,270,120,150,1,33,12,21,36,31,3,1,1,9
E33027221,538,381,111,270,3,42,9,33,95,90,3,0,2,17
E33027222,418,297,97,200,4,56,18,38,55,47,4,3,1,6
E33027223,409,304,113,191,1,46,14,32,48,48,0,0,0,10
E33027224,390,282,75,207,2,34,11,23,68,62,0,3,3,4
E33027225,360,284,91,193,2,24,14,10,46,43,1,2,0,4
E33027226,477,369,111,258,8,29,15,14,67,60,2,4,1,4
E33027227,309,219,59,160,4,45,15,30,38,34,1,2,1,3
E33027228,322,251,68,183,4,22,8,14,44,39,0,5,0,1
E33027229,326,250,62,188,3,27,9,18,44,40,0,4,0,2
E33027230,797,589,158,431,4,77,52,25,125,119,0,6,0,2
E33027231,301,231,55,176,2,38,10,28,28,24,0,1,3,2
E33027232,300,201,69,132,4,41,14,27,53,53,0,0,0,1
E33027233,294,239,79,160,1,16,7,9,36,32,1,3,0,2
E33027234,270,193,53,140,0,29,5,24,46,43,0,2,1,2
E33027235,330,210,47,163,1,62,7,55,57,56,0,1,0,0
E33027236,599,447,131,316,5,70,22,48,72,69,1,0,2,5
E33027237,585,407,122,285,11,61,21,40,104,96,1,5,2,2
E33027238,907,717,241,476,9,75,21,54,99,91,2,2,4,7
E33027239,2143,1741,414,1327,17,124,49,75,256,244,2,6,4,5
E33027240,499,370,127,243,4,70,5,65,51,50,0,1,0,4
E33027241,427,312,100,212,1,43,11,32,68,66,0,0,2,3
E33027242,368,286,89,197,1,31,8,23,43,39,0,4,0,7
E33027243,294,246,100,146,0,18,1,17,29,27,0,1,1,1
E33027244,489,298,71,227,5,129,17,112,53,47,1,3,2,4
E33027245,336,266,88,178,3,29,8,21,36,34,0,2,0,2
E33027246,322,255,49,206,5,32,4,28,28,26,0,0,2,2
E33027247,306,214,51,163,7,43,10,33,42,40,0,2,0,0
E33027248,279,222,61,161,2,24,5,19,30,29,1,0,0,1
E33027249,422,293,96,197,2,65,18,47,61,54,1,6,0,1
E33027250,575,410,149,261,4,77,30,47,79,76,0,2,1,5
E33027251,507,397,131,266,4,42,17,25,60,59,0,1,0,4
E33027252,540,393,99,294,4,65,23,42,69,67,0,2,0,9
E33027253,407,277,80,197,3,63,16,47,62,59,0,0,3,2
E33027254,398,318,97,221,7,25,10,15,46,44,0,2,0,2
E33027255,277,211,59,152,2,38,5,33,21,16,0,4,1,5
E33027256,377,309,113,196,6,24,8,16,34,30,3,1,0,4
E33027257,452,327,93,234,5,64,12,52,55,52,0,3,0,1
E33027258,616,463,168,295,4,52,18,34,79,65,9,3,2,18
E33027259,295,195,58,137,0,52,18,34,45,40,1,4,0,3
E33027260,292,223,73,150,5,19,10,9,35,30,1,2,2,10
E33027261,527,351,139,212,7,36,11,25,59,36,22,0,1,74
E33027262,362,258,80,178,4,58,10,48,37,32,2,3,0,5
E33027263,364,266,74,192,3,44,20,24,50,43,2,3,2,1
E33027264,284,218,71,147,2,31,10,21,28,23,1,2,2,5
E33027265,451,315,111,204,4,55,24,31,65,59,2,2,2,12
E33027266,328,257,80,177,2,20,5,15,48,43,4,1,0,1
E33027267,540,400,143,257,3,53,21,32,82,75,1,6,0,2
E33027268,371,306,128,178,2,15,3,12,43,40,0,3,0,5
E33027269,473,347,109,238,4,40,28,12,73,60,2,4,7,9
E33027270,795,561,159,402,3,68,38,30,158,152,1,5,0,5
E33027271,482,388,133,255,3,37,5,32,51,44,3,3,1,3
E33027272,306,262,97,165,1,14,0,14,26,24,1,1,0,3
E33027273,667,516,143,373,4,68,22,46,74,69,2,3,0,5
E33027274,678,501,165,336,5,75,33,42,93,89,4,0,0,4
E33027275,337,223,54,169,3,78,12,66,30,26,0,2,2,3
E33027276,287,224,80,144,1,27,9,18,33,31,1,1,0,2
E33027277,405,283,78,205,9,65,26,39,45,41,0,4,0,3
E33027278,426,293,95,198,4,59,23,36,65,61,0,3,1,5
E33027279,635,425,105,320,6,88,38,50,98,86,1,10,1,18
E33027280,467,346,78,268,8,48,12,36,59,56,1,2,0,6
E33027281,303,220,63,157,2,38,5,33,43,42,0,1,0,0
E33027282,254,177,59,118,1,49,15,34,26,24,0,0,2,1
E33027283,311,234,75,159,3,34,4,30,38,36,0,1,1,2
E33027284,247,216,83,133,0,10,3,7,20,20,0,0,0,1
E33027285,678,476,148,328,2,51,20,31,140,130,1,5,4,9
E33027286,465,354,126,228,4,30,13,17,65,62,1,2,0,12
E33027287,422,323,126,197,2,33,3,30,59,57,0,1,1,5
E33027288,379,222,52,170,9,73,20,53,72,71,0,1,0,3
E33027289,277,178,39,139,1,60,10,50,37,32,2,3,0,1
E33027290,343,175,34,141,12,102,16,86,52,52,0,0,0,2
E33027291,360,194,46,148,10,119,23,96,35,33,2,0,0,2
E33027292,334,222,60,162,1,42,2,40,68,65,1,2,0,1
E33027293,380,221,33,188,4,85,20,65,66,65,0,1,0,4
E33027294,650,431,124,307,7,83,21,62,128,123,3,2,0,1
E33027295,284,190,41,149,2,21,8,13,69,69,0,0,0,2
E33027296,303,206,51,155,4,48,9,39,41,40,0,1,0,4
E33027297,368,269,66,203,3,63,6,57,29,26,2,1,0,4
E33027298,635,309,84,225,6,129,33,96,137,127,0,8,2,54
E33027299,814,523,115,408,15,150,35,115,120,112,4,3,1,6
E33027300,344,217,54,163,17,50,10,40,51,45,1,4,1,9
E33027301,347,205,61,144,3,28,3,25,107,105,0,1,1,4
E33027302,378,247,87,160,1,37,10,27,76,63,8,4,1,17
E33027303,428,293,115,178,1,33,6,27,93,85,0,4,4,8
E33027304,293,236,78,158,3,20,7,13,33,33,0,0,0,1
E33027305,374,267,63,204,4,53,12,41,47,47,0,0,0,3
E33027306,586,288,89,199,12,89,23,66,187,175,3,8,1,10
E33027307,386,231,57,174,8,76,14,62,64,57,1,4,2,7
E33027308,423,212,48,164,18,49,14,35,142,137,0,5,0,2
E33027309,636,471,131,340,5,48,15,33,110,106,1,2,1,2
E33027310,336,214,54,160,3,54,12,42,60,53,0,7,0,5
E33027311,610,466,152,314,11,57,15,42,74,67,3,1,3,2
E33027312,557,402,113,289,2,72,12,60,78,64,9,5,0,3
E33027313,380,286,89,197,7,28,10,18,57,51,0,4,2,2
E33027314,492,399,120,279,3,14,5,9,71,62,2,4,3,5
E33027315,245,183,61,122,2,26,10,16,33,32,0,1,0,1
E33027316,249,179,50,129,1,23,10,13,46,39,0,4,3,0
E33027317,362,310,112,198,1,6,2,4,44,40,1,2,1,1
E33027318,325,276,64,212,1,14,1,13,33,31,2,0,0,1
E33027319,774,574,150,424,5,60,23,37,133,121,2,5,5,2
E33027320,475,342,89,253,7,41,19,22,82,69,3,10,0,3
E33027321,280,213,70,143,1,19,4,15,40,35,4,1,0,7
E33027322,285,157,66,91,3,32,9,23,88,59,17,4,8,5
E33027323,338,240,74,166,4,40,8,32,54,50,0,1,3,0
E33027324,345,255,69,186,0,49,10,39,40,38,0,2,0,1
E33027325,390,281,83,198,1,50,27,23,54,47,0,5,2,4
E33027326,287,246,86,160,2,14,3,11,22,20,0,2,0,3
E33027327,603,510,152,358,3,31,17,14,55,51,2,2,0,4
E33027328,345,229,67,162,6,45,24,21,63,59,0,1,3,2
E33027329,346,242,79,163,3,40,23,17,54,49,3,1,1,7
E33027330,327,266,72,194,0,29,14,15,31,24,1,0,6,1
E33027331,387,268,70,198,4,84,27,57,28,21,3,4,0,3
E33027332,481,321,94,227,1,117,43,74,39,35,0,4,0,3
E33027333,550,401,123,278,7,82,38,44,51,47,2,1,1,9
E33027334,437,299,81,218,6,82,34,48,45,40,1,3,1,5
E33027335,288,196,62,134,0,43,18,25,47,44,1,1,1,2
E33027336,409,336,84,252,4,18,2,16,48,42,0,4,2,3
E33027337,922,596,185,411,11,189,83,106,123,107,2,11,3,3
E33027338,346,302,33,269,2,13,5,8,29,28,0,1,0,0
E33027339,422,259,78,181,2,96,57,39,59,47,1,8,3,6
E33027340,548,380,148,232,3,74,31,43,85,70,10,5,0,6
E33027341,282,218,74,144,2,26,13,13,32,28,0,3,1,4
E33027342,505,352,113,239,5,81,39,42,65,61,3,1,0,2
E33027343,454,340,109,231,9,48,27,21,54,48,3,2,1,3
E33027344,314,198,58,140,1,33,12,21,73,65,1,6,1,9
E33027345,238,181,57,124,0,30,15,15,22,19,2,1,0,5
E33027346,334,226,73,153,3,36,17,19,62,50,4,4,4,7
E33027347,497,339,51,288,15,59,25,34,82,73,0,9,0,2
E33027348,272,186,74,112,2,40,19,21,42,37,3,0,2,2
E33027349,462,332,139,193,5,41,17,24,54,49,4,0,1,30
E33027350,280,196,66,130,0,65,15,50,17,17,0,0,0,2
E33027351,214,183,50,133,1,10,4,6,19,14,0,4,1,1
E33027352,287,182,47,135,0,75,16,59,28,24,0,3,1,2
E33027353,593,397,109,288,4,124,45,79,66,62,1,3,0,2
E33027354,310,195,60,135,8,66,16,50,39,33,0,1,5,2
E33027355,318,201,61,140,4,83,31,52,28,23,2,2,1,2
E33027356,649,497,112,385,11,58,23,35,81,78,1,2,0,2
E33027357,240,181,71,110,4,21,5,16,32,29,2,1,0,2
E33027358,365,283,110,173,8,31,14,17,37,37,0,0,0,6
E33027359,283,188,68,120,1,73,35,38,17,17,0,0,0,4
E33027360,723,543,182,361,9,88,39,49,76,70,4,2,0,7
E33027361,381,285,97,188,6,41,10,31,45,38,5,1,1,4
E33027362,618,395,107,288,5,152,65,87,65,56,2,6,1,1
E33027363,298,226,67,159,3,27,10,17,42,41,0,1,0,0
E33027364,268,212,63,149,1,14,3,11,41,40,0,1,0,0
E33027365,395,248,62,186,5,60,28,32,81,77,0,3,1,1
E33027366,361,248,73,175,5,31,13,18,74,68,1,4,1,3
E33027367,697,479,125,354,12,111,49,62,91,84,1,6,0,4
E33027368,376,276,79,197,4,55,27,28,38,33,0,4,1,3
E33027369,467,284,71,213,3,89,34,55,88,85,0,3,0,3
E33027370,652,485,144,341,4,81,43,38,76,75,0,1,0,6
E33027371,254,195,67,128,2,33,15,18,22,20,0,2,0,2
E33027372,423,311,68,243,10,50,21,29,51,44,3,1,3,1
E33027373,521,399,130,269,4,64,29,35,47,39,1,6,1,7
E33027374,327,168,56,112,5,121,66,55,28,24,1,1,2,5
E33027375,534,349,112,237,5,91,39,52,85,81,0,4,0,4
E33027376,371,277,116,161,4,58,39,19,31,27,2,2,0,1
E33027377,353,273,93,180,4,28,11,17,42,41,0,1,0,6
E33027378,237,156,49,107,1,31,10,21,46,37,6,3,0,3
E33027379,307,258,79,179,0,15,9,6,33,29,0,4,0,1
E33027380,414,340,118,222,1,29,15,14,39,37,0,2,0,5
E33027381,563,395,110,285,7,77,34,43,79,73,0,5,1,5
E33027382,321,242,62,180,7,42,20,22,29,27,0,0,2,1
E33027383,357,228,82,146,1,41,24,17,77,60,8,4,5,10
E33027384,394,246,81,165,6,60,32,28,72,57,8,4,3,10
E33027385,416,269,93,176,2,38,20,18,100,81,1,9,9,7
E33027386,261,184,57,127,1,33,17,16,37,37,0,0,0,6
E33027387,273,193,62,131,1,49,38,11,29,22,1,2,4,1
E33027388,258,178,57,121,2,50,24,26,22,19,0,3,0,6
E33027389,297,209,79,130,1,37,17,20,47,41,1,4,1,3
E33027390,254,164,52,112,0,23,15,8,58,54,3,0,1,9
E33027391,240,135,46,89,0,33,16,17,62,55,3,3,1,10
E33027392,503,362,120,242,3,62,36,26,70,64,0,4,2,6
E33027393,301,238,84,154,1,39,17,22,21,19,0,1,1,2
E33027394,503,363,114,249,2,76,41,35,52,48,0,4,0,10
E33027395,228,181,75,106,0,13,8,5,27,23,2,2,0,7
E33027396,467,325,98,227,2,75,32,43,62,59,1,2,0,3
E33027397,612,426,107,319,1,78,52,26,102,92,6,4,0,5
E33027398,303,205,64,141,2,39,20,19,48,45,3,0,0,9
E33027399,259,190,55,135,0,42,36,6,26,20,2,0,4,1
E33027400,288,251,68,183,1,6,5,1,29,28,0,1,0,1
E33027401,703,544,143,401,5,46,31,15,105,94,4,5,2,3
E33027402,419,350,94,256,1,24,18,6,43,42,0,1,0,1
E33027403,372,278,82,196,3,27,19,8,63,56,2,4,1,1
E33027404,703,565,170,395,5,42,25,17,75,68,2,4,1,16
E33027405,487,386,135,251,1,42,23,19,53,51,1,1,0,5
E33027406,329,217,65,152,2,73,67,6,35,28,4,3,0,2
E33027407,282,211,74,137,1,23,9,14,46,45,1,0,0,1
E33027408,304,256,116,140,1,18,13,5,28,27,0,1,0,1
E33027409,509,358,108,250,1,27,12,15,122,113,2,6,1,1
E33027410,424,312,100,212,5,37,28,9,69,64,0,5,0,1
E33027411,751,552,193,359,4,62,26,36,131,102,22,5,2,2
E33027412,673,488,152,336,9,71,53,18,94,84,4,5,1,11
E33027413,262,194,69,125,1,29,24,5,32,17,12,2,1,6
E33027414,293,232,74,158,2,12,11,1,39,36,0,2,1,8
E33027415,423,320,125,195,4,76,65,11,21,16,2,1,2,2
E33027416,370,339,130,209,0,10,7,3,21,20,1,0,0,0
E33027417,381,284,94,190,3,36,23,13,53,46,0,5,2,5
E33027418,330,290,132,158,0,5,2,3,31,29,1,1,0,4
E33027419,393,239,73,166,2,49,37,12,90,76,6,3,5,13
E33027420,368,277,104,173,3,20,15,5,63,60,1,2,0,5
E33027421,227,168,42,126,1,40,27,13,16,15,0,1,0,2
E33027422,327,235,59,176,2,51,47,4,35,31,1,3,0,4
E33027423,313,232,76,156,2,40,26,14,36,32,1,3,0,3
E33027424,303,236,76,160,2,24,18,6,38,35,2,1,0,3
E33027425,256,160,47,113,0,46,40,6,49,46,2,0,1,1
E33027426,328,217,60,157,8,42,38,4,60,55,1,4,0,1
E33027427,483,337,104,233,4,75,56,19,62,56,1,5,0,5
E33027428,392,332,102,230,1,15,11,4,42,39,0,3,0,2
E33027429,687,568,161,407,3,44,31,13,67,58,0,6,3,5
E33027430,318,215,78,137,2,34,22,12,62,58,0,4,0,5
E33027431,374,337,108,229,0,15,14,1,20,16,0,2,2,2
E33027432,1412,1018,328,690,8,222,105,117,160,153,1,4,2,4
E33027433,581,408,121,287,6,79,60,19,81,77,0,4,0,7
E33027434,434,308,79,229,2,74,58,16,47,41,0,6,0,3
E33027435,446,337,101,236,2,49,40,9,57,51,2,4,0,1
E33027436,273,242,96,146,0,8,2,6,21,18,0,0,3,2
E33027437,281,217,78,139,0,16,16,0,43,38,2,3,0,5
E33027438,301,247,81,166,3,20,14,6,30,29,0,1,0,1
E33027439,740,551,199,352,10,68,39,29,99,92,1,5,1,12
E33027440,250,153,56,97,5,33,23,10,56,51,0,4,1,3
E33027441,429,261,92,169,4,56,38,18,98,92,1,4,1,10
E33027442,721,488,126,362,6,110,69,41,112,106,0,6,0,5
E33027443,645,384,123,261,3,95,62,33,162,158,2,2,0,1
E33027444,314,257,95,162,1,20,9,11,35,32,1,1,1,1
E33027445,535,383,140,243,4,61,36,25,85,82,0,2,1,2
E33027446,424,300,105,195,1,50,39,11,69,65,0,4,0,4
E33027447,273,173,52,121,1,37,28,9,56,50,1,5,0,6
E33027448,424,278,65,213,7,43,15,28,94,83,1,8,2,2
E33027449,401,264,78,186,2,58,37,21,75,68,0,4,3,2
E33027450,824,570,155,415,11,82,44,38,155,144,0,9,2,6
E33027451,359,251,77,174,2,20,11,9,85,66,17,2,0,1
E33027452,462,388,115,273,3,27,19,8,43,38,1,4,0,1
E33027453,625,453,135,318,3,75,54,21,90,84,3,3,0,4
E33027454,361,260,76,184,2,29,16,13,67,60,5,2,0,3
E33027455,278,183,57,126,3,24,13,11,60,57,0,2,1,8
E33027456,300,236,76,160,2,17,11,6,43,37,1,3,2,2
E33027457,346,247,79,168,4,27,20,7,66,59,0,7,0,2
E33027458,296,205,71,134,0,22,12,10,69,63,4,2,0,0
E33027459,424,323,121,202,4,28,18,10,64,58,0,4,2,5
E33027460,429,330,119,211,2,52,35,17,43,42,0,1,0,2
E33027461,349,265,77,188,0,44,28,16,34,31,1,1,1,6
E33027462,692,500,162,338,12,78,58,20,97,78,9,8,2,5
E33027463,307,228,53,175,3,36,24,12,39,32,5,2,0,1
E33027464,333,198,44,154,3,78,29,49,53,51,1,1,0,1
E33027465,611,330,97,233,4,100,60,40,165,135,23,5,2,12
E33027466,332,222,70,152,1,78,58,20,30,26,0,1,3,1
E33027467,338,240,80,160,3,60,39,21,29,28,1,0,0,6
E33027468,377,265,85,180,6,52,39,13,52,49,0,3,0,2
E33027469,639,448,140,308,2,94,60,34,90,83,1,6,0,5
E33027470,580,383,115,268,4,109,78,31,82,73,6,1,2,2
E33027471,296,176,46,130,0,68,52,16,50,45,1,3,1,2
E33027472,316,235,80,155,0,24,18,6,56,53,0,2,1,1
E33027473,474,316,91,225,1,81,57,24,75,71,1,3,0,1
E33027474,472,336,94,242,3,61,39,22,71,62,2,7,0,1
E33027475,295,198,46,152,2,48,33,15,46,42,0,4,0,1
E33027476,359,260,64,196,6,51,20,31,41,37,1,0,3,1
E33027477,348,224,58,166,3,71,49,22,50,47,0,2,1,0
E33027478,1466,888,262,626,17,257,136,121,288,272,3,10,3,16
E33027479,495,378,113,265,2,45,28,17,66,63,1,2,0,4
E33027480,501,388,133,255,3,44,31,13,63,60,1,1,1,3
E33027481,770,519,142,377,6,73,36,37,167,155,1,10,1,5
E33027482,294,255,71,184,0,8,2,6,26,21,1,2,2,5
E33027483,288,250,84,166,1,14,9,5,21,20,0,1,0,2
E33027484,469,366,123,243,3,42,31,11,55,54,0,1,0,3
E33027485,346,269,92,177,1,35,18,17,41,34,1,4,2,0
E33027486,418,290,50,240,5,66,55,11,56,53,0,3,0,1
E33027487,349,222,49,173,5,61,53,8,58,48,0,8,2,3
E33027488,1070,751,198,553,15,187,109,78,113,94,2,14,3,4
E33027489,659,454,100,354,8,100,78,22,89,81,1,7,0,8
E33027490,661,462,125,337,8,101,73,28,86,83,1,2,0,4
E33027491,502,284,76,208,20,65,35,30,131,121,1,9,0,2
E33027492,398,271,55,216,2,51,26,25,73,70,0,3,0,1
E33027493,284,211,61,150,1,35,13,22,33,27,0,3,3,4
E33027494,557,374,95,279,6,115,96,19,61,50,0,11,0,1
E33027495,372,219,52,167,3,107,77,30,43,39,0,4,0,0
E33027496,599,399,82,317,12,116,64,52,66,63,0,3,0,6
E33027497,585,429,111,318,6,96,76,20,53,46,0,7,0,1
E33027498,426,360,64,296,1,11,7,4,53,49,0,4,0,1
E33027499,323,211,48,163,3,46,36,10,60,58,0,2,0,3
E33027500,362,233,56,177,4,82,71,11,42,41,0,1,0,1
E33027501,334,204,53,151,5,75,56,19,46,41,0,3,2,4
E33027502,321,202,43,159,0,70,51,19,48,44,0,1,3,1
E33027503,553,360,84,276,7,98,62,36,82,79,0,3,0,6
E33027504,409,270,72,198,6,74,55,19,59,47,2,5,5,0
E33027505,633,436,115,321,8,119,87,32,61,56,0,5,0,9
E33027506,423,284,50,234,15,66,55,11,53,47,0,4,2,5
E33027507,297,182,40,142,5,75,61,14,33,29,1,3,0,2
E33027508,471,311,75,236,4,93,69,24,60,51,3,5,1,3
E33027509,555,336,83,253,6,152,126,26,58,50,0,8,0,3
E33027510,397,262,44,218,0,86,78,8,48,32,0,16,0,1
E33027511,767,489,111,378,13,164,136,28,98,87,1,9,1,3
E33027512,649,437,108,329,9,128,116,12,70,65,3,2,0,5
E33027513,386,245,58,187,2,89,79,10,47,42,0,5,0,3
E33027514,333,195,43,152,4,101,89,12,29,26,0,3,0,4
E33027515,666,399,75,324,9,143,113,30,111,84,3,24,0,4
E33027516,339,244,55,189,3,57,48,9,32,26,1,3,2,3
E33027517,265,189,44,145,1,51,48,3,22,20,0,2,0,2
E33027518,474,346,94,252,1,83,74,9,42,39,0,3,0,2
E33027519,521,388,101,287,4,30,18,12,97,91,1,4,1,2
E33027520,307,216,60,156,2,58,28,30,29,27,1,1,0,2
E33027521,336,236,64,172,2,59,43,16,36,35,0,1,0,3
E33027522,311,215,84,131,5,50,17,33,39,36,0,3,0,2
E33027523,471,307,77,230,6,74,41,33,84,79,0,5,0,0
E33027524,489,365,107,258,2,51,20,31,68,53,2,13,0,3
E33027525,357,294,100,194,3,33,11,22,25,20,0,5,0,2
E33027526,325,252,70,182,0,25,9,16,47,44,0,3,0,1
E33027527,458,328,88,240,2,54,14,40,72,67,2,3,0,2
E33027528,393,303,72,231,3,38,8,30,47,45,1,0,1,2
E33027529,464,325,95,230,2,59,21,38,73,67,1,5,0,5
E33027530,385,271,71,200,2,75,28,47,35,30,1,1,3,2
E33027531,286,219,54,165,1,36,17,19,28,25,1,2,0,2
E33027532,228,170,37,133,4,9,1,8,40,34,1,3,2,5
E33027533,686,377,99,278,5,49,15,34,240,216,13,4,7,15
E33027534,389,315,102,213,1,43,12,31,29,20,3,6,0,1
E33027535,431,330,142,188,2,37,19,18,49,38,8,2,1,13
E33027536,305,237,82,155,0,31,13,18,35,34,0,1,0,2
E33027537,338,228,71,157,1,28,9,19,75,68,6,0,1,6
E33027538,297,272,98,174,1,4,0,4,20,19,0,1,0,0
E33027539,763,572,185,387,3,38,11,27,112,84,19,5,4,38
E33027540,320,278,103,175,1,9,4,5,29,27,0,1,1,3
E33027541,273,219,76,143,1,19,6,13,31,27,1,1,2,3
E33027542,326,267,72,195,0,15,5,10,36,31,2,2,1,8
E33027543,297,232,92,140,0,28,10,18,31,30,1,0,0,6
E33027544,414,296,89,207,6,31,16,15,75,71,1,3,0,6
E33027545,264,207,59,148,1,14,7,7,37,37,0,0,0,5
E33027546,240,198,65,133,0,10,4,6,31,29,0,2,0,1
E33027547,380,322,75,247,2,17,7,10,35,32,1,2,0,4
E33027548,242,184,45,139,1,21,7,14,35,33,0,2,0,1
E33027549,259,202,64,138,0,14,5,9,39,36,0,2,1,4
E33027550,332,261,81,180,0,27,8,19,41,35,0,4,2,3
E33027551,268,183,45,138,6,48,19,29,28,25,2,1,0,3
E33027552,308,263,76,187,0,21,6,15,22,22,0,0,0,2
E33027553,331,236,90,146,0,36,14,22,55,50,2,3,0,4
E33027554,282,207,63,144,0,24,11,13,48,40,1,5,2,3
E33027555,304,237,55,182,1,32,12,20,34,29,1,4,0,0
E33027556,483,368,111,257,4,30,12,18,79,72,0,7,0,2
E33027557,378,233,59,174,5,82,33,49,57,46,5,6,0,1
E33027558,623,470,122,348,10,92,30,62,48,42,0,6,0,3
E33027559,297,183,43,140,0,61,22,39,52,52,0,0,0,1
E33027560,457,335,82,253,1,63,22,41,53,47,3,3,0,5
E33027561,298,225,73,152,1,10,5,5,59,53,1,5,0,3
E33027562,337,230,49,181,6,57,15,42,39,38,0,1,0,5
E33027563,428,316,94,222,2,48,18,30,60,54,1,4,1,2
E33027564,317,253,90,163,3,25,9,16,34,33,0,1,0,2
E33027565,440,307,95,212,3,68,23,45,61,59,0,2,0,1
E33027566,500,309,111,198,2,41,25,16,142,93,32,2,15,6
E33027567,350,243,100,143,2,30,19,11,60,47,7,4,2,15
E33027568,332,290,113,177,0,8,3,5,33,25,6,0,2,1
E33027569,493,341,60,281,6,91,44,47,55,50,1,1,3,0
E33027570,607,347,84,263,8,158,65,93,89,79,0,9,1,5
E33027571,341,185,46,139,8,91,45,46,53,49,0,2,2,4
E33027572,338,228,45,183,2,64,18,46,41,39,0,2,0,3
E33027573,314,235,58,177,2,23,12,11,52,50,0,1,1,2
E33027574,422,276,74,202,5,60,20,40,76,67,0,9,0,5
E33027575,507,333,70,263,12,107,38,69,53,47,0,3,3,2
E33027576,508,407,101,306,2,29,7,22,70,60,6,2,2,0
E33027577,308,206,57,149,5,36,14,22,57,53,1,3,0,4
E33027578,385,239,51,188,3,86,21,65,53,38,8,5,2,4
E33027579,613,332,81,251,3,139,52,87,135,130,1,3,1,4
E33027580,692,417,123,294,9,171,67,104,89,84,0,4,1,6
E33027581,490,370,103,267,7,46,20,26,65,58,1,6,0,2
E33027582,395,248,59,189,7,86,28,58,53,51,0,2,0,1
E33027583,1192,819,169,650,11,132,42,90,220,211,0,9,0,10
E33027584,387,267,66,201,1,46,20,26,69,66,0,2,1,4
E33027585,340,299,98,201,2,8,2,6,26,25,0,1,0,5
E33027586,812,490,82,408,14,52,18,34,251,236,4,10,1,5
E33027587,914,581,145,436,4,194,75,119,128,124,0,4,0,7
E33027588,595,428,122,306,10,74,30,44,78,73,2,3,0,5
E33027589,345,240,62,178,3,34,15,19,66,62,1,3,0,2
E33027590,499,340,95,245,2,52,28,24,98,86,2,7,3,7
E33027591,659,404,92,312,3,76,32,44,165,156,2,7,0,11
E33027592,381,243,55,188,2,44,17,27,92,87,2,1,2,0
E33027593,426,291,83,208,4,59,24,35,71,63,2,3,3,1
E33027594,344,216,52,164,5,28,12,16,93,83,4,5,1,2
E33027595,359,217,69,148,0,42,15,27,99,91,3,5,0,1
E33027596,459,354,91,263,3,35,10,25,66,65,0,0,1,1
E33027597,294,190,56,134,4,27,8,19,72,66,0,3,3,1
E33027598,260,182,60,122,2,18,6,12,55,54,0,1,0,3
E33027599,270,167,55,112,7,32,11,21,59,56,2,1,0,5
E33027600,255,224,83,141,0,2,1,1,28,22,2,0,4,1
E33027601,312,264,79,185,1,14,6,8,28,25,1,2,0,5
E33027602,446,272,68,204,12,49,17,32,113,112,0,0,1,0
E33027603,445,338,112,226,4,40,21,19,58,46,8,3,1,5
E33027604,461,352,112,240,4,40,23,17,62,58,4,0,0,3
E33027605,270,190,51,139,2,33,14,19,44,41,1,2,0,1
E33027606,566,337,102,235,6,108,35,73,109,101,1,2,5,6
E33027607,364,226,77,149,4,32,14,18,98,96,1,1,0,4
E33027608,334,161,50,111,1,53,11,42,114,110,1,2,1,5
E33027609,364,262,64,198,3,15,6,9,83,73,7,2,1,1
E33027610,339,264,79,185,4,22,7,15,48,45,2,1,0,1
E33027611,1651,998,233,765,19,231,124,107,395,380,0,14,1,8
E33027612,517,366,130,236,3,59,18,41,88,87,0,1,0,1
E33027613,340,202,55,147,4,18,6,12,103,100,0,3,0,13
E33027614,349,242,65,177,1,44,15,29,60,56,0,4,0,2
E33027615,497,313,82,231,5,31,14,17,146,139,3,4,0,2
E33027616,311,175,54,121,1,34,7,27,98,92,2,4,0,3
E33027617,381,193,60,133,5,39,10,29,143,140,0,3,0,1
E33027618,476,269,67,202,2,49,19,30,155,150,0,4,1,1
E33027619,637,359,103,256,15,151,36,115,109,98,5,5,1,3
E33027620,313,245,69,176,0,21,10,11,47,44,0,2,1,0
E33027621,373,264,67,197,3,47,13,34,53,50,0,2,1,6
E33027622,465,362,93,269,3,29,12,17,62,59,0,3,0,9
E33027623,283,176,43,133,1,62,26,36,42,41,1,0,0,2
E33027624,638,493,158,335,3,61,41,20,71,65,2,2,2,10
E33027625,509,433,155,278,4,27,15,12,35,34,0,1,0,10
E33027626,288,222,69,153,2,33,26,7,27,22,4,1,0,4
E33027627,302,223,71,152,2,56,41,15,21,20,0,1,0,0
E33027628,258,203,65,138,2,35,27,8,15,15,0,0,0,3
E33027629,568,390,87,303,7,66,36,30,100,89,8,1,2,5
E33027630,502,374,91,283,4,55,34,21,62,51,4,6,1,7
E33027631,277,204,86,118,2,35,22,13,36,32,2,2,0,0
E33027632,269,170,42,128,0,46,36,10,47,46,0,1,0,6
E33027633,473,352,112,240,9,75,59,16,35,29,1,5,0,2
E33027634,502,343,117,226,3,110,92,18,39,38,0,1,0,7
E33027635,559,347,80,267,8,126,97,29,75,69,0,6,0,3
E33027636,381,236,43,193,3,86,69,17,55,50,1,3,1,1
E33027637,441,320,92,228,2,53,37,16,65,64,0,1,0,1
E33027638,575,371,101,270,6,144,76,68,54,53,1,0,0,0
E33027639,526,390,125,265,7,85,72,13,42,41,0,1,0,2
E33027640,378,279,70,209,2,52,40,12,41,39,0,1,1,4
E33027641,359,263,79,184,2,64,41,23,29,28,0,1,0,1
E33027642,612,294,64,230,7,252,195,57,54,50,0,2,2,5
E33027643,976,642,149,493,20,152,116,36,161,151,0,8,2,1
E33027644,361,227,51,176,6,94,77,17,33,32,0,1,0,1
E33027645,2304,1404,378,1026,27,543,312,231,323,292,15,9,7,7
E33027646,244,189,51,138,5,40,33,7,10,9,0,0,1,0
E33027647,311,187,37,150,1,104,80,24,19,18,0,1,0,0
E33027648,511,256,67,189,5,194,124,70,52,47,4,1,0,4
E33027649,341,186,39,147,6,114,94,20,33,29,1,2,1,2
E33027650,602,382,98,284,7,133,102,31,78,74,0,3,1,2
E33027651,362,199,39,160,3,87,63,24,65,60,0,3,2,8
E33027652,440,294,61,233,6,92,73,19,47,43,0,4,0,1
E33027653,268,116,14,102,8,61,22,39,81,78,0,2,1,2
E33027654,288,184,50,134,2,57,45,12,43,41,1,0,1,2
E33027655,246,160,49,111,2,54,41,13,29,26,1,2,0,1
E33027656,337,217,54,163,2,41,28,13,77,76,0,1,0,0
E33027657,306,158,38,120,1,97,85,12,48,40,6,0,2,2
E33027658,349,190,58,132,6,75,60,15,76,70,3,2,1,2
E33027659,307,177,49,128,13,66,55,11,50,48,1,1,0,1
E33027660,477,331,109,222,2,68,53,15,68,65,1,1,1,8
E33027661,653,382,101,281,9,134,79,55,122,110,2,4,6,6
E33027662,236,187,50,137,2,13,5,8,33,32,1,0,0,1
E33027663,421,289,78,211,3,40,30,10,70,61,5,3,1,19
E33027664,691,348,89,259,8,200,127,73,133,119,8,5,1,2
E33027665,277,181,57,124,1,51,45,6,39,38,1,0,0,5
E33027666,350,143,33,110,5,107,91,16,93,85,3,5,0,2
E33027667,532,269,75,194,6,146,96,50,107,102,0,3,2,4
E33027668,711,353,108,245,15,138,106,32,199,193,1,4,1,6
E33027669,293,182,61,121,2,45,41,4,52,47,3,2,0,12
E33027670,373,260,83,177,4,45,34,11,60,59,0,1,0,4
E33027671,815,542,156,386,8,51,33,18,195,173,9,5,8,19
E33027672,433,317,90,227,4,57,37,20,55,52,1,1,1,0
E33027673,254,202,50,152,1,17,6,11,32,28,0,3,1,2
E33027674,786,610,200,410,5,46,32,14,102,75,22,4,1,23
E33027675,257,174,66,108,1,26,18,8,46,39,2,0,5,10
E33027676,274,241,89,152,1,17,14,3,13,11,0,1,1,2
E33027677,259,198,80,118,1,19,12,7,36,34,0,0,2,5
E33027678,370,335,139,196,0,3,2,1,30,27,0,3,0,2
E33027679,346,284,107,177,5,27,12,15,27,25,1,1,0,3
E33027680,239,190,71,119,1,16,11,5,25,20,0,2,3,7
E33027681,520,362,148,214,4,48,4,44,95,91,3,0,1,11
E33027682,265,183,75,108,0,13,2,11,62,57,0,5,0,7
E33027683,385,282,118,164,2,32,3,29,56,46,4,5,1,13
E33027684,566,302,84,218,3,60,15,45,196,82,69,4,41,5
E33027685,327,231,86,145,0,41,3,38,51,44,2,5,0,4
E33027686,239,178,79,99,1,20,3,17,35,30,2,1,2,5
E33027687,312,202,86,116,1,33,15,18,64,50,9,5,0,12
E33027688,385,308,105,203,0,20,4,16,53,51,0,2,0,4
E33027689,272,205,86,119,2,19,6,13,40,36,1,3,0,6
E33027690,271,219,90,129,0,20,4,16,29,21,6,2,0,3
E33027691,382,255,99,156,1,32,7,25,66,60,3,2,1,28
E33027692,377,277,123,154,0,27,6,21,61,35,17,6,3,12
E33027693,354,250,93,157,0,37,9,28,63,52,10,1,0,4
E33027694,438,313,119,194,2,41,7,34,79,65,4,10,0,3
E33027695,381,277,88,189,1,38,6,32,59,51,5,2,1,6
E33027696,224,164,46,118,0,15,1,14,42,39,1,2,0,3
E33027697,299,208,72,136,5,21,3,18,61,53,7,1,0,4
E33027698,393,318,98,220,5,21,7,14,48,45,1,2,0,1
E33027699,288,225,96,129,3,16,4,12,42,36,1,5,0,2
E33027700,634,468,137,331,3,55,10,45,100,84,8,8,0,8
E33027701,471,348,143,205,2,40,8,32,61,53,3,5,0,20
E33027702,1303,937,329,608,12,145,38,107,204,189,5,9,1,5
E33027703,349,263,77,186,4,15,8,7,64,55,0,9,0,3
E33027704,1020,694,196,498,8,120,34,86,189,175,3,11,0,9
E33027705,388,256,68,188,4,61,14,47,64,59,3,2,0,3
E33027706,805,481,146,335,7,71,19,52,239,223,1,8,7,7
E33027707,618,454,146,308,6,49,8,41,108,88,3,13,4,1
E33027708,338,276,108,168,1,12,4,8,40,39,0,1,0,9
E33027709,311,252,90,162,2,22,2,20,34,30,1,3,0,1
E33027710,463,371,175,196,0,34,13,21,48,36,4,8,0,10
E33027711,403,286,85,201,0,45,15,30,66,53,6,6,1,6
E33027712,238,170,57,113,2,28,6,22,38,36,2,0,0,0
E33027713,367,218,83,135,1,47,12,35,96,85,9,1,1,5
E33027714,307,198,59,139,1,37,4,33,67,63,0,3,1,4
E33027715,223,159,47,112,0,30,13,17,31,24,4,3,0,3
E33027716,235,160,53,107,0,31,6,25,33,29,4,0,0,11
E33027717,315,219,63,156,2,31,5,26,62,55,2,4,1,1
E33027718,249,202,75,127,0,15,5,10,30,28,0,2,0,2
E33027719,331,237,90,147,2,31,2,29,55,48,2,5,0,6
E33027720,358,265,121,144,2,32,2,30,47,40,5,1,1,12
E33027721,380,285,135,150,3,41,2,39,43,37,3,3,0,8
E33027722,393,287,84,203,1,30,6,24,67,59,2,4,2,8
E33027723,305,239,77,162,0,21,9,12,41,36,3,2,0,4
E33027724,273,169,61,108,1,25,2,23,73,60,1,10,2,5
E33027725,296,215,83,132,0,19,2,17,61,52,1,7,1,1
E33027726,612,273,82,191,6,74,23,51,256,239,9,4,4,3
E33027727,422,290,90,200,4,22,6,16,103,93,5,5,0,3
E33027728,366,277,106,171,0,20,6,14,53,46,3,4,0,16
E33027729,408,287,110,177,6,31,11,20,78,69,1,5,3,6
E33027730,402,296,128,168,2,23,3,20,60,55,1,3,1,21
E33027731,406,292,88,204,4,38,4,34,67,60,1,5,1,5
E33027732,374,233,80,153,2,43,13,30,93,89,0,2,2,3
E33027733,415,306,84,222,6,25,5,20,69,55,3,7,4,9
E33027734,624,477,155,322,7,58,20,38,79,70,1,7,1,3
E33027735,280,220,63,157,1,16,7,9,42,35,0,7,0,1
E33027736,524,400,120,280,5,28,8,20,78,66,3,7,2,13
E33027737,373,271,80,191,8,19,10,9,66,60,3,3,0,9
E33027738,740,564,184,380,3,53,11,42,109,99,3,7,0,11
E33027739,449,321,110,211,4,42,7,35,77,70,0,7,0,5
E33027740,291,187,84,103,0,21,6,15,60,53,6,1,0,23
E33027741,344,241,98,143,3,31,9,22,65,53,1,7,4,4
E33027742,786,544,171,373,4,74,13,61,141,124,7,10,0,23
E33027743,304,210,75,135,5,26,1,25,58,44,8,4,2,5
E33027744,574,438,151,287,8,31,6,25,91,81,3,4,3,6
E33027745,411,334,119,215,2,16,2,14,52,41,1,7,3,7
E33027746,447,289,73,216,6,45,18,27,99,75,16,8,0,8
E33027747,301,213,81,132,1,22,5,17,63,60,1,2,0,2
E33027748,468,352,131,221,0,37,10,27,72,69,2,1,0,7
E33027749,318,253,120,133,1,16,2,14,41,38,1,2,0,7
E33027750,426,295,118,177,5,35,15,20,81,75,2,4,0,10
E33027751,629,416,142,274,13,39,10,29,104,85,12,6,1,57
E33027752,367,263,115,148,2,32,8,24,59,46,6,6,1,11
E33027753,604,447,143,304,3,46,12,34,102,93,4,5,0,6
E33027754,266,166,41,125,3,55,10,45,38,33,0,3,2,4
E33027755,359,254,43,211,0,38,7,31,66,54,0,9,3,1
E33027756,515,298,77,221,5,69,18,51,137,117,5,11,4,6
E33027757,609,436,128,308,8,58,17,41,97,87,2,6,2,10
E33027758,2150,1425,355,1070,20,230,64,166,460,421,6,31,2,15
E33027759,373,262,50,212,4,9,5,4,93,88,2,3,0,5
E33027760,259,203,49,154,8,12,1,11,32,27,4,0,1,4
E33027761,392,319,84,235,5,16,5,11,49,42,2,2,3,3
E33027762,352,233,58,175,1,38,11,27,71,66,1,2,2,9
E33027763,673,434,138,296,8,92,23,69,135,119,1,12,3,4
E33027764,255,191,54,137,1,22,3,19,40,38,0,2,0,1
E33027765,297,169,47,122,1,62,10,52,63,57,3,3,0,2
E33027766,506,321,77,244,7,82,15,67,92,81,3,6,2,4
E33027767,285,203,55,148,3,20,5,15,53,42,4,6,1,6
E33027768,702,514,194,320,3,50,17,33,127,104,9,11,3,8
E33027769,321,250,96,154,1,25,0,25,43,39,1,3,0,2
E33027770,501,310,81,229,5,50,15,35,127,119,2,6,0,9
E33027771,300,213,81,132,3,30,4,26,52,43,4,5,0,2
E33027772,798,608,228,380,3,72,18,54,106,98,2,5,1,9
E33027773,294,218,98,120,2,30,2,28,39,32,1,3,3,5
E33027774,348,240,89,151,4,37,9,28,65,56,2,5,2,2
E33027775,286,229,100,129,0,19,2,17,31,30,1,0,0,7
E33027776,486,372,127,245,4,31,4,27,72,69,2,1,0,7
E33027777,446,333,117,216,4,29,14,15,75,68,4,2,1,5
E33027778,274,209,80,129,2,20,5,15,39,34,1,4,0,4
E33027779,259,210,96,114,1,22,6,16,22,18,3,1,0,4
E33027780,251,164,72,92,2,20,5,15,48,31,14,1,2,17
E33027781,388,277,101,176,3,54,20,34,48,45,1,2,0,6
E33027782,253,199,73,126,0,22,6,16,28,24,1,3,0,4
E33027783,537,407,174,233,4,41,13,28,81,65,1,7,8,4
E33027784,462,304,113,191,6,52,14,38,91,76,10,5,0,9
E33027785,451,332,126,206,0,39,4,35,69,67,0,2,0,11
E33027786,362,256,89,167,2,38,15,23,58,52,2,3,1,8
E33027787,307,228,80,148,3,41,13,28,31,29,0,2,0,4
E33027788,433,353,119,234,4,29,8,21,44,39,0,5,0,3
E33027789,312,229,99,130,5,23,4,19,48,34,5,3,6,7
E33027790,332,249,65,184,4,33,12,21,43,39,0,4,0,3
E33027791,591,431,163,268,3,64,28,36,89,81,2,6,0,4
E33027792,644,459,161,298,5,95,33,62,78,65,0,12,1,7
E33027793,542,448,169,279,5,27,13,14,56,52,0,4,0,6
E33027794,269,224,77,147,1,16,6,10,28,25,0,3,0,0
E33027795,266,210,52,158,3,15,9,6,36,33,0,3,0,2
E33027796,780,569,156,413,7,60,9,51,136,125,1,8,2,8
E33027797,249,164,53,111,5,28,11,17,51,46,3,2,0,1
E33027798,260,236,70,166,0,7,1,6,14,14,0,0,0,3
E33027799,316,254,55,199,5,20,2,18,36,34,0,2,0,1
E33027800,519,380,124,256,6,47,20,27,83,74,1,6,2,3
E33027801,527,416,141,275,4,41,15,26,65,63,1,1,0,1
E33027802,301,184,73,111,0,28,5,23,85,77,1,6,1,4
E33027803,256,214,74,140,0,11,7,4,24,21,0,3,0,7
E33027804,364,288,76,212,5,40,19,21,29,24,0,5,0,2
E33027805,403,306,81,225,9,35,11,24,52,47,0,5,0,1
E33027806,248,188,87,101,3,17,5,12,37,35,1,1,0,3
E33027807,261,215,83,132,3,18,3,15,23,19,0,4,0,2
E33027808,354,278,98,180,2,22,9,13,50,45,1,4,0,2
E33027809,448,370,102,268,3,26,15,11,45,42,1,2,0,4
E33027810,291,237,83,154,5,21,3,18,28,23,3,1,1,0
E33027811,319,217,70,147,0,57,18,39,43,38,0,3,2,2
E33027812,373,282,104,178,1,45,20,25,42,37,1,4,0,3
E33027813,334,263,90,173,1,27,11,16,41,32,1,6,2,2
E33027814,694,522,129,393,11,59,31,28,101,94,0,6,1,1
E33027815,256,206,67,139,0,22,8,14,28,24,0,4,0,0
E33027816,345,277,89,188,5,25,16,9,34,28,0,6,0,4
E33027817,363,292,76,216,3,25,12,13,42,41,0,1,0,1
E33027818,264,216,79,137,2,16,12,4,28,23,4,1,0,2
E33027819,442,302,89,213,1,69,47,22,68,61,0,7,0,2
E33027820,1059,678,199,479,9,231,162,69,133,115,3,14,1,8
E33027821,345,286,105,181,1,25,5,20,30,28,0,2,0,3
E33027822,493,365,117,248,2,58,27,31,66,62,0,4,0,2
E33027823,399,281,103,178,3,57,27,30,55,50,2,2,1,3
E33027824,572,491,178,313,3,21,9,12,51,44,0,7,0,6
E33027825,626,459,152,307,10,76,39,37,77,66,4,7,0,4
E33027826,309,226,80,146,1,37,18,19,40,38,1,1,0,5
E33027827,516,411,145,266,2,36,13,23,57,50,0,5,2,10
E33027828,292,250,82,168,3,11,3,8,27,25,0,2,0,1
E33027829,242,158,48,110,0,16,4,12,58,41,13,2,2,10
E33027830,302,243,89,154,2,31,3,28,21,15,2,4,0,5
E33027831,266,208,76,132,1,29,15,14,22,20,0,1,1,6
E33027832,355,279,81,198,1,37,13,24,36,31,0,5,0,2
E33027833,419,347,99,248,3,21,3,18,48,48,0,0,0,0
E33027834,551,456,144,312,1,31,8,23,56,45,5,6,0,7
E33027835,406,317,70,247,7,19,6,13,63,56,0,7,0,0
E33027836,782,562,171,391,3,97,40,57,118,110,1,7,0,2
E33027837,541,410,146,264,3,38,20,18,86,78,1,6,1,4
E33027838,285,209,55,154,2,28,11,17,43,40,0,3,0,3
E33027839,392,291,108,183,3,35,16,19,60,56,2,2,0,3
E33027840,403,305,115,190,1,43,12,31,54,52,0,2,0,0
E33027841,325,242,89,153,2,19,1,18,59,58,0,0,1,3
E33027842,357,280,111,169,1,21,2,19,50,37,3,9,1,5
E33027843,236,175,62,113,7,16,7,9,36,33,2,1,0,2
E33027844,339,246,81,165,3,43,18,25,45,34,0,11,0,2
E33027845,343,250,93,157,1,34,8,26,51,40,4,6,1,7
E33027846,251,202,84,118,3,13,8,5,29,26,1,2,0,4
E33027847,295,205,83,122,1,25,8,17,59,52,1,4,2,5
E33027848,399,305,120,185,3,24,6,18,63,56,0,7,0,4
E33027849,385,338,124,214,0,12,11,1,30,22,4,4,0,5
E33027850,305,236,119,117,3,19,18,1,38,33,2,2,1,9
E33027851,312,258,110,148,0,15,8,7,36,30,1,3,2,3
E33027852,305,265,102,163,1,8,6,2,28,23,2,3,0,3
E33027853,360,253,98,155,3,19,15,4,78,70,3,5,0,7
E33027854,311,235,95,140,2,20,15,5,52,37,10,5,0,2
E33027855,361,299,132,167,1,20,14,6,35,32,1,2,0,6
E33027856,358,270,98,172,2,24,13,11,51,42,3,6,0,11
E33027857,315,238,102,136,1,13,12,1,41,31,4,2,4,22
E33027858,557,446,156,290,2,34,27,7,72,62,1,7,2,3
E33027859,337,254,92,162,1,7,5,2,67,55,0,9,3,8
E33027860,261,204,82,122,1,21,17,4,33,29,4,0,0,2
E33027861,300,231,70,161,0,17,12,5,49,46,2,1,0,3
E33027862,318,204,64,140,2,43,33,10,67,61,2,4,0,2
E33027863,396,309,110,199,2,21,10,11,58,52,1,5,0,6
E33027864,376,304,115,189,1,29,25,4,38,30,1,7,0,4
E33027865,355,256,87,169,2,31,24,7,63,61,0,2,0,3
E33027866,328,248,74,174,1,28,22,6,47,45,0,2,0,4
E33027867,273,210,75,135,1,25,21,4,35,33,0,2,0,2
E33027868,383,245,93,152,6,65,60,5,62,54,1,4,3,5
E33027869,628,468,132,336,4,50,34,16,103,85,9,7,2,3
E33027870,561,347,125,222,6,87,63,24,117,110,1,5,1,4
E33027871,489,312,88,224,1,64,49,15,109,95,2,8,4,3
E33027872,372,279,94,185,2,32,26,6,58,55,0,2,1,1
E33027873,279,208,75,133,0,15,11,4,55,47,2,6,0,1
E33027874,264,152,45,107,1,32,24,8,75,72,1,1,1,4
E33027875,393,248,98,150,1,59,51,8,83,75,2,5,1,2
E33027876,349,235,76,159,3,34,24,10,75,65,2,8,0,2
E33027877,303,177,66,111,7,41,26,15,74,61,4,7,2,4
E33027878,301,196,61,135,0,61,56,5,43,41,0,2,0,1
E33027879,434,258,95,163,0,79,48,31,94,86,4,4,0,3
E33027880,368,217,105,112,0,43,27,16,98,88,2,7,1,10
E33027881,294,142,50,92,3,37,27,10,111,107,0,2,2,1
E33027882,252,170,54,116,0,29,23,6,50,45,0,4,1,3
E33027883,241,154,55,99,0,32,30,2,53,42,0,11,0,2
E33027884,258,149,45,104,0,46,31,15,61,59,2,0,0,2
E33027885,604,428,129,299,3,64,41,23,107,103,2,2,0,2
E33027886,1175,805,237,568,4,143,104,39,215,201,1,12,1,8
E33027887,431,307,103,204,4,44,30,14,69,63,1,4,1,7
E33027888,983,751,250,501,1,80,58,22,145,126,2,14,3,6
E33027889,386,341,109,232,3,15,10,5,21,16,1,4,0,6
E33027890,370,276,94,182,1,31,28,3,58,53,1,4,0,4
E33027891,312,246,79,167,0,17,15,2,48,45,0,3,0,1
E33027892,434,264,69,195,0,106,101,5,62,58,0,4,0,2
E33027893,309,207,66,141,0,46,34,12,55,47,0,8,0,1
E33027894,438,331,90,241,2,49,40,9,53,45,1,7,0,3
E33027895,470,339,82,257,0,18,11,7,106,99,3,4,0,7
E33027896,264,203,66,137,1,6,3,3,51,50,0,1,0,3
E33027897,458,360,112,248,1,32,26,6,64,59,1,4,0,1
E33027898,265,195,57,138,0,21,12,9,46,38,0,7,1,3
E33027899,314,210,82,128,1,22,20,2,80,54,1,4,21,1
E33027900,423,344,126,218,0,23,17,6,55,47,2,6,0,1
E33027901,3603,2790,778,2012,7,260,165,95,530,431,24,44,31,16
E33027902,328,223,66,157,5,56,49,7,39,30,5,4,0,5
E33027903,292,192,54,138,0,56,48,8,43,36,5,1,1,1
E33027904,298,232,99,133,0,23,18,5,38,33,0,4,1,5
E33027905,284,241,64,177,1,9,8,1,33,30,0,0,3,0
E33027906,254,170,60,110,2,32,28,4,43,41,1,1,0,7
E33027907,383,279,116,163,2,31,19,12,64,55,2,4,3,7
E33027908,308,239,80,159,0,26,13,13,40,38,2,0,0,3
E33027909,279,236,81,155,0,14,5,9,25,23,0,0,2,4
E33027910,890,636,213,423,3,80,51,29,160,120,17,19,4,11
E33027911,290,186,78,108,3,36,7,29,55,50,0,4,1,10
E33027912,495,318,119,199,5,35,7,28,130,116,3,11,0,7
E33027913,314,221,90,131,3,22,3,19,62,59,1,2,0,6
E33027914,246,186,81,105,2,19,2,17,36,30,3,2,1,3
E33027915,436,286,117,169,3,23,6,17,113,98,11,4,0,11
E33027916,392,275,112,163,3,17,2,15,89,74,6,4,5,8
E33027917,382,248,98,150,2,43,8,35,76,73,1,2,0,13
E33027918,376,248,103,145,0,24,2,22,75,59,10,4,2,29
E33027919,288,201,90,111,2,19,8,11,53,49,2,0,2,13
E33027920,285,163,63,100,1,45,9,36,69,59,3,4,3,7
E33027921,541,356,164,192,1,57,15,42,113,94,2,13,4,14
E33027922,452,293,159,134,6,41,9,32,91,73,12,5,1,21
E33027923,259,155,66,89,2,17,3,14,72,59,5,4,4,13
E33027924,293,200,89,111,2,37,15,22,51,47,2,2,0,3
E33027925,439,351,149,202,2,25,5,20,54,50,0,4,0,7
E33027926,482,344,153,191,3,39,9,30,89,86,0,2,1,7
E33027927,380,278,121,157,2,19,2,17,74,66,3,5,0,7
E33027928,443,330,144,186,5,27,3,24,71,62,1,4,4,10
E33027929,432,325,112,213,6,21,2,19,73,69,0,4,0,7
E33027930,554,327,129,198,6,23,4,19,112,95,10,4,3,86
E33027931,331,257,119,138,2,14,6,8,54,47,3,4,0,4
E33027932,374,280,132,148,3,28,8,20,50,37,9,3,1,13
E33027933,218,160,57,103,0,19,7,12,33,31,0,0,2,6
E33027934,509,416,153,263,2,28,2,26,62,54,3,2,3,1
E33027935,356,290,111,179,0,18,5,13,40,37,1,0,2,8
E33027936,256,218,78,140,2,7,1,6,27,26,0,1,0,2
E33027937,428,295,93,202,4,49,4,45,78,74,2,1,1,2
E33027938,290,228,56,172,6,10,2,8,43,31,4,8,0,3
E33027939,326,264,82,182,2,16,3,13,42,36,1,5,0,2
E33027940,1036,655,172,483,5,167,49,118,197,173,3,14,7,12
E33027941,265,218,73,145,0,15,4,11,26,23,1,0,2,6
E33027942,321,262,84,178,0,24,6,18,32,27,3,2,0,3
E33027943,345,276,103,173,3,21,7,14,38,36,1,1,0,7
E33027944,300,221,80,141,3,19,6,13,54,39,10,1,4,3
E33027945,368,298,100,198,2,20,4,16,45,40,3,1,1,3
E33027946,606,414,123,291,1,68,23,45,116,104,2,7,3,7
E33027947,760,586,176,410,6,36,10,26,125,109,0,14,2,7
E33027948,837,644,186,458,7,58,15,43,121,96,4,17,4,7
E33027949,375,132,25,107,21,70,23,47,143,139,2,2,0,9
E33027950,330,222,54,168,1,48,9,39,57,53,1,3,0,2
E33027951,410,323,84,239,1,22,6,16,60,54,4,1,1,4
E33027952,273,185,64,121,3,22,2,20,61,55,2,2,2,2
E33027953,493,350,120,230,6,59,22,37,77,69,1,6,1,1
E33027954,393,284,87,197,0,35,13,22,74,64,1,7,2,0
E33027955,279,177,67,110,2,37,18,19,61,56,1,2,2,2
E33027956,335,196,67,129,4,34,10,24,94,89,0,3,2,7
E33027957,415,316,90,226,3,33,10,23,63,55,2,5,1,0
E33027958,642,414,125,289,2,83,25,58,138,124,3,10,1,5
E33027959,402,304,88,216,4,41,7,34,48,42,3,3,0,5
E33027960,291,176,71,105,2,21,4,17,64,54,6,4,0,28
E33027961,903,663,209,454,7,57,17,40,162,128,13,14,7,14
E33027962,241,186,75,111,2,16,6,10,35,31,3,1,0,2
E33027963,403,332,132,200,5,20,0,20,39,34,2,3,0,7
E33027964,387,308,122,186,5,24,6,18,40,36,0,3,1,10
E33027965,485,408,141,267,3,15,8,7,53,44,2,6,1,6
E33027966,447,366,131,235,1,26,8,18,51,37,6,7,1,3
E33027967,432,360,129,231,1,25,8,17,42,37,1,3,1,4
E33027968,313,224,79,145,6,28,2,26,47,44,0,3,0,8
E33027969,266,214,79,135,0,14,4,10,34,31,1,2,0,4
E33027970,325,203,61,142,0,20,6,14,98,93,0,5,0,4
E33027971,568,423,125,298,3,32,6,26,102,91,2,8,1,8
E33027972,425,252,85,167,1,23,3,20,138,61,41,4,32,11
E33027973,3526,2269,422,1847,22,187,40,147,1035,433,382,23,197,13
E33027974,312,233,78,155,0,28,10,18,49,40,2,5,2,2
E33027975,241,175,76,99,0,9,5,4,53,44,5,1,3,4
E33027976,333,272,98,174,1,15,4,11,44,41,0,2,1,1
E33027977,385,261,88,173,3,33,5,28,85,78,5,1,1,3
E33027978,402,331,113,218,2,22,4,18,42,37,2,2,1,5
E33027979,269,213,87,126,1,15,5,10,34,28,1,2,3,6
E33027980,401,325,115,210,1,19,5,14,49,42,1,6,0,7
E33027981,272,226,81,145,3,12,1,11,26,20,4,1,1,5
E33027982,277,205,79,126,0,21,11,10,44,33,4,2,5,7
E33027983,347,272,91,181,0,15,3,12,53,43,0,10,0,7
E33027984,251,200,69,131,1,13,2,11,28,22,2,4,0,9
E33027985,286,233,82,151,2,18,8,10,32,26,1,5,0,1
E33027986,260,190,60,130,1,20,2,18,44,39,0,4,1,5
E33027987,306,228,89,139,3,30,10,20,35,32,2,1,0,10
E33027988,270,184,66,118,0,33,8,25,50,41,1,7,1,3
E33027989,448,364,138,226,0,26,6,20,51,47,1,2,1,7
E33027990,287,213,69,144,3,23,4,19,47,41,4,2,0,1
E33027991,482,353,109,244,5,33,13,20,88,82,2,3,1,3
E33027992,521,423,123,300,1,26,5,21,66,60,3,2,1,5
E33027993,340,271,100,171,2,22,5,17,42,40,1,1,0,3
E33027994,405,290,117,173,0,35,8,27,73,62,5,4,2,7
E33027995,352,259,101,158,1,22,6,16,65,58,0,5,2,5
E33027996,254,199,96,103,0,14,7,7,36,29,3,2,2,5
E33027997,608,449,171,278,7,39,9,30,99,82,6,7,4,14
E33027998,600,458,174,284,4,35,16,19,88,72,9,5,2,15
E33027999,371,254,103,151,2,23,7,16,74,53,10,8,3,18
E33028000,311,248,92,156,1,22,3,19,33,26,1,6,0,7
E33028001,268,211,84,127,1,13,7,6,39,32,1,4,2,4
E33028002,510,325,107,218,3,25,7,18,140,113,11,6,10,17
E33028003,369,263,110,153,1,30,11,19,53,31,15,4,3,22
E33028004,290,222,70,152,0,21,6,15,43,41,2,0,0,4
E33028005,733,501,136,365,4,59,24,35,159,134,11,10,4,10
E33028006,311,229,90,139,1,22,5,17,52,40,6,6,0,7
E33028007,594,447,130,317,1,33,6,27,108,101,3,4,0,5
E33028008,334,241,107,134,0,27,11,16,62,50,3,9,0,4
E33028009,327,222,103,119,1,28,4,24,74,67,1,6,0,2
E33028010,387,275,86,189,1,35,7,28,72,64,0,8,0,4
E33028011,255,175,64,111,0,31,5,26,47,43,1,3,0,2
E33028012,255,186,89,97,1,23,10,13,42,33,1,7,1,3
E33028013,429,288,100,188,4,38,10,28,89,78,2,9,0,10
E33028014,594,388,159,229,4,43,8,35,139,124,4,11,0,20
E33028015,346,213,101,112,2,26,6,20,91,75,7,7,2,14
E33028016,447,260,137,123,2,71,16,55,102,87,6,6,3,12
E33028017,294,193,78,115,0,35,8,27,58,42,14,2,0,8
E33028018,365,234,121,113,0,42,12,30,65,56,4,4,1,24
E33028019,299,141,69,72,1,31,5,26,94,75,15,2,2,32
E33028020,266,144,62,82,1,53,14,39,55,50,2,3,0,13
E33028021,396,233,117,116,0,76,14,62,73,64,3,6,0,14
E33028022,456,342,151,191,1,29,5,24,81,77,0,4,0,3
E33028023,310,159,61,98,4,43,6,37,100,95,2,3,0,4
E33028024,340,265,117,148,3,32,9,23,37,29,1,7,0,3
E33028025,256,155,71,84,5,28,5,23,64,60,1,3,0,4
E33028026,693,426,172,254,3,82,16,66,170,152,2,16,0,12
E33028027,271,200,76,124,0,15,2,13,51,43,3,5,0,5
E33028028,514,272,115,157,3,65,22,43,171,167,0,1,3,3
E33028029,235,164,62,102,0,24,6,18,45,41,0,4,0,2
E33028030,250,168,98,70,3,34,8,26,39,33,2,3,1,6
E33028031,376,253,120,133,1,49,9,40,71,61,2,6,2,2
E33028032,874,644,258,386,4,73,19,54,118,102,12,4,0,35
E33028033,241,158,49,109,2,23,7,16,54,51,0,3,0,4
E33028034,293,184,78,106,0,42,9,33,64,58,1,5,0,3
E33028035,283,196,84,112,1,27,10,17,49,39,5,5,0,10
E33028036,763,500,208,292,4,90,24,66,158,146,4,8,0,11
E33028037,271,186,68,118,3,22,8,14,59,56,0,3,0,1
E33028038,278,186,65,121,2,27,6,21,54,51,0,3,0,9
E33028039,288,214,79,135,2,19,9,10,45,39,3,1,2,8
E33028040,364,278,128,150,3,26,5,21,52,46,3,2,1,5
E33028041,285,209,89,120,1,17,4,13,41,33,2,6,0,17
E33028042,260,185,75,110,1,30,8,22,40,34,3,2,1,4
E33028043,342,241,121,120,4,43,10,33,50,40,3,7,0,4
E33028044,383,270,130,140,1,32,8,24,66,55,4,3,4,14
E33028045,297,225,109,116,3,26,5,21,40,33,6,1,0,3
E33028046,197,135,51,84,2,15,3,12,37,33,0,4,0,8
E33028047,253,165,60,105,0,29,9,20,57,53,0,4,0,2
E33028048,477,365,182,183,3,32,6,26,65,52,9,2,2,12
E33028049,268,208,97,111,1,23,9,14,33,31,1,0,1,3
E33028050,503,414,130,284,1,24,7,17,60,52,5,3,0,4
E33028051,321,225,97,128,4,27,6,21,64,62,0,2,0,1
E33028052,323,239,115,124,0,25,6,19,57,48,1,6,2,2
E33028053,370,294,132,162,1,22,6,16,46,38,3,3,2,7
E33028054,550,385,155,230,3,47,8,39,106,93,2,10,1,9
E33028055,336,241,111,130,3,27,8,19,51,44,3,3,1,14
E33028056,266,186,93,93,0,19,5,14,58,55,1,1,1,3
E33028057,394,288,109,179,1,29,3,26,70,60,1,9,0,6
E33028058,292,156,78,78,1,33,9,24,71,54,10,0,7,31
E33028059,456,323,124,199,2,43,14,29,77,69,4,2,2,11
E33028060,391,272,74,198,3,40,11,29,68,59,5,3,1,8
E33028061,286,174,81,93,0,27,3,24,48,45,2,1,0,37
E33028062,227,109,41,68,0,32,9,23,70,54,9,2,5,16
E33028063,377,280,130,150,2,30,7,23,63,56,3,3,1,2
E33028064,543,400,138,262,6,57,12,45,75,69,2,4,0,5
E33028065,343,258,97,161,1,27,4,23,49,48,0,1,0,8
E33028066,282,196,72,124,3,32,9,23,47,44,0,3,0,4
E33028067,303,232,81,151,5,22,6,16,41,40,1,0,0,3
E33028068,256,200,62,138,3,16,4,12,35,30,1,4,0,2
E33028069,535,394,138,256,6,46,12,34,84,72,3,8,1,5
E33028070,311,215,81,134,2,41,5,36,49,44,0,5,0,4
E33028071,560,393,135,258,3,43,5,38,103,90,5,8,0,18
E33028072,362,269,106,163,0,35,7,28,50,44,1,5,0,8
E33028073,778,590,215,375,6,72,17,55,98,88,1,9,0,12
E33028074,491,317,111,206,1,66,20,46,106,101,2,3,0,1
E33028075,398,265,104,161,2,55,8,47,69,62,2,3,2,7
E33028076,290,190,87,103,2,28,7,21,56,47,6,2,1,14
E33028077,428,317,116,201,2,39,13,26,61,52,4,5,0,9
E33028078,302,227,98,129,2,25,11,14,33,27,3,3,0,15
E33028079,416,289,99,190,1,42,9,33,79,72,0,4,3,5
E33028080,612,418,83,335,3,40,11,29,136,121,4,11,0,15
E33028081,258,178,76,102,0,25,5,20,53,50,2,1,0,2
E33028082,298,223,78,145,2,34,15,19,37,33,0,4,0,2
E33028083,293,213,106,107,0,21,9,12,56,50,1,5,0,3
E33028084,416,308,144,164,1,36,11,25,62,58,0,3,1,9
E33028085,606,400,137,263,8,80,25,55,108,90,5,11,2,10
E33028086,395,270,105,165,3,57,21,36,56,54,0,2,0,9
E33028087,305,224,112,112,2,26,8,18,36,31,2,0,3,17
E33028088,293,218,92,126,1,22,10,12,48,43,1,4,0,4
E33028089,384,271,125,146,1,25,10,15,77,57,17,0,3,10
E33028090,270,208,81,127,2,32,6,26,27,25,0,2,0,1
E33028091,461,333,112,221,2,52,14,38,68,63,0,5,0,6
E33028092,273,192,85,107,0,28,9,19,49,42,3,4,0,4
E33028093,319,234,113,121,0,35,12,23,40,30,3,6,1,10
E33028094,350,247,113,134,9,41,17,24,47,42,0,4,1,6
E33028095,249,190,86,104,0,20,6,14,36,35,0,1,0,3
E33028096,367,287,90,197,4,30,10,20,43,39,2,2,0,3
E33028097,406,280,92,188,2,44,32,12,77,72,0,4,1,3
E33028098,262,160,48,112,0,69,54,15,33,27,0,6,0,0
E33028099,330,199,64,135,0,94,78,16,37,35,0,2,0,0
E33028100,517,364,102,262,3,68,41,27,82,75,1,5,1,0
E33028101,249,174,34,140,3,36,22,14,36,29,0,6,1,0
E33028102,323,175,44,131,4,73,54,19,70,64,2,4,0,1
E33028103,474,317,81,236,3,71,56,15,80,75,1,4,0,3
E33028104,544,315,75,240,4,144,111,33,78,68,1,7,2,3
E33028105,651,380,106,274,4,123,80,43,141,126,2,12,1,3
E33028106,288,142,34,108,10,87,68,19,43,39,0,2,2,6
E33028107,367,202,53,149,3,126,96,30,35,27,3,4,1,1
E33028108,342,225,70,155,5,59,50,9,52,51,0,1,0,1
E33028109,381,214,58,156,1,44,31,13,115,105,1,9,0,7
E33028110,421,271,77,194,2,65,55,10,82,78,1,3,0,1
E33028111,483,330,96,234,2,47,33,14,100,89,2,9,0,4
E33028112,339,205,66,139,1,34,22,12,97,90,1,6,0,2
E33028113,713,487,164,323,3,132,103,29,85,81,0,4,0,6
E33028114,320,202,65,137,3,79,63,16,36,31,0,4,1,0
E33028115,395,280,69,211,1,72,61,11,40,37,0,2,1,2
E33028116,789,603,164,439,8,56,36,20,118,110,2,4,2,4
E33028117,327,136,37,99,4,130,112,18,55,53,0,1,1,2
E33028118,586,351,83,268,10,124,70,54,97,86,0,9,2,4
E33028119,315,165,41,124,2,88,64,24,56,48,2,6,0,4
E33028120,674,503,124,379,3,75,30,45,92,85,4,3,0,1
E33028121,307,149,34,115,6,101,88,13,49,47,1,1,0,2
E33028122,1040,767,240,527,8,113,61,52,146,126,2,15,3,6
E33028123,350,164,44,120,4,125,103,22,54,50,0,4,0,3
E33028124,471,216,51,165,5,132,92,40,110,99,3,8,0,8
E33028125,563,422,124,298,4,60,34,26,72,65,2,5,0,5
E33028126,431,310,102,208,4,54,43,11,61,57,1,1,2,2
E33028127,656,459,139,320,7,96,55,41,92,86,0,5,1,2
E33028128,314,177,53,124,3,63,49,14,69,61,1,7,0,2
E33028129,243,160,43,117,1,29,23,6,51,47,0,4,0,2
E33028130,291,183,59,124,0,51,32,19,56,48,1,6,1,1
E33028131,660,482,137,345,8,30,16,14,133,123,2,6,2,7
E33028132,496,318,80,238,5,49,38,11,120,108,1,11,0,4
E33028133,285,192,73,119,1,37,19,18,52,49,0,3,0,3
E33028134,250,161,47,114,1,39,21,18,47,44,1,2,0,2
E33028135,244,127,47,80,5,58,35,23,53,49,0,2,2,1
E33028136,622,453,138,315,8,49,27,22,108,97,0,10,1,4
E33028137,390,246,71,175,1,101,76,25,41,38,0,3,0,1
E33028138,346,226,64,162,3,52,35,17,61,54,1,4,2,4
E33028139,259,164,65,99,0,35,22,13,54,50,0,4,0,6
E33028140,425,318,107,211,0,28,18,10,75,71,1,3,0,4
E33028141,346,209,62,147,1,30,22,8,102,97,0,5,0,4
E33028142,303,221,90,131,4,26,18,8,47,44,0,3,0,5
E33028143,386,270,120,150,6,46,33,13,61,56,0,4,1,3
E33028144,363,209,69,140,2,33,19,14,109,99,2,7,1,10
E33028145,312,194,67,127,1,75,67,8,42,33,1,7,1,0
E33028146,271,163,43,120,10,66,26,40,31,27,0,4,0,1
E33028147,498,288,88,200,5,111,69,42,87,78,4,5,0,7
E33028148,281,164,52,112,5,53,35,18,52,49,0,2,1,7
E33028149,343,216,49,167,5,33,15,18,87,80,0,7,0,2
E33028150,312,216,76,140,3,43,33,10,46,42,2,2,0,4
E33028151,591,359,105,254,4,90,69,21,129,120,0,9,0,9
E33028152,407,286,95,191,1,23,11,12,94,88,1,4,1,3
E33028153,1210,899,261,638,10,90,50,40,207,192,4,11,0,4
E33028154,266,154,51,103,1,28,19,9,81,77,1,3,0,2
E33028155,535,378,146,232,2,75,63,12,70,63,0,7,0,10
E33028156,1090,804,181,623,14,69,43,26,194,169,4,20,1,9
E33028157,362,209,66,143,4,62,52,10,83,71,2,10,0,4
E33028158,279,198,72,126,1,34,22,12,44,40,0,4,0,2
E33028159,421,318,101,217,1,34,28,6,66,62,0,4,0,2
E33028160,479,309,101,208,3,80,60,20,80,75,0,5,0,7
E33028161,256,196,82,114,2,25,20,5,29,29,0,0,0,4
E33028162,327,240,81,159,2,30,20,10,52,51,0,1,0,3
E33028163,257,192,79,113,1,25,20,5,35,34,1,0,0,4
E33028164,342,250,74,176,2,36,22,14,52,48,1,3,0,2
E33028165,514,345,85,260,6,101,81,20,61,54,0,5,2,1
E33028166,270,199,56,143,1,41,37,4,23,17,0,6,0,6
E33028167,283,196,74,122,4,44,33,11,34,31,1,1,1,5
E33028168,310,174,57,117,3,70,59,11,63,61,0,2,0,0
E33028169,252,157,53,104,2,37,33,4,54,51,0,3,0,2
E33028170,384,247,74,173,5,70,55,15,60,53,1,6,0,2
E33028171,417,285,82,203,11,44,13,31,74,62,0,7,5,3
E33028172,313,255,81,174,3,31,11,20,21,17,0,4,0,3
E33028173,431,349,144,205,3,43,15,28,32,30,0,1,1,4
E33028174,365,300,104,196,5,39,23,16,18,16,0,2,0,3
E33028175,422,286,83,203,10,71,33,38,55,50,1,4,0,0
E33028176,323,224,59,165,11,47,17,30,40,37,1,2,0,1
E33028177,362,282,93,189,4,13,5,8,62,58,0,4,0,1
E33028178,320,254,91,163,2,31,9,22,30,26,3,1,0,3
E33028179,513,392,128,264,1,17,8,9,91,79,3,9,0,12
E33028180,341,250,77,173,3,26,13,13,59,54,3,2,0,3
E33028181,344,258,83,175,5,28,10,18,37,33,3,1,0,16
E33028182,596,445,153,292,3,37,21,16,108,102,3,3,0,3
E33028183,485,376,119,257,2,36,15,21,66,60,0,6,0,5
E33028184,497,402,141,261,3,27,12,15,60,57,0,3,0,5
E33028185,276,230,50,180,2,12,6,6,31,28,2,1,0,1
E33028186,320,201,67,134,4,31,9,22,77,69,2,6,0,7
E33028187,628,443,159,284,5,34,6,28,136,130,4,2,0,10
E33028188,499,408,140,268,6,25,7,18,51,43,0,7,1,9
E33028189,454,290,101,189,4,58,11,47,95,76,13,4,2,7
E33028190,287,222,85,137,0,12,4,8,53,33,18,2,0,0
E33028191,449,329,127,202,4,51,11,40,62,57,2,3,0,3
E33028192,271,228,86,142,4,6,1,5,33,31,1,1,0,0
E33028193,349,258,106,152,10,44,14,30,35,31,2,2,0,2
E33028194,628,482,157,325,6,50,15,35,79,71,4,2,2,11
E33028195,441,319,121,198,3,36,14,22,72,58,2,9,3,11
E33028196,568,373,128,245,7,76,41,35,102,88,4,10,0,10
E33028197,425,336,139,197,3,21,6,15,54,48,0,6,0,11
E33028198,395,270,104,166,3,37,27,10,77,75,0,2,0,8
E33028199,606,443,151,292,4,56,33,23,97,91,1,5,0,6
E33028200,254,207,82,125,0,13,4,9,30,26,1,1,2,4
E33028201,254,179,61,118,3,22,10,12,47,46,0,0,1,3
E33028202,293,242,80,162,2,15,7,8,29,28,0,1,0,5
E33028203,264,200,75,125,3,22,15,7,38,25,5,8,0,1
E33028204,290,227,79,148,0,21,8,13,39,33,3,3,0,3
E33028205,472,339,116,223,10,32,12,20,87,75,4,8,0,4
E33028206,722,536,160,376,9,60,31,29,114,94,1,19,0,3
E33028207,505,394,129,265,5,42,18,24,62,56,2,4,0,2
E33028208,252,190,38,152,6,27,12,15,29,24,0,5,0,0
E33028209,272,204,52,152,6,22,10,12,39,33,0,5,1,1
E33028210,402,326,118,208,5,15,6,9,55,49,2,4,0,1
E33028211,336,268,94,174,3,22,8,14,35,32,2,1,0,8
E33028212,383,317,123,194,5,26,9,17,33,31,0,2,0,2
E33028213,457,337,130,207,1,45,15,30,65,61,0,4,0,9
E33028214,257,197,74,123,0,19,7,12,35,32,1,2,0,6
E33028215,355,275,106,169,1,25,11,14,47,40,2,3,2,7
E33028216,684,523,185,338,5,52,26,26,89,69,7,12,1,15
E33028217,564,412,120,292,8,40,15,25,100,92,0,8,0,4
E33028218,343,280,132,148,0,23,11,12,31,28,0,1,2,9
E33028219,442,343,124,219,3,27,13,14,61,51,3,4,3,8
E33028220,306,235,74,161,4,24,11,13,42,35,2,5,0,1
E33028221,271,205,99,106,3,27,10,17,30,24,0,6,0,6
E33028222,227,167,67,100,1,22,8,14,33,30,1,2,0,4
E33028223,397,326,97,229,1,40,6,34,27,24,1,1,1,3
E33028224,331,266,143,123,1,13,6,7,40,31,3,4,2,11
E33028225,690,477,135,342,5,77,44,33,127,120,0,7,0,4
E33028226,328,236,78,158,1,17,6,11,69,66,2,1,0,5
E33028227,332,223,88,135,2,22,9,13,67,59,4,4,0,18
E33028228,304,207,82,125,0,26,8,18,63,52,3,8,0,8
E33028229,347,261,127,134,1,28,13,15,51,43,3,5,0,6
E33028230,552,418,137,281,13,49,17,32,65,60,2,2,1,7
E33028231,273,214,82,132,2,15,7,8,39,29,9,1,0,3
E33028232,419,303,76,227,9,41,10,31,60,50,0,8,2,6
E33028233,457,359,135,224,7,32,5,27,51,45,1,5,0,8
E33028234,426,345,110,235,2,25,8,17,51,45,1,3,2,3
E33028235,504,370,139,231,6,43,13,30,79,68,5,6,0,6
E33028236,386,307,110,197,6,36,10,26,32,29,1,2,0,5
E33028237,252,207,76,131,3,25,14,11,15,14,0,1,0,2
E33028238,477,358,143,215,5,50,21,29,56,46,1,9,0,8
E33028239,257,171,74,97,2,22,6,16,49,39,6,3,1,13
E33028240,359,259,100,159,4,37,15,22,56,50,0,5,1,3
E33028241,255,197,85,112,0,19,7,12,30,26,1,3,0,9
E33028242,303,209,78,131,2,30,13,17,53,48,2,3,0,9
E33028243,279,232,103,129,3,13,3,10,23,19,1,1,2,8
E33028244,437,348,148,200,3,29,9,20,41,34,3,4,0,16
E33028245,344,254,116,138,3,22,11,11,60,52,0,7,1,5
E33028246,398,285,136,149,6,48,15,33,47,40,2,4,1,12
E33028247,245,188,83,105,5,24,6,18,26,22,0,4,0,2
E33028248,499,367,143,224,5,41,11,30,82,71,3,7,1,4
E33028249,311,229,96,133,3,40,11,29,35,31,2,2,0,4
E33028250,603,424,157,267,13,51,14,37,112,102,4,6,0,3
E33028251,414,325,121,204,2,34,10,24,50,43,0,7,0,3
E33028252,349,283,116,167,4,15,4,11,37,29,3,5,0,10
E33028253,353,271,132,139,3,26,12,14,45,37,0,1,7,8
E33028254,522,398,151,247,5,41,22,19,66,55,3,7,1,12
E33028255,289,227,82,145,5,28,7,21,23,21,0,2,0,6
E33028256,348,246,90,156,4,38,17,21,53,50,0,3,0,7
E33028257,377,288,100,188,2,32,9,23,53,47,2,3,1,2
E33028258,335,256,107,149,7,26,7,19,38,36,0,2,0,8
E33028259,317,254,99,155,1,23,8,15,33,30,0,3,0,6
E33028260,471,301,105,196,8,51,16,35,108,93,2,11,2,3
E33028261,316,260,99,161,0,12,3,9,35,35,0,0,0,9
E33028262,323,239,87,152,2,25,8,17,54,46,1,7,0,3
E33028263,413,274,109,165,4,49,18,31,82,68,1,13,0,4
E33028264,305,234,83,151,3,32,16,16,33,33,0,0,0,3
E33028265,281,208,82,126,1,20,14,6,42,35,4,1,2,10
E33028266,269,186,76,110,0,30,21,9,28,24,2,0,2,25
E33028267,218,161,59,102,2,23,10,13,29,27,1,1,0,3
E33028268,250,177,43,134,4,29,14,15,35,31,2,1,1,5
E33028269,280,205,71,134,0,33,19,14,29,26,3,0,0,13
E33028270,556,390,173,217,3,67,44,23,87,76,3,5,3,9
E33028271,248,189,81,108,1,19,11,8,32,29,1,1,1,7
E33028272,335,259,113,146,1,20,11,9,51,43,2,1,5,4
E33028273,815,460,132,328,3,88,56,32,261,244,4,5,8,3
E33028274,379,301,122,179,3,21,14,7,52,48,1,3,0,2
E33028275,356,271,101,170,1,36,21,15,35,33,2,0,0,13
E33028276,263,217,79,138,1,10,7,3,34,27,1,6,0,1
E33028277,669,462,151,311,10,80,42,38,112,101,2,8,1,5
E33028278,340,234,93,141,1,49,31,18,52,48,1,3,0,4
E33028279,537,405,154,251,2,46,30,16,74,69,0,3,2,10
E33028280,378,286,125,161,0,46,32,14,39,35,1,3,0,7
E33028281,511,296,103,193,3,100,72,28,108,69,26,5,8,4
E33028282,392,270,82,188,2,44,29,15,71,57,6,4,4,5
E33028283,453,367,116,251,3,37,20,17,46,42,1,3,0,0
E33028284,292,220,87,133,1,24,12,12,44,40,0,4,0,3
E33028285,589,450,152,298,2,41,30,11,88,77,5,4,2,8
E33028286,416,312,90,222,1,42,26,16,59,51,3,4,1,2
E33028287,372,254,74,180,3,41,24,17,71,60,3,7,1,3
E33028288,288,209,51,158,0,45,28,17,33,31,2,0,0,1
E33028289,564,386,111,275,5,87,41,46,84,77,0,6,1,2
E33028290,535,372,90,282,4,72,39,33,82,75,1,4,2,5
E33028291,293,230,82,148,3,15,15,0,40,27,10,3,0,5
E33028292,444,310,103,207,1,56,42,14,73,66,1,2,4,4
E33028293,415,316,118,198,2,34,26,8,58,45,1,9,3,5
E33028294,275,195,70,125,2,24,14,10,41,33,1,3,4,13
E33028295,346,288,102,186,0,18,13,5,40,36,0,2,2,0
E33028296,361,272,116,156,1,33,19,14,42,33,3,4,2,13
E33028297,645,446,142,304,2,90,62,28,101,92,1,8,0,6
E33028298,471,364,119,245,4,41,30,11,59,45,5,8,1,3
E33028299,524,351,110,241,2,72,45,27,97,90,0,3,4,2
E33028300,573,381,102,279,7,114,67,47,67,56,0,9,2,4
E33028301,360,220,76,144,3,53,40,13,79,74,0,4,1,5
E33028302,630,444,165,279,3,65,35,30,114,110,1,1,2,4
E33028303,445,327,96,231,3,38,23,15,73,64,1,7,1,4
E33028304,291,198,62,136,4,32,22,10,54,46,1,4,3,3
E33028305,359,226,77,149,4,37,22,15,89,84,2,3,0,3
E33028306,358,282,92,190,0,18,16,2,49,44,0,3,2,9
E33028307,321,213,62,151,0,68,61,7,35,30,0,3,2,5
E33028308,483,368,96,272,0,39,20,19,75,62,3,5,5,1
E33028309,306,202,75,127,1,22,13,9,70,59,9,2,0,11
E33028310,211,165,78,87,3,15,10,5,25,21,0,4,0,3
E33028311,227,167,67,100,2,21,11,10,32,31,1,0,0,5
E33028312,389,326,135,191,1,27,13,14,31,28,1,2,0,4
E33028313,400,330,121,209,3,27,13,14,32,26,2,4,0,8
E33028314,315,236,83,153,0,17,9,8,60,40,14,4,2,2
E33028315,363,248,109,139,0,44,23,21,61,49,7,4,1,10
E33028316,245,183,65,118,2,14,7,7,33,33,0,0,0,13
E33028317,490,349,151,198,3,28,20,8,94,82,6,1,5,16
E33028318,246,179,67,112,2,12,4,8,45,37,3,4,1,8
E33028319,381,284,92,192,2,14,9,5,77,73,0,3,1,4
E33028320,501,426,169,257,3,23,17,6,47,45,0,2,0,2
E33028321,451,355,148,207,4,27,17,10,62,50,2,6,4,3
E33028322,254,205,78,127,1,13,11,2,33,32,0,1,0,2
E33028323,399,311,103,208,4,40,22,18,41,39,0,1,1,3
E33028324,627,389,120,269,4,51,25,26,176,76,61,1,38,7
E33028325,732,462,196,266,4,67,52,15,99,70,22,6,1,100
E33028326,376,315,106,209,0,11,7,4,43,35,1,5,2,7
E33028327,229,156,63,93,0,18,15,3,44,41,1,0,2,11
E33028328,248,172,61,111,0,24,17,7,45,39,3,3,0,7
E33028329,409,297,125,172,0,28,15,13,73,63,8,2,0,11
E33028330,379,258,71,187,6,42,18,24,65,59,0,6,0,8
E33028331,302,229,66,163,1,25,9,16,44,41,0,2,1,3
E33028332,344,250,71,179,2,27,9,18,62,59,0,2,1,3
E33028333,305,203,56,147,4,46,7,39,45,42,0,3,0,7
E33028334,242,196,79,117,1,9,2,7,34,32,1,1,0,2
E33028335,460,285,94,191,2,36,14,22,127,119,2,5,1,10
E33028336,294,217,77,140,3,25,12,13,43,36,4,3,0,6
E33028337,623,136,43,93,2,38,9,29,370,307,33,3,27,77
E33028338,284,195,68,127,0,27,11,16,56,48,3,5,0,6
E33028339,333,212,77,135,0,33,13,20,76,70,3,3,0,12
E33028340,251,185,58,127,4,29,17,12,29,25,0,4,0,4
E33028341,377,179,63,116,2,26,7,19,95,62,21,0,12,75
E33028342,371,294,126,168,2,21,10,11,53,46,0,5,2,1
E33028343,276,196,70,126,3,28,11,17,44,39,0,2,3,5
E33028344,357,222,75,147,4,20,3,17,108,96,4,5,3,3
E33028345,544,393,98,295,8,59,22,37,75,64,1,3,7,9
E33028346,415,276,99,177,2,49,21,28,81,73,2,3,3,7
E33028347,367,245,60,185,6,49,19,30,66,61,1,3,1,1
E33028348,641,466,131,335,11,65,21,44,95,85,2,7,1,4
E33028349,296,193,53,140,5,57,23,34,38,34,0,4,0,3
E33028350,404,272,111,161,5,27,11,16,85,72,6,4,3,15
E33028351,668,475,140,335,5,34,8,26,117,102,5,9,1,37
E33028352,316,228,56,172,6,23,4,19,58,55,1,1,1,1
E33028353,333,187,39,148,5,40,14,26,96,94,1,1,0,5
E33028354,332,219,75,144,7,29,14,15,65,57,4,3,1,12
E33028355,229,153,60,93,3,9,6,3,51,37,11,2,1,13
E33028356,293,195,53,142,2,22,9,13,63,55,4,4,0,11
E33028357,630,373,92,281,28,65,20,45,149,132,12,5,0,15
E33028358,439,287,78,209,6,57,26,31,83,73,1,7,2,6
E33028359,374,253,82,171,6,49,14,35,53,44,4,5,0,13
E33028360,399,238,74,164,1,51,18,33,107,93,10,4,0,2
E33028361,477,287,70,217,0,125,105,20,62,54,1,6,1,3
E33028362,308,214,58,156,0,67,64,3,25,24,0,0,1,2
E33028363,639,505,172,333,6,48,34,14,68,62,0,6,0,12
E33028364,378,313,99,214,2,27,21,6,35,34,0,1,0,1
E33028365,241,174,59,115,2,21,12,9,42,41,0,1,0,2
E33028366,572,451,119,332,3,36,19,17,82,74,2,5,1,0
E33028367,412,334,106,228,2,42,31,11,32,28,0,4,0,2
E33028368,243,194,72,122,2,9,8,1,35,33,0,2,0,3
E33028369,425,273,83,190,6,58,26,32,86,83,2,1,0,2
E33028370,428,296,84,212,1,62,44,18,67,61,2,4,0,2
E33028371,333,250,66,184,1,27,10,17,49,47,0,2,0,6
E33028372,655,439,121,318,4,96,71,25,113,106,3,1,3,3
E33028373,296,249,77,172,1,18,7,11,28,27,0,1,0,0
E33028374,315,263,78,185,1,14,6,8,37,36,0,1,0,0
E33028375,336,244,61,183,3,64,39,25,20,16,2,2,0,5
E33028376,270,213,58,155,4,23,17,6,29,29,0,0,0,1
E33028377,279,216,74,142,3,13,11,2,42,41,0,1,0,5
E33028378,347,251,91,160,1,34,21,13,55,49,1,4,1,6
E33028379,608,452,159,293,3,47,37,10,99,91,2,5,1,7
E33028380,355,254,72,182,5,22,17,5,67,59,1,7,0,7
E33028381,319,187,57,130,5,33,19,14,92,85,3,4,0,2
E33028382,317,226,61,165,2,26,14,12,62,57,0,5,0,1
E33028383,322,209,59,150,0,32,15,17,79,70,5,3,1,2
E33028384,428,254,64,190,4,36,29,7,127,116,0,11,0,7
E33028385,439,232,76,156,4,81,56,25,119,115,2,2,0,3
E33028386,270,188,58,130,3,25,18,7,51,48,0,2,1,3
E33028387,253,137,39,98,6,38,20,18,70,70,0,0,0,2
E33028388,456,224,63,161,3,100,65,35,124,119,2,3,0,5
E33028389,266,195,54,141,0,8,6,2,59,56,0,2,1,4
E33028390,281,213,73,140,3,10,4,6,53,51,0,2,0,2
E33028391,693,474,128,346,3,72,48,24,133,115,3,10,5,11
E33028392,392,255,91,164,4,33,18,15,96,91,1,2,2,4
E33028393,240,143,47,96,0,17,9,8,80,78,0,2,0,0
E33028394,320,242,84,158,0,15,10,5,60,51,0,7,2,3
E33028395,507,403,113,290,0,32,15,17,71,70,0,1,0,1
E33028396,255,178,60,118,0,27,18,9,48,42,1,5,0,2
E33028397,311,233,73,160,4,23,16,7,49,47,0,2,0,2
E33028398,283,196,60,136,1,25,13,12,56,54,0,2,0,5
E33028399,1242,943,249,694,5,80,40,40,208,191,6,10,1,6
E33028400,290,232,55,177,2,12,7,5,41,37,0,4,0,3
E33028401,248,208,73,135,1,12,6,6,22,20,1,1,0,5
E33028402,5037,3787,1058,2729,24,328,176,152,879,817,19,36,7,19
E33028403,267,208,82,126,1,26,17,9,30,30,0,0,0,2
E33028404,320,216,63,153,1,42,30,12,60,57,0,1,2,1
E33028405,476,400,114,286,1,21,15,6,49,48,0,1,0,5
E33028406,508,385,97,288,3,30,13,17,88,84,1,3,0,2
E33028407,309,180,50,130,3,49,32,17,75,70,0,5,0,2
E33028408,402,275,73,202,2,29,18,11,94,88,0,2,4,2
E33028409,347,252,55,197,1,56,44,12,37,35,1,0,1,1
E33028410,345,256,68,188,1,37,25,12,51,47,0,4,0,0
E33028411,262,168,37,131,2,58,41,17,31,28,0,3,0,3
E33028412,384,272,73,199,2,56,33,23,52,45,1,6,0,2
E33028413,380,271,76,195,1,48,41,7,60,57,0,3,0,0
E33028414,818,542,137,405,3,59,36,23,205,189,1,15,0,9
E33028415,237,116,37,79,0,22,12,10,99,91,4,4,0,0
E33028416,723,569,169,400,4,46,24,22,99,95,0,4,0,5
E33028417,418,317,76,241,2,21,14,7,73,68,2,3,0,5
E33028418,278,192,58,134,1,25,12,13,58,55,0,1,2,2
E33028419,344,217,64,153,5,39,19,20,83,78,2,2,1,0
E33028420,685,465,113,352,1,59,35,24,155,146,2,5,2,5
E33028421,324,225,71,154,4,52,36,16,40,37,0,2,1,3
E33028422,356,203,71,132,1,83,58,25,64,58,0,6,0,5
E33028423,421,281,63,218,6,41,13,28,89,83,0,6,0,4
E33028424,356,253,65,188,3,46,31,15,53,45,1,7,0,1
E33028425,429,325,92,233,0,52,33,19,49,41,2,4,2,3
E33028426,332,214,67,147,4,66,52,14,48,45,2,1,0,0
E33028427,252,169,50,119,1,53,46,7,26,24,0,2,0,3
E33028428,320,220,56,164,3,50,46,4,45,41,0,4,0,2
E33028429,467,329,89,240,5,47,25,22,82,79,1,2,0,4
E33028430,264,188,58,130,2,40,34,6,31,30,1,0,0,3
E33028431,668,453,149,304,3,97,62,35,114,107,2,5,0,1
E33028432,379,272,72,200,1,49,37,12,57,56,1,0,0,0
E33028433,452,298,79,219,3,81,47,34,66,63,1,2,0,4
E33028434,607,405,114,291,3,132,58,74,56,44,4,7,1,11
E33028435,876,525,138,387,6,189,80,109,150,142,0,8,0,6
E33028436,334,205,47,158,3,80,68,12,39,38,0,0,1,7
E33028437,358,229,66,163,1,85,75,10,39,38,0,1,0,4
E33028438,605,457,92,365,4,66,48,18,78,75,1,2,0,0
E33028439,349,232,66,166,1,45,40,5,70,63,4,1,2,1
E33028440,679,389,168,221,4,94,63,31,176,158,3,9,6,16
E33028441,429,306,157,149,7,42,25,17,56,46,4,6,0,18
E33028442,366,264,118,146,3,52,36,16,42,32,2,8,0,5
E33028443,519,405,145,260,1,32,22,10,73,66,1,5,1,8
E33028444,383,277,88,189,6,35,24,11,61,58,1,2,0,4
E33028445,434,340,139,201,2,34,18,16,56,52,1,3,0,2
E33028446,288,228,89,139,0,14,8,6,42,30,9,2,1,4
E33028447,339,265,106,159,4,20,11,9,42,36,1,5,0,8
E33028448,689,455,168,287,6,43,21,22,177,167,4,5,1,8
E33028449,313,242,120,122,1,23,12,11,39,32,0,4,3,8
E33028450,296,248,108,140,3,10,5,5,35,26,4,2,3,0
E33028451,338,276,113,163,2,22,11,11,32,28,1,3,0,6
E33028452,246,174,78,96,4,29,15,14,34,28,2,2,2,5
E33028453,329,259,111,148,3,19,15,4,41,34,6,0,1,7
E33028454,278,220,64,156,3,12,5,7,41,35,4,1,1,2
E33028455,279,202,81,121,4,20,19,1,43,29,6,6,2,10
E33028456,547,439,206,233,7,39,30,9,44,40,1,3,0,18
E33028457,387,271,122,149,8,23,16,7,71,40,27,2,2,14
E33028458,336,259,126,133,4,17,12,5,46,40,5,1,0,10
E33028459,303,224,115,109,3,23,15,8,44,30,11,2,1,9
E33028460,379,307,122,185,4,21,13,8,40,35,2,2,1,7
E33028461,428,343,110,233,6,11,11,0,64,57,3,4,0,4
E33028462,531,394,143,251,9,47,31,16,71,65,1,1,4,10
E33028463,305,220,95,125,0,28,17,11,50,41,6,3,0,7
E33028464,437,319,116,203,1,44,25,19,61,51,7,3,0,12
E33028465,615,481,160,321,9,56,36,20,64,54,4,6,0,5
E33028466,470,368,147,221,3,34,21,13,62,49,7,5,1,3
E33028467,304,220,94,126,2,19,13,6,56,37,17,2,0,7
E33028468,524,403,147,256,7,36,22,14,69,62,3,3,1,9
E33028469,438,345,126,219,5,43,24,19,44,39,1,4,0,1
E33028470,278,227,86,141,0,20,16,4,26,17,4,4,1,5
E33028471,767,598,206,392,3,46,31,15,115,108,2,4,1,5
E33028472,283,228,77,151,2,18,12,6,31,25,1,0,5,4
E33028473,344,285,134,151,3,17,16,1,30,21,5,3,1,9
E33028474,287,207,78,129,11,35,28,7,30,23,3,1,3,4
E33028475,388,318,123,195,2,42,25,17,24,20,2,2,0,2
E33028476,280,189,51,138,3,38,25,13,47,42,1,3,1,3
E33028477,304,244,95,149,1,13,10,3,41,37,1,1,2,5
E33028478,591,438,167,271,10,56,36,20,85,72,7,6,0,2
E33028479,413,318,129,189,2,25,17,8,62,52,1,8,1,6
E33028480,478,372,125,247,4,40,24,16,58,47,6,5,0,4
E33028481,314,250,93,157,2,21,15,6,34,29,0,4,1,7
E33028482,411,290,119,171,2,26,21,5,77,67,7,1,2,16
E33028483,293,223,85,138,2,18,17,1,45,40,3,0,2,5
E33028484,508,268,82,186,2,45,33,12,184,179,3,1,1,9
E33028485,285,196,64,132,0,42,36,6,45,38,1,5,1,2
E33028486,335,256,93,163,2,49,23,26,26,26,0,0,0,2
E33028487,612,457,126,331,7,69,51,18,74,64,3,6,1,5
E33028488,344,255,84,171,7,43,34,9,37,28,2,1,6,2
E33028489,470,374,107,267,1,37,26,11,52,49,0,2,1,6
E33028490,557,450,130,320,3,26,17,9,74,69,2,3,0,4
E33028491,601,471,150,321,7,34,26,8,85,73,3,7,2,4
E33028492,333,278,100,178,2,21,13,8,26,23,2,1,0,6
E33028493,287,210,70,140,2,29,21,8,40,36,0,3,1,6
E33028494,717,513,145,368,7,87,61,26,108,101,3,4,0,2
E33028495,270,201,51,150,1,21,13,8,45,40,0,5,0,2
E33028496,462,346,75,271,10,33,22,11,72,64,0,8,0,1
E33028497,290,225,63,162,2,16,8,8,39,36,0,3,0,8
E33028498,526,427,142,285,6,43,29,14,49,45,1,1,2,1
E33028499,601,452,131,321,6,61,44,17,81,77,1,3,0,1
E33028500,366,282,91,191,5,35,23,12,43,39,0,3,1,1
E33028501,581,430,121,309,6,51,34,17,89,72,3,8,6,5
E33028502,333,288,100,188,0,12,6,6,32,26,1,5,0,1
E33028503,318,246,87,159,0,28,10,18,40,28,5,2,5,4
E33028504,244,196,60,136,4,21,17,4,23,13,3,7,0,0
E33028505,312,248,94,154,0,20,14,6,38,30,6,1,1,6
E33028506,323,240,77,163,0,27,17,10,53,48,2,0,3,3
E33028507,2134,1176,275,901,15,172,78,94,759,286,320,16,137,12
E33028508,829,673,173,500,3,49,24,25,99,88,2,7,2,5
E33028509,391,291,98,193,1,36,20,16,59,45,9,4,1,4
E33028510,362,296,113,183,1,36,27,9,27,21,1,4,1,2
E33028511,304,233,84,149,1,38,31,7,28,26,0,2,0,4
E33028512,429,351,109,242,3,29,22,7,40,34,2,4,0,6
E33028513,403,281,88,193,3,39,19,20,73,68,1,3,1,7
E33028514,686,501,171,330,3,73,37,36,100,82,4,9,5,9
E33028515,349,270,80,190,2,36,14,22,31,24,3,1,3,10
E33028516,356,279,92,187,1,30,10,20,42,26,6,2,8,4
E33028517,315,242,113,129,0,22,9,13,43,37,4,1,1,8
E33028518,1483,779,184,595,12,110,44,66,562,210,212,15,125,20
E33028519,420,308,128,180,2,27,19,8,58,48,5,0,5,25
E33028520,257,195,72,123,0,22,13,9,38,29,1,2,6,2
E33028521,245,163,60,103,4,34,14,20,41,29,4,3,5,3
E33028522,451,293,100,193,2,39,21,18,91,75,7,4,5,26
E33028523,818,490,124,366,11,142,65,77,173,157,7,7,2,2
E33028524,318,239,82,157,2,44,27,17,32,32,0,0,0,1
E33028525,397,244,74,170,7,99,48,51,42,33,0,7,2,5
E33028526,262,187,76,111,8,35,11,24,32,21,1,9,1,0
E33028527,543,276,82,194,1,118,66,52,140,127,5,7,1,8
E33028528,255,187,63,124,2,26,19,7,34,27,1,5,1,6
E33028529,310,218,69,149,2,35,20,15,50,43,3,4,0,5
E33028530,398,282,117,165,1,33,15,18,62,52,3,6,1,20
E33028531,273,216,70,146,2,12,5,7,33,29,3,1,0,10
E33028532,363,259,46,213,11,37,8,29,56,50,0,3,3,0
E33028533,346,267,88,179,2,8,5,3,64,58,2,4,0,5
E33028534,644,500,157,343,2,48,21,27,93,84,2,6,1,1
E33028535,406,271,68,203,4,48,16,32,81,66,0,14,1,2
E33028536,1537,1149,333,816,19,143,57,86,213,194,8,10,1,13
E33028537,344,248,81,167,4,31,14,17,58,47,3,8,0,3
E33028538,776,598,200,398,9,53,22,31,108,98,0,9,1,8
E33028539,392,288,83,205,4,38,14,24,60,51,2,7,0,2
E33028540,342,210,80,130,2,43,17,26,83,78,0,3,2,4
E33028541,166,88,25,63,2,24,16,8,50,42,0,7,1,2
E33028542,346,254,89,165,3,20,6,14,66,60,4,1,1,3
E33028543,407,277,74,203,1,22,7,15,99,97,0,1,1,8
E33028544,465,352,90,262,5,26,13,13,74,66,1,5,2,8
E33028545,321,192,54,138,1,41,12,29,86,66,1,19,0,1
E33028546,242,187,44,143,1,30,18,12,23,18,3,1,1,1
E33028547,476,323,97,226,11,55,25,30,84,69,4,9,2,3
E33028548,377,300,99,201,6,28,13,15,35,30,1,4,0,8
E33028549,388,302,111,191,2,15,8,7,65,54,5,3,3,4
E33028550,290,195,73,122,4,23,8,15,60,52,1,1,6,8
E33028551,426,332,103,229,2,34,14,20,55,43,8,2,2,3
E33028552,645,448,177,271,7,73,36,37,99,90,3,4,2,18
E33028553,302,218,69,149,1,17,4,13,53,42,5,5,1,13
E33028554,262,206,84,122,2,16,8,8,35,34,0,1,0,3
E33028555,446,328,152,176,1,31,16,15,45,36,7,0,2,41
E33028556,426,296,102,194,2,52,27,25,67,54,7,6,0,9
E33028557,390,286,83,203,1,31,15,16,67,62,2,2,1,5
E33028558,311,230,71,159,4,38,21,17,36,32,4,0,0,3
E33028559,317,242,73,169,2,28,10,18,36,28,2,6,0,9
E33028560,353,274,88,186,2,36,13,23,36,31,0,5,0,5
E33028561,689,432,131,301,16,96,41,55,137,120,6,9,2,8
E33028562,608,433,135,298,4,46,18,28,117,97,10,7,3,8
E33028563,336,240,109,131,2,24,9,15,63,53,5,5,0,7
E33028564,297,211,80,131,3,26,17,9,51,47,0,3,1,6
E33028565,416,313,126,187,4,27,11,16,53,41,6,6,0,19
E33028566,270,194,76,118,1,38,15,23,31,27,1,3,0,6
E33028567,396,310,120,190,3,18,13,5,57,50,2,3,2,8
E33028568,635,414,100,314,2,61,29,32,148,145,1,0,2,10
E33028569,1100,839,223,616,17,97,42,55,130,119,3,8,0,17
E33028570,350,262,92,170,1,29,6,23,54,48,1,4,1,4
E33028571,311,194,69,125,2,20,11,9,54,49,2,3,0,41
E33028572,361,297,87,210,3,21,7,14,35,30,2,3,0,5
E33028573,423,344,96,248,6,32,8,24,39,35,0,4,0,2
E33028574,380,257,54,203,1,69,45,24,49,45,0,3,1,4
E33028575,806,553,140,413,8,130,58,72,105,96,0,7,2,10
E33028576,399,307,59,248,4,48,26,22,37,33,0,3,1,3
E33028577,776,559,121,438,8,114,46,68,93,87,1,5,0,2
E33028578,403,293,65,228,1,62,31,31,45,43,0,2,0,2
E33028579,456,297,66,231,5,92,60,32,61,53,1,6,1,1
E33028580,424,274,72,202,2,68,33,35,80,69,3,8,0,0
E33028581,316,268,68,200,1,21,10,11,23,22,0,1,0,3
E33028582,428,292,77,215,3,69,37,32,62,59,1,2,0,2
E33028583,249,162,74,88,5,25,2,23,52,44,0,8,0,5
E33028584,264,185,92,93,8,22,3,19,44,37,5,2,0,5
E33028585,422,295,160,135,1,46,14,32,68,62,3,3,0,12
E33028586,271,209,125,84,1,21,4,17,27,23,4,0,0,13
E33028587,285,189,97,92,3,33,15,18,54,48,3,3,0,6
E33028588,350,274,121,153,1,27,14,13,43,35,3,2,3,5
E33028589,312,209,99,110,0,38,10,28,63,59,1,2,1,2
E33028590,229,173,80,93,4,8,4,4,37,29,5,1,2,7
E33028591,259,193,77,116,5,15,1,14,33,32,1,0,0,13
E33028592,833,595,236,359,0,67,9,58,124,107,8,9,0,47
E33028593,659,467,175,292,5,59,20,39,116,99,6,8,3,12
E33028594,321,223,88,135,5,35,6,29,53,48,5,0,0,5
E33028595,237,149,60,89,0,28,1,27,54,45,5,2,2,6
E33028596,292,198,91,107,2,40,2,38,46,39,4,3,0,6
E33028597,378,242,86,156,2,34,8,26,95,77,13,5,0,5
E33028598,472,331,115,216,2,39,15,24,93,76,6,9,2,7
E33028599,280,210,90,120,2,26,3,23,39,35,2,2,0,3
E33028600,386,273,82,191,5,56,4,52,51,49,0,2,0,1
E33028601,435,328,128,200,3,42,6,36,53,48,2,2,1,9
E33028602,570,373,151,222,4,91,15,76,93,83,5,5,0,9
E33028603,371,257,93,164,6,41,4,37,64,50,6,8,0,3
E33028604,279,194,93,101,0,36,3,33,44,31,8,2,3,5
E33028605,297,213,102,111,3,21,0,21,51,47,2,0,2,9
E33028606,519,374,152,222,2,60,2,58,77,72,2,2,1,6
E33028607,322,216,105,111,2,45,3,42,51,37,4,8,2,8
E33028608,405,261,86,175,4,54,6,48,79,73,3,2,1,7
E33028609,277,187,59,128,5,37,5,32,43,37,1,3,2,5
E33028610,351,239,100,139,5,46,8,38,52,48,1,2,1,9
E33028611,309,226,107,119,3,20,3,17,56,50,1,4,1,4
E33028612,471,321,117,204,4,56,10,46,88,83,0,4,1,2
E33028613,543,378,143,235,2,60,12,48,98,90,3,3,2,5
E33028614,279,194,97,97,3,51,5,46,29,25,1,1,2,2
E33028615,274,209,95,114,0,18,3,15,39,39,0,0,0,8
E33028616,309,221,103,118,1,49,5,44,33,33,0,0,0,5
E33028617,349,244,91,153,1,31,4,27,66,64,1,1,0,7
E33028618,287,228,67,161,1,28,5,23,27,26,0,1,0,3
E33028619,459,362,132,230,1,25,6,19,69,61,0,5,3,2
E33028620,275,203,81,122,3,28,4,24,34,28,2,3,1,7
E33028621,239,183,93,90,1,16,2,14,35,34,0,1,0,4
E33028622,267,197,74,123,4,31,11,20,28,27,0,0,1,7
E33028623,256,200,84,116,0,15,6,9,35,33,0,2,0,6
E33028624,636,482,164,318,3,57,21,36,90,84,2,3,1,4
E33028625,467,282,103,179,3,45,12,33,133,128,3,1,1,4
E33028626,353,265,98,167,1,24,13,11,54,37,8,1,8,9
E33028627,321,207,76,131,4,32,4,28,66,60,2,4,0,12
E33028628,620,439,140,299,2,55,13,42,119,115,0,3,1,5
E33028629,262,161,81,80,3,14,3,11,71,63,6,2,0,13
E33028630,1307,836,251,585,10,87,18,69,346,165,110,8,63,28
E33028631,479,303,77,226,4,45,5,40,115,103,9,0,3,12
E33028632,288,208,78,130,3,16,1,15,54,49,2,3,0,7
E33028633,299,192,97,95,10,36,4,32,51,47,4,0,0,10
E33028634,275,140,55,85,0,23,3,20,98,42,38,1,17,14
E33028635,259,183,87,96,0,20,1,19,50,40,6,3,1,6
E33028636,242,159,70,89,1,22,2,20,56,48,4,1,3,4
E33028637,661,514,175,339,4,44,2,42,83,73,5,3,2,16
E33028638,299,231,83,148,2,14,4,10,47,43,1,3,0,5
E33028639,482,355,137,218,4,36,3,33,79,77,1,1,0,8
E33028640,270,209,69,140,4,26,7,19,29,18,6,5,0,2
E33028641,415,326,98,228,3,35,9,26,48,43,0,5,0,3
E33028642,257,196,94,102,1,18,3,15,37,33,3,1,0,5
E33028643,225,144,55,89,0,26,2,24,48,38,7,2,1,7
E33028644,300,221,90,131,0,31,2,29,43,41,1,1,0,5
E33028645,625,509,158,351,6,40,8,32,64,59,4,0,1,6
E33028646,315,243,77,166,1,35,8,27,34,33,0,1,0,2
E33028647,460,389,91,298,4,19,8,11,45,43,0,2,0,3
E33028648,267,219,63,156,0,8,0,8,38,37,0,1,0,2
E33028649,289,238,85,153,2,13,5,8,36,31,2,3,0,0
E33028650,946,703,265,438,6,84,22,62,144,133,1,8,2,9
E33028651,318,233,43,190,3,19,8,11,59,54,3,2,0,4
E33028652,276,219,98,121,1,6,0,6,48,36,6,6,0,2
E33028653,354,240,74,166,6,36,11,25,69,66,0,3,0,3
E33028654,910,653,206,447,7,76,37,39,169,155,2,12,0,5
E33028655,1139,976,213,763,4,26,7,19,124,107,5,10,2,9
E33028656,349,277,75,202,0,14,4,10,55,48,3,4,0,3
E33028657,337,247,40,207,1,16,7,9,70,69,1,0,0,3
E33028658,3062,2547,765,1782,7,75,31,44,420,406,2,8,4,13
E33028659,317,274,73,201,0,12,6,6,28,27,0,1,0,3
E33028660,248,220,83,137,1,4,3,1,22,20,0,2,0,1
E33028661,385,280,90,190,4,19,7,12,68,57,8,0,3,14
E33028662,621,492,172,320,0,63,40,23,66,61,1,4,0,0
E33028663,273,200,67,133,1,26,14,12,41,39,1,0,1,5
E33028664,309,247,68,179,0,15,1,14,47,44,1,2,0,0
E33028665,291,221,87,134,1,19,5,14,49,43,4,1,1,1
E33028666,283,194,60,134,0,42,3,39,43,39,0,0,4,4
E33028667,586,427,98,329,4,42,17,25,110,103,0,7,0,3
E33028668,402,322,96,226,1,26,5,21,51,49,0,2,0,2
E33028669,323,258,97,161,1,17,2,15,44,36,4,1,3,3
E33028670,435,330,108,222,3,43,11,32,54,50,0,4,0,5
E33028671,244,205,108,97,2,9,3,6,26,20,4,2,0,2
E33028672,340,240,84,156,0,36,10,26,62,57,0,5,0,2
E33028673,381,275,73,202,2,37,8,29,62,58,2,2,0,5
E33028674,500,330,98,232,2,73,11,62,90,85,1,3,1,5
E33028675,339,230,71,159,1,49,10,39,58,52,2,4,0,1
E33028676,624,398,97,301,2,46,10,36,176,165,3,7,1,2
E33028677,542,373,110,263,2,65,11,54,101,77,12,11,1,1
E33028678,571,385,121,264,2,49,17,32,130,115,5,8,2,5
E33028679,485,297,96,201,7,56,11,45,123,109,7,5,2,2
E33028680,518,364,96,268,1,52,13,39,96,88,1,5,2,5
E33028681,312,223,65,158,1,28,5,23,58,43,13,1,1,2
E33028682,521,356,128,228,7,53,32,21,98,78,1,10,9,7
E33028683,556,421,160,261,1,43,19,24,81,72,3,6,0,10
E33028684,324,253,83,170,2,15,9,6,49,46,1,1,1,5
E33028685,372,293,112,181,1,26,20,6,50,43,2,5,0,2
E33028686,629,486,160,326,1,31,17,14,101,89,3,9,0,10
E33028687,298,178,56,122,2,69,57,12,46,40,0,6,0,3
E33028688,394,282,100,182,1,44,22,22,66,55,1,10,0,1
E33028689,534,417,123,294,0,42,34,8,68,62,0,6,0,7
E33028690,588,445,157,288,0,57,34,23,82,77,0,5,0,4
E33028691,293,216,64,152,3,31,11,20,41,38,1,2,0,2
E33028692,501,424,162,262,0,23,15,8,52,46,0,6,0,2
E33028693,639,506,148,358,1,49,18,31,82,73,1,8,0,1
E33028694,280,200,48,152,1,23,14,9,51,49,0,1,1,5
E33028695,252,196,51,145,2,17,7,10,33,29,0,4,0,4
E33028696,520,372,117,255,1,53,34,19,92,85,2,5,0,2
E33028697,559,432,151,281,4,41,21,20,78,72,0,6,0,4
E33028698,240,186,67,119,2,11,7,4,41,39,1,1,0,0
E33028699,445,323,104,219,1,20,9,11,99,95,1,3,0,2
E33028700,505,374,113,261,5,41,20,21,83,74,0,8,1,2
E33028701,740,566,171,395,2,63,41,22,106,99,1,5,1,3
E33028702,608,466,153,313,2,42,24,18,97,91,0,5,1,1
E33028703,234,164,45,119,1,22,12,10,43,34,1,1,7,4
E33028704,339,255,70,185,2,32,15,17,49,43,1,4,1,1
E33028705,338,267,102,165,1,23,15,8,44,41,0,2,1,3
E33028706,445,359,108,251,2,19,10,9,65,60,0,5,0,0
E33028707,296,254,91,163,0,13,7,6,26,24,0,2,0,3
E33028708,286,245,106,139,1,20,6,14,19,13,0,4,2,1
E33028709,426,354,140,214,3,21,9,12,45,41,0,4,0,3
E33028710,235,146,45,101,0,22,8,14,66,60,1,5,0,1
E33028711,1170,848,279,569,4,113,65,48,194,178,1,13,2,11
E33028712,414,287,86,201,0,27,13,14,96,88,2,6,0,4
E33028713,679,526,158,368,0,19,9,10,129,118,3,8,0,5
E33028714,324,244,90,154,1,14,10,4,64,58,1,5,0,1
E33028715,788,553,157,396,8,84,42,42,138,129,0,9,0,5
E33028716,301,187,54,133,1,38,17,21,73,65,0,8,0,2
E33028717,243,190,48,142,0,17,5,12,35,32,0,3,0,1
E33028718,261,200,81,119,0,30,11,19,31,28,1,2,0,0
E33028719,453,295,114,181,3,36,16,20,115,103,4,7,1,4
E33028720,304,214,64,150,0,40,31,9,48,42,0,5,1,2
E33028721,261,205,74,131,0,13,8,5,36,27,0,9,0,7
E33028722,297,233,63,170,1,25,5,20,37,36,0,1,0,1
E33028723,301,256,79,177,2,16,4,12,27,22,0,5,0,0
E33028724,467,361,100,261,1,27,18,9,75,69,3,3,0,3
E33028725,301,253,99,154,0,23,15,8,21,21,0,0,0,4
E33028726,738,546,156,390,2,69,30,39,117,106,3,8,0,4
E33028727,281,210,76,134,2,36,14,22,32,29,0,3,0,1
E33028728,259,182,60,122,0,45,29,16,30,26,0,3,1,2
E33028729,704,515,162,353,6,51,27,24,122,115,0,7,0,10
E33028730,342,240,80,160,2,38,26,12,59,53,0,6,0,3
E33028731,344,279,112,167,0,20,14,6,45,38,1,6,0,0
E33028732,1024,737,253,484,5,128,52,76,150,143,0,7,0,4
E33028733,267,208,91,117,0,13,6,7,38,30,2,6,0,8
E33028734,367,308,132,176,0,19,13,6,36,25,2,7,2,4
E33028735,625,429,131,298,5,65,31,34,115,109,0,5,1,11
E33028736,401,305,112,193,0,39,19,20,53,43,4,2,4,4
E33028737,271,213,89,124,0,20,7,13,33,27,1,5,0,5
E33028738,308,227,76,151,0,24,10,14,55,44,7,3,1,2
E33028739,367,309,82,227,2,4,3,1,47,43,0,4,0,5
E33028740,373,300,108,192,1,21,12,9,48,43,2,3,0,3
E33028741,302,220,82,138,6,26,15,11,44,36,3,5,0,6
E33028742,359,251,94,157,2,39,24,15,63,58,4,1,0,4
E33028743,298,231,118,113,5,17,10,7,41,36,1,4,0,4
E33028744,248,207,98,109,0,15,12,3,20,19,0,1,0,6
E33028745,399,310,103,207,2,29,19,10,53,46,0,7,0,5
E33028746,662,292,112,180,1,52,29,23,315,286,19,8,2,2
E33028747,329,245,92,153,5,23,17,6,42,30,5,6,1,14
E33028748,420,309,141,168,10,36,26,10,61,55,4,2,0,4
E33028749,273,203,83,120,2,20,16,4,44,36,0,6,2,4
E33028750,246,164,82,82,0,12,9,3,51,46,4,1,0,19
E33028751,353,269,128,141,1,29,21,8,43,36,1,4,2,11
E33028752,245,172,74,98,2,28,23,5,36,30,3,1,2,7
E33028753,350,272,94,178,5,21,10,11,47,41,2,3,1,5
E33028754,253,192,90,102,1,19,17,2,37,31,5,0,1,4
E33028755,463,340,147,193,0,66,37,29,55,49,2,4,0,2
E33028756,556,411,129,282,8,44,26,18,87,83,1,3,0,6
E33028757,317,217,105,112,5,30,21,9,61,57,0,4,0,4
E33028758,280,179,76,103,1,34,5,29,30,26,1,2,1,36
E33028759,270,163,54,109,0,29,2,27,40,31,5,2,2,38
E33028760,404,267,117,150,0,26,9,17,64,55,6,3,0,47
E33028761,376,246,105,141,3,16,2,14,39,36,1,1,1,72
E33028762,493,295,87,208,9,28,11,17,70,58,3,8,1,91
E33028763,659,363,121,242,7,84,32,52,180,158,16,3,3,25
E33028764,462,291,91,200,9,56,28,28,99,91,1,7,0,7
E33028765,289,190,65,125,6,38,20,18,50,49,0,1,0,5
E33028766,375,215,65,150,4,48,18,30,89,80,4,5,0,19
E33028767,573,335,106,229,11,65,19,46,133,116,8,8,1,29
E33028768,416,266,87,179,4,31,7,24,105,92,3,8,2,10
E33028769,274,165,55,110,7,51,24,27,46,41,0,5,0,5
E33028770,385,281,58,223,2,30,21,9,69,65,1,3,0,3
E33028771,342,279,34,245,1,5,3,2,57,55,0,2,0,0
E33028772,497,359,50,309,2,18,12,6,116,108,0,6,2,2
E33028773,698,459,104,355,26,76,15,61,132,122,4,5,1,5
E33028774,345,239,36,203,16,46,3,43,42,37,0,5,0,2
E33028775,301,212,48,164,12,34,10,24,42,40,0,2,0,1
E33028776,858,607,149,458,17,102,49,53,126,90,15,5,16,6
E33028777,241,172,41,131,7,19,6,13,38,34,0,4,0,5
E33028778,330,253,79,174,1,22,8,14,43,38,2,3,0,11
E33028779,252,197,66,131,0,33,21,12,20,19,0,1,0,2
E33028780,238,166,59,107,3,25,7,18,42,38,1,1,2,2
E33028781,250,186,74,112,2,22,9,13,34,25,5,3,1,6
E33028782,348,260,84,176,5,32,14,18,42,39,2,1,0,9
E33028783,383,282,78,204,6,51,12,39,42,40,1,1,0,2
E33028784,1221,842,186,656,13,158,55,103,206,186,5,12,3,2
E33028785,485,376,97,279,5,30,9,21,70,66,1,3,0,4
E33028786,250,173,39,134,2,18,7,11,56,50,1,5,0,1
E33028787,1232,874,231,643,22,113,31,82,216,203,0,11,2,7
E33028788,484,359,78,281,4,32,10,22,84,76,0,8,0,5
E33028789,985,746,159,587,9,53,22,31,169,149,0,18,2,8
E33028790,271,197,54,143,2,14,4,10,57,55,0,2,0,1
E33028791,519,329,67,262,5,44,16,28,132,122,3,4,3,9
E33028792,289,188,27,161,8,24,4,20,67,64,0,3,0,2
E33028793,326,233,43,190,3,32,8,24,53,49,2,2,0,5
E33028794,367,224,33,191,7,25,8,17,108,102,1,4,1,3
E33028795,458,268,55,213,11,50,10,40,125,117,0,8,0,4
E33028796,389,258,74,184,3,35,10,25,93,88,0,5,0,0
E33028797,310,213,69,144,5,36,22,14,53,46,5,2,0,3
E33028798,639,371,103,268,5,102,62,40,156,142,1,13,0,5
E33028799,286,137,44,93,0,94,65,29,54,47,1,6,0,1
E33028800,352,233,98,135,4,38,19,19,74,71,1,2,0,3
E33028801,535,401,108,293,0,36,23,13,94,84,0,10,0,4
E33028802,512,357,75,282,3,31,18,13,119,109,0,9,1,2
E33028803,379,299,83,216,1,28,15,13,50,47,1,2,0,1
E33028804,317,256,79,177,0,25,22,3,33,28,0,5,0,3
E33028805,329,253,109,144,1,27,16,11,41,35,1,4,1,7
E33028806,315,196,58,138,2,59,49,10,57,51,1,5,0,1
E33028807,623,406,97,309,3,67,39,28,140,133,2,3,2,7
E33028808,369,287,59,228,0,31,10,21,47,44,1,2,0,4
E33028809,408,269,78,191,2,59,40,19,76,70,0,6,0,2
E33028810,448,330,111,219,2,53,33,20,58,54,2,2,0,5
E33028811,379,309,41,268,5,11,9,2,52,52,0,0,0,2
E33028812,298,240,26,214,0,9,8,1,49,44,1,4,0,0
E33028813,332,285,46,239,0,9,7,2,35,34,0,1,0,3
E33028814,441,308,69,239,8,48,41,7,71,67,0,4,0,6
E33028815,489,378,102,276,5,34,18,16,69,60,0,9,0,3
E33028816,2914,2083,493,1590,27,80,39,41,708,675,2,25,6,16
E33028817,272,175,63,112,2,35,25,10,55,52,0,2,1,5
E33028818,231,128,32,96,3,26,16,10,70,64,0,6,0,4
E33028819,688,468,100,368,12,27,14,13,176,162,4,10,0,5
E33028820,796,456,109,347,6,44,25,19,283,269,3,9,2,7
E33028821,698,468,95,373,3,34,21,13,190,186,0,3,1,3
E33028822,555,370,82,288,5,15,7,8,162,155,2,4,1,3
E33028823,3149,1825,441,1384,38,125,65,60,1145,1094,7,39,5,16
E33028824,309,202,64,138,2,23,11,12,80,80,0,0,0,2
E33028825,4334,2815,638,2177,41,160,84,76,1297,1222,5,52,18,21
E33028826,1821,1124,257,867,22,70,38,32,590,555,2,28,5,15
E33028827,984,657,168,489,7,32,20,12,280,263,0,14,3,8
E33028828,363,234,60,174,1,27,9,18,98,93,0,4,1,3
E33028829,2732,1773,499,1274,16,97,49,48,829,805,0,19,5,17
E33028830,2826,1473,400,1073,18,152,72,80,1167,1126,1,33,7,16
E33028831,1673,1126,294,832,12,47,23,24,483,472,1,7,3,5
E33028832,2642,1814,455,1359,19,109,47,62,690,662,1,22,5,10
E33028833,1985,1348,335,1013,17,66,28,38,545,519,1,23,2,9
E33028834,268,167,32,135,3,10,2,8,85,82,0,3,0,3
E33028835,822,525,146,379,7,31,13,18,255,238,1,13,3,4
E33028836,533,279,72,207,5,48,26,22,196,189,1,5,1,5
E33028837,549,323,103,220,7,27,14,13,174,170,0,3,1,18
E33028838,588,343,95,248,5,30,19,11,203,192,1,10,0,7
E33028839,353,232,54,178,3,8,5,3,109,108,1,0,0,1
E33028840,858,541,139,402,8,37,19,18,256,242,0,12,2,16
E33028841,253,102,33,69,2,26,11,15,119,116,1,2,0,4
E33028842,178,96,32,64,0,7,6,1,73,70,0,3,0,2
E33028843,807,473,122,351,8,50,23,27,268,258,0,8,2,8
E33028844,1006,619,169,450,9,86,50,36,285,276,1,8,0,7
E33028845,998,612,135,477,18,44,12,32,317,300,2,11,4,7
E33028846,544,335,95,240,5,36,16,20,165,159,0,5,1,3
E33028847,412,255,73,182,4,43,30,13,109,106,0,3,0,1
E33028848,468,303,84,219,3,17,5,12,143,136,0,7,0,2
E33028849,2379,1657,365,1292,20,94,57,37,602,584,1,14,3,6
E33028850,328,214,64,150,6,39,21,18,69,63,0,6,0,0
E33028851,1520,935,241,694,31,78,43,35,465,443,4,12,6,11
E33028852,1987,1084,225,859,20,81,35,46,782,745,5,26,6,20
E33028853,766,406,86,320,10,24,15,9,320,311,1,8,0,6
E33028854,4098,2922,677,2245,42,180,88,92,931,893,2,29,7,23
E33028855,368,228,65,163,9,28,18,10,103,94,1,6,2,0
E33028856,253,159,42,117,2,25,16,9,67,64,1,2,0,0
E33028857,1150,696,176,520,11,52,31,21,385,368,0,15,2,6
E33028858,874,439,130,309,13,54,23,31,363,349,1,10,3,5
E33028859,2059,1234,331,903,17,82,41,41,709,678,7,19,5,17
E33028860,347,203,53,150,3,20,9,11,119,115,0,0,4,2
E33028861,445,346,102,244,4,11,4,7,80,76,2,2,0,4
E33028862,227,174,53,121,1,3,2,1,47,39,1,2,5,2
E33028863,651,370,82,288,4,30,15,15,241,232,2,7,0,6
E33028864,2761,1683,436,1247,33,151,76,75,873,813,2,45,13,21
E33028865,279,114,20,94,5,26,13,13,127,126,1,0,0,7
E33028866,160,97,21,76,3,16,8,8,42,40,1,1,0,2
E33028867,308,230,72,158,1,9,6,3,65,57,0,6,2,3
E33028868,341,200,61,139,5,21,11,10,111,108,1,1,1,4
E33028869,5321,2702,697,2005,38,218,102,116,2333,2280,6,33,14,30
E33028870,281,178,59,119,1,22,11,11,80,74,0,5,1,0
E33028871,459,347,102,245,4,29,11,18,75,71,0,4,0,4
E33028872,951,655,186,469,24,72,42,30,195,184,0,9,2,5
E33028873,319,157,56,101,4,47,23,24,107,104,0,3,0,4
E33028874,217,105,30,75,3,25,17,8,83,71,0,4,8,1
E33028875,2017,1320,241,1079,14,76,35,41,598,582,3,11,2,9
E33028876,383,225,62,163,3,32,19,13,118,113,0,2,3,5
E33028877,299,219,56,163,1,22,7,15,55,51,0,4,0,2
E33028878,522,326,110,216,2,46,28,18,142,135,1,5,1,6
E33028879,609,394,108,286,10,21,7,14,176,164,3,9,0,8
E33028880,522,349,110,239,5,38,11,27,128,120,1,6,1,2
E33028881,1516,922,217,705,15,73,37,36,498,473,4,19,2,8
E33028882,705,460,117,343,11,44,22,22,188,179,0,8,1,2
E33028883,378,226,68,158,4,23,10,13,123,117,1,4,1,2
E33028884,256,185,51,134,2,7,3,4,60,57,0,2,1,2
E33028885,1507,926,237,689,13,60,33,27,501,475,2,23,1,7
E33028886,260,206,45,161,1,12,10,2,41,39,0,2,0,0
E33028887,285,183,48,135,2,31,17,14,63,57,1,3,2,6
E33028888,266,195,61,134,4,19,8,11,45,41,1,2,1,3
E33028889,380,258,82,176,9,17,8,9,92,87,0,4,1,4
E33028890,379,268,49,219,1,20,12,8,88,80,0,3,5,2
E33028891,456,319,73,246,3,21,9,12,111,104,2,4,1,2
E33028892,423,264,70,194,5,21,10,11,131,123,0,7,1,2
E33028893,2244,1230,286,944,27,77,30,47,898,849,3,42,4,12
E33028894,927,624,144,480,5,50,28,22,244,233,0,10,1,4
E33028895,222,149,47,102,0,17,9,8,53,49,1,2,1,3
E33028896,402,241,48,193,6,37,20,17,114,100,5,6,3,4
E33028897,469,294,93,201,3,26,12,14,143,136,0,4,3,3
E33028898,1694,1099,263,836,13,91,46,45,481,449,7,24,1,10
E33028899,531,290,92,198,9,47,21,26,182,177,1,4,0,3
E33028900,612,412,122,290,10,24,13,11,163,158,0,5,0,3
E33028901,1702,1020,220,800,20,123,65,58,527,498,4,23,2,12
E33028902,450,245,58,187,2,34,19,15,166,159,0,6,1,3
E33028903,1983,1256,299,957,25,121,43,78,573,537,2,29,5,8
E33028904,1716,1121,242,879,14,66,33,33,505,479,3,22,1,10
E33028905,753,494,138,356,12,29,16,13,209,197,2,9,1,9
E33028906,211,117,19,98,6,11,4,7,73,67,1,5,0,4
E33028907,257,163,50,113,5,21,6,15,67,66,0,1,0,1
E33028908,2820,1784,424,1360,27,119,58,61,877,840,5,25,7,13
E33028909,1384,958,247,711,15,74,35,39,330,310,3,14,3,7
E33028910,1846,974,218,756,51,378,174,204,424,402,3,15,4,19
E33028911,4271,2713,559,2154,55,425,245,180,1050,999,9,32,10,28
E33028912,1416,874,224,650,17,76,40,36,440,422,1,11,6,9
E33028913,248,146,47,99,5,35,19,16,60,54,1,5,0,2
E33028914,5327,3099,784,2315,63,175,95,80,1954,1865,1,83,5,36
E33028915,320,177,48,129,3,16,11,5,118,114,0,2,2,6
E33028916,369,224,57,167,5,20,7,13,113,105,0,6,2,7
E33028917,1091,675,137,538,11,59,20,39,339,328,0,9,2,7
E33028918,960,632,148,484,9,64,32,32,251,239,1,11,0,4
E33028919,207,115,30,85,1,11,8,3,77,75,1,1,0,3
E33028920,941,639,157,482,5,68,46,22,223,210,2,9,2,6
E33028921,391,217,65,152,4,32,16,16,136,128,0,5,3,2
E33028922,215,124,41,83,7,15,6,9,66,61,0,5,0,3
E33028923,853,534,120,414,19,72,36,36,225,211,3,11,0,3
E33028924,274,183,44,139,1,27,18,9,60,54,0,4,2,3
E33028925,228,110,21,89,2,20,12,8,95,90,1,4,0,1
E33028926,1183,684,206,478,17,109,64,45,363,344,2,13,4,10
E33028927,520,335,89,246,2,25,10,15,154,146,0,8,0,4
E33028928,208,160,44,116,2,9,5,4,37,32,0,2,3,0
E33028929,610,378,93,285,7,27,13,14,196,190,1,5,0,2
E33028930,1218,696,161,535,18,74,36,38,423,407,1,13,2,7
E33028931,387,248,58,190,3,13,4,9,122,109,1,8,4,1
E33028932,858,511,120,391,12,90,42,48,241,233,0,7,1,4
E33028933,456,244,56,188,4,32,16,16,172,163,0,9,0,4
E33028934,599,442,89,353,5,31,16,15,118,111,1,6,0,3
E33028935,977,593,140,453,6,44,19,25,327,305,0,21,1,7
E33028936,1112,798,189,609,12,37,28,9,260,247,0,13,0,5
E33028937,836,520,116,404,7,48,20,28,256,247,1,8,0,5
E33028938,237,123,49,74,5,19,8,11,86,84,1,1,0,4
E33028939,338,255,90,165,0,25,13,12,55,50,0,5,0,3
E33028940,932,535,149,386,9,127,73,54,253,243,3,5,2,8
E33028941,1400,960,183,777,12,50,22,28,375,357,1,12,5,3
E33028942,501,331,68,263,4,28,13,15,136,134,1,1,0,2
E33028943,2344,1675,359,1316,21,84,35,49,555,532,1,18,4,9
E33028944,908,583,117,466,12,62,33,29,244,225,1,16,2,7
E33028945,1469,1009,230,779,27,83,42,41,339,314,2,20,3,11
E33028946,512,408,106,302,0,21,11,10,82,75,1,6,0,1
E33028947,539,376,87,289,3,30,13,17,130,125,0,4,1,0
E33028948,1192,907,219,688,5,47,22,25,230,221,1,8,0,3
E33028949,503,384,103,281,4,22,9,13,92,90,0,1,1,1
E33028950,249,159,51,108,4,24,13,11,62,60,0,1,1,0
E33028951,1171,850,210,640,17,50,22,28,251,231,2,16,2,3
E33028952,744,506,113,393,5,38,19,19,192,183,0,8,1,3
E33028953,1919,1000,291,709,14,75,36,39,821,803,2,12,4,9
E33028954,471,288,64,224,8,52,29,23,114,112,0,0,2,9
E33028955,273,129,44,85,6,57,25,32,80,75,0,3,2,1
E33028956,2521,1883,368,1515,10,87,45,42,527,495,3,28,1,14
E33028957,666,446,92,354,7,32,14,18,175,169,2,4,0,6
E33028958,302,71,18,53,8,43,18,25,180,178,0,2,0,0
E33028959,1020,720,155,565,9,33,20,13,254,242,0,10,2,4
E33028960,1056,809,161,648,17,93,42,51,128,119,2,5,2,9
E33028961,279,205,46,159,3,14,7,7,55,49,1,4,1,2
E33028962,962,743,169,574,7,25,15,10,183,176,0,6,1,4
E33028963,856,602,159,443,5,37,18,19,207,198,2,7,0,5
E33028964,1566,827,231,596,20,217,124,93,491,473,1,10,7,11
E33028965,971,709,139,570,6,34,20,14,214,208,0,6,0,8
E33028966,778,545,147,398,7,42,21,21,179,171,2,6,0,5
E33028967,403,303,78,225,2,11,6,5,86,84,0,1,1,1
E33028968,1169,804,176,628,13,72,36,36,274,260,1,12,1,6
E33028969,679,420,106,314,5,56,29,27,194,184,1,7,2,4
E33028970,1104,865,207,658,9,45,28,17,179,171,0,8,0,6
E33028971,729,568,140,428,7,30,20,10,123,117,0,6,0,1
E33028972,1245,894,195,699,11,36,13,23,297,287,0,8,2,7
E33028973,910,587,153,434,12,51,27,24,255,244,1,9,1,5
E33028974,1232,856,207,649,6,34,12,22,327,313,2,10,2,9
E33028975,1162,811,173,638,12,43,20,23,289,280,1,8,0,7
E33028976,350,224,45,179,2,31,19,12,91,84,0,7,0,2
E33028977,2453,1678,363,1315,25,87,38,49,647,620,2,16,9,16
E33028978,529,357,94,263,2,23,15,8,146,136,1,8,1,1
E33028979,268,183,59,124,2,10,5,5,71,68,1,2,0,2
E33028980,671,490,113,377,9,29,14,15,140,132,0,8,0,3
E33028981,474,349,79,270,5,27,11,16,91,85,0,3,3,2
E33028982,1682,1226,311,915,23,54,34,20,374,362,3,7,2,5
E33028983,1657,1230,256,974,16,53,20,33,346,323,1,19,3,12
E33028984,339,231,48,183,6,23,11,12,78,76,0,1,1,1
E33028985,254,146,40,106,0,21,10,11,87,83,0,4,0,0
E33028986,250,132,28,104,4,40,18,22,74,70,0,4,0,0
E33028987,723,587,141,446,7,27,12,15,102,97,1,3,1,0
E33028988,1025,693,172,521,15,37,14,23,271,258,3,8,2,9
E33028989,254,157,46,111,5,25,20,5,65,64,0,1,0,2
E33028990,395,273,60,213,6,21,12,9,93,85,0,7,1,2
E33028991,1507,847,166,681,9,78,38,40,562,543,0,14,5,11
E33028992,343,163,37,126,5,31,17,14,139,136,0,3,0,5
E33028993,482,312,66,246,7,24,10,14,135,127,1,5,2,4
E33028994,431,264,67,197,6,29,21,8,128,121,1,6,0,4
E33028995,370,231,73,158,4,21,11,10,110,107,0,1,2,4
E33028996,3918,2946,717,2229,38,178,75,103,739,702,8,27,2,17
E33028997,1788,1310,339,971,10,71,32,39,381,356,1,23,1,16
E33028998,708,489,129,360,11,34,13,21,170,163,1,6,0,4
E33028999,1205,837,164,673,9,52,22,30,296,284,1,9,2,11
E33029000,432,299,66,233,3,16,7,9,112,106,2,3,1,2
E33029001,433,306,57,249,8,21,9,12,98,91,1,5,1,0
E33029002,1355,928,207,721,21,64,26,38,337,327,2,8,0,5
E33029003,1993,1421,316,1105,18,75,47,28,473,454,1,17,1,6
E33029004,2607,1895,431,1464,22,86,44,42,589,556,1,26,6,15
E33029005,708,484,124,360,6,35,18,17,179,167,2,10,0,4
E33029006,626,448,112,336,5,15,6,9,156,146,3,6,1,2
E33029007,1112,790,189,601,13,43,28,15,263,249,0,13,1,3
E33029008,564,433,128,305,4,29,12,17,96,88,1,5,2,2
E33029009,1000,690,144,546,14,132,90,42,159,146,2,9,2,5
E33029010,385,172,58,114,3,116,93,23,93,88,0,3,2,1
E33029011,638,442,110,332,11,100,69,31,80,79,0,0,1,5
E33029012,378,193,51,142,4,102,74,28,77,73,0,3,1,2
E33029013,230,105,24,81,2,66,52,14,55,55,0,0,0,2
E33029014,339,208,52,156,2,51,44,7,78,76,0,2,0,0
E33029015,652,465,111,354,16,71,47,24,100,93,1,5,1,0
E33029016,231,138,40,98,0,48,30,18,45,40,0,4,1,0
E33029017,343,218,65,153,7,62,39,23,52,46,1,5,0,4
E33029018,345,230,59,171,5,57,40,17,48,40,2,5,1,5
E33029019,428,291,74,217,7,71,55,16,59,57,0,2,0,0
E33029020,324,155,43,112,9,99,56,43,59,55,0,2,2,2
E33029021,258,168,41,127,10,36,34,2,43,38,2,3,0,1
E33029022,334,231,78,153,7,64,56,8,32,27,0,5,0,0
E33029023,1642,1133,319,814,10,311,253,58,182,171,1,8,2,6
E33029024,4306,3516,976,2540,22,425,322,103,333,315,2,13,3,10
E33029025,494,321,71,250,3,80,60,20,84,80,0,4,0,6
E33029026,673,430,109,321,13,126,90,36,100,100,0,0,0,4
E33029027,1284,853,190,663,14,227,156,71,184,171,1,10,2,6
E33029028,234,135,31,104,0,47,28,19,52,48,2,2,0,0
E33029029,592,289,72,217,6,192,162,30,104,100,0,3,1,1
E33029030,685,442,132,310,8,129,96,33,101,93,1,5,2,5
E33029031,933,657,161,496,6,132,105,27,130,122,1,5,2,8
E33029032,2122,1456,438,1018,41,246,140,106,364,354,2,7,1,15
E33029033,244,102,36,66,4,22,11,11,111,107,1,1,2,5
E33029034,360,140,40,100,4,39,19,20,175,169,0,3,3,2
E33029035,522,327,107,220,10,77,36,41,106,100,0,4,2,2
E33029036,1068,709,210,499,23,85,49,36,245,234,1,8,2,6
E33029037,1650,1230,318,912,30,142,69,73,238,217,6,14,1,10
E33029038,680,461,92,369,9,47,24,23,156,154,0,2,0,7
E33029039,360,181,56,125,6,65,41,24,102,96,0,6,0,6
E33029040,313,180,54,126,0,38,25,13,93,89,3,0,1,2
E33029041,355,207,70,137,5,20,14,6,119,114,2,3,0,4
E33029042,232,139,46,93,2,30,23,7,60,57,0,2,1,1
E33029043,1246,701,216,485,12,197,118,79,326,318,0,7,1,10
E33029044,214,109,29,80,0,28,18,10,72,65,1,3,3,5
E33029045,367,236,89,147,3,20,11,9,100,100,0,0,0,8
E33029046,259,170,62,108,5,22,16,6,58,52,2,3,1,4
E33029047,238,132,44,88,1,14,6,8,89,80,4,5,0,2
E33029048,243,176,58,118,6,7,3,4,52,49,0,3,0,2
E33029049,366,261,88,173,3,35,19,16,66,65,0,1,0,1
E33029050,1396,727,233,494,23,238,107,131,390,368,2,16,4,18
E33029051,235,125,46,79,2,24,8,16,75,73,0,2,0,9
E33029052,301,192,77,115,3,33,16,17,71,68,1,2,0,2
E33029053,276,173,70,103,0,30,20,10,69,66,0,3,0,4
E33029054,337,209,59,150,10,39,24,15,76,70,1,3,2,3
E33029055,307,169,66,103,3,40,16,24,92,89,0,3,0,3
E33029056,404,244,85,159,1,47,26,21,104,95,2,4,3,8
E33029057,309,153,43,110,5,32,20,12,113,109,0,4,0,6
E33029058,348,195,65,130,2,25,17,8,122,119,0,3,0,4
E33029059,403,215,72,143,3,38,24,14,144,137,2,4,1,3
E33029060,847,516,183,333,9,80,42,38,234,230,0,3,1,8
E33029061,240,130,50,80,1,36,28,8,68,63,0,5,0,5
E33029062,238,162,40,122,1,14,7,7,56,54,0,2,0,5
E33029063,228,140,40,100,1,11,7,4,63,60,0,3,0,13
E33029064,1238,805,262,543,10,104,49,55,312,301,2,9,0,7
E33029065,204,106,17,89,1,31,17,14,63,60,0,2,1,3
E33029066,423,264,91,173,7,59,38,21,90,87,1,1,1,3
E33029067,724,455,136,319,6,109,66,43,150,141,1,5,3,4
E33029068,513,325,104,221,5,59,33,26,120,118,0,2,0,4
E33029069,358,266,65,201,2,25,14,11,63,55,1,7,0,2
E33029070,285,168,51,117,4,37,23,14,71,67,0,4,0,5
E33029071,360,200,58,142,6,72,42,30,75,74,0,1,0,7
E33029072,210,139,30,109,3,12,3,9,52,48,1,1,2,4
E33029073,484,39,12,27,0,4,1,3,49,44,0,1,4,392
E33029074,908,492,170,322,2,65,32,33,343,324,9,5,5,6
E33029075,566,399,130,269,5,48,29,19,109,103,0,4,2,5
E33029076,496,308,86,222,8,47,34,13,126,120,1,4,1,7
E33029077,294,193,42,151,1,28,15,13,69,66,1,2,0,3
E33029078,268,181,45,136,3,20,9,11,61,58,0,3,0,3
E33029079,543,386,105,281,10,70,43,27,69,65,0,4,0,8
E33029080,254,162,52,110,3,30,15,15,59,55,2,1,1,0
E33029081,249,150,51,99,3,36,27,9,57,49,2,5,1,3
E33029082,437,268,91,177,5,31,21,10,124,110,0,10,4,9
E33029083,2463,1554,520,1034,38,325,177,148,525,488,8,24,5,21
E33029084,266,167,56,111,4,19,11,8,72,68,0,4,0,4
E33029085,459,254,83,171,2,32,14,18,168,161,0,7,0,3
E33029086,214,147,42,105,2,14,6,8,51,48,0,3,0,0
E33029087,227,137,45,92,0,24,16,8,66,65,0,1,0,0
E33029088,534,335,101,234,4,79,38,41,110,99,1,4,6,6
E33029089,294,208,45,163,1,20,14,6,56,51,0,5,0,9
E33029090,702,317,99,218,3,130,83,47,248,235,0,10,3,4
E33029091,397,252,68,184,8,49,30,19,86,81,0,3,2,2
E33029092,422,186,66,120,1,37,20,17,195,190,2,2,1,3
E33029093,227,146,45,101,0,16,9,7,59,58,0,0,1,6
E33029094,259,134,52,82,0,54,22,32,69,65,0,3,1,2
E33029095,925,523,119,404,15,172,84,88,210,202,1,7,0,5
E33029096,231,181,58,123,2,15,7,8,32,30,0,2,0,1
E33029097,282,174,51,123,4,43,14,29,61,49,9,2,1,0
E33029098,492,374,93,281,9,46,13,33,63,58,1,3,1,0
E33029099,437,315,75,240,3,64,16,48,55,54,0,1,0,0
E33029100,238,188,52,136,2,24,8,16,24,18,0,6,0,0
E33029101,242,161,52,109,1,40,15,25,40,38,1,1,0,0
E33029102,901,625,162,463,6,126,68,58,135,126,0,9,0,9
E33029103,292,178,40,138,5,51,30,21,54,46,1,6,1,4
E33029104,266,195,57,138,3,33,9,24,32,26,1,3,2,3
E33029105,656,422,100,322,11,133,54,79,87,83,0,4,0,3
E33029106,261,153,36,117,1,41,22,19,65,62,0,2,1,1
E33029107,617,510,147,363,5,38,9,29,61,55,2,3,1,3
E33029108,1452,1013,251,762,16,232,66,166,183,166,2,14,1,8
E33029109,799,575,141,434,14,98,47,51,112,106,1,5,0,0
E33029110,251,167,51,116,2,24,9,15,54,51,0,3,0,4
E33029111,268,180,49,131,3,40,17,23,45,38,0,6,1,0
E33029112,708,470,117,353,2,122,46,76,110,103,1,4,2,4
E33029113,568,433,124,309,6,54,21,33,73,70,2,1,0,2
E33029114,536,369,116,253,7,96,29,67,61,60,0,1,0,3
E33029115,735,512,127,385,9,103,44,59,105,98,0,6,1,6
E33029116,405,265,74,191,8,59,38,21,70,66,0,3,1,3
E33029117,312,197,43,154,2,43,16,27,66,61,1,4,0,4
E33029118,661,489,116,373,9,92,34,58,68,67,0,1,0,3
E33029119,769,532,133,399,15,114,42,72,105,97,0,8,0,3
E33029120,811,621,161,460,14,80,30,50,95,85,0,10,0,1
E33029121,395,226,65,161,5,103,50,53,59,56,0,3,0,2
E33029122,222,154,39,115,4,31,17,14,31,29,0,2,0,2
E33029123,377,217,63,154,6,67,19,48,81,74,0,7,0,6
E33029124,288,165,42,123,6,80,36,44,36,30,0,5,1,1
E33029125,229,149,41,108,3,33,19,14,42,40,0,2,0,2
E33029126,637,371,82,289,6,104,49,55,154,147,1,5,1,2
E33029127,268,183,65,118,2,34,12,22,48,43,0,4,1,1
E33029128,693,458,108,350,6,112,55,57,114,105,0,6,3,3
E33029129,214,142,42,100,4,32,9,23,32,30,0,2,0,4
E33029130,366,244,57,187,4,65,31,34,51,45,2,3,1,2
E33029131,1846,1326,402,924,20,265,87,178,224,213,2,8,1,11
E33029132,311,212,56,156,5,53,21,32,40,39,0,1,0,1
E33029133,160,115,31,84,1,19,7,12,24,21,0,3,0,1
E33029134,260,187,41,146,2,38,13,25,33,31,0,2,0,0
E33029135,1060,848,218,630,15,81,37,44,111,98,1,12,0,5
E33029136,351,199,58,141,7,55,24,31,90,90,0,0,0,0
E33029137,266,184,38,146,2,30,7,23,48,46,0,2,0,2
E33029138,722,464,113,351,13,129,37,92,114,110,0,3,1,2
E33029139,297,191,50,141,5,43,14,29,55,52,0,3,0,3
E33029140,211,155,33,122,4,23,3,20,29,26,0,1,2,0
E33029141,338,246,66,180,7,46,19,27,36,33,0,3,0,3
E33029142,202,144,31,113,1,31,10,21,26,25,0,1,0,0
E33029143,486,298,59,239,8,90,25,65,88,83,0,4,1,2
E33029144,742,377,94,283,12,100,43,57,246,233,3,10,0,7
E33029145,461,319,72,247,10,64,19,45,65,63,0,2,0,3
E33029146,812,454,137,317,5,68,35,33,275,255,0,17,3,10
E33029147,469,228,49,179,7,78,48,30,155,151,1,3,0,1
E33029148,341,188,57,131,5,40,15,25,105,96,2,1,6,3
E33029149,570,384,103,281,10,64,24,40,104,95,0,4,5,8
E33029150,301,127,38,89,3,45,16,29,120,117,2,0,1,6
E33029151,779,387,142,245,7,197,100,97,184,175,0,7,2,4
E33029152,335,168,56,112,5,41,14,27,115,106,3,2,4,6
E33029153,375,269,101,168,0,25,13,12,77,76,0,0,1,4
E33029154,460,252,71,181,4,72,42,30,130,121,0,9,0,2
E33029155,395,198,77,121,5,52,27,25,136,129,0,6,1,4
E33029156,348,194,58,136,2,47,26,21,105,102,0,3,0,0
E33029157,410,233,72,161,9,44,20,24,121,117,0,4,0,3
E33029158,396,269,102,167,2,39,23,16,83,72,2,6,3,3
E33029159,534,316,118,198,3,50,25,25,164,150,2,11,1,1
E33029160,867,453,129,324,10,112,63,49,282,267,2,13,0,10
E33029161,482,268,61,207,3,59,28,31,149,143,0,5,1,3
E33029162,504,243,75,168,6,106,53,53,146,138,1,7,0,3
E33029163,492,270,67,203,5,41,21,20,175,166,1,6,2,1
E33029164,639,347,109,238,13,72,35,37,201,193,1,6,1,6
E33029165,384,193,62,131,6,51,30,21,131,127,1,2,1,3
E33029166,625,308,73,235,12,120,48,72,180,172,0,5,3,5
E33029167,678,436,141,295,10,93,43,50,134,127,0,7,0,5
E33029168,165,115,32,83,1,15,4,11,31,28,2,1,0,3
E33029169,1019,671,222,449,15,117,57,60,209,200,3,3,3,7
E33029170,777,414,127,287,11,89,53,36,258,252,1,5,0,5
E33029171,748,381,125,256,8,68,31,37,287,275,2,8,2,4
E33029172,261,133,31,102,6,46,22,24,75,72,0,2,1,1
E33029173,379,246,83,163,3,29,12,17,99,92,1,5,1,2
E33029174,277,158,52,106,6,54,22,32,54,54,0,0,0,5
E33029175,644,462,90,372,9,49,17,32,121,106,2,11,2,3
E33029176,478,261,66,195,4,78,39,39,127,120,2,1,4,8
E33029177,309,129,39,90,10,81,35,46,89,83,2,4,0,0
E33029178,784,602,160,442,12,44,8,36,125,109,2,12,2,1
E33029179,771,586,171,415,4,95,31,64,80,75,0,5,0,6
E33029180,1778,1278,269,1009,25,142,52,90,329,307,2,16,4,4
E33029181,734,497,127,370,19,110,26,84,100,94,1,4,1,8
E33029182,751,509,129,380,4,118,28,90,114,109,0,4,1,6
E33029183,227,159,47,112,3,36,9,27,29,28,0,1,0,0
E33029184,489,327,100,227,6,85,19,66,67,57,1,8,1,4
E33029185,246,150,42,108,9,27,9,18,59,55,0,4,0,1
E33029186,1647,1032,288,744,11,303,114,189,290,270,2,18,0,11
E33029187,349,254,73,181,5,22,8,14,65,62,0,2,1,3
E33029188,292,200,63,137,1,27,7,20,63,59,0,4,0,1
E33029189,419,268,77,191,4,70,34,36,72,69,1,1,1,5
E33029190,200,128,32,96,0,33,12,21,34,31,0,3,0,5
E33029191,287,163,59,104,3,59,20,39,62,54,2,5,1,0
E33029192,364,211,46,165,2,67,20,47,82,78,0,3,1,2
E33029193,295,209,47,162,2,46,18,28,38,36,0,2,0,0
E33029194,412,284,93,191,2,30,12,18,92,86,2,4,0,4
E33029195,1751,1365,410,955,20,180,49,131,180,167,1,10,2,6
E33029196,522,383,113,270,5,77,30,47,54,52,1,1,0,3
E33029197,354,212,55,157,2,60,25,35,79,75,0,4,0,1
E33029198,1535,1105,240,865,29,85,25,60,311,297,0,11,3,5
E33029199,1074,820,150,670,15,93,33,60,142,129,0,12,1,4
E33029200,1028,614,151,463,7,235,88,147,168,160,0,8,0,4
E33029201,800,538,120,418,9,122,31,91,122,109,1,10,2,9
E33029202,426,318,90,228,4,53,19,34,49,46,0,3,0,2
E33029203,424,281,81,200,4,78,34,44,58,51,4,2,1,3
E33029204,251,172,45,127,3,24,9,15,41,40,1,0,0,11
E33029205,737,515,132,383,4,91,28,63,122,114,1,6,1,5
E33029206,120,83,27,56,0,21,2,19,15,14,0,1,0,1
E33029207,232,136,39,97,4,38,9,29,54,53,1,0,0,0
E33029208,327,208,48,160,10,43,17,26,60,60,0,0,0,6
E33029209,394,270,80,190,4,34,6,28,84,78,0,6,0,2
E33029210,752,496,118,378,20,133,32,101,103,92,1,10,0,0
E33029211,277,220,61,159,3,15,5,10,37,34,0,3,0,2
E33029212,242,179,44,135,6,18,5,13,36,35,0,1,0,3
E33029213,374,266,52,214,4,66,27,39,38,33,0,5,0,0
E33029214,494,309,89,220,6,97,28,69,79,70,1,7,1,3
E33029215,296,174,29,145,2,57,16,41,59,57,0,2,0,4
E33029216,211,158,57,101,2,27,9,18,24,23,0,1,0,0
E33029217,680,460,131,329,14,119,36,83,85,82,0,2,1,2
E33029218,785,554,139,415,12,101,37,64,116,108,0,8,0,2
E33029219,642,527,149,378,5,56,26,30,54,50,0,4,0,0
E33029220,3006,2121,654,1467,42,393,86,307,436,413,4,18,1,14
E33029221,431,319,95,224,6,37,23,14,66,62,2,2,0,3
E33029222,229,139,34,105,2,35,10,25,50,48,2,0,0,3
E33029223,291,213,61,152,0,53,7,46,23,21,0,1,1,2
E33029224,239,202,59,143,4,7,2,5,23,21,0,1,1,3
E33029225,780,545,137,408,9,139,22,117,83,81,0,0,2,4
E33029226,225,160,45,115,2,39,8,31,24,21,0,2,1,0
E33029227,352,259,90,169,8,44,6,38,38,37,1,0,0,3
E33029228,666,372,74,298,10,145,45,100,132,126,0,5,1,7
E33029229,380,216,64,152,5,95,44,51,63,61,0,2,0,1
E33029230,420,319,76,243,3,52,17,35,45,40,2,2,1,1
E33029231,255,160,45,115,3,37,19,18,55,51,0,3,1,0
E33029232,338,250,64,186,1,37,10,27,45,43,0,2,0,5
E33029233,254,170,35,135,1,37,7,30,43,38,1,3,1,3
E33029234,450,339,119,220,1,57,27,30,52,51,0,1,0,1
E33029235,272,195,49,146,1,27,14,13,48,42,2,2,2,1
E33029236,378,178,49,129,7,34,19,15,156,146,3,5,2,3
E33029237,258,151,46,105,2,20,11,9,84,79,0,4,1,1
E33029238,247,149,46,103,5,29,19,10,62,59,0,2,1,2
E33029239,247,142,48,94,4,24,13,11,76,70,2,4,0,1
E33029240,936,549,133,416,15,59,27,32,311,299,1,8,3,2
E33029241,304,160,44,116,5,27,16,11,108,97,4,5,2,4
E33029242,212,72,22,50,3,67,36,31,70,68,0,1,1,0
E33029243,339,192,54,138,2,23,18,5,120,116,0,4,0,2
E33029244,206,94,28,66,4,18,12,6,90,85,0,4,1,0
E33029245,369,212,78,134,6,23,15,8,127,119,2,6,0,1
E33029246,1235,661,142,519,17,75,34,41,470,455,0,14,1,12
E33029247,685,333,88,245,11,113,60,53,223,214,0,5,4,5
E33029248,216,123,46,77,4,13,4,9,75,72,1,2,0,1
E33029249,242,157,48,109,2,17,7,10,66,62,0,4,0,0
E33029250,261,160,61,99,2,15,10,5,83,79,0,2,2,1
E33029251,231,110,26,84,5,19,14,5,96,93,0,2,1,1
E33029252,788,498,131,367,15,59,29,30,210,195,2,13,0,6
E33029253,4171,2427,845,1582,70,326,169,157,1318,1261,5,46,6,30
E33029254,728,456,117,339,9,72,37,35,184,178,2,3,1,7
E33029255,384,121,32,89,4,33,10,23,221,208,1,9,3,5
E33029256,526,276,90,186,19,53,33,20,173,159,1,12,1,5
E33029257,409,130,33,97,2,144,109,35,128,121,0,5,2,5
E33029258,244,87,29,58,1,52,38,14,102,92,1,5,4,2
E33029259,3378,1793,445,1348,77,651,321,330,830,784,8,34,4,27
E33029260,267,93,26,67,4,39,21,18,129,123,1,2,3,2
E33029261,505,330,86,244,6,37,16,21,129,121,1,6,1,3
E33029262,204,115,32,83,6,24,12,12,53,53,0,0,0,6
E33029263,226,126,43,83,5,14,10,4,80,69,2,9,0,1
E33029264,230,131,36,95,5,16,9,7,74,69,0,3,2,4
E33029265,389,246,67,179,3,29,15,14,109,100,0,7,2,2
E33029266,199,79,24,55,3,17,13,4,94,91,1,2,0,6
E33029267,373,223,61,162,7,13,9,4,129,122,0,6,1,1
E33029268,1226,658,137,521,16,61,34,27,479,463,0,15,1,12
E33029269,448,267,65,202,6,37,19,18,136,128,0,8,0,2
E33029270,471,251,66,185,7,55,24,31,156,151,0,4,1,2
E33029271,412,183,61,122,8,30,17,13,190,168,0,19,3,1
E33029272,278,134,53,81,5,36,17,19,102,98,1,3,0,1
E33029273,213,98,41,57,4,43,34,9,66,62,2,2,0,2
E33029274,440,237,81,156,6,47,28,19,141,125,1,12,3,9
E33029275,383,252,74,178,7,27,8,19,96,93,0,2,1,1
E33029276,731,512,122,390,6,21,11,10,190,179,4,7,0,2
E33029277,570,344,96,248,13,44,16,28,166,154,0,5,7,3
E33029278,1024,646,210,436,16,68,31,37,284,270,0,11,3,10
E33029279,243,116,36,80,2,27,14,13,94,88,1,5,0,4
E33029280,197,116,30,86,3,10,3,7,68,65,0,2,1,0
E33029281,493,242,62,180,6,44,32,12,198,192,0,6,0,3
E33029282,294,188,57,131,3,15,10,5,86,78,0,7,1,2
E33029283,752,428,93,335,12,52,29,23,257,242,0,14,1,3
E33029284,311,162,58,104,9,23,12,11,114,111,0,3,0,3
E33029285,211,148,59,89,2,11,8,3,49,45,0,3,1,1
E33029286,371,203,51,152,4,24,17,7,140,130,1,8,1,0
E33029287,369,195,47,148,5,20,10,10,148,142,0,6,0,1
E33029288,389,173,44,129,10,60,35,25,146,142,0,3,1,0
E33029289,1374,729,171,558,16,63,32,31,561,538,2,19,2,5
E33029290,441,244,56,188,6,20,7,13,168,166,0,1,1,3
E33029291,404,232,52,180,5,32,17,15,130,123,0,5,2,5
E33029292,224,108,41,67,3,41,21,20,72,70,0,1,1,0
E33029293,206,99,33,66,2,25,14,11,76,67,1,8,0,4
E33029294,439,215,58,157,5,30,15,15,184,178,0,6,0,5
E33029295,221,127,35,92,0,7,0,7,85,75,0,10,0,2
E33029296,278,140,31,109,4,24,17,7,108,101,2,5,0,2
E33029297,492,270,68,202,6,63,38,25,151,146,1,4,0,2
E33029298,265,145,39,106,2,23,16,7,95,93,0,1,1,0
E33029299,219,111,29,82,1,27,15,12,78,72,0,4,2,2
E33029300,349,141,38,103,3,46,21,25,156,146,5,4,1,3
E33029301,209,112,30,82,1,20,12,8,75,72,0,3,0,1
E33029302,414,252,46,206,11,49,25,24,101,91,4,5,1,1
E33029303,238,116,32,84,5,31,18,13,83,78,0,4,1,3
E33029304,513,263,65,198,4,24,10,14,220,202,0,13,5,2
E33029305,573,297,60,237,8,45,15,30,217,202,6,7,2,6
E33029306,387,197,64,133,6,32,18,14,146,141,0,2,3,6
E33029307,353,138,42,96,3,101,69,32,110,104,0,5,1,1
E33029308,553,158,50,108,7,118,62,56,267,248,1,17,1,3
E33029309,924,548,118,430,21,145,80,65,207,197,0,9,1,3
E33029310,648,315,91,224,3,46,26,20,277,265,3,7,2,7
E33029311,222,77,18,59,3,56,30,26,86,84,0,2,0,0
E33029312,264,101,31,70,4,39,32,7,113,106,1,5,1,7
E33029313,198,73,23,50,2,45,28,17,75,73,1,1,0,3
E33029314,644,341,92,249,13,75,32,43,207,197,0,9,1,8
E33029315,321,121,41,80,2,41,24,17,155,150,2,2,1,2
E33029316,405,187,58,129,5,83,51,32,122,117,1,3,1,8
E33029317,432,206,55,151,4,54,33,21,164,145,0,12,7,4
E33029318,1756,1002,235,767,22,113,55,58,609,583,3,19,4,10
E33029319,361,183,49,134,10,55,30,25,112,103,3,6,0,1
E33029320,236,86,25,61,5,46,30,16,94,92,1,0,1,5
E33029321,309,155,44,111,6,63,29,34,84,79,1,3,1,1
E33029322,351,164,54,110,6,39,25,14,135,131,0,4,0,7
E33029323,252,108,41,67,3,56,29,27,85,80,0,4,1,0
E33029324,247,120,48,72,4,16,9,7,103,98,2,2,1,4
E33029325,243,133,40,93,4,16,9,7,86,83,0,3,0,4
E33029326,315,113,21,92,5,81,46,35,111,107,0,1,3,5
E33029327,197,87,26,61,1,23,19,4,86,80,2,4,0,0
E33029328,346,137,48,89,2,31,21,10,173,156,8,9,0,3
E33029329,227,153,48,105,1,22,12,10,48,47,0,1,0,3
E33029330,416,207,91,116,2,71,50,21,129,126,0,3,0,7
E33029331,711,383,126,257,3,140,90,50,174,163,2,7,2,11
E33029332,318,103,35,68,5,42,19,23,166,160,3,3,0,2
E33029333,208,81,32,49,5,41,24,17,80,73,2,2,3,1
E33029334,1176,653,140,513,18,74,38,36,426,398,2,25,1,5
E33029335,558,288,67,221,5,25,12,13,233,212,8,11,2,7
E33029336,333,175,39,136,5,20,7,13,132,123,1,7,1,1
E33029337,690,315,74,241,16,60,32,28,294,280,2,12,0,5
E33029338,250,102,18,84,2,29,11,18,112,107,0,5,0,5
E33029339,271,124,22,102,7,34,14,20,103,97,1,3,2,3
E33029340,404,176,53,123,2,47,25,22,174,166,0,7,1,5
E33029341,793,476,119,357,17,74,40,34,222,210,2,9,1,4
E33029342,1158,652,138,514,29,54,21,33,416,391,1,22,2,7
E33029343,467,351,106,245,3,23,16,7,86,81,1,4,0,4
E33029344,871,519,134,385,26,93,51,42,232,223,1,8,0,1
E33029345,488,309,77,232,9,26,12,14,140,133,0,5,2,4
E33029346,499,262,76,186,8,36,20,16,189,184,2,3,0,4
E33029347,108,71,17,54,1,6,4,2,30,29,0,1,0,0
E33029348,413,250,70,180,8,28,12,16,123,116,0,5,2,4
E33029349,270,174,40,134,4,13,8,5,76,72,0,2,2,3
E33029350,920,467,130,337,8,80,55,25,357,327,2,24,4,8
E33029351,248,185,48,137,0,15,7,8,46,44,0,2,0,2
E33029352,230,148,39,109,3,19,11,8,59,57,0,2,0,1
E33029353,285,219,73,146,4,12,7,5,48,45,0,3,0,2
E33029354,361,218,66,152,20,51,27,24,67,65,0,2,0,5
E33029355,207,147,58,89,0,10,2,8,47,42,1,2,2,3
E33029356,1012,651,166,485,14,67,29,38,273,253,1,15,4,7
E33029357,311,242,71,171,0,6,3,3,63,57,0,4,2,0
E33029358,193,146,48,98,0,5,3,2,40,33,0,0,7,2
E33029359,361,247,73,174,3,42,18,24,67,61,1,5,0,2
E33029360,484,344,98,246,6,19,8,11,112,105,0,6,1,3
E33029361,440,255,93,162,0,60,33,27,122,117,1,4,0,3
E33029362,432,305,82,223,4,25,10,15,97,90,0,5,2,1
E33029363,726,495,151,344,6,41,17,24,178,173,0,5,0,6
E33029364,432,258,79,179,5,24,12,12,142,132,1,6,3,3
E33029365,427,308,107,201,6,19,7,12,90,80,2,4,4,4
E33029366,498,217,45,172,4,53,29,24,217,210,0,5,2,7
E33029367,307,222,70,152,4,19,5,14,55,51,0,2,2,7
E33029368,371,228,64,164,5,24,15,9,110,104,0,6,0,4
E33029369,525,389,140,249,8,30,16,14,95,82,4,6,3,3
E33029370,358,268,90,178,4,14,8,6,69,60,0,5,4,3
E33029371,2471,1602,359,1243,19,96,44,52,737,712,1,23,1,17
E33029372,209,128,41,87,6,29,7,22,46,43,0,3,0,0
E33029373,277,175,42,133,7,24,9,15,69,67,0,1,1,2
E33029374,747,431,88,343,14,45,25,20,254,241,1,9,3,3
E33029375,200,121,27,94,2,10,8,2,65,61,0,4,0,2
E33029376,763,479,145,334,12,93,41,52,171,162,0,8,1,8
E33029377,1242,701,171,530,27,134,63,71,368,347,0,16,5,12
E33029378,1062,592,149,443,18,72,44,28,375,359,2,13,1,5
E33029379,288,141,36,105,4,32,22,10,110,105,2,2,1,1
E33029380,883,591,153,438,4,50,27,23,230,218,1,9,2,8
E33029381,340,174,44,130,9,30,15,15,124,121,0,3,0,3
E33029382,397,238,86,152,4,37,28,9,116,112,1,2,1,2
E33029383,584,328,124,204,9,88,45,43,152,143,0,9,0,7
E33029384,493,248,74,174,10,36,21,15,196,185,1,8,2,3
E33029385,854,461,137,324,16,67,40,27,300,284,2,11,3,10
E33029386,209,128,30,98,1,14,11,3,65,63,0,2,0,1
E33029387,287,150,45,105,6,29,18,11,99,97,0,2,0,3
E33029388,211,88,28,60,1,20,10,10,102,97,2,3,0,0
E33029389,288,145,32,113,2,23,11,12,112,104,1,7,0,6
E33029390,393,164,49,115,3,19,12,7,200,194,2,4,0,7
E33029391,543,245,32,213,9,27,15,12,257,245,0,12,0,5
E33029392,316,156,42,114,4,41,23,18,110,108,0,2,0,5
E33029393,218,115,27,88,2,27,19,8,70,69,0,1,0,4
E33029394,370,146,48,98,3,48,19,29,163,153,1,9,0,10
E33029395,223,131,36,95,3,16,7,9,72,68,0,4,0,1
E33029396,206,86,18,68,7,25,10,15,86,80,0,5,1,2
E33029397,756,365,86,279,10,64,30,34,317,302,0,11,4,0
E33029398,254,123,26,97,1,34,21,13,94,94,0,0,0,2
E33029399,298,146,30,116,5,29,18,11,114,104,0,9,1,4
E33029400,1352,775,137,638,17,52,26,26,498,482,1,13,2,10
E33029401,228,121,49,72,1,23,11,12,82,79,1,2,0,1
E33029402,578,288,67,221,9,43,15,28,233,224,0,6,3,5
E33029403,1611,863,201,662,27,151,88,63,558,520,1,37,0,12
E33029404,616,362,119,243,8,66,34,32,175,167,0,6,2,5
E33029405,282,144,29,115,5,40,19,21,90,88,0,2,0,3
E33029406,233,103,42,61,4,53,32,21,69,65,0,4,0,4
E33029407,1803,930,278,652,47,244,109,135,564,536,4,14,10,18
E33029408,325,160,54,106,4,23,12,11,134,124,2,3,5,4
E33029409,279,175,39,136,6,16,8,8,81,76,0,5,0,1
E33029410,249,111,39,72,8,11,6,5,119,118,0,1,0,0
E33029411,189,117,33,84,1,13,7,6,57,56,0,1,0,1
E33029412,210,139,39,100,7,25,12,13,38,36,0,2,0,1
E33029413,224,119,37,82,3,17,8,9,83,78,1,3,1,2
E33029414,274,166,44,122,2,15,8,7,91,84,0,5,2,0
E33029415,608,338,98,240,6,52,31,21,205,193,4,8,0,7
E33029416,275,130,32,98,4,28,20,8,110,106,0,4,0,3
E33029417,194,104,14,90,7,10,6,4,72,67,1,4,0,1
E33029418,623,251,56,195,3,76,47,29,290,282,1,4,3,3
E33029419,306,152,37,115,3,49,13,36,99,91,1,6,1,3
E33029420,4217,2322,609,1713,106,618,281,337,1143,1051,38,36,18,28
E33029421,296,196,51,145,1,14,7,7,83,80,1,2,0,2
E33029422,970,671,159,512,16,82,36,46,194,184,1,7,2,7
E33029423,226,119,27,92,9,23,15,8,71,59,0,12,0,4
E33029424,533,313,73,240,11,37,21,16,168,161,0,7,0,4
E33029425,1069,667,139,528,14,51,37,14,335,318,0,17,0,2
E33029426,223,157,52,105,1,19,14,5,46,46,0,0,0,0
E33029427,555,297,76,221,4,53,29,24,197,190,0,7,0,4
E33029428,331,215,65,150,5,23,11,12,88,81,0,7,0,0
E33029429,466,260,64,196,13,35,12,23,156,149,0,6,1,2
E33029430,304,155,44,111,3,38,31,7,104,99,1,3,1,4
E33029431,332,187,45,142,6,27,15,12,107,105,0,2,0,5
E33029432,456,253,77,176,3,22,13,9,174,168,0,4,2,4
E33029433,304,192,76,116,6,24,10,14,78,71,0,7,0,4
E33029434,825,449,114,335,7,169,98,71,194,188,0,4,2,6
E33029435,551,308,90,218,4,49,36,13,189,185,1,2,1,1
E33029436,607,450,110,340,7,37,23,14,107,97,0,9,1,6
E33029437,213,141,46,95,2,12,5,7,56,54,0,2,0,2
E33029438,1239,748,179,569,12,57,29,28,418,401,0,14,3,4
E33029439,361,185,55,130,6,31,11,20,133,127,1,3,2,6
E33029440,1217,723,157,566,10,49,18,31,430,411,0,16,3,5
E33029441,654,410,88,322,12,80,41,39,143,131,4,7,1,9
E33029442,219,140,42,98,3,19,11,8,55,53,0,2,0,2
E33029443,198,101,27,74,0,21,8,13,73,72,0,1,0,3
E33029444,379,200,47,153,7,37,20,17,133,130,0,3,0,2
E33029445,450,239,55,184,5,33,19,14,172,163,3,6,0,1
E33029446,544,316,77,239,23,36,21,15,165,159,0,5,1,4
E33029447,400,242,67,175,4,25,15,10,129,125,0,4,0,0
E33029448,536,298,63,235,9,43,32,11,182,177,0,4,1,4
E33029449,833,497,117,380,5,72,38,34,257,244,1,12,0,2
E33029450,298,154,36,118,4,51,27,24,87,82,0,4,1,2
E33029451,403,259,58,201,7,18,11,7,112,105,1,5,1,7
E33029452,216,93,26,67,2,18,14,4,102,100,0,2,0,1
E33029453,565,379,113,266,7,42,23,19,134,126,2,4,2,3
E33029454,1524,956,197,759,19,77,38,39,462,438,1,23,0,10
E33029455,664,452,114,338,5,41,18,23,161,149,0,11,1,5
E33029456,721,445,121,324,15,38,23,15,222,211,1,10,0,1
E33029457,598,364,86,278,8,55,33,22,166,156,0,9,1,5
E33029458,237,130,43,87,3,28,15,13,76,74,0,1,1,0
E33029459,411,218,61,157,8,42,16,26,141,134,1,6,0,2
E33029460,1166,655,182,473,9,73,38,35,419,407,0,10,2,10
E33029461,321,209,50,159,1,22,12,10,83,80,1,2,0,6
E33029462,470,245,52,193,4,30,21,9,186,178,1,4,3,5
E33029463,164,125,40,85,1,4,3,1,33,30,0,3,0,1
E33029464,406,272,84,188,6,31,17,14,91,81,3,5,2,6
E33029465,946,537,157,380,16,80,42,38,306,291,1,13,1,7
E33029466,1008,670,154,516,11,70,30,40,253,245,0,7,1,4
E33029467,1091,731,183,548,15,59,32,27,281,266,2,11,2,5
E33029468,676,386,117,269,11,54,36,18,223,210,5,7,1,2
E33029469,222,111,37,74,3,15,7,8,88,84,0,3,1,5
E33029470,523,251,91,160,4,75,51,24,182,179,0,3,0,11
E33029471,704,394,93,301,13,45,20,25,246,238,1,6,1,6
E33029472,294,169,55,114,10,33,14,19,74,68,2,4,0,8
E33029473,332,146,33,113,6,46,21,25,132,124,0,6,2,2
E33029474,703,436,110,326,13,54,26,28,194,178,8,4,4,6
E33029475,521,278,60,218,15,29,13,16,197,184,0,10,3,2
E33029476,410,178,55,123,6,48,21,27,174,169,0,3,2,4
E33029477,242,119,36,83,2,26,18,8,88,83,0,3,2,7
E33029478,446,169,42,127,9,66,40,26,199,197,0,2,0,3
E33029479,317,147,45,102,5,94,57,37,68,64,1,2,1,3
E33029480,469,208,47,161,8,131,82,49,121,114,0,7,0,1
E33029481,513,202,52,150,12,145,87,58,152,148,2,0,2,2
E33029482,423,225,53,172,10,56,32,24,130,125,0,5,0,2
E33029483,2657,1386,351,1035,47,331,199,132,860,819,4,31,6,33
E33029484,447,149,46,103,7,122,60,62,160,154,0,6,0,9
E33029485,636,266,82,184,7,164,86,78,196,187,0,7,2,3
E33029486,271,134,32,102,2,36,17,19,98,91,1,6,0,1
E33029487,604,392,95,297,6,39,18,21,165,155,0,9,1,2
E33029488,599,360,113,247,11,62,35,27,157,146,2,6,3,9
E33029489,805,485,109,376,14,66,35,31,232,225,0,5,2,8
E33029490,211,92,30,62,2,45,30,15,65,64,0,1,0,7
E33029491,213,88,31,57,0,30,14,16,92,85,1,5,1,3
E33029492,513,310,86,224,7,67,39,28,122,113,3,4,2,7
E33029493,338,166,43,123,5,63,38,25,102,98,1,2,1,2
E33029494,305,168,40,128,4,41,20,21,90,81,0,8,1,2
E33029495,311,147,29,118,5,41,14,27,116,107,0,8,1,2
E33029496,226,88,17,71,3,34,17,17,96,91,0,5,0,5
E33029497,1209,649,186,463,16,263,163,100,266,253,2,9,2,15
E33029498,1085,655,177,478,27,176,98,78,219,204,0,12,3,8
E33029499,429,227,72,155,9,72,31,41,116,105,0,6,5,5
E33029500,738,479,130,349,13,72,41,31,165,162,0,1,2,9
E33029501,483,290,64,226,17,85,45,40,86,82,0,2,2,5
E33029502,286,160,49,111,4,18,6,12,97,95,0,2,0,7
E33029503,432,251,59,192,7,27,15,12,144,138,0,6,0,3
E33029504,175,71,18,53,2,21,12,9,80,76,0,3,1,1
E33029505,785,423,105,318,17,67,35,32,269,260,2,6,1,9
E33029506,287,148,46,102,5,80,45,35,53,51,1,1,0,1
E33029507,1115,720,213,507,24,69,32,37,299,282,0,17,0,3
E33029508,1755,1268,291,977,18,86,42,44,378,364,3,8,3,5
E33029509,528,251,53,198,15,88,55,33,167,164,1,2,0,7
E33029510,214,115,31,84,2,27,20,7,64,59,0,3,2,6
E33029511,1518,750,170,580,21,291,165,126,441,426,5,4,6,15
E33029512,491,254,73,181,12,37,12,25,182,179,1,2,0,6
E33029513,537,267,62,205,5,119,85,34,144,136,0,8,0,2
E33029514,1637,915,211,704,30,270,139,131,411,382,10,14,5,11
E33029515,2078,1023,217,806,44,492,274,218,509,484,1,17,7,10
E33029516,2606,1872,554,1318,42,254,145,109,423,393,5,23,2,15
E33029517,1399,1060,214,846,9,64,37,27,262,251,1,9,1,4
E33029518,2564,1644,360,1284,23,95,51,44,781,754,1,21,5,21
E33029519,618,320,66,254,8,56,25,31,232,222,0,9,1,2
E33029520,1783,1033,235,798,30,103,46,57,610,583,0,23,4,7
E33029521,407,168,56,112,4,108,64,44,122,115,0,6,1,5
E33029522,1029,572,158,414,15,228,160,68,205,193,2,8,2,9
E33029523,307,120,29,91,7,59,37,22,118,109,1,7,1,3
E33029524,383,202,59,143,7,47,23,24,125,118,4,3,0,2
E33029525,3094,1713,380,1333,69,229,118,111,1068,1025,0,37,6,15
E33029526,393,172,51,121,5,70,38,32,140,73,45,2,20,6
E33029527,363,171,52,119,2,56,20,36,132,128,2,1,1,2
E33029528,196,85,22,63,1,23,11,12,81,80,0,0,1,6
E33029529,257,125,43,82,2,29,19,10,99,90,1,2,6,2
E33029530,1958,1034,346,688,43,335,197,138,531,498,0,21,12,15
E33029531,204,91,31,60,2,71,41,30,40,38,0,1,1,0
E33029532,772,303,70,233,11,176,114,62,273,269,2,1,1,9
E33029533,287,164,32,132,13,30,13,17,79,75,1,1,2,1
E33029534,998,511,109,402,15,207,124,83,259,252,0,7,0,6
E33029535,1382,855,168,687,11,107,57,50,400,379,1,15,5,9
E33029536,2279,1215,273,942,40,371,204,167,633,596,3,28,6,20
E33029537,1051,386,122,264,23,251,137,114,384,368,2,10,4,7
E33029538,733,398,107,291,14,143,79,64,172,165,1,5,1,6
E33029539,783,522,133,389,15,87,49,38,152,149,0,2,1,7
E33029540,569,350,98,252,2,105,51,54,108,102,0,6,0,4
E33029541,649,363,84,279,7,125,61,64,150,143,0,5,2,4
E33029542,533,282,64,218,4,120,57,63,124,119,0,3,2,3
E33029543,461,182,58,124,2,85,40,45,186,172,3,8,3,6
E33029544,759,447,100,347,14,115,48,67,180,176,1,2,1,3
E33029545,660,452,101,351,15,51,27,24,138,132,1,5,0,4
E33029546,319,215,43,172,3,45,31,14,56,51,0,5,0,0
E33029547,220,165,49,116,2,18,11,7,34,32,0,1,1,1
E33029548,613,418,98,320,6,48,22,26,134,129,0,5,0,7
E33029549,407,243,60,183,7,81,40,41,71,71,0,0,0,5
E33029550,438,260,82,178,9,72,33,39,91,87,1,1,2,6
E33029551,350,228,53,175,11,38,20,18,72,68,0,3,1,1
E33029552,1745,1245,302,943,33,150,67,83,309,295,1,11,2,8
E33029553,398,288,78,210,5,37,22,15,64,60,0,3,1,4
E33029554,247,136,33,103,5,25,12,13,77,73,0,1,3,4
E33029555,1267,870,224,646,8,60,22,38,323,312,1,7,3,6
E33029556,587,389,103,286,7,69,35,34,117,109,1,7,0,5
E33029557,1036,657,195,462,19,192,89,103,166,152,3,10,1,2
E33029558,840,635,157,478,12,39,18,21,151,145,0,6,0,3
E33029559,444,195,50,145,4,107,50,57,135,122,1,10,2,3
E33029560,280,166,49,117,5,47,26,21,56,56,0,0,0,6
E33029561,329,172,40,132,4,38,17,21,106,101,1,3,1,9
E33029562,234,131,30,101,3,44,22,22,50,48,0,2,0,6
E33029563,654,408,120,288,6,104,45,59,134,127,1,6,0,2
E33029564,220,106,21,85,2,41,13,28,70,69,1,0,0,1
E33029565,281,158,40,118,4,37,20,17,81,79,1,1,0,1
E33029566,209,91,20,71,0,30,14,16,88,86,0,2,0,0
E33029567,324,184,56,128,6,50,26,24,82,72,1,8,1,2
E33029568,337,184,55,129,4,73,37,36,76,66,3,7,0,0
E33029569,497,325,62,263,6,60,25,35,104,100,0,2,2,2
E33029570,368,197,59,138,4,96,51,45,65,60,0,4,1,6
E33029571,564,362,87,275,8,114,52,62,77,71,0,2,4,3
E33029572,585,289,57,232,11,133,70,63,149,138,0,10,1,3
E33029573,553,304,62,242,6,103,54,49,136,131,0,4,1,4
E33029574,400,250,68,182,7,53,24,29,87,84,1,1,1,3
E33029575,935,640,144,496,10,65,23,42,216,204,0,9,3,4
E33029576,404,274,53,221,4,38,17,21,85,80,1,2,2,3
E33029577,308,208,64,144,3,27,16,11,67,61,2,4,0,3
E33029578,365,196,43,153,3,49,36,13,115,107,1,6,1,2
E33029579,629,377,84,293,8,96,62,34,145,140,1,4,0,3
E33029580,296,157,33,124,7,47,18,29,82,80,1,1,0,3
E33029581,387,218,62,156,4,62,36,26,94,78,2,13,1,9
E33029582,252,179,48,131,4,30,18,12,34,28,3,3,0,5
E33029583,359,175,38,137,3,69,41,28,109,105,0,2,2,3
E33029584,343,196,54,142,7,58,33,25,80,72,0,8,0,2
E33029585,994,632,176,456,14,164,71,93,181,169,4,7,1,3
E33029586,582,364,72,292,2,78,44,34,133,123,0,9,1,5
E33029587,708,396,84,312,6,102,52,50,200,187,1,10,2,4
E33029588,314,143,27,116,7,51,29,22,109,105,1,3,0,4
E33029589,422,180,60,120,2,87,52,35,150,140,1,6,3,3
E33029590,546,243,77,166,6,78,43,35,212,198,0,13,1,7
E33029591,3007,1965,607,1358,66,398,189,209,560,529,2,15,14,18
E33029592,464,306,90,216,2,25,7,18,127,121,1,5,0,4
E33029593,304,141,43,98,2,46,24,22,109,105,1,2,1,6
E33029594,449,233,56,177,8,66,35,31,137,128,0,7,2,5
E33029595,452,225,71,154,10,43,21,22,171,167,0,2,2,3
E33029596,346,185,54,131,11,60,33,27,88,87,0,1,0,2
E33029597,329,154,43,111,5,39,17,22,128,121,2,4,1,3
E33029598,418,211,67,144,9,85,45,40,108,103,1,4,0,5
E33029599,659,410,106,304,17,49,21,28,177,169,0,7,1,6
E33029600,676,447,161,286,13,52,27,25,160,148,2,9,1,4
E33029601,441,225,57,168,5,97,50,47,113,103,0,7,3,1
E33029602,631,311,86,225,6,94,46,48,215,211,1,2,1,5
E33029603,329,188,73,115,1,45,27,18,93,85,0,7,1,2
E33029604,303,170,38,132,6,37,21,16,88,86,0,2,0,2
E33029605,253,108,39,69,3,85,48,37,55,54,0,1,0,2
E33029606,248,129,40,89,3,26,11,15,89,86,0,1,2,1
E33029607,357,187,56,131,3,48,17,31,115,112,0,3,0,4
E33029608,406,246,77,169,4,53,22,31,98,91,0,4,3,5
E33029609,908,498,152,346,30,172,81,91,201,194,0,7,0,7
E33029610,524,307,74,233,12,56,30,26,139,126,0,7,6,10
E33029611,598,314,92,222,8,69,35,34,199,186,0,13,0,8
E33029612,372,132,41,91,4,46,22,24,185,181,0,3,1,5
E33029613,272,118,34,84,3,27,11,16,122,122,0,0,0,2
E33029614,407,239,96,143,4,55,25,30,105,101,1,3,0,4
E33029615,3197,1524,425,1099,51,618,308,310,985,942,4,26,13,19
E33029616,325,172,59,113,3,48,24,24,101,98,0,2,1,1
E33029617,372,202,67,135,6,41,19,22,120,118,0,2,0,3
E33029618,385,220,64,156,5,42,23,19,118,115,1,2,0,0
E33029619,197,127,40,87,3,30,13,17,35,32,1,1,1,2
E33029620,224,112,29,83,3,29,13,16,78,74,0,2,2,2
E33029621,566,287,73,214,11,70,38,32,191,182,0,8,1,7
E33029622,1092,591,193,398,17,212,144,68,254,242,1,11,0,18
E33029623,1663,1132,319,813,32,217,107,110,266,248,1,13,4,16
E33029624,392,253,58,195,3,43,23,20,93,91,0,1,1,0
E33029625,482,259,74,185,6,51,34,17,166,160,3,2,1,0
E33029626,600,471,154,317,6,36,22,14,86,75,4,5,2,1
E33029627,500,345,103,242,7,33,19,14,115,107,4,3,1,0
E33029628,407,210,62,148,4,46,21,25,145,139,2,2,2,2
E33029629,1021,473,110,363,15,88,42,46,440,413,3,16,8,5
E33029630,325,169,55,114,4,58,24,34,89,82,0,7,0,5
E33029631,1382,758,214,544,27,99,56,43,485,464,0,17,4,13
E33029632,233,116,35,81,2,39,18,21,74,73,0,0,1,2
E33029633,380,206,49,157,10,32,19,13,131,125,1,2,3,1
E33029634,936,513,138,375,12,59,35,24,344,317,9,18,0,8
E33029635,1074,734,226,508,5,49,14,35,269,264,1,4,0,17
E33029636,1825,1077,290,787,31,171,78,93,537,508,1,18,10,9
E33029637,275,150,32,118,5,35,19,16,83,81,0,2,0,2
E33029638,1101,668,171,497,12,109,68,41,302,277,1,16,8,10
E33029639,499,308,86,222,3,52,28,24,132,120,1,8,3,4
E33029640,289,147,43,104,7,37,24,13,96,92,0,2,2,2
E33029641,747,447,162,285,6,79,48,31,208,195,0,13,0,7
E33029642,491,295,88,207,2,59,33,26,133,128,0,2,3,2
E33029643,301,183,50,133,1,30,13,17,85,83,0,2,0,2
E33029644,623,441,175,266,15,62,35,27,100,99,1,0,0,5
E33029645,338,194,65,129,5,37,21,16,101,100,0,1,0,1
E33029646,381,257,74,183,6,33,17,16,84,78,0,6,0,1
E33029647,611,353,104,249,17,58,33,25,180,169,0,9,2,3
E33029648,380,191,53,138,9,81,50,31,98,96,0,1,1,1
E33029649,789,530,140,390,12,130,73,57,114,109,1,2,2,3
E33029650,240,99,35,64,9,25,12,13,107,104,0,3,0,0
E33029651,633,380,96,284,23,80,40,40,147,133,2,4,8,3
E33029652,257,121,27,94,1,29,18,11,103,99,0,4,0,3
E33029653,309,151,40,111,5,42,25,17,109,106,0,1,2,2
E33029654,221,145,36,109,3,29,21,8,44,37,0,1,6,0
E33029655,302,194,71,123,2,27,14,13,75,68,1,2,4,4
E33029656,219,116,36,80,4,29,16,13,69,68,0,1,0,1
E33029657,306,164,59,105,5,30,12,18,101,86,2,6,7,6
E33029658,419,259,92,167,5,63,37,26,82,76,0,5,1,10
E33029659,476,259,89,170,5,61,31,30,142,124,5,10,3,9
E33029660,673,380,95,285,11,87,54,33,191,178,2,7,4,4
E33029661,428,196,56,140,4,60,27,33,164,160,0,3,1,4
E33029662,428,151,46,105,6,55,27,28,208,196,0,10,2,8
E33029663,803,424,126,298,21,75,41,34,278,272,1,5,0,5
E33029664,515,327,71,256,9,42,19,23,133,119,2,12,0,4
E33029665,233,134,41,93,8,26,14,12,62,52,2,8,0,3
E33029666,828,474,95,379,8,55,18,37,286,272,1,11,2,5
E33029667,572,306,80,226,4,25,14,11,232,222,0,10,0,5
E33029668,254,138,55,83,9,31,20,11,72,66,0,4,2,4
E33029669,306,230,67,163,2,39,25,14,31,30,0,1,0,4
E33029670,434,330,119,211,3,41,21,20,56,47,3,5,1,4
E33029671,257,157,37,120,1,28,19,9,61,56,4,1,0,10
E33029672,267,194,71,123,3,21,16,5,37,36,0,1,0,12
E33029673,336,227,69,158,7,32,21,11,68,66,0,2,0,2
E33029674,211,113,24,89,3,38,31,7,56,56,0,0,0,1
E33029675,241,138,36,102,1,36,20,16,66,59,2,3,2,0
E33029676,593,313,106,207,6,90,57,33,182,174,1,6,1,2
E33029677,214,124,43,81,3,42,27,15,44,43,0,1,0,1
E33029678,205,146,49,97,2,15,12,3,40,36,0,2,2,2
E33029679,290,180,47,133,4,56,32,24,49,45,0,2,2,1
E33029680,295,213,52,161,3,43,29,14,33,32,0,0,1,3
E33029681,623,395,127,268,9,123,80,43,92,84,2,4,2,4
E33029682,504,322,97,225,4,88,51,37,86,84,0,0,2,4
E33029683,276,176,53,123,5,55,40,15,37,35,1,0,1,3
E33029684,541,313,88,225,7,94,62,32,124,122,0,0,2,3
E33029685,424,223,66,157,4,69,47,22,123,119,1,3,0,5
E33029686,510,288,61,227,5,71,41,30,144,140,0,3,1,2
E33029687,500,334,87,247,4,68,40,28,88,84,1,3,0,6
E33029688,1374,667,182,485,26,194,124,70,476,459,1,10,6,11
E33029689,659,423,127,296,8,47,35,12,171,156,6,8,1,10
E33029690,410,225,56,169,3,68,37,31,111,107,0,4,0,3
E33029691,229,129,40,89,2,21,13,8,76,63,2,7,4,1
E33029692,231,153,49,104,1,27,18,9,48,46,0,0,2,2
E33029693,772,477,135,342,8,134,84,50,152,145,0,6,1,1
E33029694,201,117,29,88,1,37,23,14,46,44,0,2,0,0
E33029695,292,200,62,138,4,45,35,10,43,40,0,3,0,0
E33029696,473,241,52,189,6,106,74,32,117,111,0,4,2,3
E33029697,413,280,72,208,8,64,44,20,61,60,0,1,0,0
E33029698,436,258,68,190,3,94,52,42,79,75,1,3,0,2
E33029699,551,349,111,238,4,92,60,32,103,98,0,4,1,3
E33029700,557,399,126,273,8,80,48,32,68,66,0,2,0,2
E33029701,924,579,161,418,11,145,97,48,187,174,2,10,1,2
E33029702,344,220,61,159,3,60,43,17,61,57,2,2,0,0
E33029703,432,283,60,223,2,52,33,19,91,86,0,4,1,4
E33029704,354,237,77,160,7,60,38,22,49,46,1,2,0,1
E33029705,624,369,102,267,10,107,72,35,126,120,0,6,0,12
E33029706,241,170,60,110,1,12,7,5,57,55,0,1,1,1
E33029707,206,167,64,103,1,18,12,6,18,17,1,0,0,2
E33029708,2002,1578,465,1113,30,177,115,62,211,204,0,7,0,6
E33029709,554,362,90,272,2,82,49,33,100,95,0,4,1,8
E33029710,340,224,75,149,6,20,12,8,86,78,2,6,0,4
E33029711,2775,1705,450,1255,42,446,243,203,560,523,5,25,7,22
E33029712,955,456,127,329,15,258,159,99,220,214,0,6,0,6
E33029713,202,103,25,78,3,32,22,10,63,63,0,0,0,1
E33029714,285,134,34,100,1,46,32,14,104,97,3,4,0,0
E33029715,338,200,57,143,5,70,54,16,62,57,0,3,2,1
E33029716,395,275,66,209,5,61,32,29,54,51,0,3,0,0
E33029717,212,132,33,99,0,40,32,8,37,35,0,2,0,3
E33029718,662,367,98,269,6,179,108,71,106,94,3,4,5,4
E33029719,215,145,53,92,3,31,15,16,33,32,0,1,0,3
E33029720,331,229,47,182,8,54,30,24,36,34,1,1,0,4
E33029721,324,218,49,169,9,48,24,24,48,46,1,1,0,1
E33029722,266,132,32,100,4,40,18,22,90,86,0,2,2,0
E33029723,491,285,115,170,6,45,24,21,150,146,0,3,1,5
E33029724,632,290,94,196,8,128,71,57,203,179,1,18,5,3
E33029725,372,169,49,120,5,69,42,27,122,121,1,0,0,7
E33029726,208,94,23,71,1,31,15,16,82,71,5,6,0,0
E33029727,493,290,91,199,5,80,41,39,112,106,0,4,2,6
E33029728,232,137,43,94,1,48,20,28,43,41,0,2,0,3
E33029729,637,321,84,237,12,119,63,56,179,168,1,9,1,6
E33029730,419,185,43,142,4,123,66,57,105,100,1,2,2,2
E33029731,230,95,25,70,3,38,25,13,93,87,0,5,1,1
E33029732,1327,831,208,623,28,162,88,74,300,285,2,12,1,6
E33029733,431,300,91,209,3,52,24,28,72,66,0,5,1,4
E33029734,423,229,47,182,6,107,57,50,78,72,0,2,4,3
E33029735,416,213,56,157,6,88,49,39,107,104,0,2,1,2
E33029736,664,462,115,347,6,96,52,44,97,92,0,4,1,3
E33029737,1019,535,152,383,17,319,181,138,136,126,1,6,3,12
E33029738,210,91,19,72,5,71,45,26,42,38,0,1,3,1
E33029739,780,538,145,393,10,137,72,65,90,86,0,4,0,5
E33029740,239,123,23,100,4,61,28,33,49,42,0,5,2,2
E33029741,1845,949,254,695,19,438,277,161,431,231,115,11,74,8
E33029742,308,197,47,150,3,58,35,23,49,47,0,2,0,1
E33029743,988,545,127,418,11,196,101,95,232,221,1,8,2,4
E33029744,359,236,73,163,4,44,20,24,72,66,0,5,1,3
E33029745,116,67,18,49,4,22,13,9,23,22,0,0,1,0
E33029746,259,155,33,122,3,51,22,29,49,47,0,1,1,1
E33029747,2980,1424,337,1087,74,833,389,444,638,603,3,25,7,11
E33029748,425,190,39,151,17,98,54,44,115,104,0,10,1,5
E33029749,345,143,40,103,10,72,34,38,118,111,0,6,1,2
E33029750,504,196,57,139,6,175,96,79,120,117,0,3,0,7
E33029751,416,151,44,107,4,131,72,59,129,125,0,3,1,1
E33029752,1591,841,164,677,51,398,184,214,293,274,1,12,6,8
E33029753,1266,718,169,549,39,283,133,150,220,209,0,9,2,6
E33029754,462,220,48,172,11,45,23,22,183,178,1,4,0,3
E33029755,775,354,77,277,9,67,21,46,341,327,0,13,1,4
E33029756,1150,714,171,543,18,45,21,24,366,348,2,14,2,7
E33029757,450,310,68,242,4,16,7,9,117,113,0,4,0,3
E33029758,279,124,32,92,7,28,13,15,119,116,0,3,0,1
E33029759,209,105,19,86,3,14,8,6,85,79,0,6,0,2
E33029760,1287,824,191,633,9,49,27,22,399,387,0,10,2,6
E33029761,655,497,144,353,8,39,21,18,109,102,0,5,2,2
E33029762,472,320,84,236,2,16,8,8,133,127,0,5,1,1
E33029763,201,112,32,80,3,14,7,7,65,63,1,1,0,7
E33029764,332,233,55,178,8,14,8,6,76,75,0,1,0,1
E33029765,434,233,47,186,2,28,13,15,170,164,0,5,1,1
E33029766,374,150,27,123,11,25,8,17,185,182,0,3,0,3
E33029767,341,192,51,141,2,13,10,3,132,127,0,4,1,2
E33029768,445,291,76,215,5,29,17,12,119,107,2,10,0,1
E33029769,498,260,83,177,4,21,5,16,207,192,0,14,1,6
E33029770,344,152,39,113,6,79,48,31,106,96,1,8,1,1
E33029771,567,292,94,198,15,167,83,84,89,86,0,3,0,4
E33029772,423,213,76,137,9,48,31,17,147,140,0,7,0,6
E33029773,834,446,123,323,15,49,22,27,321,304,2,11,4,3
E33029774,258,153,22,131,9,39,21,18,46,41,1,3,1,11
E33029775,272,102,42,60,1,35,15,20,130,126,0,3,1,4
E33029776,264,117,35,82,3,46,20,26,96,92,0,4,0,2
E33029777,303,123,39,84,2,64,36,28,111,107,1,3,0,3
E33029778,476,213,67,146,6,123,58,65,125,121,0,3,1,9
E33029779,269,124,34,90,8,49,29,20,88,84,1,3,0,0
E33029780,307,151,39,112,6,78,41,37,70,67,0,3,0,2
E33029781,906,492,120,372,14,37,17,20,354,333,2,18,1,9
E33029782,795,482,113,369,14,50,14,36,247,239,0,7,1,2
E33029783,917,535,150,385,10,83,34,49,285,277,0,8,0,4
E33029784,334,147,40,107,14,90,47,43,78,77,0,1,0,5
E33029785,272,132,40,92,4,39,13,26,95,85,2,7,1,2
E33029786,450,185,49,136,5,71,38,33,186,178,0,8,0,3
E33029787,481,240,70,170,10,81,32,49,141,135,1,2,3,9
E33029788,731,386,112,274,15,147,81,66,181,174,0,6,1,2
E33029789,4436,2206,612,1594,130,871,300,571,1193,1133,13,32,15,36
E33029790,6681,4037,887,3150,128,371,173,198,2101,2013,10,71,7,44
E33029791,167,63,22,41,3,41,18,23,57,56,0,0,1,3
E33029792,235,88,25,63,5,41,19,22,101,100,0,1,0,0
E33029793,811,405,104,301,7,65,34,31,323,309,1,8,5,11
E33029794,3498,1595,447,1148,100,819,288,531,958,889,16,41,12,26
E33029795,383,192,58,134,6,83,34,49,100,94,0,5,1,2
E33029796,1017,532,124,408,13,45,21,24,418,404,1,11,2,9
E33029797,1305,656,158,498,16,124,53,71,495,475,5,12,3,14
E33029798,611,318,97,221,3,41,23,18,244,236,1,7,0,5
E33029799,1053,533,135,398,22,64,33,31,420,405,1,12,2,14
E33029800,1732,978,201,777,23,91,39,52,625,602,5,15,3,15
E33029801,653,275,76,199,7,106,59,47,260,244,6,8,2,5
E33029802,267,139,49,90,10,32,13,19,81,71,3,6,1,5
E33029803,416,239,72,167,4,34,16,18,136,126,0,6,4,3
E33029804,274,137,33,104,3,42,22,20,90,79,4,6,1,2
E33029805,371,161,48,113,5,37,23,14,161,159,0,2,0,7
E33029806,567,379,100,279,8,37,16,21,136,131,2,3,0,7
E33029807,435,219,68,151,8,56,27,29,146,141,0,4,1,6
E33029808,661,349,89,260,10,51,28,23,247,238,4,5,0,4
E33029809,381,151,27,124,10,101,53,48,118,112,0,5,1,1
E33029810,261,101,23,78,4,55,35,20,100,94,1,5,0,1
E33029811,446,211,66,145,8,68,40,28,152,148,0,3,1,7
E33029812,456,217,70,147,12,97,53,44,125,120,0,3,2,5
E33029813,708,264,77,187,8,143,75,68,285,267,1,10,7,8
E33029814,1401,536,166,370,21,269,152,117,556,530,3,15,8,19
E33029815,1421,866,268,598,47,275,137,138,232,221,1,9,1,1
E33029816,697,296,66,230,10,67,34,33,322,312,0,8,2,2
E33029817,2357,1771,424,1347,49,249,130,119,273,252,3,18,0,15
E33029818,508,214,61,153,4,89,43,46,198,183,3,7,5,3
E33029819,436,214,73,141,4,46,22,24,165,158,0,7,0,7
E33029820,275,124,37,87,5,28,20,8,117,114,0,3,0,1
E33029821,384,203,64,139,10,37,10,27,129,121,4,3,1,5
E33029822,219,106,26,80,1,51,31,20,58,57,0,1,0,3
E33029823,630,334,103,231,3,93,50,43,195,188,0,5,2,5
E33029824,506,235,70,165,11,59,38,21,191,177,2,11,1,10
E33029825,876,470,147,323,5,104,46,58,283,268,1,13,1,14
E33029826,570,227,77,150,3,78,36,42,256,239,2,13,2,6
E33029827,232,102,36,66,7,75,40,35,46,45,0,1,0,2
E33029828,433,140,44,96,5,169,88,81,112,101,0,9,2,7
E33029829,262,142,29,113,4,34,21,13,81,77,0,4,0,1
E33029830,294,96,17,79,3,61,29,32,131,129,0,2,0,3
E33029831,1339,504,105,399,12,299,157,142,513,484,12,14,3,11
E33029832,548,217,45,172,12,114,55,59,200,192,1,2,5,5
E33029833,547,227,73,154,3,141,77,64,167,161,0,4,2,9
E33029834,345,156,30,126,5,73,45,28,110,106,0,4,0,1
E33029835,450,185,54,131,3,89,51,38,171,162,5,4,0,2
E33029836,515,208,48,160,1,82,41,41,219,213,2,3,1,5
E33029837,493,254,55,199,4,63,28,35,168,164,0,4,0,4
E33029838,339,166,52,114,5,46,30,16,120,112,2,4,2,2
E33029839,369,175,73,102,9,54,36,18,129,128,0,1,0,2
E33029840,476,260,72,188,15,85,51,34,114,104,0,7,3,2
E33029841,593,279,80,199,6,134,85,49,169,159,0,8,2,5
E33029842,262,142,33,109,3,51,22,29,66,59,0,3,4,0
E33029843,220,125,33,92,5,32,12,20,57,56,0,1,0,1
E33029844,393,230,66,164,3,59,37,22,99,96,0,2,1,2
E33029845,835,329,102,227,8,261,149,112,228,218,1,6,3,9
E33029846,585,191,52,139,11,201,121,80,175,166,1,7,1,7
E33029847,250,79,27,52,4,52,32,20,110,103,2,0,5,5
E33029848,587,230,77,153,6,175,107,68,174,167,1,5,1,2
E33029849,560,267,76,191,12,120,81,39,147,143,0,4,0,14
E33029850,359,186,48,138,1,65,42,23,106,99,0,6,1,1
E33029851,736,409,88,321,10,153,94,59,157,149,2,4,2,7
E33029852,317,169,43,126,6,89,49,40,53,53,0,0,0,0
E33029853,375,168,54,114,4,72,37,35,125,111,0,13,1,6
E33029854,783,331,104,227,2,196,127,69,246,238,1,6,1,8
E33029855,779,423,131,292,12,211,127,84,133,126,1,6,0,0
E33029856,831,437,106,331,12,193,116,77,184,174,0,8,2,5
E33029857,332,196,51,145,4,62,31,31,68,65,0,3,0,2
E33029858,1210,797,210,587,19,199,123,76,185,176,1,7,1,10
E33029859,1752,981,232,749,32,404,244,160,327,314,0,9,4,8
E33029860,307,201,52,149,3,33,14,19,70,67,0,3,0,0
E33029861,577,369,110,259,8,63,40,23,134,131,0,2,1,3
E33029862,471,292,64,228,7,41,15,26,129,121,4,3,1,2
E33029863,207,127,40,87,1,24,8,16,54,53,1,0,0,1
E33029864,378,230,72,158,3,62,33,29,80,73,1,2,4,3
E33029865,367,240,77,163,4,28,4,24,93,87,0,5,1,2
E33029866,250,147,51,96,2,19,11,8,81,77,0,3,1,1
E33029867,854,505,138,367,15,106,54,52,223,217,1,1,4,5
E33029868,489,260,56,204,3,89,50,39,133,128,0,4,1,4
E33029869,657,359,113,246,9,115,51,64,170,161,0,4,5,4
E33029870,352,247,85,162,5,32,15,17,67,65,0,1,1,1
E33029871,543,362,97,265,6,43,28,15,130,126,0,4,0,2
E33029872,511,354,116,238,7,61,37,24,87,78,0,1,8,2
E33029873,401,256,65,191,4,16,8,8,122,117,0,3,2,3
E33029874,420,298,105,193,7,50,24,26,59,52,1,1,5,6
E33029875,491,288,74,214,10,55,31,24,130,126,1,3,0,8
E33029876,519,269,91,178,11,68,29,39,165,154,1,7,3,6
E33029877,323,200,60,140,7,40,25,15,76,72,1,3,0,0
E33029878,611,338,140,198,0,36,25,11,143,91,41,8,3,94
E33029879,443,244,80,164,0,32,19,13,165,156,3,4,2,2
E33029880,257,138,38,100,3,21,9,12,95,93,1,0,1,0
E33029881,250,187,72,115,5,9,4,5,47,47,0,0,0,2
E33029882,1583,1112,368,744,25,180,91,89,261,245,1,11,4,5
E33029883,378,176,59,117,5,57,26,31,139,135,3,1,0,1
E33029884,297,193,70,123,5,37,13,24,61,58,0,3,0,1
E33029885,1108,849,254,595,7,65,33,32,171,163,0,6,2,16
E33029886,818,598,192,406,11,77,39,38,126,116,1,8,1,6
E33029887,296,193,61,132,1,34,18,16,66,58,5,3,0,2
E33029888,277,193,53,140,1,23,14,9,58,56,1,1,0,2
E33029889,266,191,82,109,3,20,14,6,44,41,1,1,1,8
E33029890,306,224,77,147,5,25,10,15,51,50,1,0,0,1
E33029891,249,169,66,103,0,21,11,10,57,51,3,1,2,2
E33029892,220,161,52,109,1,13,5,8,44,42,0,1,1,1
E33029893,218,133,38,95,1,10,3,7,73,71,0,1,1,1
E33029894,482,247,82,165,4,61,34,27,165,156,2,6,1,5
E33029895,214,145,49,96,2,17,8,9,48,46,0,2,0,2
E33029896,355,270,89,181,4,23,11,12,54,51,0,3,0,4
E33029897,232,153,46,107,7,22,9,13,50,48,1,1,0,0
E33029898,291,187,53,134,3,31,16,15,69,62,0,6,1,1
E33029899,1400,838,230,608,23,139,68,71,392,382,1,7,2,8
E33029900,825,663,195,468,10,69,45,24,80,76,2,2,0,3
E33029901,623,394,89,305,4,118,86,32,103,92,8,1,2,4
E33029902,898,564,171,393,8,203,167,36,118,111,0,6,1,5
E33029903,394,287,77,210,4,46,31,15,56,51,1,4,0,1
E33029904,347,250,73,177,4,43,32,11,47,44,0,3,0,3
E33029905,711,512,114,398,5,78,52,26,115,107,2,6,0,1
E33029906,438,307,90,217,4,57,41,16,67,63,0,3,1,3
E33029907,200,147,30,117,2,19,12,7,31,26,0,5,0,1
E33029908,674,467,108,359,8,105,78,27,89,81,3,5,0,5
E33029909,298,218,68,150,2,37,19,18,41,35,3,3,0,0
E33029910,556,366,92,274,4,104,71,33,79,76,1,2,0,3
E33029911,254,181,41,140,1,31,25,6,41,37,1,2,1,0
E33029912,215,142,32,110,2,34,29,5,37,33,0,4,0,0
E33029913,426,269,70,199,8,60,44,16,89,88,0,1,0,0
E33029914,414,273,74,199,7,62,51,11,72,68,0,4,0,0
E33029915,549,395,110,285,7,77,61,16,68,64,0,3,1,2
E33029916,431,285,73,212,2,66,48,18,76,74,0,2,0,2
E33029917,648,444,140,304,1,103,67,36,97,92,1,4,0,3
E33029918,688,552,159,393,5,63,47,16,66,65,0,1,0,2
E33029919,734,594,154,440,8,58,38,20,74,68,0,6,0,0
E33029920,218,150,35,115,2,22,12,10,42,40,0,2,0,2
E33029921,497,297,64,233,5,96,83,13,97,94,0,3,0,2
E33029922,227,162,45,117,0,15,13,2,48,44,0,4,0,2
E33029923,335,231,48,183,1,49,40,9,49,45,0,3,1,5
E33029924,473,351,95,256,3,54,41,13,63,62,1,0,0,2
E33029925,550,409,124,285,4,75,55,20,61,56,0,5,0,1
E33029926,352,276,95,181,1,26,20,6,49,47,0,2,0,0
E33029927,290,217,50,167,0,20,15,5,53,51,1,1,0,0
E33029928,311,243,55,188,3,26,20,6,31,28,0,3,0,8
E33029929,343,227,72,155,2,56,43,13,57,53,1,2,1,1
E33029930,249,180,44,136,2,27,18,9,39,35,0,4,0,1
E33029931,376,278,67,211,4,31,21,10,62,57,0,5,0,1
E33029932,676,484,135,349,8,95,64,31,87,85,0,2,0,2
E33029933,295,213,51,162,2,36,24,12,43,35,2,5,1,1
E33029934,474,291,63,228,7,83,61,22,93,89,0,4,0,0
E33029935,306,237,81,156,1,34,16,18,32,29,0,3,0,2
E33029936,298,213,64,149,1,31,26,5,53,51,0,2,0,0
E33029937,289,209,56,153,3,28,15,13,48,47,0,1,0,1
E33029938,204,171,43,128,0,11,6,5,20,19,0,1,0,2
E33029939,272,207,66,141,1,34,25,9,23,18,4,0,1,7
E33029940,353,227,50,177,1,37,22,15,84,81,2,1,0,4
E33029941,294,174,45,129,4,40,24,16,67,62,2,1,2,9
E33029942,549,404,55,349,6,17,11,6,120,117,2,1,0,2
E33029943,952,683,223,460,24,107,59,48,135,121,1,12,1,3
E33029944,464,364,84,280,7,15,10,5,76,73,0,1,2,2
E33029945,634,410,82,328,17,49,27,22,154,150,2,0,2,4
E33029946,208,134,50,84,4,26,11,15,43,43,0,0,0,1
E33029947,207,121,38,83,3,30,15,15,51,48,0,3,0,2
E33029948,409,267,75,192,4,59,31,28,79,75,0,3,1,0
E33029949,1129,658,125,533,13,41,22,19,414,405,0,5,4,3
E33029950,612,412,109,303,11,86,46,40,102,95,1,5,1,1
E33029951,852,569,114,455,12,31,17,14,237,224,1,5,7,3
E33029952,543,339,99,240,7,94,57,37,102,92,0,7,3,1
E33029953,408,288,47,241,7,15,9,6,98,91,0,6,1,0
E33029954,259,196,42,154,2,19,10,9,41,37,0,4,0,1
E33029955,694,483,110,373,9,41,21,20,160,153,1,5,1,1
E33029956,1086,801,179,622,13,31,18,13,237,232,0,4,1,4
E33029957,1397,928,213,715,26,140,90,50,299,270,15,13,1,4
E33029958,358,250,64,186,5,19,10,9,83,78,3,2,0,1
E33029959,609,395,90,305,14,65,29,36,134,127,0,7,0,1
E33029960,704,453,142,311,12,83,44,39,150,141,0,8,1,6
E33029961,337,230,71,159,4,33,16,17,67,62,1,4,0,3
E33029962,138,81,17,64,2,9,5,4,45,44,0,1,0,1
E33029963,347,224,54,170,17,40,19,21,63,59,1,3,0,3
E33029964,322,194,39,155,9,34,17,17,81,77,0,4,0,4
E33029965,409,258,56,202,7,29,17,12,111,105,0,3,3,4
E33029966,6086,4995,999,3996,64,190,83,107,820,780,3,29,8,17
E33029967,907,567,130,437,24,102,53,49,207,192,5,8,2,7
E33029968,608,446,110,336,14,68,31,37,79,74,2,2,1,1
E33029969,3502,2177,563,1614,66,359,187,172,869,816,5,33,15,31
E33029970,622,380,100,280,20,94,42,52,123,112,0,7,4,5
E33029971,633,420,102,318,10,43,20,23,153,143,1,4,5,7
E33029972,344,214,69,145,7,38,20,18,85,82,0,2,1,0
E33029973,805,548,146,402,12,71,36,35,168,163,0,4,1,6
E33029974,342,239,58,181,7,32,10,22,62,60,1,1,0,2
E33029975,3022,1964,506,1458,57,320,153,167,668,640,3,19,6,13
E33029976,230,177,40,137,7,14,6,8,31,27,1,2,1,1
E33029977,4666,3031,787,2244,86,463,235,228,1055,999,4,40,12,31
E33029978,246,176,58,118,3,24,5,19,43,39,1,3,0,0
E33029979,424,279,81,198,8,35,18,17,100,95,0,4,1,2
E33029980,329,217,47,170,8,48,29,19,56,54,0,2,0,0
E33029981,1295,848,185,663,18,67,37,30,356,340,4,8,4,6
E33029982,408,261,71,190,6,59,33,26,78,71,1,5,1,4
E33029983,549,390,103,287,5,47,23,24,102,99,0,3,0,5
E33029984,6441,4518,1103,3415,113,559,284,275,1217,1160,8,42,7,34
E33029985,657,362,88,274,9,74,32,42,207,197,1,9,0,5
E33029986,1033,805,216,589,22,80,47,33,120,110,3,5,2,6
E33029987,320,174,43,131,9,58,40,18,77,73,0,4,0,2
E33029988,233,167,39,128,2,14,6,8,48,48,0,0,0,2
E33029989,757,557,132,425,12,45,27,18,137,121,4,7,5,6
E33029990,698,456,108,348,5,28,19,9,208,200,1,5,2,1
E33029991,2023,1439,302,1137,24,180,81,99,365,350,3,7,5,15
E33029992,679,397,104,293,11,52,25,27,215,203,3,8,1,4
E33029993,659,350,83,267,18,57,21,36,231,212,11,7,1,3
E33029994,6260,4340,991,3349,114,531,284,247,1241,1169,10,46,16,34
E33029995,1088,501,134,367,9,279,157,122,277,264,1,6,6,22
E33029996,336,230,63,167,1,27,13,14,70,65,2,2,1,8
E33029997,697,502,179,323,5,52,35,17,127,115,8,3,1,11
E33029998,1344,965,299,666,18,149,78,71,205,185,5,7,8,7
E33029999,1791,1182,274,908,9,173,112,61,420,397,4,16,3,7
E33030000,578,360,106,254,6,68,41,27,142,127,1,13,1,2
E33030001,600,438,137,301,2,59,34,25,99,90,3,5,1,2
E33030002,514,297,70,227,7,75,38,37,131,126,2,1,2,4
E33030003,1632,914,277,637,24,161,90,71,528,199,184,13,132,5
E33030004,895,505,155,350,8,155,78,77,222,203,6,11,2,5
E33030005,366,235,77,158,4,49,30,19,77,69,3,4,1,1
E33030006,329,157,41,116,5,39,18,21,127,115,2,4,6,1
E33030007,281,180,54,126,3,40,23,17,55,52,1,2,0,3
E33030008,216,129,26,103,3,37,21,16,46,42,0,4,0,1
E33030009,244,150,40,110,1,31,16,15,56,52,3,1,0,6
E33030010,222,104,28,76,0,39,25,14,78,73,2,2,1,1
E33030011,338,214,65,149,10,56,36,20,56,54,1,0,1,2
E33030012,621,397,92,305,9,102,71,31,111,101,0,8,2,2
E33030013,264,173,51,122,6,25,9,16,58,53,2,3,0,2
E33030014,213,130,36,94,3,37,22,15,42,38,2,1,1,1
E33030015,613,425,120,305,4,30,19,11,152,145,0,4,3,2
E33030016,207,144,48,96,3,22,13,9,36,36,0,0,0,2
E33030017,272,164,48,116,4,27,14,13,76,72,0,4,0,1
E33030018,470,297,77,220,11,63,36,27,97,91,0,5,1,2
E33030019,296,234,54,180,3,11,7,4,46,43,1,1,1,2
E33030020,309,194,48,146,6,34,17,17,70,65,1,4,0,5
E33030021,293,203,60,143,3,22,12,10,65,62,1,0,2,0
E33030022,641,432,105,327,4,33,19,14,170,163,2,4,1,2
E33030023,918,561,135,426,19,137,75,62,194,186,3,5,0,7
E33030024,315,217,62,155,10,27,16,11,60,56,0,3,1,1
E33030025,301,181,45,136,9,42,23,19,63,56,0,7,0,6
E33030026,764,528,176,352,10,113,64,49,109,101,4,2,2,4
E33030027,670,470,130,340,11,43,22,21,143,138,1,4,0,3
E33030028,1111,804,173,631,10,44,24,20,248,237,2,9,0,5
E33030029,514,345,70,275,11,48,26,22,107,102,0,4,1,3
E33030030,2033,1448,316,1132,26,115,61,54,436,421,3,11,1,8
E33030031,265,196,75,121,6,33,21,12,28,27,0,1,0,2
E33030032,925,559,150,409,12,107,67,40,243,227,3,9,4,4
E33030033,613,372,94,278,10,81,45,36,147,145,0,1,1,3
E33030034,2483,1829,524,1305,39,268,141,127,331,310,8,10,3,16
E33030035,693,450,123,327,8,60,37,23,172,157,1,11,3,3
E33030036,113,74,22,52,6,16,11,5,12,12,0,0,0,5
E33030037,501,346,116,230,5,60,39,21,90,84,2,4,0,0
E33030038,267,155,48,107,2,47,22,25,63,61,0,2,0,0
E33030039,246,180,64,116,4,20,8,12,38,35,2,1,0,4
E33030040,216,145,36,109,4,15,7,8,52,45,0,4,3,0
E33030041,238,161,50,111,6,23,18,5,48,41,2,4,1,0
E33030042,377,241,71,170,7,52,28,24,76,68,2,5,1,1
E33030043,224,118,35,83,3,54,33,21,48,48,0,0,0,1
E33030044,386,234,64,170,9,35,19,16,107,106,0,1,0,1
E33030045,1216,924,230,694,9,65,29,36,216,207,2,5,2,2
E33030046,499,399,90,309,2,12,4,8,84,80,1,3,0,2
E33030047,570,366,114,252,4,96,39,57,99,95,0,4,0,5
E33030048,1186,853,262,591,24,152,92,60,154,141,4,5,4,3
E33030049,420,298,82,216,5,46,29,17,65,61,2,1,1,6
E33030050,3167,2308,443,1865,37,128,59,69,683,653,4,24,2,11
E33030051,756,576,121,455,4,35,18,17,136,131,1,4,0,5
E33030052,799,532,126,406,23,87,36,51,151,144,1,6,0,6
E33030053,299,199,51,148,10,46,31,15,43,40,0,2,1,1
E33030054,1386,784,172,612,21,134,72,62,440,430,1,8,1,7
E33030055,876,633,123,510,12,34,17,17,195,191,1,2,1,2
E33030056,950,509,159,350,11,83,51,32,341,326,4,9,2,6
E33030057,592,339,109,230,14,54,39,15,178,166,1,11,0,7
E33030058,543,343,92,251,9,99,49,50,90,79,1,9,1,2
E33030059,349,207,65,142,10,54,35,19,74,68,1,4,1,4
E33030060,358,233,49,184,3,48,25,23,74,72,0,2,0,0
E33030061,418,280,63,217,7,60,33,27,70,63,2,5,0,1
E33030062,1034,703,158,545,21,126,78,48,177,166,0,9,2,7
E33030063,725,398,112,286,13,90,43,47,222,211,0,9,2,2
E33030064,481,320,75,245,9,67,35,32,83,77,0,3,3,2
E33030065,1263,797,202,595,25,145,74,71,294,282,4,5,3,2
E33030066,233,128,35,93,6,42,29,13,56,53,0,2,1,1
E33030067,541,365,93,272,9,83,58,25,81,77,0,4,0,3
E33030068,239,146,39,107,8,46,28,18,35,29,3,1,2,4
E33030069,619,418,89,329,16,32,17,15,152,144,0,8,0,1
E33030070,920,676,220,456,12,78,32,46,145,122,4,7,12,9
E33030071,251,157,43,114,6,30,16,14,57,51,0,6,0,1
E33030072,1812,1259,381,878,51,223,117,106,269,256,1,9,3,10
E33030073,795,482,108,374,13,110,60,50,188,174,4,10,0,2
E33030074,140,87,18,69,5,20,14,6,27,25,2,0,0,1
E33030075,655,425,117,308,5,80,49,31,139,130,1,6,2,6
E33030076,420,278,67,211,9,62,32,30,70,65,0,2,3,1
E33030077,3310,2213,560,1653,62,352,174,178,662,614,13,26,9,21
E33030078,235,152,45,107,3,27,14,13,49,46,1,0,2,4
E33030079,489,280,82,198,8,92,49,43,106,96,2,6,2,3
E33030080,411,189,59,130,1,71,35,36,150,143,0,5,2,0
E33030081,718,383,136,247,15,148,78,70,166,159,1,5,1,6
E33030082,258,150,36,114,4,41,24,17,62,60,0,2,0,1
E33030083,195,103,26,77,2,39,26,13,50,46,3,1,0,1
E33030084,287,171,42,129,6,34,14,20,72,70,0,1,1,4
E33030085,380,240,77,163,11,38,19,19,87,79,1,3,4,4
E33030086,490,292,61,231,18,42,20,22,138,134,2,2,0,0
E33030087,390,213,75,138,3,47,25,22,120,112,1,1,6,7
E33030088,345,163,37,126,5,30,23,7,146,139,1,6,0,1
E33030089,488,259,52,207,10,69,47,22,148,143,1,3,1,2
E33030090,589,331,86,245,8,75,45,30,174,169,1,3,1,1
E33030091,272,169,36,133,7,18,8,10,78,75,0,3,0,0
E33030092,6672,4287,918,3369,139,469,240,229,1747,1660,6,70,11,30
E33030093,893,483,112,371,19,91,55,36,294,285,1,7,1,6
E33030094,359,140,45,95,3,50,30,20,151,142,1,7,1,15
E33030095,416,161,53,108,8,79,42,37,164,157,0,5,2,4
E33030096,496,293,112,181,4,47,28,19,147,143,3,1,0,5
E33030097,1128,645,140,505,22,46,18,28,410,398,0,11,1,5
E33030098,599,309,77,232,7,24,16,8,252,237,0,14,1,7
E33030099,1760,892,203,689,18,120,54,66,723,691,5,24,3,7
E33030100,717,360,73,287,7,38,15,23,311,306,0,4,1,1
E33030101,304,135,34,101,2,67,33,34,95,90,0,5,0,5
E33030102,377,201,61,140,11,43,18,25,121,111,0,6,4,1
E33030103,436,172,43,129,4,81,53,28,177,169,2,6,0,2
E33030104,528,302,86,216,12,39,15,24,171,166,1,3,1,4
E33030105,513,295,89,206,9,62,30,32,137,132,0,5,0,10
E33030106,416,135,39,96,7,197,119,78,75,71,0,4,0,2
E33030107,141,32,12,20,2,71,47,24,34,30,0,3,1,2
E33030108,275,127,28,99,3,44,25,19,98,90,0,5,3,3
E33030109,473,287,70,217,6,51,33,18,124,118,0,5,1,5
E33030110,1163,781,153,628,12,36,18,18,320,307,0,11,2,14
E33030111,225,144,32,112,2,14,12,2,64,64,0,0,0,1
E33030112,605,405,100,305,9,21,11,10,168,160,0,6,2,2
E33030113,3833,2371,578,1793,35,125,61,64,1278,1229,4,38,7,24
E33030114,555,331,97,234,5,24,14,10,189,181,1,5,2,6
E33030115,2494,1166,249,917,40,128,65,63,1146,1103,4,34,5,14
E33030116,518,283,76,207,3,30,18,12,199,192,1,6,0,3
E33030117,1906,1203,354,849,22,92,51,41,575,528,2,38,7,14
E33030118,412,218,58,160,2,26,10,16,160,155,0,5,0,6
E33030119,1152,796,173,623,6,36,18,18,308,297,1,9,1,6
E33030120,364,200,55,145,7,21,10,11,136,134,1,1,0,0
E33030121,277,198,41,157,3,18,9,9,58,57,1,0,0,0
E33030122,812,487,112,375,7,115,65,50,200,191,1,4,4,3
E33030123,503,303,70,233,6,45,27,18,145,142,0,2,1,4
E33030124,518,298,105,193,12,54,31,23,147,137,2,7,1,7
E33030125,362,135,47,88,8,140,85,55,72,64,2,4,2,7
E33030126,221,160,43,117,1,9,8,1,51,46,0,4,1,0
E33030127,205,102,21,81,4,13,6,7,85,81,0,4,0,1
E33030128,376,192,44,148,5,34,24,10,143,132,0,11,0,2
E33030129,211,114,30,84,6,15,7,8,73,67,1,4,1,3
E33030130,348,196,66,130,2,8,1,7,140,131,1,7,1,2
E33030131,321,189,44,145,7,14,7,7,108,103,0,5,0,3
E33030132,302,154,42,112,2,66,17,49,70,67,1,0,2,10
E33030133,608,378,87,291,11,28,12,16,186,174,1,10,1,5
E33030134,662,368,104,264,15,78,35,43,198,190,0,8,0,3
E33030135,266,157,54,103,5,19,6,13,85,82,1,1,1,0
E33030136,237,150,52,98,1,25,22,3,59,55,0,4,0,2
E33030137,215,76,25,51,0,38,18,20,97,96,0,1,0,4
E33030138,1058,457,98,359,10,229,123,106,354,336,0,13,5,8
E33030139,1585,854,237,617,48,306,145,161,362,344,1,13,4,15
E33030140,1370,714,219,495,17,124,59,65,508,487,3,15,3,7
E33030141,702,361,78,283,10,118,70,48,208,192,1,13,2,5
E33030142,836,572,137,435,14,62,39,23,184,178,0,4,2,4
E33030143,756,399,95,304,17,84,38,46,252,241,1,9,1,4
E33030144,289,131,17,114,7,31,19,12,118,113,0,5,0,2
E33030145,446,241,47,194,13,47,30,17,142,136,0,4,2,3
E33030146,670,359,98,261,8,56,29,27,244,228,1,13,2,3
E33030147,307,151,41,110,3,13,8,5,138,135,0,3,0,2
E33030148,512,265,63,202,11,31,17,14,202,195,0,6,1,3
E33030149,206,107,16,91,2,57,31,26,38,36,0,2,0,2
E33030150,808,443,128,315,14,96,58,38,251,234,1,16,0,4
E33030151,293,192,43,149,3,21,7,14,76,73,0,3,0,1
E33030152,740,503,122,381,14,66,31,35,153,145,0,8,0,4
E33030153,794,435,93,342,14,41,19,22,303,291,1,10,1,1
E33030154,416,216,50,166,3,108,65,43,88,84,0,3,1,1
E33030155,317,176,33,143,7,66,42,24,65,60,1,4,0,3
E33030156,667,382,92,290,8,105,58,47,168,160,0,6,2,4
E33030157,256,116,32,84,4,62,40,22,71,69,0,2,0,3
E33030158,202,93,19,74,5,51,22,29,51,48,1,2,0,2
E33030159,248,81,26,55,0,79,45,34,88,84,1,2,1,0
E33030160,3511,2264,540,1724,42,181,97,84,1012,965,3,36,8,12
E33030161,1155,643,161,482,23,181,103,78,306,292,3,9,2,2
E33030162,381,153,41,112,3,105,52,53,118,112,0,3,3,2
E33030163,1302,858,182,676,15,83,40,43,339,321,3,14,1,7
E33030164,352,205,53,152,15,59,28,31,71,68,1,0,2,2
E33030165,257,111,16,95,1,52,36,16,91,86,1,4,0,2
E33030166,252,102,25,77,1,25,14,11,124,121,3,0,0,0
E33030167,415,192,45,147,4,55,27,28,157,152,3,2,0,7
E33030168,936,457,83,374,18,116,71,45,335,313,3,11,8,10
E33030169,407,246,57,189,11,40,13,27,103,94,1,7,1,7
E33030170,445,235,59,176,8,46,20,26,152,145,1,5,1,4
E33030171,269,134,34,100,2,26,13,13,107,106,1,0,0,0
E33030172,288,145,32,113,3,46,33,13,91,83,0,7,1,3
E33030173,447,283,49,234,9,21,11,10,134,127,1,6,0,0
E33030174,208,126,26,100,4,25,7,18,51,47,1,1,2,2
E33030175,719,373,88,285,7,33,13,20,300,287,0,11,2,6
E33030176,438,195,35,160,7,63,33,30,171,161,2,5,3,2
E33030177,478,169,40,129,2,19,10,9,286,276,0,9,1,2
E33030178,242,110,26,84,3,34,16,18,92,90,0,1,1,3
E33030179,1023,515,122,393,22,70,38,32,409,389,1,16,3,7
E33030180,163,98,20,78,2,6,3,3,56,52,1,1,2,1
E33030181,306,165,38,127,3,21,11,10,114,111,0,3,0,3
E33030182,274,153,46,107,3,16,9,7,99,98,0,1,0,3
E33030183,748,344,84,260,8,70,25,45,324,303,2,16,3,2
E33030184,396,199,39,160,3,45,19,26,147,135,4,8,0,2
E33030185,988,568,129,439,16,46,28,18,349,340,1,8,0,9
E33030186,233,126,37,89,4,19,6,13,84,79,1,4,0,0
E33030187,208,124,22,102,4,12,8,4,67,61,0,6,0,1
E33030188,255,160,38,122,3,9,3,6,81,78,1,2,0,2
E33030189,410,204,61,143,10,24,17,7,169,161,0,6,2,3
E33030190,191,116,24,92,0,11,4,7,59,52,5,1,1,5
E33030191,270,128,34,94,7,19,12,7,109,100,1,3,5,7
E33030192,367,230,68,162,5,27,12,15,101,94,0,7,0,4
E33030193,227,139,31,108,2,21,11,10,63,61,0,2,0,2
E33030194,379,202,40,162,5,20,12,8,149,139,0,10,0,3
E33030195,336,162,43,119,8,72,46,26,88,87,0,1,0,6
E33030196,444,255,60,195,6,33,12,21,148,139,0,7,2,2
E33030197,242,139,31,108,4,23,11,12,76,75,1,0,0,0
E33030198,338,137,39,98,4,19,16,3,176,171,2,3,0,2
E33030199,657,418,103,315,12,38,17,21,182,171,1,10,0,7
E33030200,1153,637,124,513,16,55,20,35,438,415,2,20,1,7
E33030201,425,255,75,180,8,29,16,13,133,128,0,5,0,0
E33030202,821,438,100,338,15,51,29,22,312,296,1,13,2,5
E33030203,253,151,43,108,5,12,5,7,84,79,0,4,1,1
E33030204,633,415,94,321,7,41,26,15,168,157,1,10,0,2
E33030205,221,138,22,116,0,20,12,8,61,58,0,3,0,2
E33030206,321,171,54,117,1,16,9,7,128,120,0,8,0,5
E33030207,454,201,52,149,4,56,28,28,189,179,3,6,1,4
E33030208,614,313,76,237,10,19,8,11,269,252,1,15,1,3
E33030209,898,437,145,292,11,176,111,65,261,245,1,11,4,13
E33030210,957,503,134,369,21,88,45,43,339,315,0,22,2,6
E33030211,377,246,76,170,3,28,16,12,99,92,0,7,0,1
E33030212,213,67,18,49,1,79,56,23,58,56,0,1,1,8
E33030213,193,101,31,70,3,43,27,16,45,43,0,1,1,1
E33030214,601,175,55,120,6,295,186,109,115,111,0,3,1,10
E33030215,617,303,76,227,15,107,63,44,184,175,0,8,1,8
E33030216,723,417,117,300,12,141,88,53,146,135,2,5,4,7
E33030217,7871,4316,1158,3158,106,1620,831,789,1771,1689,10,57,15,58
E33030218,2636,1361,376,985,64,648,370,278,540,511,4,20,5,23
E33030219,331,153,56,97,7,96,60,36,71,60,0,11,0,4
E33030220,333,143,40,103,7,84,46,38,97,93,0,3,1,2
E33030221,440,245,72,173,11,79,49,30,101,98,0,1,2,4
E33030222,352,132,41,91,3,93,65,28,120,116,1,3,0,4
E33030223,1529,874,182,692,40,328,209,119,272,253,0,17,2,15
E33030224,353,137,37,100,5,53,34,19,148,141,3,4,0,10
E33030225,406,167,57,110,1,151,88,63,87,82,1,4,0,0
E33030226,330,131,39,92,2,56,33,23,138,132,3,1,2,3
E33030227,1024,569,137,432,18,104,45,59,323,304,0,18,1,10
E33030228,859,562,142,420,9,83,51,32,200,190,0,10,0,5
E33030229,322,146,59,87,5,42,21,21,125,119,3,2,1,4
E33030230,943,564,126,438,9,100,61,39,265,255,0,7,3,5
E33030231,287,161,39,122,5,28,15,13,90,87,0,3,0,3
E33030232,426,212,66,146,7,52,27,25,143,138,0,5,0,12
E33030233,678,323,105,218,14,111,57,54,221,210,0,8,3,9
E33030234,415,196,62,134,2,34,22,12,173,163,1,8,1,10
E33030235,413,221,49,172,5,38,15,23,140,129,2,9,0,9
E33030236,346,177,41,136,2,33,18,15,122,115,1,4,2,12
E33030237,520,277,64,213,7,42,26,16,188,178,0,7,3,6
E33030238,255,118,30,88,4,22,11,11,105,102,1,1,1,6
E33030239,408,152,40,112,6,58,36,22,174,169,0,4,1,18
E33030240,1386,612,145,467,30,191,108,83,535,505,3,23,4,18
E33030241,412,167,57,110,5,57,23,34,170,166,0,3,1,13
E33030242,340,176,54,122,6,28,15,13,124,118,0,5,1,6
E33030243,239,144,53,91,4,15,6,9,63,58,1,4,0,13
E33030244,407,153,35,118,8,64,27,37,171,165,0,5,1,11
E33030245,618,269,96,173,7,92,43,49,246,229,10,7,0,4
E33030246,220,87,29,58,1,19,9,10,113,110,1,2,0,0
E33030247,4792,2153,575,1578,92,693,364,329,1809,1732,6,60,11,45
E33030248,281,127,40,87,10,26,18,8,112,106,3,2,1,6
E33030249,359,209,57,152,3,19,10,9,124,119,2,3,0,4
E33030250,1446,681,232,449,26,125,54,71,586,551,8,24,3,28
E33030251,447,201,60,141,6,29,14,15,206,197,4,2,3,5
E33030252,424,217,84,133,6,35,16,19,148,142,1,4,1,18
E33030253,281,99,40,59,4,35,16,19,135,127,0,6,2,8
E33030254,564,268,109,159,12,48,26,22,226,216,3,5,2,10
E33030255,2279,1162,365,797,45,227,100,127,828,788,5,24,11,17
E33030256,304,148,45,103,11,40,18,22,101,97,0,3,1,4
E33030257,555,232,75,157,4,66,31,35,250,220,10,8,12,3
E33030258,297,112,33,79,4,39,24,15,140,134,2,2,2,2
E33030259,374,184,55,129,9,32,17,15,145,135,1,7,2,4
E33030260,329,151,54,97,3,45,34,11,125,122,1,2,0,5
E33030261,443,194,57,137,7,46,26,20,188,182,4,1,1,8
E33030262,1543,896,273,623,47,281,128,153,301,283,4,12,2,18
E33030263,221,85,20,65,4,36,18,18,95,93,1,1,0,1
E33030264,399,179,39,140,2,64,34,30,147,143,0,1,3,7
E33030265,516,253,72,181,3,59,28,31,197,188,3,4,2,4
E33030266,210,109,39,70,4,35,11,24,58,56,1,1,0,4
E33030267,409,182,62,120,10,27,15,12,182,180,1,1,0,8
E33030268,701,334,82,252,16,134,60,74,210,205,0,3,2,7
E33030269,239,88,38,50,3,28,8,20,112,106,0,3,3,8
E33030270,728,287,92,195,15,99,45,54,316,304,4,6,2,11
E33030271,624,281,106,175,6,52,29,23,278,265,2,10,1,7
E33030272,218,103,34,69,3,28,12,16,81,75,0,6,0,3
E33030273,713,377,94,283,11,98,45,53,225,213,0,12,0,2
E33030274,310,112,28,84,9,43,24,19,137,131,2,2,2,9
E33030275,206,66,18,48,5,31,11,20,103,93,2,5,3,1
E33030276,370,160,48,112,1,56,22,34,152,143,0,7,2,1
E33030277,398,112,40,72,5,162,68,94,114,104,1,7,2,5
E33030278,236,125,45,80,5,30,13,17,70,67,1,2,0,6
E33030279,1236,617,189,428,11,301,148,153,294,276,2,11,5,13
E33030280,275,113,46,67,3,25,14,11,127,124,1,0,2,7
E33030281,283,147,57,90,3,17,8,9,112,106,0,5,1,4
E33030282,209,100,34,66,2,10,6,4,92,87,0,2,3,5
E33030283,330,163,56,107,6,21,8,13,139,133,1,4,1,1
E33030284,219,146,57,89,0,14,7,7,58,56,0,1,1,1
E33030285,282,117,46,71,1,34,19,15,124,121,1,1,1,6
E33030286,352,197,69,128,2,31,14,17,120,113,1,6,0,2
E33030287,281,120,53,67,3,46,21,25,99,95,1,2,1,13
E33030288,474,211,78,133,14,106,48,58,140,126,5,7,2,3
E33030289,1509,846,177,669,13,103,44,59,534,504,2,26,2,13
E33030290,331,122,34,88,3,46,20,26,158,151,2,2,3,2
E33030291,406,215,53,162,12,69,39,30,104,93,1,9,1,6
E33030292,330,96,36,60,4,53,25,28,171,163,0,6,2,6
E33030293,263,129,49,80,4,16,7,9,113,107,1,5,0,1
E33030294,395,133,59,74,2,96,64,32,155,152,1,2,0,9
E33030295,192,112,49,63,1,17,8,9,50,47,0,1,2,12
E33030296,310,132,45,87,3,37,12,25,128,118,0,9,1,10
E33030297,2878,1841,418,1423,45,146,86,60,828,789,3,34,2,18
E33030298,477,212,51,161,4,70,36,34,188,175,2,10,1,3
E33030299,1863,864,193,671,37,241,117,124,707,681,1,20,5,14
E33030300,505,216,74,142,3,50,18,32,231,220,0,10,1,5
E33030301,272,108,35,73,4,34,22,12,114,109,0,5,0,12
E33030302,258,111,53,58,3,32,16,16,105,98,1,5,1,7
E33030303,491,276,89,187,8,42,22,20,153,142,2,9,0,12
E33030304,793,344,100,244,11,85,39,46,340,323,3,12,2,13
E33030305,343,112,41,71,8,33,15,18,182,179,1,1,1,8
E33030306,1372,638,175,463,50,287,118,169,389,372,1,14,2,8
E33030307,1549,867,259,608,47,193,65,128,429,394,11,21,3,13
E33030308,2173,1188,339,849,57,298,115,183,602,542,17,31,12,28
E33030309,256,160,62,98,7,28,12,16,57,53,2,2,0,4
E33030310,478,181,50,131,6,124,70,54,156,149,0,7,0,11
E33030311,532,271,85,186,7,55,17,38,195,181,4,9,1,4
E33030312,260,138,54,84,2,20,12,8,97,89,1,4,3,3
E33030313,279,150,60,90,1,39,20,19,85,81,1,3,0,4
E33030314,347,151,53,98,9,71,33,38,109,107,0,2,0,7
E33030315,3593,1704,477,1227,103,755,283,472,1001,942,9,34,16,30
E33030316,961,622,139,483,16,84,43,41,228,217,1,10,0,11
E33030317,629,484,177,307,7,50,15,35,83,71,0,7,5,5
E33030318,1113,673,153,520,16,101,44,57,316,302,0,12,2,7
E33030319,275,140,44,96,6,37,20,17,86,79,2,5,0,6
E33030320,374,249,61,188,2,27,8,19,90,79,0,10,1,6
E33030321,292,220,75,145,8,18,9,9,45,42,0,2,1,1
E33030322,356,257,60,197,2,40,27,13,56,52,0,4,0,1
E33030323,905,548,150,398,5,123,65,58,223,205,8,10,0,6
E33030324,312,225,56,169,4,36,22,14,45,42,1,2,0,2
E33030325,267,172,47,125,3,23,13,10,69,66,0,2,1,0
E33030326,394,239,67,172,1,50,30,20,102,97,1,3,1,2
E33030327,252,125,30,95,1,31,18,13,94,89,0,4,1,1
E33030328,309,214,53,161,2,19,10,9,74,72,0,2,0,0
E33030329,313,224,87,137,1,29,17,12,57,55,0,2,0,2
E33030330,1814,1323,345,978,33,143,84,59,311,285,3,20,3,4
E33030331,1535,1169,327,842,16,90,42,48,249,230,6,9,4,11
E33030332,531,293,74,219,7,62,28,34,161,149,0,8,4,8
E33030333,595,436,116,320,7,38,18,20,113,107,0,4,2,1
E33030334,202,102,31,71,2,31,18,13,65,61,2,1,1,2
E33030335,604,339,119,220,14,115,67,48,134,127,0,5,2,2
E33030336,1067,695,218,477,7,136,69,67,225,215,0,9,1,4
E33030337,367,212,71,141,8,53,33,20,90,85,1,4,0,4
E33030338,232,133,35,98,2,16,8,8,79,75,0,4,0,2
E33030339,220,148,34,114,5,15,8,7,50,49,0,1,0,2
E33030340,2168,1161,339,822,28,288,145,143,673,644,3,19,7,18
E33030341,440,239,58,181,0,44,28,16,155,151,1,3,0,2
E33030342,262,145,40,105,0,20,9,11,96,86,2,6,2,1
E33030343,271,150,41,109,3,41,30,11,67,62,2,1,2,10
E33030344,768,502,129,373,7,57,28,29,199,187,1,10,1,3
E33030345,379,260,59,201,6,20,9,11,92,89,1,2,0,1
E33030346,399,273,70,203,6,37,17,20,82,78,1,3,0,1
E33030347,395,290,61,229,3,20,8,12,81,73,1,5,2,1
E33030348,394,215,58,157,2,56,30,26,114,111,1,0,2,7
E33030349,268,146,37,109,1,34,25,9,84,82,1,1,0,3
E33030350,267,151,45,106,4,25,10,15,83,80,0,2,1,4
E33030351,239,152,32,120,6,35,28,7,46,43,0,3,0,0
E33030352,294,232,68,164,2,26,11,15,32,27,1,2,2,2
E33030353,378,271,76,195,8,24,10,14,70,64,0,6,0,5
E33030354,814,556,165,391,16,80,45,35,161,148,4,8,1,1
E33030355,286,181,45,136,7,35,13,22,63,59,3,1,0,0
E33030356,419,120,22,98,6,77,46,31,213,200,5,6,2,3
E33030357,433,242,59,183,15,41,24,17,133,126,2,4,1,2
E33030358,8195,4361,999,3362,189,1314,704,610,2266,1976,166,82,42,65
E33030359,538,287,69,218,15,73,45,28,157,142,3,8,4,6
E33030360,594,351,92,259,10,137,79,58,91,86,2,3,0,5
E33030361,1458,772,184,588,15,282,166,116,381,357,1,19,4,8
E33030362,856,489,92,397,12,116,56,60,228,211,1,7,9,11
E33030363,336,135,32,103,5,84,59,25,110,106,0,4,0,2
E33030364,211,94,28,66,6,34,20,14,76,72,0,4,0,1
E33030365,535,194,46,148,9,49,22,27,279,270,2,4,3,4
E33030366,856,346,108,238,17,87,51,36,392,375,0,16,1,14
E33030367,2276,1221,263,958,29,143,97,46,865,824,2,36,3,18
E33030368,1141,683,160,523,26,85,38,47,338,317,4,13,4,9
E33030369,233,102,35,67,2,18,11,7,94,86,2,5,1,17
E33030370,1334,896,183,713,39,185,95,90,202,191,1,10,0,12
E33030371,369,222,67,155,14,29,14,15,100,96,1,3,0,4
E33030372,803,477,145,332,9,116,61,55,197,183,2,9,3,4
E33030373,873,435,96,339,6,129,75,54,297,281,3,12,1,6
E33030374,322,153,41,112,3,45,21,24,116,113,1,2,0,5
E33030375,601,288,56,232,7,63,30,33,237,223,2,11,1,6
E33030376,446,267,47,220,6,103,63,40,68,65,0,3,0,2
E33030377,975,563,112,451,16,203,101,102,189,173,2,12,2,4
E33030378,685,372,96,276,21,117,64,53,170,162,2,2,4,5
E33030379,234,86,25,61,1,34,23,11,111,107,1,1,2,2
E33030380,459,210,61,149,8,48,26,22,188,175,3,8,2,5
E33030381,493,187,53,134,8,139,66,73,158,151,1,5,1,1
E33030382,233,114,29,85,2,56,24,32,60,53,0,5,2,1
E33030383,1214,726,116,610,35,228,109,119,213,202,3,8,0,12
E33030384,341,132,25,107,2,92,47,45,107,99,2,3,3,8
E33030385,227,64,20,44,3,78,37,41,81,74,0,6,1,1
E33030386,357,151,40,111,4,105,58,47,94,92,1,1,0,3
E33030387,518,235,49,186,5,107,54,53,168,159,0,8,1,3
E33030388,551,210,56,154,9,120,64,56,205,196,0,8,1,7
E33030389,8088,3963,947,3016,219,1801,889,912,2053,1945,28,66,14,52
E33030390,705,413,121,292,14,137,71,66,135,128,1,4,2,6
E33030391,322,173,49,124,7,45,25,20,93,90,0,3,0,4
E33030392,204,78,18,60,8,38,19,19,79,69,1,7,2,1
E33030393,784,553,91,462,26,79,40,39,121,110,0,9,2,5
E33030394,328,197,53,144,2,39,15,24,87,84,1,2,0,3
E33030395,754,319,78,241,9,230,136,94,191,181,0,8,2,5
E33030396,279,160,49,111,4,16,11,5,96,92,0,4,0,3
E33030397,422,227,66,161,9,71,35,36,114,111,0,3,0,1
E33030398,534,249,75,174,3,126,72,54,153,143,2,3,5,3
E33030399,327,132,32,100,5,65,34,31,122,121,0,1,0,3
E33030400,287,189,57,132,1,49,22,27,48,44,0,4,0,0
E33030401,1056,549,139,410,15,162,79,83,325,314,1,9,1,5
E33030402,643,353,85,268,7,89,47,42,185,170,8,7,0,9
E33030403,206,67,27,40,2,63,24,39,72,66,0,5,1,2
E33030404,1131,848,121,727,24,108,50,58,144,134,1,9,0,7
E33030405,266,124,17,107,3,65,35,30,71,66,0,3,2,3
E33030406,552,397,72,325,8,85,30,55,59,54,0,3,2,3
E33030407,261,151,45,106,4,63,26,37,39,37,0,1,1,4
E33030408,173,75,15,60,0,57,29,28,38,34,1,2,1,3
E33030409,306,131,21,110,4,86,50,36,83,75,0,3,5,2
E33030410,222,68,19,49,2,65,43,22,84,83,0,1,0,3
E33030411,617,316,79,237,16,127,81,46,157,152,0,2,3,1
E33030412,259,150,52,98,1,66,29,37,42,39,0,3,0,0
E33030413,2647,1618,369,1249,58,539,252,287,416,387,3,20,6,16
E33030414,241,118,25,93,3,53,23,30,64,57,0,5,2,3
E33030415,238,115,20,95,2,63,39,24,55,48,3,4,0,3
E33030416,307,142,33,109,3,98,49,49,62,60,0,2,0,2
E33030417,800,356,78,278,12,208,102,106,218,206,2,8,2,6
E33030418,668,429,115,314,9,55,27,28,170,163,1,6,0,5
E33030419,263,190,38,152,4,32,18,14,36,30,1,2,3,1
E33030420,215,132,46,86,1,28,14,14,52,50,0,2,0,2
E33030421,300,169,63,106,6,54,34,20,71,69,1,1,0,0
E33030422,1085,510,154,356,15,195,101,94,348,328,5,7,8,17
E33030423,251,163,34,129,4,41,19,22,41,40,1,0,0,2
E33030424,1081,685,190,495,19,148,84,64,226,216,1,8,1,3
E33030425,396,209,48,161,3,61,35,26,120,109,1,7,3,3
E33030426,491,330,89,241,1,85,46,39,74,67,0,6,1,1
E33030427,309,222,54,168,0,48,22,26,37,34,0,1,2,2
E33030428,301,191,42,149,5,38,18,20,64,59,1,4,0,3
E33030429,1006,498,107,391,15,59,36,23,424,397,1,22,4,10
E33030430,333,140,42,98,1,60,32,28,128,126,1,0,1,4
E33030431,541,338,121,217,5,67,25,42,128,117,2,8,1,3
E33030432,364,184,53,131,2,27,6,21,147,140,2,4,1,4
E33030433,215,107,36,71,2,29,15,14,73,65,2,3,3,4
E33030434,960,606,149,457,16,90,47,43,243,236,1,6,0,5
E33030435,1106,659,172,487,14,50,24,26,381,362,2,17,0,2
E33030436,1340,752,201,551,13,103,48,55,466,441,2,17,6,6
E33030437,296,214,89,125,2,20,9,11,54,49,0,3,2,6
E33030438,379,240,59,181,5,12,4,8,122,112,0,8,2,0
E33030439,571,389,102,287,7,73,38,35,101,89,0,11,1,1
E33030440,331,221,66,155,6,47,20,27,54,51,0,3,0,3
E33030441,1703,1187,351,836,24,199,84,115,284,262,5,13,4,9
E33030442,351,224,46,178,9,57,32,25,58,55,1,1,1,3
E33030443,1053,524,153,371,14,199,102,97,304,296,1,6,1,12
E33030444,514,371,63,308,9,40,16,24,91,85,0,6,0,3
E33030445,396,202,43,159,6,51,20,31,135,123,0,6,6,2
E33030446,856,553,162,391,14,97,45,52,189,179,3,5,2,3
E33030447,263,166,44,122,5,27,12,15,62,56,2,4,0,3
E33030448,223,130,43,87,3,18,9,9,63,61,1,1,0,9
E33030449,664,376,105,271,7,88,55,33,188,184,0,2,2,5
E33030450,489,331,87,244,8,59,29,30,90,77,0,12,1,1
E33030451,664,452,119,333,7,82,46,36,114,113,0,0,1,9
E33030452,1049,561,165,396,11,218,105,113,254,238,1,13,2,5
E33030453,3609,2391,603,1788,78,504,288,216,618,576,2,31,9,18
E33030454,1752,828,242,586,11,481,268,213,416,398,1,16,1,16
E33030455,461,244,51,193,6,92,54,38,114,109,1,3,1,5
E33030456,734,442,117,325,7,128,87,41,153,144,1,5,3,4
E33030457,472,219,57,162,3,86,50,36,162,157,0,4,1,2
E33030458,1024,598,153,445,9,227,136,91,186,173,1,9,3,4
E33030459,1770,983,246,737,21,375,216,159,382,365,0,15,2,9
E33030460,971,562,122,440,17,239,158,81,151,141,0,9,1,2
E33030461,275,112,26,86,7,62,34,28,92,90,0,2,0,2
E33030462,576,256,51,205,6,77,38,39,233,217,2,8,6,4
E33030463,236,132,45,87,0,38,19,19,63,59,0,2,2,3
E33030464,588,293,83,210,9,104,63,41,175,163,1,8,3,7
E33030465,335,199,44,155,1,45,28,17,89,87,0,2,0,1
E33030466,680,408,120,288,7,116,60,56,143,137,0,5,1,6
E33030467,2533,1369,293,1076,47,526,234,292,572,543,1,22,6,19
E33030468,713,388,91,297,25,129,66,63,168,163,3,2,0,3
E33030469,436,213,58,155,11,93,43,50,116,112,1,3,0,3
E33030470,650,395,89,306,12,109,66,43,129,124,1,3,1,5
E33030471,1519,959,212,747,31,237,125,112,285,267,0,12,6,7
E33030472,463,210,42,168,5,101,69,32,145,140,0,5,0,2
E33030473,238,132,28,104,4,34,18,16,66,61,0,5,0,2
E33030474,786,589,180,409,14,67,41,26,114,97,1,15,1,2
E33030475,723,433,129,304,13,89,58,31,181,169,2,9,1,7
E33030476,232,179,55,124,0,16,5,11,36,31,0,5,0,1
E33030477,243,153,38,115,2,24,16,8,64,54,0,7,3,0
E33030478,911,643,158,485,8,111,77,34,144,136,1,5,2,5
E33030479,324,208,62,146,1,56,33,23,59,59,0,0,0,0
E33030480,920,609,170,439,26,131,80,51,151,146,0,5,0,3
E33030481,385,294,92,202,2,29,14,15,56,50,0,6,0,4
E33030482,462,288,84,204,5,70,37,33,90,89,0,1,0,9
E33030483,272,185,79,106,3,21,11,10,62,59,0,3,0,1
E33030484,575,382,116,266,5,86,52,34,95,92,0,2,1,7
E33030485,383,291,92,199,3,37,26,11,52,48,0,4,0,0
E33030486,334,197,57,140,7,44,18,26,84,81,0,2,1,2
E33030487,691,452,151,301,9,99,72,27,127,123,0,2,2,4
E33030488,300,179,62,117,5,37,23,14,78,70,1,7,0,1
E33030489,377,265,74,191,2,54,37,17,55,54,0,1,0,1
E33030490,833,570,157,413,8,133,96,37,117,110,0,7,0,5
E33030491,409,302,91,211,7,52,41,11,46,43,1,1,1,2
E33030492,643,401,114,287,6,61,40,21,172,162,0,10,0,3
E33030493,427,281,84,197,3,39,25,14,97,88,4,5,0,7
E33030494,330,212,60,152,5,25,11,14,86,83,1,2,0,2
E33030495,320,202,68,134,2,36,20,16,76,71,3,2,0,4
E33030496,615,361,116,245,5,64,40,24,177,170,1,5,1,8
E33030497,548,335,100,235,7,102,59,43,101,98,0,3,0,3
E33030498,329,171,55,116,6,43,19,24,103,95,1,5,2,6
E33030499,480,259,64,195,6,45,18,27,164,145,2,7,10,6
E33030500,428,257,70,187,6,76,34,42,84,75,0,9,0,5
E33030501,178,119,16,103,1,11,4,7,47,39,2,5,1,0
E33030502,372,208,39,169,4,45,17,28,114,98,10,5,1,1
E33030503,805,467,140,327,16,171,87,84,147,140,3,3,1,4
E33030504,311,163,61,102,5,55,21,34,82,77,2,0,3,6
E33030505,691,441,157,284,9,54,21,33,182,157,11,4,10,5
E33030506,663,446,97,349,5,28,11,17,181,168,2,10,1,3
E33030507,722,427,164,263,5,58,21,37,226,205,11,9,1,6
E33030508,361,184,58,126,4,47,9,38,120,112,2,4,2,6
E33030509,203,117,27,90,5,17,5,12,61,59,1,0,1,3
E33030510,948,589,152,437,5,67,23,44,281,271,0,8,2,6
E33030511,254,160,47,113,1,14,7,7,78,74,0,4,0,1
E33030512,335,197,50,147,3,21,11,10,112,110,1,1,0,2
E33030513,326,214,54,160,3,21,11,10,79,76,0,1,2,9
E33030514,333,154,44,110,6,51,27,24,120,106,2,12,0,2
E33030515,201,136,40,96,4,18,7,11,41,38,0,2,1,2
E33030516,590,314,80,234,6,69,34,35,192,174,2,13,3,9
E33030517,200,107,24,83,2,14,5,9,74,70,1,3,0,3
E33030518,507,225,55,170,7,25,15,10,243,232,1,9,1,7
E33030519,398,238,66,172,5,19,7,12,131,125,1,4,1,5
E33030520,278,140,41,99,2,39,16,23,95,89,2,2,2,2
E33030521,175,111,34,77,4,7,2,5,52,50,0,2,0,1
E33030522,307,202,45,157,3,17,4,13,84,79,1,3,1,1
E33030523,242,156,61,95,0,42,23,19,44,40,0,4,0,0
E33030524,1345,708,202,506,22,177,89,88,415,397,2,14,2,23
E33030525,326,189,55,134,2,19,7,12,111,110,0,1,0,5
E33030526,234,154,35,119,3,24,8,16,52,48,0,4,0,1
E33030527,225,174,53,121,2,18,9,9,30,30,0,0,0,1
E33030528,976,715,239,476,14,49,12,37,197,191,1,4,1,1
E33030529,640,425,118,307,7,17,8,9,185,178,0,7,0,6
E33030530,371,254,69,185,5,28,12,16,83,74,2,5,2,1
E33030531,1048,633,117,516,19,65,25,40,317,303,0,12,2,14
E33030532,368,257,67,190,11,23,7,16,76,67,3,6,0,1
E33030533,914,564,151,413,18,92,33,59,234,226,3,3,2,6
E33030534,1277,885,267,618,22,113,47,66,248,231,2,13,2,9
E33030535,245,157,43,114,6,16,2,14,64,61,0,3,0,2
E33030536,201,110,26,84,3,20,7,13,64,59,1,4,0,4
E33030537,355,209,64,145,8,33,9,24,103,99,2,0,2,2
E33030538,570,339,76,263,16,78,37,41,134,121,8,5,0,3
E33030539,210,95,31,64,3,43,17,26,69,65,0,2,2,0
E33030540,675,364,83,281,15,137,77,60,155,146,2,6,1,4
E33030541,1021,537,156,381,15,90,51,39,369,353,1,13,2,10
E33030542,1358,727,182,545,25,266,122,144,332,308,2,20,2,8
E33030543,318,103,21,82,7,139,96,43,64,62,0,2,0,5
E33030544,625,278,66,212,11,73,33,40,256,246,0,8,2,7
E33030545,951,660,176,484,15,53,22,31,216,208,1,7,0,7
E33030546,905,559,146,413,12,77,36,41,246,229,1,11,5,11
E33030547,1542,979,215,764,24,81,35,46,449,432,1,16,0,9
E33030548,1637,1062,262,800,31,142,73,69,394,380,1,12,1,8
E33030549,758,447,115,332,4,28,16,12,273,262,1,9,1,6
E33030550,1413,892,199,693,21,70,42,28,424,400,2,20,2,6
E33030551,322,148,40,108,1,52,36,16,119,115,0,4,0,2
E33030552,311,190,50,140,6,36,18,18,77,71,0,6,0,2
E33030553,571,246,68,178,10,138,80,58,172,158,2,6,6,5
E33030554,280,118,28,90,6,39,25,14,113,103,4,5,1,4
E33030555,654,309,80,229,17,53,31,22,271,255,4,11,1,4
E33030556,747,432,103,329,11,81,31,50,220,208,1,9,2,3
E33030557,461,252,62,190,7,26,14,12,164,159,0,3,2,12
E33030558,954,594,145,449,9,78,45,33,268,247,1,19,1,5
E33030559,315,188,39,149,5,36,21,15,86,82,2,2,0,0
E33030560,1891,1185,257,928,28,114,66,48,555,537,0,16,2,9
E33030561,1064,669,144,525,17,88,47,41,284,274,0,9,1,6
E33030562,395,194,63,131,8,32,15,17,159,151,5,3,0,2
E33030563,245,120,32,88,2,32,19,13,90,87,0,3,0,1
E33030564,2561,1638,315,1323,29,154,77,77,722,693,0,25,4,18
E33030565,1430,1046,260,786,21,192,104,88,168,160,0,6,2,3
E33030566,799,488,97,391,9,75,32,43,224,214,2,7,1,3
E33030567,199,120,43,77,0,30,17,13,47,46,0,0,1,2
E33030568,476,281,50,231,11,34,15,19,148,140,1,7,0,2
E33030569,786,497,107,390,17,47,20,27,222,210,2,9,1,3
E33030570,704,360,90,270,10,60,28,32,268,256,0,10,2,6
E33030571,298,194,38,156,5,45,22,23,53,51,0,2,0,1
E33030572,224,91,19,72,4,18,7,11,108,103,1,3,1,3
E33030573,1362,893,224,669,18,107,55,52,338,320,3,12,3,6
E33030574,829,577,135,442,7,50,26,24,191,186,0,4,1,4
E33030575,4922,3139,629,2510,61,245,128,117,1448,1376,2,64,6,29
E33030576,3105,2037,443,1594,72,283,143,140,704,652,0,47,5,9
E33030577,299,133,30,103,3,61,34,27,101,97,0,3,1,1
E33030578,236,118,24,94,4,34,21,13,80,78,0,2,0,0
E33030579,483,266,80,186,5,61,43,18,149,142,1,5,1,2
E33030580,1855,1176,397,779,40,253,139,114,379,358,0,20,1,7
E33030581,1031,556,122,434,27,178,71,107,255,240,1,14,0,15
E33030582,395,126,29,97,6,113,69,44,144,138,0,5,1,6
E33030583,964,503,124,379,18,139,89,50,303,284,4,12,3,1
E33030584,4555,2488,604,1884,112,787,419,368,1135,1011,71,27,26,33
E33030585,321,179,56,123,0,38,18,20,104,99,0,5,0,0
E33030586,779,413,148,265,11,51,27,24,296,272,4,15,5,8
E33030587,300,173,40,133,3,40,22,18,79,72,2,2,3,5
E33030588,449,249,65,184,12,52,32,20,133,129,0,2,2,3
E33030589,643,437,130,307,10,59,11,48,134,129,0,5,0,3
E33030590,635,414,122,292,2,100,57,43,108,83,19,5,1,11
E33030591,357,99,24,75,6,158,99,59,89,84,0,4,1,5
E33030592,450,155,27,128,9,179,124,55,104,95,0,8,1,3
E33030593,241,104,28,76,4,68,33,35,65,60,0,4,1,0
E33030594,520,286,73,213,17,76,30,46,138,117,11,6,4,3
E33030595,689,384,72,312,7,137,77,60,156,144,2,8,2,5
E33030596,353,220,75,145,3,34,18,16,89,86,1,2,0,7
E33030597,649,382,90,292,14,83,48,35,161,154,0,3,4,9
E33030598,1373,698,150,548,18,299,177,122,349,327,4,13,5,9
E33030599,886,466,125,341,26,225,130,95,166,154,0,7,5,3
E33030600,1309,735,174,561,13,117,73,44,432,404,3,21,4,12
E33030601,365,195,41,154,10,82,49,33,76,73,0,1,2,2
E33030602,453,215,60,155,4,142,96,46,89,85,0,3,1,3
E33030603,388,204,41,163,7,29,18,11,144,136,0,6,2,4
E33030604,390,203,50,153,6,48,20,28,132,124,1,7,0,1
E33030605,2402,1367,327,1040,34,179,90,89,809,775,2,28,4,13
E33030606,1953,1048,262,786,17,63,25,38,810,775,0,29,6,15
E33030607,331,195,57,138,1,36,19,17,98,95,0,3,0,1
E33030608,1120,549,148,401,19,56,28,28,488,467,1,20,0,8
E33030609,1604,1009,235,774,30,117,61,56,437,421,0,15,1,11
E33030610,239,143,38,105,6,39,21,18,47,40,0,5,2,4
E33030611,193,112,36,76,2,25,15,10,49,47,0,2,0,5
E33030612,6350,3608,808,2800,68,240,108,132,2382,2277,5,85,15,52
E33030613,351,160,37,123,6,62,38,24,118,115,0,2,1,5
E33030614,866,430,102,328,18,117,61,56,293,271,10,10,2,8
E33030615,1411,844,185,659,18,160,95,65,380,362,0,16,2,9
E33030616,477,173,37,136,5,190,135,55,109,100,2,3,4,0
E33030617,306,89,26,63,1,107,72,35,103,98,1,2,2,6
E33030618,244,98,25,73,5,107,68,39,31,28,1,2,0,3
E33030619,238,81,25,56,3,112,72,40,40,39,0,1,0,2
E33030620,548,261,50,211,6,181,113,68,97,90,0,5,2,3
E33030621,757,477,126,351,11,118,52,66,147,143,0,3,1,4
E33030622,228,115,25,90,7,28,15,13,77,68,0,9,0,1
E33030623,952,582,147,435,15,179,92,87,174,164,0,9,1,2
E33030624,640,392,92,300,4,130,60,70,109,103,2,3,1,5
E33030625,857,549,112,437,18,105,47,58,182,168,2,10,2,3
E33030626,1371,815,181,634,24,245,131,114,285,266,1,17,1,2
E33030627,738,428,103,325,8,146,66,80,149,143,2,4,0,7
E33030628,394,247,76,171,4,50,26,24,91,86,2,3,0,2
E33030629,1049,725,198,527,11,62,22,40,246,230,5,9,2,5
E33030630,282,223,57,166,2,21,11,10,32,27,0,5,0,4
E33030631,340,229,59,170,4,22,10,12,81,67,8,5,1,4
E33030632,242,177,54,123,1,13,6,7,46,38,0,8,0,5
E33030633,223,144,31,113,0,20,10,10,55,54,1,0,0,4
E33030634,772,539,178,361,6,88,43,45,136,130,0,6,0,3
E33030635,286,178,58,120,2,42,27,15,62,58,2,2,0,2
E33030636,867,503,143,360,16,167,87,80,177,170,1,5,1,4
E33030637,1601,1095,215,880,19,57,27,30,420,398,1,19,2,10
E33030638,499,314,64,250,3,54,23,31,126,116,6,3,1,2
E33030639,372,247,64,183,5,60,30,30,59,50,1,5,3,1
E33030640,667,474,109,365,12,78,40,38,101,97,0,3,1,2
E33030641,237,136,39,97,7,44,27,17,48,44,1,3,0,2
E33030642,660,288,82,206,10,194,91,103,162,156,2,3,1,6
E33030643,317,109,19,90,10,128,77,51,70,61,0,7,2,0
E33030644,1312,740,164,576,13,94,41,53,458,442,0,12,4,7
E33030645,1083,637,125,512,29,239,99,140,171,159,2,6,4,7
E33030646,1393,746,184,562,27,303,133,170,314,306,0,6,2,3
E33030647,668,461,81,380,10,79,41,38,114,107,2,1,4,4
E33030648,215,88,23,65,2,52,28,24,71,65,1,4,1,2
E33030649,775,435,117,318,9,169,94,75,156,145,2,7,2,6
E33030650,397,118,25,93,4,51,33,18,218,215,0,3,0,6
E33030651,1765,993,219,774,34,102,55,47,622,589,4,27,2,14
E33030652,221,122,43,79,6,28,8,20,65,63,0,0,2,0
E33030653,297,171,36,135,2,33,14,19,86,80,0,3,3,5
E33030654,2823,1806,435,1371,38,203,91,112,755,727,0,24,4,21
E33030655,208,99,40,59,1,48,24,24,60,57,1,1,1,0
E33030656,808,455,108,347,19,39,24,15,290,286,0,4,0,5
E33030657,373,141,33,108,7,69,38,31,150,143,1,5,1,6
E33030658,1278,783,192,591,27,52,28,24,404,392,2,8,2,12
E33030659,1123,716,192,524,15,99,52,47,285,250,25,6,4,8
E33030660,894,615,155,460,8,62,25,37,202,193,0,7,2,7
E33030661,1122,712,132,580,9,80,40,40,314,302,1,10,1,7
E33030662,272,115,43,72,3,83,40,43,64,62,2,0,0,7
E33030663,233,141,55,86,2,36,17,19,53,51,0,2,0,1
E33030664,664,325,73,252,8,122,61,61,206,191,1,11,3,3
E33030665,647,341,86,255,8,47,21,26,250,234,2,14,0,1
E33030666,1352,555,127,428,20,164,81,83,593,554,1,34,4,20
E33030667,494,322,85,237,6,26,18,8,138,136,0,2,0,2
E33030668,805,317,75,242,11,92,42,50,382,372,1,7,2,3
E33030669,4117,2476,562,1914,34,191,94,97,1387,1330,4,47,6,29
E33030670,618,315,92,223,6,63,26,37,231,209,3,15,4,3
E33030671,372,206,47,159,3,45,24,21,118,112,1,4,1,0
E33030672,449,245,75,170,2,48,27,21,151,148,0,3,0,3
E33030673,246,127,49,78,2,20,13,7,93,87,0,6,0,4
E33030674,128,72,18,54,10,18,8,10,27,26,0,1,0,1
E33030675,518,288,93,195,14,89,45,44,123,113,1,6,3,4
E33030676,520,262,50,212,11,92,43,49,150,131,0,13,6,5
E33030677,217,91,22,69,6,41,20,21,78,71,1,4,2,1
E33030678,1046,550,106,444,18,51,22,29,423,397,8,14,4,4
E33030679,583,317,79,238,11,45,16,29,206,201,0,5,0,4
E33030680,5540,3738,775,2963,46,163,80,83,1573,1524,7,36,6,20
E33030681,362,177,35,142,4,11,8,3,167,159,0,8,0,3
E33030682,645,272,76,196,6,89,45,44,272,261,1,5,5,6
E33030683,278,146,49,97,0,49,23,26,82,78,3,0,1,1
E33030684,473,285,64,221,10,58,20,38,118,110,1,7,0,2
E33030685,246,140,40,100,5,45,16,29,55,52,1,2,0,1
E33030686,428,197,51,146,6,119,67,52,104,97,0,6,1,2
E33030687,637,341,88,253,8,135,58,77,149,142,1,5,1,4
E33030688,285,145,32,113,1,81,32,49,55,49,0,6,0,3
E33030689,773,436,106,330,24,64,29,35,246,235,0,9,2,3
E33030690,1111,830,184,646,7,55,32,23,212,204,0,7,1,7
E33030691,1264,853,178,675,16,82,40,42,309,296,0,10,3,4
E33030692,245,141,42,99,4,36,21,15,63,61,0,1,1,1
E33030693,3804,2892,678,2214,39,241,124,117,617,586,4,22,5,15
E33030694,829,325,81,244,21,212,119,93,263,243,4,11,5,8
E33030695,483,262,99,163,4,78,41,37,136,124,1,6,5,3
E33030696,1023,677,215,462,9,161,93,68,172,168,0,2,2,4
E33030697,1213,483,110,373,9,307,183,124,400,377,3,18,2,14
E33030698,1017,505,153,352,15,233,140,93,253,245,1,7,0,11
E33030699,390,209,55,154,11,43,17,26,123,119,0,3,1,4
E33030700,349,169,47,122,3,94,48,46,81,76,1,3,1,2
E33030701,1134,707,201,506,11,188,109,79,221,207,0,13,1,7
E33030702,494,245,68,177,5,105,66,39,131,119,7,3,2,8
E33030703,340,182,55,127,4,57,35,22,93,87,0,3,3,4
E33030704,211,135,51,84,2,35,17,18,37,37,0,0,0,2
E33030705,596,289,96,193,4,140,82,58,160,157,0,2,1,3
E33030706,275,141,42,99,1,70,37,33,61,58,1,2,0,2
E33030707,342,172,46,126,5,98,47,51,61,60,0,1,0,6
E33030708,848,452,130,322,7,145,71,74,233,225,0,7,1,11
E33030709,707,247,66,181,4,186,89,97,262,249,3,7,3,8
E33030710,502,273,89,184,12,88,51,37,125,121,0,3,1,4
E33030711,225,114,27,87,3,32,13,19,71,68,0,3,0,5
E33030712,466,311,80,231,5,72,36,36,74,70,0,4,0,4
E33030713,751,444,132,312,4,140,80,60,159,149,0,6,4,4
E33030714,358,164,32,132,5,85,40,45,102,95,0,6,1,2
E33030715,369,118,37,81,6,124,67,57,118,109,0,2,7,3
E33030716,290,116,31,85,1,50,25,25,113,100,1,12,0,10
E33030717,443,225,56,169,9,84,46,38,121,111,4,4,2,4
E33030718,294,146,36,110,5,39,20,19,100,95,1,3,1,4
E33030719,753,474,133,341,6,113,60,53,154,151,0,2,1,6
E33030720,669,416,120,296,13,32,17,15,202,194,3,5,0,6
E33030721,491,249,56,193,9,41,18,23,192,181,0,9,2,0
E33030722,739,387,90,297,13,134,71,63,196,176,6,12,2,9
E33030723,735,416,138,278,13,147,91,56,153,142,1,6,4,6
E33030724,2278,1383,410,973,54,400,211,189,425,407,4,11,3,16
E33030725,460,191,52,139,2,107,45,62,156,145,4,6,1,4
E33030726,274,123,39,84,4,31,22,9,115,111,0,3,1,1
E33030727,386,170,54,116,3,79,54,25,133,125,1,6,1,1
E33030728,475,214,73,141,5,93,47,46,158,145,3,8,2,5
E33030729,425,162,43,119,5,98,62,36,150,148,0,1,1,10
E33030730,364,192,59,133,4,66,34,32,99,98,0,1,0,3
E33030731,317,112,32,80,1,106,59,47,97,91,3,3,0,1
E33030732,286,143,31,112,2,56,32,24,82,79,1,2,0,3
E33030733,494,211,57,154,4,107,55,52,168,162,1,5,0,4
E33030734,214,79,26,53,0,72,28,44,63,59,2,2,0,0
E33030735,360,184,51,133,6,74,38,36,91,90,0,1,0,5
E33030736,230,99,28,71,1,39,17,22,89,85,0,4,0,2
E33030737,276,95,24,71,7,23,14,9,148,144,0,3,1,3
E33030738,197,86,20,66,1,20,9,11,89,87,1,1,0,1
E33030739,199,79,16,63,3,27,17,10,86,77,1,7,1,4
E33030740,854,372,88,284,7,189,105,84,284,273,1,7,3,2
E33030741,246,116,35,81,7,48,29,19,73,70,0,1,2,2
E33030742,636,264,72,192,7,146,100,46,211,204,0,6,1,8
E33030743,396,166,38,128,6,74,40,34,146,142,1,2,1,4
E33030744,2082,1083,272,811,32,646,375,271,316,293,1,17,5,5
E33030745,1025,522,129,393,17,204,121,83,273,261,0,11,1,9
E33030746,753,368,101,267,10,163,108,55,207,199,2,6,0,5
E33030747,308,137,28,109,3,76,38,38,89,87,0,2,0,3
E33030748,515,324,100,224,7,55,36,19,126,116,0,8,2,3
E33030749,207,124,30,94,2,9,6,3,70,61,1,8,0,2
E33030750,294,145,42,103,7,89,47,42,48,45,0,3,0,5
E33030751,225,112,36,76,5,26,10,16,78,77,0,1,0,4
E33030752,418,192,57,135,5,125,82,43,96,91,1,4,0,0
E33030753,220,140,50,90,3,20,11,9,53,37,6,10,0,4
E33030754,373,195,33,162,4,55,26,29,114,104,1,8,1,5
E33030755,752,272,67,205,11,260,183,77,206,196,0,6,4,3
E33030756,839,409,114,295,14,144,88,56,266,252,0,11,3,6
E33030757,549,211,78,133,1,131,86,45,199,190,0,7,2,7
E33030758,244,98,32,66,1,44,30,14,100,95,2,2,1,1
E33030759,242,113,31,82,7,30,20,10,85,83,1,1,0,7
E33030760,619,285,89,196,10,46,32,14,267,260,1,4,2,11
E33030761,382,178,50,128,10,22,11,11,168,163,1,4,0,4
E33030762,574,408,79,329,13,48,26,22,100,94,2,3,1,5
E33030763,1271,813,247,566,12,89,34,55,350,328,2,17,3,7
E33030764,7061,3933,964,2969,133,1201,469,732,1757,1642,25,72,18,37
E33030765,144,73,28,45,1,33,24,9,36,32,0,4,0,1
E33030766,212,112,39,73,1,26,9,17,71,64,1,5,1,2
E33030767,450,165,65,100,6,68,35,33,205,195,0,8,2,6
E33030768,236,103,40,63,5,29,16,13,92,89,0,3,0,7
E33030769,434,242,59,183,6,25,11,14,156,143,4,9,0,5
E33030770,219,101,22,79,1,37,25,12,79,77,1,1,0,1
E33030771,933,543,111,432,17,41,17,24,324,308,1,11,4,8
E33030772,255,123,40,83,8,46,22,24,74,68,1,2,3,4
E33030773,1138,511,124,387,26,147,62,85,445,421,4,12,8,9
E33030774,924,536,127,409,12,143,75,68,225,212,2,8,3,8
E33030775,604,191,50,141,6,107,54,53,298,288,0,6,4,2
E33030776,668,347,110,237,4,82,36,46,222,213,1,7,1,13
E33030777,832,354,78,276,9,162,88,74,299,283,1,10,5,8
E33030778,308,145,43,102,2,31,17,14,116,111,0,4,1,14
E33030779,558,280,76,204,7,58,32,26,203,187,3,12,1,10
E33030780,284,83,26,57,6,34,18,16,159,155,2,1,1,2
E33030781,691,251,69,182,6,139,83,56,291,276,2,8,5,4
E33030782,998,529,145,384,14,67,29,38,372,358,2,10,2,16
E33030783,281,162,46,116,8,24,8,16,79,75,1,1,2,8
E33030784,675,281,66,215,12,169,93,76,209,196,0,13,0,4
E33030785,544,246,65,181,9,65,31,34,221,211,3,4,3,3
E33030786,260,147,38,109,1,15,5,10,89,87,2,0,0,8
E33030787,871,563,141,422,14,80,46,34,211,197,1,13,0,3
E33030788,286,130,46,84,7,53,28,25,92,81,1,10,0,4
E33030789,281,167,61,106,3,15,10,5,94,89,0,4,1,2
E33030790,4191,2241,546,1695,23,170,88,82,1733,1677,4,44,8,24
E33030791,289,110,31,79,6,87,46,41,83,79,0,1,3,3
E33030792,287,173,50,123,5,22,10,12,86,82,0,3,1,1
E33030793,719,426,97,329,10,30,18,12,249,238,2,9,0,4
E33030794,273,139,50,89,5,39,15,24,86,80,2,4,0,4
E33030795,819,547,139,408,17,105,56,49,144,131,3,8,2,6
E33030796,237,103,39,64,4,33,13,20,93,83,7,2,1,4
E33030797,302,119,40,79,5,59,25,34,118,111,1,6,0,1
E33030798,509,268,66,202,13,77,60,17,150,144,2,4,0,1
E33030799,276,156,49,107,5,38,20,18,75,67,0,5,3,2
E33030800,638,276,72,204,3,111,52,59,241,225,1,9,6,7
E33030801,237,118,25,93,5,48,17,31,63,60,0,3,0,3
E33030802,471,273,88,185,6,59,27,32,127,122,1,4,0,6
E33030803,2407,1405,359,1046,36,200,96,104,756,735,5,13,3,10
E33030804,289,151,31,120,3,25,12,13,108,103,0,3,2,2
E33030805,998,537,141,396,17,144,67,77,295,280,2,12,1,5
E33030806,337,120,34,86,6,60,40,20,146,138,4,3,1,5
E33030807,722,390,121,269,7,61,33,28,257,247,0,8,2,7
E33030808,259,94,23,71,1,42,31,11,117,113,0,0,4,5
E33030809,396,215,51,164,9,26,11,15,143,140,0,2,1,3
E33030810,241,88,33,55,2,42,21,21,106,104,0,1,1,3
E33030811,536,266,100,166,10,57,23,34,177,167,3,3,4,26
E33030812,306,127,55,72,2,21,10,11,149,137,5,4,3,7
E33030813,428,159,60,99,6,49,24,25,202,173,18,3,8,12
E33030814,357,196,74,122,4,24,10,14,124,117,3,4,0,9
E33030815,580,220,66,154,12,67,30,37,276,269,0,6,1,5
E33030816,262,176,51,125,8,26,17,9,52,45,4,3,0,0
E33030817,216,113,37,76,3,15,9,6,79,73,0,6,0,6
E33030818,772,413,111,302,10,54,30,24,287,271,2,11,3,8
E33030819,1039,652,168,484,15,53,25,28,310,291,0,17,2,9
E33030820,385,235,68,167,4,40,21,19,101,95,0,5,1,5
E33030821,291,123,30,93,1,14,5,9,149,147,0,1,1,4
E33030822,683,431,122,309,4,30,16,14,215,208,0,4,3,3
E33030823,206,93,30,63,9,22,9,13,74,59,5,3,7,8
E33030824,581,289,95,194,6,37,15,22,243,230,0,7,6,6
E33030825,216,130,46,84,2,16,6,10,60,57,0,0,3,8
E33030826,471,200,80,120,6,42,23,19,211,205,3,1,2,12
E33030827,639,257,83,174,11,86,53,33,274,261,3,6,4,11
E33030828,1360,708,198,510,8,48,29,19,589,571,2,10,6,7
E33030829,234,133,42,91,5,14,6,8,78,75,0,3,0,4
E33030830,928,562,128,434,12,30,14,16,317,302,2,10,3,7
E33030831,649,417,141,276,7,33,13,20,182,170,1,9,2,10
E33030832,260,125,41,84,5,21,12,9,104,93,8,3,0,5
E33030833,236,80,36,44,4,42,22,20,105,105,0,0,0,5
E33030834,294,98,34,64,2,67,39,28,122,120,1,1,0,5
E33030835,530,179,38,141,5,103,58,45,240,227,1,9,3,3
E33030836,235,105,31,74,2,28,9,19,98,94,0,3,1,2
E33030837,423,149,43,106,6,78,41,37,180,159,15,4,2,10
E33030838,305,110,41,69,2,38,16,22,145,124,14,4,3,10
E33030839,655,395,73,322,24,93,52,41,139,129,3,6,1,4
E33030840,1236,606,179,427,24,193,89,104,400,361,18,10,11,13
E33030841,904,511,188,323,10,105,65,40,244,230,4,6,4,34
E33030842,223,116,34,82,2,29,12,17,71,70,0,1,0,5
E33030843,661,381,107,274,17,93,47,46,166,152,3,9,2,4
E33030844,555,272,73,199,5,32,17,15,241,234,0,7,0,5
E33030845,344,179,46,133,6,29,19,10,127,120,1,4,2,3
E33030846,197,125,39,86,2,14,7,7,53,49,1,1,2,3
E33030847,419,158,46,112,5,57,32,25,188,177,1,8,2,11
E33030848,336,180,60,120,1,17,7,10,134,119,3,10,2,4
E33030849,217,137,38,99,1,18,12,6,56,56,0,0,0,5
E33030850,250,129,38,91,6,28,10,18,82,76,1,3,2,5
E33030851,321,181,65,116,10,37,14,23,90,87,1,1,1,3
E33030852,195,108,23,85,4,21,11,10,55,41,2,7,5,7
E33030853,283,153,47,106,4,24,14,10,96,88,0,7,1,6
E33030854,347,158,55,103,3,50,23,27,129,124,2,1,2,7
E33030855,388,198,37,161,2,14,7,7,170,165,0,5,0,4
E33030856,497,278,60,218,13,30,15,15,172,164,0,6,2,4
E33030857,389,260,81,179,5,34,14,20,85,80,0,5,0,5
E33030858,375,175,44,131,6,28,22,6,161,154,3,4,0,5
E33030859,468,281,70,211,7,27,11,16,151,144,0,7,0,2
E33030860,701,457,136,321,10,61,33,28,171,162,3,5,1,2
E33030861,777,439,111,328,10,58,28,30,264,254,0,8,2,6
E33030862,948,512,140,372,13,137,63,74,274,262,3,9,0,12
E33030863,258,120,27,93,3,17,9,8,116,113,0,3,0,2
E33030864,197,108,31,77,5,20,7,13,61,55,2,2,2,3
E33030865,331,158,52,106,2,28,14,14,136,121,2,8,5,7
E33030866,201,82,21,61,2,8,5,3,109,108,0,1,0,0
E33030867,218,122,43,79,2,22,11,11,70,66,0,4,0,2
E33030868,637,344,114,230,8,86,34,52,192,184,1,4,3,7
E33030869,924,523,144,379,22,133,55,78,232,214,1,13,4,14
E33030870,220,89,21,68,2,35,16,19,93,91,0,1,1,1
E33030871,661,401,88,313,6,34,17,17,214,198,2,13,1,6
E33030872,211,116,29,87,0,8,4,4,86,80,1,5,0,1
E33030873,797,517,157,360,20,43,23,20,210,197,0,11,2,7
E33030874,205,105,40,65,4,19,8,11,74,72,1,0,1,3
E33030875,634,362,74,288,9,33,16,17,225,212,1,12,0,5
E33030876,246,156,32,124,6,14,8,6,67,66,0,1,0,3
E33030877,454,275,90,185,5,28,16,12,139,129,0,9,1,7
E33030878,976,619,148,471,9,36,16,20,309,294,1,13,1,3
E33030879,1198,792,177,615,16,51,27,24,335,319,1,12,3,4
E33030880,1620,923,259,664,20,74,37,37,586,562,3,18,3,17
E33030881,370,183,54,129,2,24,9,15,156,146,2,5,3,5
E33030882,303,139,51,88,2,21,13,8,135,127,2,3,3,6
E33030883,453,268,80,188,4,43,16,27,132,127,3,1,1,6
E33030884,527,228,54,174,5,71,35,36,218,208,1,6,3,5
E33030885,285,185,63,122,3,15,9,6,77,75,0,2,0,5
E33030886,225,123,40,83,2,16,7,9,68,64,0,3,1,16
E33030887,1122,643,195,448,13,132,56,76,325,305,4,14,2,9
E33030888,555,248,84,164,3,23,6,17,277,265,0,12,0,4
E33030889,496,268,58,210,4,15,7,8,207,192,1,9,5,2
E33030890,1009,383,106,277,24,394,231,163,203,190,1,8,4,5
E33030891,603,178,46,132,15,94,44,50,312,301,1,7,3,4
E33030892,242,127,51,76,5,35,15,20,73,72,0,1,0,2
E33030893,203,116,32,84,0,29,10,19,55,54,0,1,0,3
E33030894,841,492,144,348,12,35,18,17,294,270,6,15,3,8
E33030895,286,170,47,123,3,36,23,13,73,71,1,1,0,4
E33030896,691,427,86,341,7,70,24,46,184,181,1,1,1,3
E33030897,205,101,46,55,2,24,15,9,76,70,1,3,2,2
E33030898,248,145,48,97,1,15,6,9,83,82,0,1,0,4
E33030899,201,115,42,73,1,17,5,12,64,63,0,1,0,4
E33030900,1580,978,293,685,20,64,30,34,511,479,5,23,4,7
E33030901,245,153,45,108,3,16,11,5,71,67,1,2,1,2
E33030902,198,81,24,57,6,23,8,15,85,84,0,1,0,3
E33030903,340,211,80,131,4,19,8,11,102,97,0,5,0,4
E33030904,219,115,29,86,2,34,19,15,64,61,0,3,0,4
E33030905,356,218,58,160,4,22,9,13,103,94,2,7,0,9
E33030906,363,216,90,126,1,33,19,14,113,106,0,5,2,0
E33030907,238,137,45,92,3,11,6,5,85,82,0,2,1,2
E33030908,268,185,55,130,3,17,7,10,59,55,0,2,2,4
E33030909,232,153,57,96,1,16,6,10,57,53,1,3,0,5
E33030910,234,130,29,101,7,21,9,12,74,70,0,3,1,2
E33030911,563,375,112,263,4,38,13,25,144,140,0,4,0,2
E33030912,455,320,100,220,1,31,17,14,101,93,1,7,0,2
E33030913,195,130,48,82,2,10,2,8,52,50,0,2,0,1
E33030914,219,103,31,72,5,12,4,8,92,87,1,3,1,7
E33030915,236,136,28,108,0,14,3,11,83,78,1,4,0,3
E33030916,199,130,38,92,4,11,3,8,52,51,0,1,0,2
E33030917,246,153,51,102,1,16,6,10,73,69,0,4,0,3
E33030918,1012,616,175,441,14,65,34,31,312,299,1,10,2,5
E33030919,333,194,64,130,4,25,13,12,107,94,2,8,3,3
E33030920,254,126,35,91,1,29,18,11,93,90,0,3,0,5
E33030921,222,132,45,87,2,13,10,3,69,62,1,6,0,6
E33030922,230,122,53,69,3,19,6,13,84,80,1,3,0,2
E33030923,228,124,33,91,3,42,25,17,59,56,0,1,2,0
E33030924,200,120,37,83,4,9,7,2,65,61,0,4,0,2
E33030925,352,182,59,123,6,21,10,11,143,139,1,3,0,0
E33030926,241,107,23,84,2,21,8,13,109,107,0,2,0,2
E33030927,212,90,28,62,3,18,6,12,101,96,2,3,0,0
E33030928,294,183,52,131,2,25,10,15,83,81,0,2,0,1
E33030929,226,114,37,77,3,17,9,8,90,90,0,0,0,2
E33030930,195,71,20,51,3,28,20,8,88,83,0,3,2,5
E33030931,786,458,122,336,11,43,18,25,269,248,0,18,3,5
E33030932,207,102,35,67,5,32,18,14,67,66,0,1,0,1
E33030933,349,186,64,122,3,42,25,17,112,109,0,2,1,6
E33030934,2383,1349,340,1009,41,315,167,148,668,639,5,18,6,10
E33030935,373,184,43,141,6,62,35,27,117,113,0,4,0,4
E33030936,233,104,31,73,4,19,9,10,99,94,0,4,1,7
E33030937,365,221,56,165,3,28,14,14,106,102,1,2,1,7
E33030938,306,150,33,117,4,25,15,10,125,120,0,5,0,2
E33030939,412,249,94,155,6,30,13,17,124,113,4,5,2,3
E33030940,216,136,48,88,8,19,9,10,52,48,1,2,1,1
E33030941,482,262,98,164,11,43,24,19,162,156,0,3,3,4
E33030942,721,327,102,225,19,112,54,58,255,229,21,4,1,8
E33030943,408,215,75,140,7,41,20,21,115,110,1,1,3,30
E33030944,1441,716,200,516,26,135,65,70,554,524,3,21,6,10
E33030945,265,170,39,131,2,28,18,10,63,56,5,1,1,2
E33030946,663,428,112,316,14,129,62,67,87,79,2,5,1,5
E33030947,249,97,32,65,3,49,35,14,98,94,1,2,1,2
E33030948,352,122,29,93,3,50,29,21,175,172,0,2,1,2
E33030949,293,146,43,103,4,45,24,21,97,95,0,1,1,1
E33030950,1162,629,175,454,15,41,16,25,462,436,0,24,2,15
E33030951,215,104,27,77,1,22,17,5,84,79,0,4,1,4
E33030952,144,40,10,30,0,42,16,26,58,56,0,2,0,4
E33030953,265,106,34,72,3,48,24,24,94,91,0,2,1,14
E33030954,234,89,32,57,3,53,38,15,86,84,1,1,0,3
E33030955,426,203,46,157,8,47,22,25,161,154,0,7,0,7
E33030956,1100,550,135,415,32,61,37,24,451,427,2,21,1,6
E33030957,901,355,60,295,7,121,67,54,413,399,1,12,1,5
E33030958,386,110,30,80,4,67,42,25,200,195,0,3,2,5
E33030959,217,93,39,54,0,31,21,10,90,87,0,0,3,3
E33030960,215,76,21,55,1,43,25,18,93,87,2,3,1,2
E33030961,226,56,15,41,3,34,17,17,131,126,0,5,0,2
E33030962,252,82,26,56,2,31,9,22,135,127,1,6,1,2
E33030963,441,269,61,208,5,20,15,5,143,136,1,4,2,4
E33030964,335,132,33,99,7,48,35,13,143,134,4,2,3,5
E33030965,236,114,36,78,4,29,17,12,89,87,0,2,0,0
E33030966,651,345,73,272,10,35,17,18,259,251,0,6,2,2
E33030967,354,119,26,93,16,41,16,25,174,166,1,6,1,4
E33030968,243,152,46,106,1,33,21,12,57,54,0,3,0,0
E33030969,372,201,43,158,5,14,4,10,112,107,1,4,0,40
E33030970,1453,988,404,584,24,184,92,92,245,227,1,12,5,12
E33030971,1354,764,197,567,14,75,30,45,490,475,4,10,1,11
E33030972,617,375,103,272,8,25,11,14,204,191,1,9,3,5
E33030973,227,111,38,73,3,37,16,21,73,70,1,2,0,3
E33030974,496,221,51,170,9,29,16,13,231,219,2,8,2,6
E33030975,380,251,62,189,8,14,6,8,106,95,0,8,3,1
E33030976,2668,1387,461,926,34,166,72,94,1046,1005,3,32,6,35
E33030977,602,327,106,221,10,63,31,32,197,189,1,5,2,5
E33030978,256,102,27,75,2,18,8,10,133,124,1,7,1,1
E33030979,819,459,137,322,12,60,29,31,282,274,1,6,1,6
E33030980,477,184,37,147,9,44,22,22,232,222,3,7,0,8
E33030981,275,202,54,148,0,4,3,1,67,64,0,1,2,2
E33030982,622,429,111,318,4,40,29,11,140,124,3,9,4,9
E33030983,434,265,54,211,4,30,16,14,127,123,1,3,0,8
E33030984,2236,1398,317,1081,27,93,45,48,704,675,9,18,2,14
E33030985,822,632,188,444,15,56,27,29,117,107,0,7,3,2
E33030986,500,272,68,204,8,25,13,12,193,188,0,5,0,2
E33030987,205,116,40,76,6,6,5,1,77,73,0,4,0,0
E33030988,496,336,85,251,4,23,14,9,130,126,0,4,0,3
E33030989,302,174,48,126,2,17,9,8,105,99,0,4,2,4
E33030990,1209,731,149,582,8,40,19,21,422,399,1,21,1,8
E33030991,739,444,129,315,7,40,21,19,242,225,1,14,2,6
E33030992,410,165,49,116,4,49,23,26,190,184,0,5,1,2
E33030993,642,361,80,281,4,49,31,18,224,212,0,11,1,4
E33030994,372,220,70,150,7,34,16,18,111,100,7,2,2,0
E33030995,694,365,83,282,4,32,16,16,289,282,1,6,0,4
E33030996,883,566,127,439,18,71,39,32,226,212,1,12,1,2
E33030997,295,162,48,114,7,21,8,13,103,96,0,7,0,2
E33030998,720,423,93,330,12,30,20,10,252,240,0,11,1,3
E33030999,475,311,76,235,7,23,10,13,132,123,1,8,0,2
E33031000,642,478,159,319,4,73,40,33,84,82,1,1,0,3
E33031001,911,478,171,307,21,56,35,21,345,330,3,12,0,11
E33031002,240,133,41,92,5,19,12,7,83,75,0,6,2,0
E33031003,1065,652,171,481,13,58,22,36,338,319,2,13,4,4
E33031004,1104,732,199,533,15,63,34,29,286,270,0,15,1,8
E33031005,211,139,64,75,1,20,9,11,49,44,0,2,3,2
E33031006,1800,1065,369,696,23,138,68,70,559,532,5,16,6,15
E33031007,299,160,38,122,3,27,19,8,109,105,3,1,0,0
E33031008,288,193,64,129,6,16,9,7,69,66,0,3,0,4
E33031009,300,176,50,126,1,12,8,4,110,105,0,4,1,1
E33031010,675,329,78,251,9,62,38,24,272,260,0,10,2,3
E33031011,250,117,33,84,3,19,13,6,109,105,0,3,1,2
E33031012,914,585,110,475,22,91,35,56,208,192,1,13,2,8
E33031013,256,116,27,89,3,33,21,12,103,100,0,2,1,1
E33031014,266,106,29,77,5,22,10,12,131,127,1,2,1,2
E33031015,761,434,113,321,10,30,13,17,279,262,0,17,0,8
E33031016,1449,1020,280,740,17,87,51,36,316,306,0,10,0,9
E33031017,444,229,53,176,6,25,13,12,176,168,1,7,0,8
E33031018,244,141,48,93,2,11,6,5,88,86,0,2,0,2
E33031019,325,141,40,101,5,41,20,21,138,131,2,4,1,0
E33031020,222,96,29,67,4,31,20,11,90,84,0,6,0,1
E33031021,393,191,55,136,7,33,20,13,159,150,2,5,2,3
E33031022,413,203,52,151,3,30,17,13,175,171,0,3,1,2
E33031023,191,66,13,53,4,26,12,14,95,89,0,5,1,0
E33031024,429,163,37,126,4,60,36,24,197,194,0,3,0,5
E33031025,304,152,34,118,3,25,15,10,123,114,1,5,3,1
E33031026,501,272,72,200,8,42,28,14,174,168,0,5,1,5
E33031027,239,91,26,65,7,18,14,4,113,110,0,3,0,10
E33031028,588,310,73,237,11,25,14,11,241,224,0,13,4,1
E33031029,279,123,27,96,3,27,17,10,124,118,2,4,0,2
E33031030,2507,1247,367,880,35,332,158,174,867,825,3,28,11,26
E33031031,266,150,38,112,0,20,8,12,95,87,0,6,2,1
E33031032,241,113,25,88,2,19,12,7,101,94,0,7,0,6
E33031033,271,133,38,95,1,12,3,9,124,122,0,2,0,1
E33031034,868,535,108,427,9,50,30,20,269,254,3,11,1,5
E33031035,525,258,70,188,2,77,47,30,184,173,1,10,0,4
E33031036,559,161,40,121,9,75,44,31,307,302,0,3,2,7
E33031037,296,128,38,90,1,21,14,7,140,134,0,5,1,6
E33031038,257,129,39,90,3,29,12,17,95,93,0,2,0,1
E33031039,943,464,133,331,19,199,95,104,254,236,2,8,8,7
E33031040,310,161,31,130,5,26,11,15,114,110,2,2,0,4
E33031041,271,117,37,80,4,28,14,14,120,109,1,8,2,2
E33031042,211,101,37,64,2,23,15,8,83,78,1,4,0,2
E33031043,371,242,45,197,16,24,3,21,88,80,3,2,3,1
E33031044,1623,1163,245,918,17,99,53,46,332,318,1,10,3,12
E33031045,480,271,63,208,12,59,25,34,134,121,0,11,2,4
E33031046,228,140,30,110,7,14,12,2,66,58,0,6,2,1
E33031047,402,196,40,156,6,27,9,18,168,163,2,3,0,5
E33031048,286,130,22,108,5,21,10,11,129,122,0,7,0,1
E33031049,410,192,45,147,7,35,22,13,172,168,2,1,1,4
E33031050,313,115,32,83,6,41,21,20,146,143,0,2,1,5
E33031051,779,425,113,312,7,80,43,37,259,254,1,4,0,8
E33031052,452,222,48,174,3,25,16,9,200,190,1,6,3,2
E33031053,226,139,41,98,4,10,7,3,72,63,5,4,0,1
E33031054,988,617,185,432,5,61,28,33,300,284,2,13,1,5
E33031055,673,373,123,250,5,29,16,13,260,254,0,6,0,6
E33031056,522,289,82,207,5,34,20,14,191,184,2,4,1,3
E33031057,222,102,15,87,3,32,21,11,80,75,0,4,1,5
E33031058,473,149,40,109,2,88,53,35,232,221,1,7,3,2
E33031059,293,149,41,108,3,17,11,6,114,110,0,2,2,10
E33031060,344,174,57,117,8,14,5,9,146,143,0,2,1,2
E33031061,794,461,135,326,9,61,22,39,261,241,1,14,5,2
E33031062,424,242,67,175,5,27,17,10,148,143,0,4,1,2
E33031063,291,169,48,121,6,27,19,8,87,85,0,2,0,2
E33031064,807,442,115,327,3,59,25,34,300,291,1,8,0,3
E33031065,220,158,55,103,2,12,8,4,47,42,0,5,0,1
E33031066,1069,602,156,446,8,71,48,23,378,366,4,6,2,10
E33031067,409,163,37,126,9,46,17,29,188,179,0,7,2,3
E33031068,683,458,119,339,17,44,22,22,159,151,0,7,1,5
E33031069,1080,559,213,346,27,135,68,67,344,330,1,11,2,15
E33031070,277,174,44,130,1,17,6,11,85,79,1,3,2,0
E33031071,384,229,67,162,8,22,11,11,119,112,0,7,0,6
E33031072,371,220,69,151,9,17,10,7,121,114,0,6,1,4
E33031073,373,192,57,135,6,46,30,16,126,121,0,5,0,3
E33031074,290,78,25,53,2,52,27,25,158,150,0,4,4,0
E33031075,202,131,35,96,1,19,10,9,50,43,0,5,2,1
E33031076,414,291,82,209,5,15,8,7,101,97,1,3,0,2
E33031077,1177,508,121,387,16,68,35,33,579,558,1,11,9,6
E33031078,927,421,112,309,12,97,60,37,381,359,1,10,11,16
E33031079,211,77,25,52,3,25,20,5,102,96,0,4,2,4
E33031080,357,225,75,150,3,8,2,6,119,113,1,5,0,2
E33031081,969,437,123,314,7,26,14,12,491,470,0,12,9,8
E33031082,1161,699,187,512,13,71,36,35,369,354,0,14,1,9
E33031083,336,144,38,106,3,65,39,26,105,97,3,2,3,19
E33031084,190,113,32,81,3,22,12,10,52,48,1,3,0,0
E33031085,409,263,61,202,3,51,31,20,89,83,1,4,1,3
E33031086,5128,3607,1036,2571,95,269,122,147,1123,1045,15,58,5,34
E33031087,228,116,28,88,5,24,11,13,83,79,0,3,1,0
E33031088,450,191,47,144,6,41,22,19,209,199,1,9,0,3
E33031089,280,187,50,137,5,29,16,13,59,54,1,2,2,0
E33031090,1779,1198,312,886,28,109,61,48,433,408,3,14,8,11
E33031091,730,441,103,338,13,64,36,28,208,186,9,13,0,4
E33031092,1149,674,199,475,8,52,22,30,401,380,2,14,5,14
E33031093,531,326,95,231,5,36,19,17,161,149,2,8,2,3
E33031094,561,380,113,267,8,47,28,19,125,108,1,14,2,1
E33031095,4088,2368,615,1753,39,172,99,73,1482,1425,4,45,8,27
E33031096,312,165,53,112,5,33,18,15,104,95,1,3,5,5
E33031097,722,438,103,335,12,46,17,29,221,216,0,4,1,5
E33031098,7513,5084,1237,3847,107,431,230,201,1809,1424,235,46,104,82
E33031099,256,126,38,88,2,16,7,9,111,108,1,2,0,1
E33031100,455,268,82,186,3,56,23,33,124,86,23,1,14,4
E33031101,327,145,31,114,4,43,22,21,132,126,0,4,2,3
E33031102,241,116,34,82,1,34,17,17,89,83,0,6,0,1
E33031103,293,159,51,108,8,23,12,11,96,92,0,2,2,7
E33031104,410,256,81,175,4,12,7,5,135,127,0,6,2,3
E33031105,516,309,98,211,9,39,16,23,148,135,3,5,5,11
E33031106,478,341,88,253,6,21,11,10,107,102,1,4,0,3
E33031107,371,162,33,129,9,32,18,14,161,154,1,2,4,7
E33031108,217,112,28,84,7,27,13,14,65,60,0,1,4,6
E33031109,811,443,143,300,13,53,25,28,296,285,3,8,0,6
E33031110,401,224,75,149,3,38,22,16,133,127,1,4,1,3
E33031111,1165,788,186,602,16,41,24,17,313,298,0,13,2,7
E33031112,463,293,93,200,4,27,15,12,133,127,2,3,1,6
E33031113,361,218,72,146,7,22,9,13,113,107,1,5,0,1
E33031114,648,360,128,232,9,33,12,21,243,227,0,15,1,3
E33031115,262,104,42,62,3,22,13,9,131,125,1,1,4,2
E33031116,322,183,69,114,5,20,13,7,107,100,1,5,1,7
E33031117,513,319,111,208,4,20,12,8,169,163,0,3,3,1
E33031118,330,216,56,160,4,21,10,11,88,82,1,5,0,1
E33031119,1999,1232,345,887,22,182,82,100,549,342,115,17,75,14
E33031120,239,174,71,103,3,15,5,10,43,42,0,1,0,4
E33031121,540,356,109,247,5,31,14,17,139,129,2,5,3,9
E33031122,739,457,177,280,13,34,16,18,222,211,1,10,0,13
E33031123,315,185,52,133,1,14,7,7,114,104,0,4,6,1
E33031124,289,165,53,112,4,30,11,19,88,85,1,2,0,2
E33031125,260,129,42,87,4,28,12,16,98,94,0,3,1,1
E33031126,365,200,67,133,5,26,11,15,131,124,2,2,3,3
E33031127,414,239,72,167,1,25,14,11,144,133,5,5,1,5
E33031128,150,80,31,49,0,11,6,5,54,53,0,1,0,5
E33031129,677,423,128,295,8,41,28,13,197,188,1,6,2,8
E33031130,331,235,76,159,2,14,5,9,78,76,0,2,0,2
E33031131,326,203,62,141,2,26,19,7,90,85,1,4,0,5
E33031132,336,178,52,126,3,20,10,10,135,126,7,1,1,0
E33031133,509,323,96,227,0,36,17,19,148,138,1,7,2,2
E33031134,370,234,87,147,6,53,20,33,70,59,6,1,4,7
E33031135,305,166,53,113,2,30,7,23,103,101,1,1,0,4
E33031136,1142,864,182,682,20,91,44,47,156,145,0,8,3,11
E33031137,453,330,91,239,7,20,8,12,93,91,1,1,0,3
E33031138,207,123,36,87,2,18,8,10,63,57,6,0,0,1
E33031139,2018,1263,281,982,64,257,138,119,423,404,2,15,2,11
E33031140,373,205,62,143,4,29,14,15,131,123,0,6,2,4
E33031141,3194,2225,467,1758,55,373,179,194,524,500,1,21,2,17
E33031142,483,314,81,233,6,23,15,8,137,134,0,3,0,3
E33031143,712,445,123,322,7,40,20,20,216,203,0,13,0,4
E33031144,308,138,45,93,3,60,35,25,105,99,4,1,1,2
E33031145,1317,742,201,541,27,88,40,48,452,434,1,15,2,8
E33031146,384,179,52,127,8,80,42,38,114,110,1,3,0,3
E33031147,2330,1608,392,1216,60,171,87,84,478,449,3,26,0,13
E33031148,3193,1741,400,1341,27,221,115,106,1182,1132,4,38,8,22
E33031149,389,143,43,100,3,39,22,17,193,186,2,5,0,11
E33031150,303,188,49,139,4,29,16,13,76,73,0,2,1,6
E33031151,480,331,88,243,7,65,35,30,70,62,3,4,1,7
E33031152,214,112,44,68,4,24,13,11,74,73,0,1,0,0
E33031153,209,130,56,74,4,13,2,11,57,53,0,4,0,5
E33031154,2393,1896,527,1369,28,169,81,88,285,276,1,8,0,15
E33031155,3939,2475,913,1562,52,365,185,180,997,939,5,46,7,50
E33031156,279,137,56,81,2,47,28,19,72,61,3,7,1,21
E33031157,882,566,149,417,16,63,37,26,231,221,0,9,1,6
E33031158,1148,736,213,523,19,89,48,41,299,286,1,11,1,5
E33031159,2194,1502,402,1100,27,172,86,86,482,460,6,14,2,11
E33031160,446,229,72,157,14,32,20,12,166,152,2,12,0,5
E33031161,363,198,56,142,5,48,24,24,112,108,1,3,0,0
E33031162,849,601,161,440,15,79,48,31,151,145,1,5,0,3
E33031163,438,191,40,151,7,75,40,35,160,152,2,5,1,5
E33031164,328,201,48,153,10,38,17,21,78,70,0,8,0,1
E33031165,305,188,65,123,2,24,15,9,89,86,0,3,0,2
E33031166,570,322,93,229,3,75,43,32,161,154,1,6,0,9
E33031167,290,184,66,118,4,32,15,17,63,58,0,4,1,7
E33031168,270,107,48,59,2,41,29,12,79,46,23,2,8,41
E33031169,230,127,31,96,8,25,13,12,68,55,1,12,0,2
E33031170,400,197,54,143,7,54,27,27,134,125,2,7,0,8
E33031171,284,145,31,114,3,43,21,22,89,79,2,7,1,4
E33031172,280,170,56,114,1,31,22,9,77,74,0,3,0,1
E33031173,373,155,39,116,4,46,22,24,164,160,1,1,2,4
E33031174,447,211,72,139,3,34,18,16,196,193,1,2,0,3
E33031175,636,335,90,245,8,46,25,21,243,233,0,7,3,4
E33031176,212,112,37,75,4,19,5,14,74,68,2,4,0,3
E33031177,1368,878,235,643,25,89,45,44,365,339,11,13,2,11
E33031178,569,287,83,204,9,79,43,36,187,181,1,4,1,7
E33031179,357,224,49,175,2,26,12,14,103,97,2,4,0,2
E33031180,476,324,128,196,3,45,19,26,86,80,1,5,0,18
E33031181,236,118,32,86,1,19,11,8,90,87,0,3,0,8
E33031182,1101,716,157,559,17,66,28,38,292,281,5,6,0,10
E33031183,331,152,44,108,6,23,8,15,148,139,1,7,1,2
E33031184,140,50,12,38,3,9,3,6,76,71,0,5,0,2
E33031185,587,257,57,200,9,66,33,33,248,236,2,5,5,7
E33031186,352,199,50,149,4,27,13,14,120,117,1,1,1,2
E33031187,258,110,33,77,3,27,17,10,116,114,0,2,0,2
E33031188,210,103,29,74,7,16,7,9,80,78,1,1,0,4
E33031189,225,112,37,75,2,35,20,15,76,64,2,4,6,0
E33031190,1591,992,239,753,21,72,45,27,498,478,0,16,4,8
E33031191,275,136,43,93,10,15,8,7,112,105,2,4,1,2
E33031192,1347,931,266,665,20,106,52,54,284,246,4,30,4,6
E33031193,311,105,28,77,9,37,10,27,156,151,2,2,1,4
E33031194,363,170,30,140,2,17,8,9,173,166,0,7,0,1
E33031195,305,137,28,109,10,48,41,7,107,101,0,6,0,3
E33031196,556,290,86,204,8,76,34,42,177,168,0,8,1,5
E33031197,348,237,53,184,2,15,8,7,89,83,0,6,0,5
E33031198,3092,1851,509,1342,63,410,209,201,746,696,5,39,6,22
E33031199,420,247,73,174,7,33,12,21,129,123,0,6,0,4
E33031200,268,153,56,97,3,23,11,12,73,67,1,5,0,16
E33031201,421,182,43,139,5,65,35,30,162,150,0,9,3,7
E33031202,279,160,42,118,5,23,14,9,85,77,1,4,3,6
E33031203,1567,731,186,545,26,96,51,45,700,675,1,21,3,14
E33031204,619,369,101,268,13,26,14,12,208,198,0,9,1,3
E33031205,1679,1045,275,770,28,99,47,52,495,470,5,17,3,12
E33031206,337,152,41,111,20,72,28,44,89,82,0,3,4,4
E33031207,935,549,147,402,17,82,37,45,273,254,2,15,2,14
E33031208,425,205,67,138,5,46,25,21,155,148,0,7,0,14
E33031209,3082,2132,469,1663,38,222,96,126,675,650,7,13,5,15
E33031210,163,76,15,61,2,34,19,15,51,49,1,1,0,0
E33031211,887,459,125,334,17,129,63,66,276,271,2,2,1,6
E33031212,1768,989,223,766,11,147,85,62,617,590,1,20,6,4
E33031213,3002,1613,351,1262,28,146,71,75,1192,1141,7,40,4,23
E33031214,737,433,102,331,8,42,23,19,251,235,4,12,0,3
E33031215,214,127,50,77,4,23,6,17,55,53,1,0,1,5
E33031216,1038,391,103,288,8,216,111,105,415,383,4,26,2,8
E33031217,398,251,74,177,4,40,17,23,97,91,1,5,0,6
E33031218,514,281,71,210,10,40,23,17,179,175,1,1,2,4
E33031219,267,141,50,91,3,25,11,14,87,80,2,5,0,11
E33031220,344,193,60,133,0,44,25,19,103,96,1,4,2,4
E33031221,668,417,130,287,6,117,65,52,121,110,0,9,2,7
E33031222,589,371,96,275,7,40,16,24,170,163,1,4,2,1
E33031223,558,262,56,206,7,35,17,18,251,238,0,13,0,3
E33031224,636,343,73,270,9,67,38,29,216,201,1,12,2,1
E33031225,527,271,51,220,10,43,20,23,201,194,0,6,1,2
E33031226,567,225,56,169,10,178,100,78,152,142,2,6,2,2
E33031227,220,77,16,61,3,33,17,16,103,103,0,0,0,4
E33031228,305,131,35,96,6,21,9,12,143,138,0,4,1,4
E33031229,414,224,41,183,6,15,6,9,168,163,0,5,0,1
E33031230,220,70,21,49,2,28,14,14,117,114,0,2,1,3
E33031231,265,108,17,91,4,21,9,12,131,124,0,6,1,1
E33031232,251,103,29,74,4,20,8,12,118,112,1,5,0,6
E33031233,364,212,85,127,4,11,5,6,131,122,1,8,0,6
E33031234,322,221,75,146,2,10,6,4,85,79,0,2,4,4
E33031235,373,228,86,142,4,28,15,13,109,102,1,6,0,4
E33031236,237,129,48,81,0,20,10,10,66,63,1,1,1,22
E33031237,259,158,51,107,2,11,5,6,82,79,0,2,1,6
E33031238,298,140,39,101,5,42,19,23,108,99,0,7,2,3
E33031239,299,130,30,100,3,25,12,13,139,135,1,3,0,2
E33031240,312,145,44,101,5,24,11,13,134,131,0,3,0,4
E33031241,346,180,47,133,7,31,21,10,123,112,0,10,1,5
E33031242,248,115,36,79,3,21,15,6,104,103,0,1,0,5
E33031243,279,150,36,114,3,20,11,9,100,92,0,8,0,6
E33031244,849,511,112,399,14,42,19,23,276,263,1,11,1,6
E33031245,584,262,73,189,9,56,34,22,255,238,5,8,4,2
E33031246,194,71,14,57,1,20,14,6,100,95,0,5,0,2
E33031247,269,154,45,109,4,13,4,9,97,96,0,1,0,1
E33031248,580,323,91,232,5,23,10,13,225,219,0,6,0,4
E33031249,501,226,85,141,15,67,46,21,188,183,2,3,0,5
E33031250,295,177,59,118,6,29,6,23,81,78,0,3,0,2
E33031251,207,117,35,82,5,14,4,10,69,65,1,3,0,2
E33031252,431,245,42,203,8,8,2,6,165,160,1,4,0,5
E33031253,304,97,25,72,2,49,31,18,153,151,1,1,0,3
E33031254,272,163,50,113,1,22,12,10,83,76,2,4,1,3
E33031255,410,250,74,176,7,21,12,9,127,118,0,7,2,5
E33031256,236,108,31,77,4,24,21,3,99,90,0,8,1,1
E33031257,407,247,72,175,6,15,8,7,136,129,1,6,0,3
E33031258,312,196,42,154,2,20,12,8,90,81,1,8,0,4
E33031259,309,111,24,87,4,33,15,18,156,144,2,6,4,5
E33031260,398,236,52,184,8,28,11,17,122,110,3,7,2,4
E33031261,596,291,71,220,8,37,19,18,258,244,1,13,0,2
E33031262,847,545,150,395,13,67,41,26,214,201,1,12,0,8
E33031263,303,139,38,101,7,22,14,8,135,132,0,2,1,0
E33031264,502,292,73,219,2,63,31,32,141,135,0,5,1,4
E33031265,502,243,56,187,3,41,25,16,210,199,0,7,4,5
E33031266,258,132,38,94,5,19,12,7,102,94,6,2,0,0
E33031267,390,219,54,165,5,13,7,6,152,141,1,8,2,1
E33031268,279,125,31,94,4,30,9,21,114,112,0,2,0,6
E33031269,261,136,45,91,0,29,15,14,95,92,1,2,0,1
E33031270,235,95,28,67,5,29,18,11,102,95,0,3,4,4
E33031271,225,121,44,77,3,14,4,10,79,75,1,3,0,8
E33031272,950,507,124,383,10,65,39,26,365,343,0,18,4,3
E33031273,195,87,26,61,3,13,6,7,87,82,1,4,0,5
E33031274,228,120,37,83,5,22,9,13,79,76,0,1,2,2
E33031275,343,118,41,77,2,29,16,13,189,179,0,3,7,5
E33031276,213,149,53,96,4,13,7,6,44,40,1,2,1,3
E33031277,637,318,120,198,3,27,10,17,278,274,0,3,1,11
E33031278,1459,908,241,667,15,62,28,34,464,450,0,14,0,10
E33031279,211,108,28,80,5,15,8,7,81,78,0,3,0,2
E33031280,224,148,56,92,2,5,2,3,68,63,1,3,1,1
E33031281,306,155,29,126,1,39,21,18,110,106,0,2,2,1
E33031282,360,146,43,103,10,22,16,6,180,176,1,2,1,2
E33031283,502,226,74,152,6,46,27,19,214,204,0,6,4,10
E33031284,221,115,43,72,2,24,16,8,76,72,0,4,0,4
E33031285,496,245,68,177,6,28,19,9,214,204,0,7,3,3
E33031286,1303,799,207,592,13,53,21,32,428,415,0,13,0,10
E33031287,313,205,53,152,2,23,8,15,80,74,1,4,1,3
E33031288,232,120,33,87,1,22,11,11,87,83,0,4,0,2
E33031289,243,117,33,84,2,27,16,11,93,88,0,3,2,4
E33031290,304,214,69,145,3,10,2,8,75,70,0,4,1,2
E33031291,197,120,38,82,1,16,7,9,60,54,1,4,1,0
E33031292,355,247,70,177,9,17,11,6,80,77,0,3,0,2
E33031293,262,132,48,84,5,21,13,8,101,94,2,4,1,3
E33031294,1153,728,235,493,15,41,24,17,363,344,0,15,4,6
E33031295,262,172,60,112,0,17,8,9,68,64,2,2,0,5
E33031296,227,132,37,95,6,7,2,5,78,74,1,3,0,4
E33031297,209,106,24,82,1,13,6,7,86,84,0,2,0,3
E33031298,390,253,60,193,2,10,5,5,123,112,0,10,1,2
E33031299,222,125,34,91,6,20,8,12,66,65,0,1,0,5
E33031300,501,184,50,134,4,59,33,26,249,243,0,6,0,5
E33031301,343,187,54,133,4,30,16,14,119,112,1,5,1,3
E33031302,405,244,61,183,2,21,13,8,134,129,1,2,2,4
E33031303,260,174,46,128,1,12,6,6,70,66,0,4,0,3
E33031304,348,227,81,146,3,16,8,8,97,92,2,1,2,5
E33031305,234,130,33,97,4,13,5,8,83,80,0,2,1,4
E33031306,238,137,43,94,5,14,4,10,79,75,1,2,1,3
E33031307,356,179,35,144,5,29,12,17,139,131,1,7,0,4
E33031308,203,128,46,82,0,11,1,10,63,62,0,1,0,1
E33031309,217,110,39,71,2,38,26,12,64,61,0,3,0,3
E33031310,461,226,69,157,6,97,62,35,130,123,0,5,2,2
E33031311,265,139,44,95,3,22,7,15,100,97,0,1,2,1
E33031312,459,215,61,154,6,88,46,42,141,134,0,6,1,9
E33031313,229,107,26,81,3,54,28,26,61,60,0,1,0,4
E33031314,324,123,31,92,3,85,54,31,112,109,0,2,1,1
E33031315,262,99,37,62,1,38,22,16,120,115,2,3,0,4
E33031316,288,109,31,78,1,23,10,13,152,145,2,2,3,3
E33031317,392,230,89,141,7,26,8,18,126,118,0,5,3,3
E33031318,213,129,48,81,6,23,17,6,55,55,0,0,0,0
E33031319,209,125,39,86,1,10,3,7,70,68,0,0,2,3
E33031320,507,170,50,120,8,78,40,38,248,238,1,6,3,3
E33031321,387,193,49,144,5,28,7,21,158,155,2,1,0,3
E33031322,995,576,146,430,12,68,27,41,327,318,0,8,1,12
E33031323,487,316,79,237,5,21,13,8,134,121,4,8,1,11
E33031324,241,149,47,102,2,10,6,4,77,70,2,5,0,3
E33031325,569,185,52,133,5,72,35,37,304,297,0,5,2,3
E33031326,418,268,65,203,7,22,11,11,113,106,0,5,2,8
E33031327,239,132,48,84,3,7,2,5,92,90,0,2,0,5
E33031328,228,142,58,84,1,7,3,4,72,68,0,3,1,6
E33031329,246,134,49,85,4,8,5,3,95,91,1,2,1,5
E33031330,309,184,66,118,7,16,9,7,97,90,1,5,1,5
E33031331,346,163,64,99,5,16,8,8,154,110,35,2,7,8
E33031332,229,109,28,81,4,26,13,13,85,83,0,1,1,5
E33031333,206,101,40,61,3,20,10,10,80,77,1,2,0,2
E33031334,294,173,41,132,5,26,13,13,89,87,0,1,1,1
E33031335,216,134,52,82,3,27,14,13,47,42,0,3,2,5
E33031336,352,157,53,104,3,23,11,12,129,121,3,3,2,40
E33031337,723,282,81,201,14,86,48,38,336,321,1,8,6,5
E33031338,232,119,30,89,5,14,9,5,90,84,0,4,2,4
E33031339,270,145,50,95,2,22,12,10,98,95,0,3,0,3
E33031340,231,139,38,101,2,23,11,12,63,59,1,3,0,4
E33031341,208,129,50,79,4,11,6,5,57,54,1,2,0,7
E33031342,426,271,78,193,5,13,8,5,129,124,1,2,2,8
E33031343,223,141,53,88,3,11,9,2,63,60,1,2,0,5
E33031344,306,153,35,118,5,44,20,24,103,96,1,5,1,1
E33031345,819,326,99,227,11,113,67,46,345,332,3,7,3,24
E33031346,315,180,47,133,1,16,10,6,117,112,1,3,1,1
E33031347,433,269,52,217,6,47,20,27,107,105,0,1,1,4
E33031348,213,75,26,49,2,31,17,14,102,96,1,5,0,3
E33031349,644,402,122,280,6,33,16,17,198,185,2,11,0,5
E33031350,515,253,79,174,5,64,35,29,179,165,1,12,1,14
E33031351,304,198,58,140,7,15,6,9,81,77,1,3,0,3
E33031352,314,198,60,138,7,12,7,5,93,87,1,5,0,4
E33031353,1307,875,237,638,28,84,48,36,310,292,0,15,3,10
E33031354,206,110,35,75,6,16,12,4,71,70,0,0,1,3
E33031355,359,118,28,90,4,37,16,21,197,192,0,5,0,3
E33031356,201,117,28,89,6,11,8,3,61,58,0,3,0,6
E33031357,462,282,85,197,10,38,17,21,123,115,0,8,0,9
E33031358,280,124,20,104,6,20,10,10,118,106,7,5,0,12
E33031359,552,294,66,228,10,43,19,24,198,190,1,5,2,7
E33031360,232,129,34,95,1,31,10,21,68,64,0,3,1,3
E33031361,381,209,53,156,3,23,10,13,140,136,0,4,0,6
E33031362,325,176,36,140,3,27,14,13,119,117,1,1,0,0
E33031363,210,86,25,61,3,25,14,11,93,91,1,1,0,3
E33031364,426,252,48,204,4,21,14,7,147,143,0,4,0,2
E33031365,372,211,59,152,4,37,8,29,117,108,0,9,0,3
E33031366,214,99,25,74,4,8,4,4,102,98,1,3,0,1
E33031367,214,113,28,85,3,18,9,9,77,70,0,2,5,3
E33031368,519,192,39,153,6,40,22,18,280,270,0,8,2,1
E33031369,513,289,71,218,10,24,14,10,189,184,1,3,1,1
E33031370,731,453,115,338,14,62,26,36,197,184,0,13,0,5
E33031371,313,188,47,141,1,21,9,12,101,93,2,5,1,2
E33031372,325,149,55,94,2,22,12,10,150,145,1,4,0,2
E33031373,250,130,37,93,1,14,6,8,102,97,0,5,0,3
E33031374,411,253,73,180,18,28,11,17,106,105,0,1,0,6
E33031375,235,113,31,82,6,17,6,11,98,92,0,3,3,1
E33031376,196,99,21,78,5,9,6,3,79,75,1,3,0,4
E33031377,219,147,60,87,2,17,9,8,52,50,0,2,0,1
E33031378,281,145,40,105,2,22,16,6,112,106,0,5,1,0
E33031379,190,77,22,55,3,13,7,6,96,93,0,3,0,1
E33031380,215,72,26,46,2,75,50,25,64,58,0,3,3,2
E33031381,1606,958,252,706,12,158,76,82,464,450,3,6,5,14
E33031382,465,278,78,200,4,37,20,17,139,131,1,5,2,7
E33031383,233,113,31,82,3,29,13,16,87,85,0,2,0,1
E33031384,267,161,35,126,2,20,12,8,80,78,0,2,0,4
E33031385,223,119,40,79,3,17,7,10,80,75,0,5,0,4
E33031386,440,248,67,181,4,31,14,17,152,148,0,4,0,5
E33031387,574,348,121,227,13,64,31,33,145,137,1,5,2,4
E33031388,511,219,45,174,16,38,24,14,237,230,2,3,2,1
E33031389,260,153,36,117,1,6,4,2,98,92,0,6,0,2
E33031390,231,143,40,103,4,10,9,1,74,72,0,0,2,0
E33031391,550,341,79,262,7,44,18,26,158,145,0,13,0,0
E33031392,103,65,27,38,0,5,2,3,31,27,0,2,2,2
E33031393,2774,1400,415,985,42,656,349,307,661,626,2,28,5,15
E33031394,307,162,49,113,2,12,10,2,126,123,2,0,1,5
E33031395,289,139,32,107,5,28,13,15,115,108,1,6,0,2
E33031396,279,145,36,109,8,30,16,14,96,81,0,15,0,0
E33031397,401,231,71,160,0,46,24,22,119,110,3,4,2,5
E33031398,394,278,77,201,2,17,9,8,92,92,0,0,0,5
E33031399,257,129,33,96,2,14,5,9,110,106,0,3,1,2
E33031400,223,121,37,84,1,19,11,8,78,77,1,0,0,4
E33031401,251,137,33,104,3,26,15,11,79,76,0,1,2,6
E33031402,188,78,22,56,7,16,6,10,86,84,0,0,2,1
E33031403,228,145,30,115,2,19,10,9,62,57,2,3,0,0
E33031404,521,310,63,247,8,33,20,13,168,161,1,6,0,2
E33031405,625,331,62,269,9,57,37,20,227,217,1,9,0,1
E33031406,231,122,32,90,5,14,2,12,88,81,0,5,2,2
E33031407,222,100,31,69,5,24,11,13,93,87,0,6,0,0
E33031408,571,319,79,240,11,25,11,14,213,197,1,15,0,3
E33031409,868,482,107,375,7,48,21,27,322,302,0,19,1,9
E33031410,554,284,65,219,9,26,11,15,232,221,0,9,2,3
E33031411,261,132,50,82,3,29,11,18,94,91,0,3,0,3
E33031412,215,135,40,95,0,4,2,2,74,73,0,1,0,2
E33031413,427,276,68,208,3,32,18,14,113,111,0,2,0,3
E33031414,352,200,45,155,6,30,14,16,114,107,0,4,3,2
E33031415,209,114,33,81,3,19,9,10,70,65,1,3,1,3
E33031416,281,156,35,121,3,12,5,7,107,102,2,3,0,3
E33031417,771,375,78,297,12,31,13,18,349,339,3,5,2,4
E33031418,271,139,42,97,5,27,7,20,100,94,0,5,1,0
E33031419,368,175,44,131,9,29,13,16,150,142,1,7,0,5
E33031420,282,138,38,100,2,20,14,6,121,108,3,5,5,1
E33031421,213,109,30,79,5,23,12,11,75,74,0,1,0,1
E33031422,238,60,21,39,4,37,19,18,136,128,0,3,5,1
E33031423,251,144,38,106,2,14,5,9,90,86,0,4,0,1
E33031424,216,55,8,47,7,35,16,19,117,115,2,0,0,2
E33031425,361,129,44,85,4,48,32,16,178,165,1,11,1,2
E33031426,311,160,46,114,3,27,14,13,121,106,9,6,0,0
E33031427,222,56,17,39,3,35,23,12,128,122,1,4,1,0
E33031428,287,115,26,89,3,22,15,7,145,142,0,3,0,2
E33031429,241,96,24,72,1,32,13,19,108,102,3,2,1,4
E33031430,283,154,41,113,2,30,18,12,95,92,0,3,0,2
E33031431,285,136,44,92,9,28,15,13,105,103,0,2,0,7
E33031432,278,131,38,93,4,33,13,20,109,104,1,4,0,1
E33031433,271,78,27,51,4,31,15,16,151,146,0,2,3,7
E33031434,436,240,61,179,8,24,11,13,160,148,0,10,2,4
E33031435,200,71,21,50,3,11,5,6,115,108,2,2,3,0
E33031436,332,149,53,96,5,16,6,10,159,156,1,1,1,3
E33031437,321,145,35,110,7,30,10,20,136,132,0,3,1,3
E33031438,295,150,49,101,4,55,21,34,84,82,0,2,0,2
E33031439,368,184,45,139,3,22,8,14,149,143,0,6,0,10
E33031440,270,170,34,136,3,13,5,8,84,81,0,3,0,0
E33031441,200,85,22,63,2,14,5,9,93,91,0,2,0,6
E33031442,348,197,37,160,2,14,9,5,134,126,0,8,0,1
E33031443,313,187,44,143,1,17,5,12,108,100,0,2,6,0
E33031444,249,113,31,82,1,39,18,21,92,88,2,2,0,4
E33031445,641,351,85,266,4,26,10,16,256,244,1,11,0,4
E33031446,489,229,54,175,2,25,9,16,228,223,0,5,0,5
E33031447,466,241,54,187,9,34,21,13,181,171,0,9,1,1
E33031448,676,365,106,259,8,40,13,27,257,249,1,5,2,6
E33031449,250,114,42,72,1,40,23,17,94,92,0,2,0,1
E33031450,207,107,33,74,1,26,14,12,67,62,1,4,0,6
E33031451,222,117,38,79,2,23,4,19,80,77,1,0,2,0
E33031452,283,118,27,91,2,30,15,15,130,126,0,4,0,3
E33031453,401,278,97,181,7,37,18,19,78,74,1,3,0,1
E33031454,245,83,23,60,2,33,20,13,126,120,3,2,1,1
E33031455,377,149,36,113,2,32,17,15,191,188,0,2,1,3
E33031456,197,78,28,50,4,26,12,14,88,88,0,0,0,1
E33031457,833,332,77,255,8,42,19,23,447,432,2,12,1,4
E33031458,215,135,31,104,1,12,4,8,63,63,0,0,0,4
E33031459,216,114,39,75,2,12,6,6,83,79,3,1,0,5
E33031460,317,134,27,107,1,31,14,17,150,148,2,0,0,1
E33031461,389,232,84,148,2,21,8,13,125,116,0,9,0,9
E33031462,219,121,47,74,3,22,10,12,67,65,1,0,1,6
E33031463,488,265,65,200,6,117,38,79,98,93,0,4,1,2
E33031464,239,159,53,106,5,41,18,23,34,33,0,1,0,0
E33031465,621,336,97,239,6,36,19,17,238,229,0,9,0,5
E33031466,631,290,94,196,16,113,53,60,207,190,1,14,2,5
E33031467,277,127,37,90,8,53,42,11,88,78,3,4,3,1
E33031468,457,363,75,288,6,36,11,25,52,50,0,2,0,0
E33031469,943,627,184,443,12,155,42,113,141,131,3,7,0,8
E33031470,2285,1562,357,1205,38,149,87,62,527,503,1,21,2,9
E33031471,1189,793,220,573,14,125,65,60,251,236,2,12,1,6
E33031472,229,142,30,112,1,21,7,14,65,61,0,4,0,0
E33031473,1941,1422,277,1145,47,125,57,68,339,319,3,13,4,8
E33031474,228,106,28,78,4,43,25,18,75,69,5,1,0,0
E33031475,492,328,90,238,12,42,17,25,108,103,2,3,0,2
E33031476,529,319,74,245,4,51,25,26,152,133,2,17,0,3
E33031477,737,478,112,366,9,40,22,18,201,191,2,7,1,9
E33031478,717,507,142,365,9,69,35,34,130,122,0,4,4,2
E33031479,353,197,46,151,7,34,22,12,112,107,0,3,2,3
E33031480,455,280,69,211,3,31,14,17,140,131,1,7,1,1
E33031481,1204,753,205,548,16,82,57,25,345,328,2,13,2,8
E33031482,1135,586,136,450,9,90,46,44,441,428,1,6,6,9
E33031483,515,347,72,275,4,21,10,11,143,134,1,6,2,0
E33031484,733,529,95,434,11,46,27,19,145,132,0,12,1,2
E33031485,1832,1254,270,984,13,73,40,33,488,469,2,15,2,4
E33031486,327,207,49,158,2,20,12,8,92,84,3,4,1,6
E33031487,1905,1447,358,1089,21,70,39,31,359,345,0,13,1,8
E33031488,210,124,18,106,3,10,7,3,71,69,0,1,1,2
E33031489,290,171,53,118,6,42,26,16,70,65,0,5,0,1
E33031490,583,301,77,224,9,57,28,29,208,197,1,9,1,8
E33031491,459,315,76,239,4,19,10,9,118,107,4,4,3,3
E33031492,442,307,79,228,5,29,11,18,98,92,2,3,1,3
E33031493,541,362,101,261,10,26,15,11,135,130,0,3,2,8
E33031494,1695,1222,252,970,11,65,31,34,389,376,1,11,1,8
E33031495,746,490,115,375,7,28,15,13,216,208,2,5,1,5
E33031496,572,386,80,306,7,28,13,15,146,140,0,6,0,5
E33031497,1362,963,231,732,8,70,31,39,318,305,1,12,0,3
E33031498,495,294,69,225,5,11,7,4,180,177,1,2,0,5
E33031499,381,223,40,183,5,35,13,22,117,112,1,4,0,1
E33031500,282,168,45,123,4,34,20,14,74,71,0,3,0,2
E33031501,2876,1843,439,1404,29,122,58,64,861,821,4,33,3,21
E33031502,2234,1424,335,1089,21,105,52,53,673,639,3,24,7,11
E33031503,2321,1727,392,1335,22,92,50,42,472,459,1,12,0,8
E33031504,639,419,113,306,10,43,23,20,162,158,0,1,3,5
E33031505,1330,768,180,588,12,184,87,97,354,326,10,15,3,12
E33031506,930,606,115,491,13,46,29,17,258,248,2,7,1,7
E33031507,1502,889,173,716,6,58,28,30,543,525,5,10,3,6
E33031508,2631,1570,385,1185,20,100,48,52,917,884,4,26,3,24
E33031509,3386,2124,543,1581,22,138,60,78,1074,1033,5,27,9,28
E33031510,479,299,70,229,5,21,16,5,153,149,1,3,0,1
E33031511,1068,706,170,536,9,40,19,21,308,293,7,6,2,5
E33031512,1487,1027,231,796,16,75,39,36,359,338,0,19,2,10
E33031513,281,182,46,136,5,8,3,5,86,84,0,2,0,0
E33031514,736,403,112,291,11,35,20,15,278,264,1,13,0,9
E33031515,934,631,147,484,10,82,54,28,203,194,1,8,0,8
E33031516,352,270,71,199,3,20,8,12,59,58,0,1,0,0
E33031517,2337,1496,410,1086,30,84,37,47,711,690,1,18,2,16
E33031518,643,478,137,341,6,28,10,18,125,119,0,6,0,6
E33031519,777,508,126,382,6,32,13,19,228,212,1,14,1,3
E33031520,1623,994,252,742,9,71,32,39,539,512,6,18,3,10
E33031521,5170,3334,762,2572,53,161,82,79,1579,1520,12,42,5,43
E33031522,1155,756,204,552,12,72,33,39,310,295,3,12,0,5
E33031523,346,173,50,123,3,14,4,10,152,146,1,5,0,4
E33031524,1030,610,148,462,8,68,41,27,335,323,2,9,1,9
E33031525,711,494,126,368,9,61,34,27,144,133,0,10,1,3
E33031526,914,549,115,434,7,41,18,23,309,292,3,10,4,8
E33031527,1112,692,144,548,12,70,37,33,330,312,0,18,0,8
E33031528,885,352,76,276,10,186,109,77,330,317,0,7,6,7
E33031529,709,439,108,331,6,25,9,16,233,227,1,4,1,6
E33031530,1028,713,132,581,8,39,18,21,262,253,0,7,2,6
E33031531,400,245,61,184,4,23,14,9,126,123,1,2,0,2
E33031532,3456,2025,494,1531,27,124,64,60,1252,1219,2,27,4,28
E33031533,292,192,53,139,3,38,18,20,56,53,0,3,0,3
E33031534,1168,724,187,537,6,42,20,22,388,381,0,5,2,8
E33031535,1225,699,155,544,13,50,29,21,458,434,1,22,1,5
E33031536,1243,894,154,740,9,53,36,17,283,268,2,11,2,4
E33031537,693,439,104,335,5,30,17,13,215,204,1,10,0,4
E33031538,1597,1011,253,758,16,49,18,31,517,494,3,19,1,4
E33031539,228,141,33,108,4,13,9,4,69,66,0,2,1,1
E33031540,1308,777,151,626,18,53,26,27,457,441,1,12,3,3
E33031541,268,155,42,113,5,18,5,13,86,79,0,5,2,4
E33031542,190,118,28,90,3,25,10,15,41,39,0,2,0,3
E33031543,2423,1649,397,1252,15,86,45,41,654,628,3,22,1,19
E33031544,417,213,44,169,8,67,36,31,126,117,0,8,1,3
E33031545,435,315,53,262,2,14,5,9,103,96,0,5,2,1
E33031546,369,188,39,149,1,60,39,21,119,109,0,8,2,1
E33031547,816,470,116,354,7,53,23,30,281,264,1,15,1,5
E33031548,201,132,36,96,4,9,6,3,56,52,0,3,1,0
E33031549,4314,2678,578,2100,35,139,66,73,1441,1390,3,41,7,21
E33031550,2979,2064,486,1578,23,97,45,52,785,747,6,26,6,10
E33031551,662,466,87,379,5,36,16,20,153,138,0,13,2,2
E33031552,581,367,82,285,3,22,10,12,186,176,0,8,2,3
E33031553,1145,678,170,508,10,50,25,25,396,376,1,18,1,11
E33031554,468,274,68,206,6,18,5,13,162,158,0,3,1,8
E33031555,641,362,82,280,5,47,28,19,223,211,5,7,0,4
E33031556,570,311,80,231,10,45,16,29,203,197,1,4,1,1
E33031557,2541,1672,397,1275,26,125,63,62,697,669,2,22,4,21
E33031558,300,187,53,134,9,9,4,5,89,87,0,2,0,6
E33031559,3299,2102,500,1602,32,132,67,65,1018,969,4,40,5,15
E33031560,290,135,35,100,5,22,7,15,126,125,0,1,0,2
E33031561,472,129,31,98,13,77,44,33,249,243,2,4,0,4
E33031562,643,371,80,291,7,36,24,12,223,219,0,3,1,6
E33031563,229,148,41,107,1,11,5,6,67,63,0,4,0,2
E33031564,6633,4467,1079,3388,40,193,108,85,1893,1827,10,48,8,40
E33031565,490,360,107,253,2,28,12,16,99,94,0,5,0,1
E33031566,672,492,116,376,5,39,20,19,134,123,3,8,0,2
E33031567,734,537,115,422,5,33,16,17,157,152,0,4,1,2
E33031568,991,670,157,513,13,59,28,31,242,235,1,5,1,7
E33031569,1322,747,165,582,16,80,47,33,469,449,2,13,5,10
E33031570,230,145,39,106,1,17,10,7,65,65,0,0,0,2
E33031571,1374,975,232,743,10,38,16,22,343,325,1,15,2,8
E33031572,4921,2977,741,2236,28,140,75,65,1747,1690,8,34,15,29
E33031573,663,429,114,315,3,28,16,12,198,193,2,3,0,5
E33031574,720,315,106,209,6,92,56,36,287,272,0,13,2,20
E33031575,504,344,87,257,4,21,12,9,129,116,0,9,4,6
E33031576,482,294,88,206,5,41,22,19,136,127,0,8,1,6
E33031577,452,272,60,212,6,18,8,10,155,147,0,8,0,1
E33031578,505,353,85,268,4,24,12,12,122,117,0,2,3,2
E33031579,1667,1148,294,854,14,72,34,38,418,401,2,13,2,15
E33031580,392,234,58,176,3,24,10,14,128,125,0,2,1,3
E33031581,1134,823,167,656,17,43,18,25,248,233,2,13,0,3
E33031582,449,288,66,222,2,18,9,9,139,130,0,9,0,2
E33031583,1484,941,199,742,13,67,32,35,451,431,1,16,3,12
E33031584,1084,687,146,541,19,37,18,19,335,321,1,13,0,6
E33031585,207,131,34,97,1,6,3,3,67,65,0,2,0,2
E33031586,412,261,73,188,2,26,12,14,119,105,8,4,2,4
E33031587,1039,755,178,577,15,20,9,11,246,241,0,3,2,3
E33031588,1307,811,165,646,12,42,23,19,437,425,0,10,2,5
E33031589,405,238,62,176,3,32,17,15,129,121,0,7,1,3
E33031590,327,221,58,163,6,9,6,3,87,73,11,2,1,4
E33031591,1146,674,151,523,11,89,47,42,363,342,1,18,2,9
E33031592,2161,1397,336,1061,24,138,73,65,584,561,3,18,2,18
E33031593,205,99,21,78,6,44,24,20,55,55,0,0,0,1
E33031594,393,229,66,163,3,19,10,9,140,129,1,8,2,2
E33031595,1536,866,220,646,18,42,18,24,548,520,9,11,8,62
E33031596,960,481,116,365,9,109,74,35,354,338,1,13,2,7
E33031597,1053,701,164,537,2,52,20,32,291,280,1,10,0,7
E33031598,344,196,50,146,8,39,18,21,98,92,2,4,0,3
E33031599,410,236,63,173,2,20,7,13,150,143,2,4,1,2
E33031600,260,134,46,88,4,18,9,9,100,97,1,2,0,4
E33031601,357,226,62,164,2,23,8,15,104,100,0,3,1,2
E33031602,474,360,86,274,3,12,5,7,98,90,0,8,0,1
E33031603,1316,884,193,691,21,52,21,31,351,342,0,6,3,8
E33031604,419,238,59,179,7,27,17,10,146,141,0,4,1,1
E33031605,357,226,58,168,2,23,12,11,101,99,0,2,0,5
E33031606,682,412,118,294,7,37,20,17,217,206,1,7,3,9
E33031607,249,140,43,97,3,14,9,5,87,81,1,4,1,5
E33031608,1158,741,179,562,12,35,18,17,365,357,0,8,0,5
E33031609,1961,1170,287,883,15,83,32,51,678,653,1,20,4,15
E33031610,1447,937,230,707,10,74,39,35,416,400,0,16,0,10
E33031611,268,185,59,126,3,11,9,2,68,66,0,2,0,1
E33031612,418,279,61,218,6,31,15,16,100,96,0,4,0,2
E33031613,444,293,108,185,6,14,9,5,131,126,0,5,0,0
E33031614,1154,779,172,607,12,43,23,20,314,302,1,11,0,6
E33031615,933,611,151,460,7,50,21,29,258,245,1,12,0,7
E33031616,755,507,133,374,6,44,23,21,192,181,1,5,5,6
E33031617,501,264,68,196,5,40,25,15,190,181,0,7,2,2
E33031618,449,274,60,214,9,23,10,13,138,135,0,3,0,5
E33031619,303,206,63,143,0,9,2,7,80,77,0,3,0,8
E33031620,1795,1214,293,921,13,54,27,27,502,487,1,13,1,12
E33031621,390,223,66,157,6,26,12,14,133,128,1,3,1,2
E33031622,428,156,49,107,5,62,38,24,198,187,0,9,2,7
E33031623,1200,766,191,575,7,54,19,35,367,348,2,13,4,6
E33031624,227,167,43,124,1,33,10,23,23,22,0,1,0,3
E33031625,419,239,63,176,7,111,28,83,60,57,0,1,2,2
E33031626,290,194,57,137,3,41,28,13,45,41,0,4,0,7
E33031627,381,273,67,206,6,38,27,11,61,54,1,5,1,3
E33031628,762,559,152,407,3,119,84,35,76,66,1,5,4,5
E33031629,640,422,140,282,3,110,77,33,104,97,0,7,0,1
E33031630,1456,1169,308,861,11,105,67,38,165,155,2,7,1,6
E33031631,975,653,187,466,12,163,114,49,146,138,1,3,4,1
E33031632,426,293,62,231,1,68,48,20,64,61,0,3,0,0
E33031633,176,130,24,106,2,21,17,4,23,21,0,1,1,0
E33031634,290,200,54,146,11,28,18,10,50,48,0,2,0,1
E33031635,561,445,153,292,3,45,38,7,63,59,0,4,0,5
E33031636,456,304,78,226,3,75,64,11,72,68,0,4,0,2
E33031637,1340,845,236,609,25,227,156,71,238,224,3,8,3,5
E33031638,345,198,59,139,4,55,28,27,85,83,0,2,0,3
E33031639,364,208,64,144,4,52,27,25,96,88,1,7,0,4
E33031640,1705,991,231,760,25,309,169,140,368,341,1,21,5,12
E33031641,832,682,107,575,15,37,18,19,97,92,0,4,1,1
E33031642,204,121,22,99,2,26,13,13,49,46,0,3,0,6
E33031643,715,511,143,368,8,58,24,34,135,126,1,5,3,3
E33031644,385,282,110,172,5,54,28,26,42,37,0,5,0,2
E33031645,361,252,61,191,3,38,20,18,67,61,1,5,0,1
E33031646,501,284,74,210,4,76,41,35,132,127,0,4,1,5
E33031647,1390,1070,334,736,25,140,69,71,146,134,4,8,0,9
E33031648,334,202,57,145,6,39,18,21,86,81,0,4,1,1
E33031649,594,308,85,223,7,89,41,48,185,178,0,3,4,5
E33031650,327,119,35,84,7,60,37,23,140,129,4,6,1,1
E33031651,394,154,37,117,2,98,45,53,136,125,0,4,7,4
E33031652,408,229,64,165,7,64,23,41,105,96,2,6,1,3
E33031653,329,142,42,100,9,84,42,42,92,85,0,4,3,2
E33031654,280,142,51,91,1,87,40,47,49,46,0,3,0,1
E33031655,574,349,80,269,14,94,46,48,112,105,0,5,2,5
E33031656,963,595,166,429,9,155,84,71,194,185,1,6,2,10
E33031657,357,203,42,161,6,31,13,18,113,111,0,2,0,4
E33031658,979,659,165,494,14,110,50,60,188,177,3,7,1,8
E33031659,6850,3730,880,2850,84,456,241,215,2534,2426,13,83,12,46
E33031660,4527,2885,618,2267,51,206,86,120,1367,1316,3,39,9,18
E33031661,1715,1283,248,1035,24,67,32,35,333,313,2,17,1,8
E33031662,2895,1527,283,1244,36,195,96,99,1122,1089,3,26,4,15
E33031663,637,412,104,308,9,45,24,21,169,159,0,9,1,2
E33031664,863,465,111,354,10,61,32,29,320,303,2,12,3,7
E33031665,1147,454,101,353,17,196,93,103,474,464,0,8,2,6
E33031666,2388,1414,271,1143,16,85,41,44,862,838,1,22,1,11
E33031667,3041,1978,418,1560,36,120,62,58,894,850,3,35,6,13
E33031668,6664,4141,884,3257,86,425,235,190,1978,1907,6,55,10,34
E33031669,10920,6707,1432,5275,99,392,193,199,3674,3551,12,86,25,48
E33031670,1041,635,151,484,18,203,94,109,179,171,0,7,1,6
E33031671,2057,1262,263,999,49,473,194,279,262,248,1,13,0,11
E33031672,595,388,72,316,6,57,43,14,144,139,0,5,0,0
E33031673,277,137,31,106,6,45,23,22,88,85,1,2,0,1
E33031674,3166,1968,370,1598,33,210,99,111,934,901,4,27,2,21
E33031675,9497,6406,1387,5019,110,360,181,179,2570,2480,10,68,12,51
E33031676,8339,5349,1146,4203,86,422,188,234,2449,2361,9,59,20,33
E33031677,248,85,23,62,5,37,16,21,118,113,0,1,4,3
E33031678,11397,7389,1442,5947,109,411,202,209,3438,3327,16,79,16,50
E33031679,5938,3420,812,2608,62,221,95,126,2200,2096,8,78,18,35
E33031680,6538,3954,833,3121,68,241,101,140,2243,2168,5,45,25,32
E33031681,6482,3667,828,2839,61,226,106,120,2500,2410,5,71,14,28
E33031682,3512,2236,500,1736,44,204,104,100,1011,975,2,27,7,17
E33031683,334,147,42,105,3,84,41,43,100,91,2,6,1,0
E33031684,314,173,54,119,3,58,25,33,78,75,0,1,2,2
E33031685,654,351,95,256,13,113,61,52,173,167,0,4,2,4
E33031686,409,198,61,137,11,82,48,34,114,106,2,6,0,4
E33031687,217,105,38,67,1,34,19,15,77,74,0,2,1,0
E33031688,209,102,25,77,1,63,30,33,42,38,1,3,0,1
E33031689,298,126,25,101,0,69,40,29,102,99,0,3,0,1
E33031690,462,224,68,156,5,93,54,39,139,134,0,5,0,1
E33031691,214,87,23,64,13,41,17,24,73,71,1,1,0,0
E33031692,504,249,52,197,1,102,52,50,147,138,0,5,4,5
E33031693,763,387,96,291,29,210,83,127,132,115,1,7,9,5
E33031694,691,375,76,299,15,98,47,51,200,187,3,8,2,3
E33031695,750,383,87,296,19,39,13,26,302,283,0,16,3,7
E33031696,819,225,57,168,11,391,262,129,183,174,0,6,3,9
E33031697,657,366,80,286,8,48,25,23,230,217,1,10,2,5
E33031698,763,443,80,363,18,106,50,56,189,183,3,3,0,7
E33031699,334,179,54,125,7,39,31,8,107,96,1,5,5,2
E33031700,608,296,58,238,13,58,28,30,239,236,1,2,0,2
E33031701,246,112,25,87,0,30,21,9,96,88,2,5,1,8
E33031702,248,158,36,122,7,40,18,22,41,41,0,0,0,2
E33031703,921,483,113,370,11,90,52,38,322,305,1,11,5,15
E33031704,570,305,85,220,12,60,35,25,185,176,2,7,0,8
E33031705,692,401,86,315,16,119,56,63,153,143,1,8,1,3
E33031706,908,333,82,251,19,288,191,97,257,246,2,6,3,11
E33031707,434,225,42,183,4,29,10,19,172,167,0,4,1,4
E33031708,396,231,62,169,8,58,35,23,88,84,1,3,0,11
E33031709,398,250,49,201,6,21,10,11,119,114,0,4,1,2
E33031710,3537,2510,584,1926,29,129,58,71,848,818,10,17,3,21
E33031711,1163,803,210,593,39,155,79,76,162,151,2,6,3,4
E33031712,320,160,32,128,36,46,13,33,78,73,0,5,0,0
E33031713,247,139,35,104,7,27,12,15,73,72,0,1,0,1
E33031714,519,342,64,278,14,32,12,20,128,122,2,1,3,3
E33031715,326,220,64,156,7,40,15,25,57,54,1,2,0,2
E33031716,1265,719,225,494,27,180,112,68,328,311,5,7,5,11
E33031717,512,259,79,180,7,80,49,31,165,150,1,7,7,1
E33031718,416,174,49,125,3,89,56,33,139,133,0,4,2,11
E33031719,357,145,47,98,3,86,45,41,121,115,1,4,1,2
E33031720,387,129,24,105,3,73,46,27,175,160,1,6,8,7
E33031721,1154,716,274,442,21,130,84,46,275,263,3,8,1,12
E33031722,126,51,13,38,1,32,24,8,41,38,0,3,0,1
E33031723,246,106,38,68,7,30,16,14,97,91,0,6,0,6
E33031724,1083,569,142,427,30,126,51,75,354,330,3,19,2,4
E33031725,589,304,92,212,7,97,60,37,175,167,1,7,0,6
E33031726,254,133,39,94,5,21,11,10,93,84,0,8,1,2
E33031727,840,634,177,457,17,48,27,21,133,125,2,5,1,8
E33031728,713,440,138,302,7,70,36,34,190,174,2,10,4,6
E33031729,254,108,21,87,7,74,39,35,63,59,0,4,0,2
E33031730,226,155,39,116,2,29,21,8,34,31,0,3,0,6
E33031731,233,157,44,113,2,26,16,10,47,43,0,4,0,1
E33031732,1103,757,258,499,9,176,109,67,152,144,0,7,1,9
E33031733,425,316,108,208,7,36,21,15,62,58,1,3,0,4
E33031734,351,221,78,143,7,37,18,19,86,82,0,4,0,0
E33031735,468,262,67,195,3,74,45,29,126,117,0,5,4,3
E33031736,465,321,82,239,5,39,22,17,99,94,1,2,2,1
E33031737,410,297,93,204,2,24,12,12,83,77,0,5,1,4
E33031738,2089,1199,365,834,27,285,147,138,566,537,3,21,5,12
E33031739,221,160,51,109,3,40,19,21,17,15,0,1,1,1
E33031740,479,286,84,202,8,72,34,38,112,108,0,2,2,1
E33031741,335,103,29,74,2,120,72,48,103,93,1,8,1,7
E33031742,921,638,163,475,12,108,49,59,160,145,0,14,1,3
E33031743,930,518,176,342,7,85,44,41,314,289,1,20,4,6
E33031744,4536,2853,627,2226,59,251,141,110,1339,1297,7,30,5,34
E33031745,213,117,28,89,3,43,21,22,47,45,1,1,0,3
E33031746,330,200,29,171,2,45,22,23,80,75,0,3,2,3
E33031747,470,233,71,162,8,90,41,49,135,127,2,5,1,4
E33031748,1449,783,234,549,19,171,98,73,464,433,1,24,6,12
E33031749,407,194,48,146,2,91,46,45,117,101,10,5,1,3
E33031750,481,258,60,198,9,110,51,59,98,88,3,6,1,6
E33031751,252,126,20,106,1,60,34,26,63,61,0,2,0,2
E33031752,981,334,74,260,11,353,206,147,268,253,3,9,3,15
E33031753,2529,1579,368,1211,33,130,69,61,772,732,3,32,5,15
E33031754,391,202,44,158,10,36,24,12,139,132,2,4,1,4
E33031755,893,483,134,349,13,72,42,30,315,295,1,17,2,10
E33031756,847,493,182,311,10,39,14,25,287,275,2,10,0,18
E33031757,654,374,73,301,12,39,20,19,223,209,0,13,1,6
E33031758,470,272,86,186,5,43,28,15,145,134,1,9,1,5
E33031759,452,277,84,193,10,38,21,17,123,115,1,6,1,4
E33031760,383,282,73,209,9,36,17,19,54,51,0,3,0,2
E33031761,354,191,47,144,6,40,21,19,115,110,0,3,2,2
E33031762,1284,686,240,446,28,131,62,69,429,398,4,24,3,10
E33031763,360,138,43,95,5,51,23,28,166,156,0,9,1,0
E33031764,669,438,114,324,7,82,41,41,139,126,0,12,1,3
E33031765,1003,589,240,349,17,83,40,43,306,292,1,12,1,8
E33031766,271,153,61,92,3,22,11,11,89,88,0,1,0,4
E33031767,1196,756,276,480,30,83,29,54,321,307,1,12,1,6
E33031768,1776,1077,375,702,38,130,57,73,520,494,0,22,4,11
E33031769,285,119,27,92,1,41,15,26,120,118,0,2,0,4
E33031770,751,435,135,300,15,73,32,41,222,217,0,4,1,6
E33031771,854,422,81,341,12,72,41,31,343,332,0,8,3,5
E33031772,641,403,96,307,7,54,28,26,176,166,2,7,1,1
E33031773,6326,3248,865,2383,141,1305,616,689,1578,1474,25,48,31,54
E33031774,1856,1232,297,935,26,103,46,57,487,451,1,30,5,8
E33031775,519,363,104,259,17,36,21,15,100,96,0,4,0,3
E33031776,205,112,31,81,11,22,13,9,58,56,0,2,0,2
E33031777,272,159,35,124,5,30,16,14,75,71,0,3,1,3
E33031778,230,135,40,95,3,31,20,11,60,59,0,0,1,1
E33031779,262,163,50,113,3,26,15,11,67,61,2,3,1,3
E33031780,306,154,53,101,3,54,32,22,95,89,3,2,1,0
E33031781,331,213,61,152,4,33,14,19,79,71,1,5,2,2
E33031782,634,327,76,251,15,47,22,25,240,228,0,12,0,5
E33031783,257,105,41,64,1,76,43,33,70,70,0,0,0,5
E33031784,691,369,97,272,7,113,68,45,191,173,9,7,2,11
E33031785,413,231,64,167,6,112,59,53,63,59,1,3,0,1
E33031786,1320,578,110,468,8,115,56,59,611,566,4,34,7,8
E33031787,484,276,88,188,7,44,21,23,151,140,0,11,0,6
E33031788,1170,668,196,472,26,261,98,163,209,196,0,7,6,6
E33031789,316,140,41,99,8,44,21,23,121,115,0,5,1,3
E33031790,306,178,51,127,3,31,20,11,88,83,0,4,1,6
E33031791,366,161,45,116,11,63,32,31,126,122,0,4,0,5
E33031792,1471,595,152,443,27,279,139,140,566,550,1,11,4,4
E33031793,674,299,83,216,10,62,24,38,299,288,1,5,5,4
E33031794,363,180,57,123,11,63,33,30,108,105,0,1,2,1
E33031795,727,409,123,286,6,103,52,51,204,195,3,5,1,5
E33031796,270,136,38,98,3,39,16,23,92,90,0,2,0,0
E33031797,464,217,61,156,19,71,37,34,154,145,0,5,4,3
E33031798,241,110,24,86,10,35,14,21,85,79,2,4,0,1
E33031799,443,261,87,174,15,50,25,25,114,103,0,10,1,3
E33031800,345,223,89,134,3,57,31,26,60,53,0,7,0,2
E33031801,335,250,66,184,4,24,12,12,57,57,0,0,0,0
E33031802,309,193,80,113,2,48,20,28,66,63,0,0,3,0
E33031803,667,371,113,258,6,100,54,46,189,182,0,5,2,1
E33031804,292,165,51,114,2,28,16,12,93,88,1,1,3,4
E33031805,427,188,61,127,7,108,46,62,119,112,0,4,3,5
E33031806,704,404,114,290,11,128,60,68,155,149,0,4,2,6
E33031807,1519,878,232,646,32,204,102,102,397,377,3,14,3,8
E33031808,912,516,173,343,9,169,107,62,209,191,2,13,3,9
E33031809,4766,2837,867,1970,85,678,215,463,1139,1069,4,28,38,27
E33031810,526,206,48,158,3,126,71,55,183,178,1,4,0,8
E33031811,347,191,49,142,7,72,36,36,75,71,0,4,0,2
E33031812,275,125,41,84,1,48,29,19,96,89,1,5,1,5
E33031813,282,140,37,103,2,41,18,23,94,90,1,3,0,5
E33031814,529,181,45,136,4,120,79,41,219,215,0,1,3,5
E33031815,253,70,14,56,1,31,15,16,147,138,0,6,3,4
E33031816,244,139,31,108,3,31,16,15,67,65,0,2,0,4
E33031817,677,386,87,299,21,122,56,66,143,128,5,10,0,5
E33031818,276,128,33,95,2,25,14,11,118,113,0,5,0,3
E33031819,352,232,67,165,3,22,9,13,85,76,2,7,0,10
E33031820,322,210,39,171,3,25,14,11,83,76,2,3,2,1
E33031821,230,140,42,98,2,44,25,19,44,41,1,1,1,0
E33031822,238,135,34,101,2,16,9,7,83,82,0,0,1,2
E33031823,683,371,78,293,19,67,48,19,223,212,1,9,1,3
E33031824,652,350,87,263,6,37,15,22,253,243,1,6,3,6
E33031825,823,532,141,391,14,32,16,16,235,219,2,13,1,10
E33031826,683,455,122,333,9,47,26,21,170,160,4,6,0,2
E33031827,577,295,81,214,6,54,27,27,215,207,1,7,0,7
E33031828,805,518,130,388,13,54,24,30,217,204,0,12,1,3
E33031829,1026,596,141,455,25,62,36,26,336,320,2,10,4,7
E33031830,520,323,77,246,5,33,14,19,157,134,0,22,1,2
E33031831,613,330,92,238,6,79,36,43,193,181,2,10,0,5
E33031832,318,173,45,128,5,44,23,21,95,85,0,7,3,1
E33031833,481,225,54,171,7,47,19,28,200,190,1,7,2,2
E33031834,271,145,47,98,5,28,17,11,92,86,1,4,1,1
E33031835,578,338,69,269,5,33,22,11,201,182,2,17,0,1
E33031836,324,188,51,137,3,36,24,12,96,87,1,6,2,1
E33031837,881,474,111,363,25,73,38,35,305,292,1,10,2,4
E33031838,554,292,64,228,14,34,15,19,211,203,2,6,0,3
E33031839,272,146,39,107,4,24,11,13,97,92,0,5,0,1
E33031840,404,199,47,152,6,20,12,8,175,175,0,0,0,4
E33031841,417,234,56,178,7,29,13,16,144,134,1,9,0,3
E33031842,280,149,47,102,0,16,8,8,115,108,0,5,2,0
E33031843,315,176,47,129,5,20,8,12,114,109,0,4,1,0
E33031844,222,118,35,83,1,16,6,10,86,79,0,4,3,1
E33031845,302,172,51,121,9,26,15,11,94,90,0,3,1,1
E33031846,434,232,55,177,5,16,6,10,181,172,1,8,0,0
E33031847,251,139,43,96,2,26,11,15,84,70,0,13,1,0
E33031848,419,250,57,193,9,24,11,13,134,124,2,5,3,2
E33031849,1264,784,274,510,31,169,78,91,271,258,1,11,1,9
E33031850,333,115,27,88,1,67,34,33,148,144,0,4,0,2
E33031851,778,518,160,358,11,61,39,22,183,170,2,9,2,5
E33031852,793,517,140,377,4,45,24,21,224,214,2,4,4,3
E33031853,365,182,55,127,8,9,3,6,161,153,1,6,1,5
E33031854,226,124,41,83,1,8,3,5,89,87,1,1,0,4
E33031855,210,109,39,70,0,44,18,26,57,55,0,2,0,0
E33031856,277,148,51,97,6,64,36,28,54,53,0,0,1,5
E33031857,359,229,95,134,3,38,18,20,88,83,1,4,0,1
E33031858,365,260,76,184,3,38,25,13,59,55,0,1,3,5
E33031859,244,107,17,90,7,49,25,24,79,71,0,6,2,2
E33031860,226,126,38,88,1,43,21,22,53,52,0,1,0,3
E33031861,1164,593,136,457,11,248,106,142,303,289,2,12,0,9
E33031862,414,205,44,161,13,110,41,69,85,79,0,5,1,1
E33031863,370,234,68,166,6,60,21,39,69,65,0,4,0,1
E33031864,398,243,60,183,7,77,41,36,70,64,0,4,2,1
E33031865,262,146,32,114,3,27,16,11,84,77,1,6,0,2
E33031866,910,566,145,421,16,138,78,60,186,175,0,10,1,4
E33031867,381,202,50,152,0,89,53,36,88,75,0,12,1,2
E33031868,327,141,38,103,8,82,53,29,95,88,0,5,2,1
E33031869,574,279,68,211,8,114,64,50,167,154,0,12,1,6
E33031870,390,171,33,138,8,83,46,37,126,119,0,5,2,2
E33031871,554,253,73,180,8,149,86,63,141,131,0,7,3,3
E33031872,765,374,72,302,20,162,76,86,205,195,3,5,2,4
E33031873,682,408,104,304,10,91,44,47,171,164,0,7,0,2
E33031874,1141,620,154,466,22,187,94,93,309,299,1,6,3,3
E33031875,337,239,41,198,10,26,11,15,60,57,0,2,1,2
E33031876,599,447,144,303,14,81,42,39,54,52,0,2,0,3
E33031877,386,243,58,185,9,71,41,30,61,60,0,0,1,2
E33031878,874,397,88,309,9,101,55,46,365,356,0,8,1,2
E33031879,349,202,46,156,2,41,27,14,100,97,0,3,0,4
E33031880,1020,406,100,306,10,149,79,70,451,438,1,10,2,4
E33031881,231,79,27,52,5,72,32,40,68,68,0,0,0,7
E33031882,236,154,37,117,1,40,20,20,39,29,0,10,0,2
E33031883,596,329,87,242,7,94,63,31,162,158,0,2,2,4
E33031884,458,335,88,247,10,49,35,14,61,59,0,2,0,3
E33031885,300,198,53,145,5,62,53,9,34,33,1,0,0,1
E33031886,218,145,45,100,2,33,30,3,36,33,0,3,0,2
E33031887,231,144,38,106,7,51,33,18,29,27,0,1,1,0
E33031888,493,277,78,199,8,113,73,40,89,83,1,4,1,6
E33031889,598,369,107,262,6,122,89,33,99,93,0,6,0,2
E33031890,1208,861,265,596,21,150,97,53,170,158,1,9,2,6
E33031891,253,170,48,122,3,44,25,19,35,34,1,0,0,1
E33031892,1782,1218,320,898,25,217,126,91,310,286,0,21,3,12
E33031893,258,157,46,111,1,32,26,6,64,59,0,5,0,4
E33031894,1030,808,255,553,7,99,61,38,111,105,2,4,0,5
E33031895,311,170,41,129,5,48,27,21,84,73,5,4,2,4
E33031896,826,604,188,416,12,107,63,44,102,99,0,3,0,1
E33031897,426,219,46,173,8,47,21,26,146,139,0,6,1,6
E33031898,1024,639,174,465,10,53,23,30,319,309,1,8,1,3
E33031899,1394,797,153,644,23,88,36,52,481,452,0,26,3,5
E33031900,3252,2009,415,1594,23,123,61,62,1078,1050,3,20,5,19
E33031901,441,154,40,114,10,49,23,26,223,212,1,9,1,5
E33031902,3019,2006,448,1558,30,156,75,81,813,770,4,29,10,14
E33031903,1181,571,150,421,41,248,106,142,314,297,7,8,2,7
E33031904,1396,820,169,651,17,61,29,32,489,479,1,6,3,9
E33031905,2396,1201,313,888,63,465,186,279,648,616,3,16,13,19
E33031906,2224,1420,354,1066,39,261,128,133,498,480,1,12,5,6
E33031907,313,191,65,126,2,25,12,13,90,83,0,6,1,5
E33031908,412,203,42,161,9,30,16,14,168,159,2,6,1,2
E33031909,406,181,60,121,5,61,35,26,154,146,0,8,0,5
E33031910,243,139,53,86,0,13,3,10,87,84,0,1,2,4
E33031911,283,201,60,141,5,10,8,2,64,57,0,2,5,3
E33031912,299,184,56,128,2,12,7,5,101,98,0,2,1,0
E33031913,255,161,54,107,1,23,10,13,66,63,0,1,2,4
E33031914,229,123,41,82,5,12,5,7,89,85,0,2,2,0
E33031915,221,118,36,82,4,18,6,12,79,78,0,1,0,2
E33031916,211,88,26,62,2,13,7,6,107,102,1,4,0,1
E33031917,484,332,85,247,4,17,9,8,129,126,0,3,0,2
E33031918,414,259,75,184,4,23,11,12,126,124,0,0,2,2
E33031919,428,241,80,161,10,21,13,8,148,142,2,2,2,8
E33031920,632,422,123,299,4,24,9,15,180,168,0,12,0,2
E33031921,203,101,30,71,7,21,13,8,69,68,0,1,0,5
E33031922,195,95,23,72,3,24,15,9,71,70,0,1,0,2
E33031923,411,268,60,208,8,23,17,6,109,106,0,3,0,3
E33031924,239,167,45,122,2,16,10,6,53,47,0,3,3,1
E33031925,254,151,44,107,1,18,10,8,83,82,0,1,0,1
E33031926,209,100,34,66,3,13,5,8,92,86,0,3,3,1
E33031927,271,131,35,96,3,39,21,18,96,91,1,2,2,2
E33031928,193,84,22,62,0,14,8,6,93,91,0,1,1,2
E33031929,310,152,43,109,2,34,20,14,115,106,2,7,0,7
E33031930,208,77,15,62,3,26,13,13,99,94,0,5,0,3
E33031931,737,396,95,301,2,62,26,36,272,262,2,6,2,5
E33031932,393,234,75,159,5,36,24,12,115,109,1,5,0,3
E33031933,743,334,103,231,4,76,37,39,322,308,3,10,1,7
E33031934,1044,473,138,335,15,100,49,51,448,424,3,18,3,8
E33031935,660,339,90,249,7,50,27,23,263,252,1,10,0,1
E33031936,3544,1512,444,1068,53,737,397,340,1211,1159,4,38,10,31
E33031937,203,76,18,58,3,15,8,7,109,102,0,6,1,0
E33031938,742,421,109,312,8,38,20,18,272,257,2,13,0,3
E33031939,960,612,147,465,8,32,18,14,302,288,0,14,0,6
E33031940,302,149,42,107,5,35,16,19,110,103,0,5,2,3
E33031941,661,266,56,210,12,53,27,26,326,316,1,7,2,4
E33031942,483,237,63,174,6,45,21,24,190,179,0,10,1,5
E33031943,313,198,35,163,6,35,24,11,74,68,1,3,2,0
E33031944,263,122,25,97,6,42,21,21,91,89,1,1,0,2
E33031945,1423,565,136,429,22,287,144,143,540,498,3,31,8,9
E33031946,213,130,32,98,3,10,6,4,70,66,0,3,1,0
E33031947,261,145,39,106,3,18,5,13,91,88,0,1,2,4
E33031948,709,358,59,299,10,40,21,19,299,276,0,21,2,2
E33031949,284,135,43,92,2,17,12,5,126,122,0,4,0,4
E33031950,574,265,70,195,12,129,78,51,166,157,0,9,0,2
E33031951,509,217,49,168,4,105,45,60,180,174,0,5,1,3
E33031952,500,255,61,194,6,31,18,13,203,195,0,8,0,5
E33031953,372,193,49,144,4,22,11,11,149,146,1,2,0,4
E33031954,352,189,60,129,7,24,15,9,131,122,3,5,1,1
E33031955,254,113,27,86,3,26,14,12,111,109,2,0,0,1
E33031956,417,157,45,112,6,64,42,22,185,176,1,3,5,5
E33031957,402,160,51,109,5,62,35,27,173,164,1,6,2,2
E33031958,235,101,21,80,5,36,21,15,91,87,0,3,1,2
E33031959,1113,582,103,479,19,45,22,23,461,443,1,14,3,6
E33031960,1133,664,132,532,15,80,38,42,368,355,1,11,1,6
E33031961,216,127,39,88,4,10,3,7,73,69,1,3,0,2
E33031962,885,366,111,255,13,86,40,46,415,396,0,17,2,5
E33031963,225,106,22,84,3,17,11,6,96,90,1,5,0,3
E33031964,215,123,29,94,8,26,17,9,54,49,0,4,1,4
E33031965,198,81,19,62,1,15,8,7,100,97,0,2,1,1
E33031966,508,245,63,182,4,16,8,8,240,228,2,9,1,3
E33031967,276,148,37,111,1,18,9,9,109,100,0,8,1,0
E33031968,202,79,16,63,3,22,12,10,96,91,0,4,1,2
E33031969,970,418,90,328,10,38,13,25,502,489,2,10,1,2
E33031970,331,172,41,131,2,16,6,10,138,128,1,8,1,3
E33031971,227,117,30,87,0,16,11,5,92,89,2,0,1,2
E33031972,204,105,32,73,3,15,11,4,81,74,0,6,1,0
E33031973,199,104,28,76,4,12,7,5,79,77,1,1,0,0
E33031974,624,343,63,280,16,33,20,13,228,214,0,11,3,4
E33031975,753,435,89,346,8,37,22,15,266,252,0,13,1,7
E33031976,225,126,26,100,3,6,2,4,88,82,0,6,0,2
E33031977,1807,958,245,713,16,281,169,112,529,500,4,17,8,23
E33031978,218,119,33,86,2,13,7,6,81,76,1,4,0,3
E33031979,1741,906,200,706,23,136,75,61,665,630,4,29,2,11
E33031980,335,191,40,151,5,34,12,22,102,96,2,1,3,3
E33031981,1209,658,168,490,13,99,51,48,428,405,2,20,1,11
E33031982,739,421,92,329,12,38,22,16,264,251,0,13,0,4
E33031983,210,115,23,92,2,17,8,9,75,73,0,1,1,1
E33031984,412,298,53,245,0,35,20,15,77,74,0,3,0,2
E33031985,802,355,78,277,12,68,42,26,364,341,4,17,2,3
E33031986,358,170,35,135,2,27,12,15,158,150,2,4,2,1
E33031987,456,266,80,186,6,50,25,25,132,123,2,7,0,2
E33031988,260,118,24,94,4,39,23,16,96,94,0,1,1,3
E33031989,225,107,31,76,5,36,25,11,74,73,0,1,0,3
E33031990,256,146,43,103,3,30,12,18,71,70,0,1,0,6
E33031991,309,169,46,123,6,16,11,5,115,110,0,5,0,3
E33031992,283,162,38,124,4,27,11,16,88,81,1,5,1,2
E33031993,233,100,18,82,2,16,9,7,111,108,1,1,1,4
E33031994,232,129,26,103,6,21,7,14,74,70,0,3,1,2
E33031995,318,185,42,143,3,25,17,8,104,102,0,2,0,1
E33031996,552,286,74,212,11,31,9,22,223,215,0,6,2,1
E33031997,203,81,24,57,3,34,20,14,84,81,0,1,2,1
E33031998,340,164,48,116,5,21,12,9,147,141,2,4,0,3
E33031999,433,186,41,145,9,40,20,20,196,182,0,11,3,2
E33032000,197,106,35,71,2,25,3,22,64,60,1,3,0,0
E33032001,251,112,26,86,3,33,18,15,100,96,1,2,1,3
E33032002,211,113,41,72,0,19,9,10,79,75,1,1,2,0
E33032003,618,361,76,285,9,27,14,13,219,208,0,10,1,2
E33032004,415,241,53,188,9,24,13,11,138,129,0,7,2,3
E33032005,615,320,74,246,9,35,19,16,249,239,3,6,1,2
E33032006,205,97,35,62,3,30,14,16,73,70,0,3,0,2
E33032007,359,218,49,169,6,15,11,4,117,114,0,3,0,3
E33032008,770,332,72,260,14,39,22,17,377,370,0,7,0,8
E33032009,306,134,33,101,7,47,21,26,116,114,0,2,0,2
E33032010,626,322,98,224,10,79,50,29,213,206,1,5,1,2
E33032011,719,401,92,309,11,43,23,20,259,247,0,11,1,5
E33032012,185,94,26,68,3,10,6,4,75,70,0,5,0,3
E33032013,286,139,24,115,3,18,9,9,124,120,0,2,2,2
E33032014,204,77,26,51,2,29,17,12,89,85,0,2,2,7
E33032015,332,169,37,132,3,20,9,11,137,131,1,5,0,3
E33032016,375,186,51,135,8,21,11,10,158,152,0,4,2,2
E33032017,274,145,37,108,4,30,16,14,95,93,0,2,0,0
E33032018,326,192,48,144,2,10,2,8,112,100,4,7,1,10
E33032019,258,105,29,76,2,16,13,3,130,122,0,7,1,5
E33032020,585,312,69,243,9,34,11,23,227,221,1,5,0,3
E33032021,527,341,82,259,7,22,10,12,156,147,0,8,1,1
E33032022,243,93,28,65,5,28,9,19,114,112,1,1,0,3
E33032023,236,135,40,95,1,22,11,11,75,74,0,1,0,3
E33032024,219,89,34,55,4,24,13,11,99,95,3,1,0,3
E33032025,237,114,40,74,5,8,3,5,107,97,1,8,1,3
E33032026,275,167,51,116,2,19,7,12,87,83,0,3,1,0
E33032027,224,119,35,84,5,17,5,12,81,76,0,5,0,2
E33032028,651,412,107,305,10,28,8,20,198,190,1,5,2,3
E33032029,422,210,50,160,3,37,13,24,167,158,0,6,3,5
E33032030,724,376,106,270,7,53,32,21,283,266,0,15,2,5
E33032031,197,105,26,79,6,18,11,7,66,65,0,0,1,2
E33032032,686,438,138,300,10,31,15,16,204,197,1,6,0,3
E33032033,355,153,35,118,1,27,14,13,168,157,0,7,4,6
E33032034,480,268,88,180,8,18,5,13,182,176,0,3,3,4
E33032035,224,109,46,63,5,12,5,7,95,95,0,0,0,3
E33032036,204,88,23,65,2,28,11,17,84,73,9,2,0,2
E33032037,266,154,45,109,6,24,11,13,82,79,0,1,2,0
E33032038,357,106,23,83,8,41,21,20,197,194,0,3,0,5
E33032039,404,177,46,131,9,83,47,36,132,126,0,4,2,3
E33032040,242,121,25,96,5,16,8,8,99,95,1,2,1,1
E33032041,305,134,31,103,3,22,9,13,140,132,0,5,3,6
E33032042,464,261,68,193,5,32,13,19,162,151,0,9,2,4
E33032043,244,132,36,96,1,15,7,8,91,87,1,3,0,5
E33032044,387,236,73,163,2,24,11,13,122,116,0,4,2,3
E33032045,879,440,115,325,7,81,42,39,343,326,2,5,10,8
E33032046,1197,626,171,455,12,49,18,31,503,478,0,24,1,7
E33032047,281,136,39,97,7,31,14,17,107,101,0,6,0,0
E33032048,240,127,40,87,1,17,11,6,93,88,0,4,1,2
E33032049,319,192,64,128,4,11,8,3,112,102,3,5,2,0
E33032050,327,186,41,145,6,19,5,14,113,109,0,4,0,3
E33032051,197,109,28,81,1,16,12,4,67,62,0,4,1,4
E33032052,326,150,45,105,6,22,10,12,146,138,0,4,4,2
E33032053,948,545,163,382,9,52,23,29,336,322,1,8,5,6
E33032054,246,131,37,94,2,19,8,11,88,85,0,3,0,6
E33032055,263,181,62,119,1,9,4,5,70,62,0,7,1,2
E33032056,473,296,59,237,12,36,9,27,126,117,1,6,2,3
E33032057,347,189,50,139,3,12,3,9,138,137,0,0,1,5
E33032058,621,303,71,232,6,56,31,25,248,229,6,10,3,8
E33032059,623,237,66,171,10,51,32,19,321,302,5,12,2,4
E33032060,495,255,83,172,6,50,17,33,182,175,0,5,2,2
E33032061,241,111,28,83,2,37,19,18,84,72,0,1,11,7
E33032062,404,156,62,94,4,50,16,34,189,92,57,2,38,5
E33032063,458,237,65,172,8,57,30,27,154,138,10,5,1,2
E33032064,793,362,92,270,14,51,23,28,354,339,0,14,1,12
E33032065,235,136,46,90,2,10,3,7,80,72,2,5,1,7
E33032066,209,83,29,54,6,19,6,13,93,88,1,3,1,8
E33032067,1651,970,331,639,25,104,54,50,529,497,4,22,6,23
E33032068,3899,2530,631,1899,52,237,118,119,1058,1001,5,44,8,22
E33032069,275,147,40,107,6,17,11,6,105,100,0,4,1,0
E33032070,207,85,28,57,3,24,11,13,95,94,0,1,0,0
E33032071,294,115,36,79,3,28,14,14,146,142,0,3,1,2
E33032072,464,195,54,141,2,39,22,17,227,211,3,11,2,1
E33032073,501,219,54,165,9,47,26,21,223,198,5,19,1,3
E33032074,211,83,29,54,4,21,12,9,101,95,0,6,0,2
E33032075,380,189,40,149,7,53,30,23,129,122,0,3,4,2
E33032076,309,180,41,139,3,34,19,15,89,85,0,1,3,3
E33032077,293,144,54,90,6,39,24,15,99,95,2,2,0,5
E33032078,213,118,40,78,2,8,4,4,84,75,3,3,3,1
E33032079,529,184,46,138,10,66,29,37,259,247,1,9,2,10
E33032080,960,378,99,279,9,131,76,55,435,425,2,6,2,7
E33032081,374,149,52,97,3,49,29,20,168,160,0,6,2,5
E33032082,194,84,41,43,5,30,5,25,69,65,0,2,2,6
E33032083,1599,583,132,451,21,364,181,183,622,588,0,27,7,9
E33032084,214,99,31,68,3,18,11,7,88,83,0,5,0,6
E33032085,202,91,22,69,4,20,5,15,76,71,1,4,0,11
E33032086,225,126,36,90,4,15,9,6,79,73,0,6,0,1
E33032087,202,130,48,82,3,19,12,7,49,45,0,4,0,1
E33032088,459,287,96,191,11,38,19,19,118,112,1,4,1,5
E33032089,1085,644,176,468,13,48,17,31,372,350,2,19,1,8
E33032090,214,131,43,88,4,20,7,13,52,49,0,2,1,7
E33032091,127,68,25,43,2,14,9,5,38,37,1,0,0,5
E33032092,1860,1288,312,976,37,141,82,59,384,372,2,9,1,10
E33032093,482,345,79,266,10,33,12,21,89,86,0,3,0,5
E33032094,1868,1184,319,865,19,111,60,51,542,511,2,26,3,12
E33032095,770,467,120,347,4,50,25,25,245,234,4,7,0,4
E33032096,367,217,80,137,5,32,15,17,111,104,1,5,1,2
E33032097,294,179,56,123,3,58,26,32,54,53,0,1,0,0
E33032098,601,255,77,178,9,95,46,49,233,223,1,8,1,9
E33032099,3311,2368,602,1766,45,235,116,119,648,618,9,17,4,15
E33032100,407,244,55,189,7,31,10,21,122,118,2,2,0,3
E33032101,1740,1179,278,901,27,119,61,58,410,393,4,8,5,5
E33032102,307,170,50,120,3,13,5,8,120,110,0,7,3,1
E33032103,499,351,81,270,8,28,15,13,110,99,1,6,4,2
E33032104,7526,6228,1027,5201,105,436,202,234,720,645,29,37,9,37
E33032105,228,111,26,85,2,16,11,5,98,97,0,1,0,1
E33032106,243,176,43,133,1,12,6,6,51,50,0,1,0,3
E33032107,838,491,123,368,7,55,26,29,277,257,3,16,1,8
E33032108,561,210,72,138,9,79,31,48,258,232,1,24,1,5
E33032109,3961,1929,594,1335,75,323,141,182,1613,1518,5,73,17,21
E33032110,306,124,47,77,6,25,14,11,141,135,1,3,2,10
E33032111,681,313,77,236,21,169,85,84,168,159,2,5,2,10
E33032112,1018,389,108,281,18,248,124,124,349,336,1,9,3,14
E33032113,404,144,37,107,1,92,41,51,147,142,0,2,3,20
E33032114,246,130,36,94,2,7,0,7,106,104,0,2,0,1
E33032115,370,195,35,160,4,31,10,21,139,126,3,10,0,1
E33032116,272,130,35,95,5,27,15,12,109,107,0,2,0,1
E33032117,199,109,34,75,2,20,8,12,67,64,0,3,0,1
E33032118,287,152,39,113,3,18,9,9,111,104,0,5,2,3
E33032119,666,374,86,288,7,59,36,23,222,220,0,2,0,4
E33032120,436,220,41,179,3,58,37,21,155,153,0,2,0,0
E33032121,293,154,43,111,8,26,17,9,104,100,0,4,0,1
E33032122,249,117,35,82,5,44,23,21,82,79,0,2,1,1
E33032123,357,187,50,137,3,52,23,29,115,106,0,8,1,0
E33032124,241,129,32,97,2,23,11,12,86,84,0,1,1,1
E33032125,220,98,27,71,2,33,17,16,86,84,1,1,0,1
E33032126,298,171,49,122,5,33,18,15,88,81,0,7,0,1
E33032127,497,253,67,186,4,46,20,26,192,185,0,6,1,2
E33032128,487,276,81,195,4,35,21,14,171,163,1,6,1,1
E33032129,527,360,81,279,4,33,16,17,127,122,1,4,0,3
E33032130,448,242,58,184,7,26,13,13,169,159,1,8,1,4
E33032131,629,241,60,181,12,128,78,50,246,230,1,12,3,2
E33032132,568,260,73,187,12,119,67,52,177,171,0,4,2,0
E33032133,452,182,60,122,11,99,48,51,153,150,0,2,1,7
E33032134,273,125,28,97,5,11,6,5,128,122,0,6,0,4
E33032135,852,391,113,278,15,49,24,25,390,373,2,12,3,7
E33032136,303,141,44,97,7,30,11,19,125,121,0,4,0,0
E33032137,450,221,45,176,11,36,21,15,179,172,0,5,2,3
E33032138,521,237,64,173,11,60,33,27,212,196,1,12,3,1
E33032139,465,247,42,205,3,25,19,6,190,183,1,5,1,0
E33032140,749,431,95,336,11,53,24,29,251,245,0,6,0,3
E33032141,409,250,63,187,4,38,15,23,115,108,0,6,1,2
E33032142,1985,1189,250,939,15,66,31,35,697,669,1,18,9,18
E33032143,1551,680,148,532,19,77,33,44,763,739,3,19,2,12
E33032144,485,276,77,199,5,50,28,22,152,145,2,4,1,2
E33032145,465,164,48,116,13,98,54,44,185,174,1,10,0,5
E33032146,656,428,84,344,8,49,29,20,167,156,0,8,3,4
E33032147,431,265,61,204,3,41,23,18,120,114,1,2,3,2
E33032148,226,110,29,81,0,22,15,7,89,84,0,4,1,5
E33032149,378,205,58,147,2,29,20,9,139,135,1,1,2,3
E33032150,225,85,23,62,7,19,8,11,113,113,0,0,0,1
E33032151,414,210,61,149,9,80,45,35,111,109,0,2,0,4
E33032152,396,176,46,130,7,38,18,20,170,164,1,4,1,5
E33032153,199,87,23,64,0,24,17,7,87,84,0,3,0,1
E33032154,394,177,40,137,4,36,18,18,171,162,1,8,0,6
E33032155,315,128,34,94,6,18,13,5,159,154,0,5,0,4
E33032156,422,179,39,140,7,121,68,53,112,105,1,6,0,3
E33032157,2488,1612,528,1084,35,132,76,56,692,669,2,18,3,17
E33032158,265,175,58,117,2,37,25,12,45,40,0,5,0,6
E33032159,335,188,42,146,3,42,27,15,99,97,0,2,0,3
E33032160,221,104,34,70,19,42,19,23,53,49,1,3,0,3
E33032161,417,230,57,173,3,23,16,7,157,153,2,1,1,4
E33032162,124,94,37,57,2,10,8,2,16,15,0,0,1,2
E33032163,310,148,35,113,3,70,40,30,84,72,1,9,2,5
E33032164,373,204,63,141,6,75,39,36,86,74,1,6,5,2
E33032165,930,535,154,381,6,252,131,121,130,121,4,2,3,7
E33032166,1484,1006,269,737,39,276,144,132,157,149,1,6,1,6
E33032167,153,66,17,49,1,41,23,18,43,42,0,1,0,2
E33032168,974,655,115,540,19,146,54,92,152,144,1,7,0,2
E33032169,613,403,87,316,15,108,54,54,84,76,2,6,0,3
E33032170,209,133,29,104,4,47,29,18,24,21,0,3,0,1
E33032171,334,139,46,93,2,116,63,53,73,68,1,3,1,4
E33032172,298,129,33,96,1,109,75,34,56,55,0,1,0,3
E33032173,260,159,74,85,3,34,17,17,57,51,0,4,2,7
E33032174,371,212,58,154,1,59,33,26,96,93,0,2,1,3
E33032175,1556,1032,228,804,17,68,44,24,431,411,1,19,0,8
E33032176,1173,699,182,517,15,74,28,46,379,357,1,20,1,6
E33032177,3448,2174,577,1597,41,217,125,92,997,942,5,46,4,19
E33032178,3735,2132,549,1583,35,154,84,70,1398,1346,3,40,9,16
E33032179,600,367,68,299,6,47,33,14,175,169,0,4,2,5
E33032180,711,475,126,349,4,51,19,32,178,167,0,7,4,3
E33032181,1327,717,226,491,36,135,67,68,423,405,0,14,4,16
E33032182,346,208,55,153,3,91,51,40,43,40,0,3,0,1
E33032183,462,242,63,179,5,121,109,12,89,86,0,3,0,5
E33032184,322,204,63,141,1,56,42,14,56,51,1,4,0,5
E33032185,264,146,44,102,2,45,33,12,70,68,0,1,1,1
E33032186,377,278,79,199,3,30,26,4,62,56,0,4,2,4
E33032187,477,311,85,226,5,60,39,21,97,91,1,4,1,4
E33032188,398,280,87,193,3,29,21,8,80,75,0,5,0,6
E33032189,422,280,52,228,4,51,36,15,81,72,3,5,1,6
E33032190,279,162,47,115,1,52,47,5,64,59,0,1,4,0
E33032191,466,316,71,245,3,49,27,22,94,86,2,6,0,4
E33032192,467,349,77,272,3,49,39,10,63,57,0,5,1,3
E33032193,1034,770,232,538,10,130,90,40,119,112,1,5,1,5
E33032194,484,297,71,226,7,83,69,14,90,84,0,6,0,7
E33032195,524,331,82,249,0,78,63,15,106,98,0,2,6,9
E33032196,530,351,59,292,3,86,70,16,89,83,0,6,0,1
E33032197,467,232,49,183,2,149,135,14,84,78,0,5,1,0
E33032198,346,224,70,154,9,76,64,12,36,34,0,1,1,1
E33032199,346,199,61,138,4,77,63,14,59,49,1,4,5,7
E33032200,588,359,90,269,3,169,138,31,56,53,1,2,0,1
E33032201,448,283,71,212,3,94,76,18,64,59,0,3,2,4
E33032202,499,309,69,240,7,84,74,10,97,93,1,3,0,2
E33032203,309,184,39,145,3,66,57,9,50,44,3,2,1,6
E33032204,375,241,47,194,4,71,54,17,59,55,0,3,1,0
E33032205,384,235,41,194,6,79,69,10,60,54,1,3,2,4
E33032206,475,270,49,221,9,96,67,29,99,96,2,1,0,1
E33032207,692,337,77,260,21,132,111,21,196,192,0,2,2,6
E33032208,444,290,55,235,3,66,59,7,83,73,3,7,0,2
E33032209,486,320,60,260,3,83,71,12,76,72,0,3,1,4
E33032210,573,377,93,284,9,98,91,7,88,85,0,2,1,1
E33032211,319,204,46,158,3,55,51,4,57,53,1,2,1,0
E33032212,301,185,47,138,3,53,34,19,57,54,2,1,0,3
E33032213,501,317,83,234,5,81,55,26,96,86,1,9,0,2
E33032214,308,249,39,210,1,16,10,6,40,35,1,2,2,2
E33032215,570,428,119,309,3,75,51,24,62,60,0,2,0,2
E33032216,756,543,129,414,6,75,64,11,127,109,1,16,1,5
E33032217,760,564,138,426,0,50,39,11,140,133,0,5,2,6
E33032218,383,242,64,178,3,46,35,11,90,89,1,0,0,2
E33032219,325,189,42,147,7,64,53,11,63,58,2,2,1,2
E33032220,422,256,35,221,2,82,69,13,80,73,0,7,0,2
E33032221,539,331,59,272,5,113,96,17,88,79,2,7,0,2
E33032222,334,170,38,132,1,102,88,14,61,61,0,0,0,0
E33032223,456,247,55,192,3,97,81,16,103,96,2,2,3,6
E33032224,373,216,42,174,2,85,74,11,69,65,2,1,1,1
E33032225,305,189,39,150,1,69,59,10,43,40,0,2,1,3
E33032226,358,205,41,164,1,87,65,22,62,60,0,1,1,3
E33032227,363,193,33,160,3,85,70,15,82,81,1,0,0,0
E33032228,590,306,68,238,9,148,117,31,124,115,0,7,2,3
E33032229,375,171,47,124,17,116,94,22,71,65,3,3,0,0
E33032230,717,287,60,227,7,150,117,33,271,247,2,18,4,2
E33032231,930,466,123,343,19,187,126,61,255,234,4,16,1,3
E33032232,283,170,50,120,1,31,26,5,81,77,0,4,0,0
E33032233,388,209,51,158,4,44,29,15,130,124,0,6,0,1
E33032234,407,186,39,147,2,47,32,15,165,150,1,10,4,7
E33032235,302,167,35,132,5,33,18,15,97,91,1,4,1,0
E33032236,321,196,53,143,4,37,27,10,80,76,0,4,0,4
E33032237,470,287,51,236,5,101,87,14,77,70,0,7,0,0
E33032238,735,386,65,321,10,156,124,32,178,164,0,9,5,5
E33032239,427,240,64,176,2,87,63,24,94,91,1,2,0,4
E33032240,722,425,72,353,11,129,118,11,150,145,0,5,0,7
E33032241,436,282,82,200,3,79,62,17,65,60,0,5,0,7
E33032242,429,233,58,175,4,93,68,25,97,90,2,5,0,2
E33032243,313,153,35,118,5,89,77,12,66,64,0,1,1,0
E33032244,688,410,97,313,9,130,99,31,136,128,0,7,1,3
E33032245,816,506,104,402,15,137,97,40,153,146,0,7,0,5
E33032246,461,234,59,175,6,93,79,14,122,109,0,12,1,6
E33032247,635,439,104,335,1,75,57,18,114,107,3,4,0,6
E33032248,345,203,44,159,0,32,17,15,110,102,0,6,2,0
E33032249,296,159,28,131,5,55,38,17,71,65,0,5,1,6
E33032250,468,263,44,219,7,89,65,24,107,99,3,4,1,2
E33032251,376,159,27,132,3,143,134,9,68,60,1,2,5,3
E33032252,521,251,84,167,20,128,110,18,120,107,0,7,6,2
E33032253,559,230,46,184,17,196,172,24,109,95,0,6,8,7
E33032254,959,526,123,403,12,161,125,36,258,242,0,11,5,2
E33032255,250,131,45,86,1,73,56,17,44,41,0,3,0,1
E33032256,297,146,27,119,2,89,69,20,55,53,0,1,1,5
E33032257,300,190,49,141,1,71,62,9,37,36,0,0,1,1
E33032258,286,151,31,120,5,64,53,11,65,62,0,2,1,1
E33032259,531,305,100,205,6,91,56,35,128,120,0,7,1,1
E33032260,475,266,63,203,5,137,100,37,66,54,2,9,1,1
E33032261,286,198,73,125,3,29,18,11,48,47,0,0,1,8
E33032262,545,400,129,271,8,45,22,23,86,80,1,5,0,6
E33032263,267,215,81,134,3,11,6,5,33,29,0,3,1,5
E33032264,354,273,88,185,2,21,11,10,53,48,2,3,0,5
E33032265,459,329,96,233,6,52,28,24,69,67,0,2,0,3
E33032266,311,221,89,132,4,23,12,11,51,45,0,2,4,12
E33032267,288,219,83,136,2,18,12,6,47,41,5,1,0,2
E33032268,494,355,97,258,3,34,23,11,92,85,3,4,0,10
E33032269,429,281,96,185,6,52,23,29,86,84,1,1,0,4
E33032270,362,261,95,166,2,13,6,7,78,78,0,0,0,8
E33032271,298,218,72,146,1,16,7,9,59,56,0,2,1,4
E33032272,471,287,84,203,3,72,40,32,108,102,0,6,0,1
E33032273,356,260,61,199,1,42,36,6,50,49,0,1,0,3
E33032274,381,226,82,144,3,63,37,26,85,82,0,3,0,4
E33032275,451,359,132,227,9,18,8,10,65,63,0,2,0,0
E33032276,370,273,89,184,0,17,8,9,62,57,0,3,2,18
E33032277,279,195,51,144,2,21,15,6,58,52,0,0,6,3
E33032278,415,296,75,221,8,58,39,19,52,50,0,2,0,1
E33032279,404,200,61,139,15,129,111,18,54,50,1,2,1,6
E33032280,466,315,103,212,2,69,33,36,73,68,1,3,1,7
E33032281,356,219,69,150,7,51,37,14,74,60,4,7,3,5
E33032282,654,471,135,336,10,64,40,24,105,101,1,2,1,4
E33032283,434,289,98,191,2,35,20,15,104,94,1,6,3,4
E33032284,375,280,90,190,3,33,14,19,58,56,0,2,0,1
E33032285,410,245,74,171,1,48,31,17,112,110,0,2,0,4
E33032286,390,272,102,170,7,41,19,22,70,63,2,5,0,0
E33032287,285,239,77,162,3,13,6,7,27,25,2,0,0,3
E33032288,680,442,146,296,10,81,51,30,136,130,0,4,2,11
E33032289,528,370,121,249,4,42,30,12,104,101,0,2,1,8
E33032290,370,249,74,175,1,27,14,13,92,89,0,3,0,1
E33032291,227,152,49,103,4,16,11,5,48,43,1,4,0,7
E33032292,275,185,53,132,5,44,32,12,38,37,0,1,0,3
E33032293,316,201,77,124,9,26,14,12,79,77,0,2,0,1
E33032294,362,244,90,154,1,50,25,25,60,58,0,1,1,7
E33032295,231,145,54,91,0,32,17,15,50,50,0,0,0,4
E33032296,751,512,164,348,14,80,50,30,131,123,5,1,2,14
E33032297,329,260,119,141,2,16,10,6,44,44,0,0,0,7
E33032298,371,221,77,144,2,43,19,24,99,86,7,2,4,6
E33032299,311,234,87,147,3,10,3,7,61,58,0,0,3,3
E33032300,277,202,95,107,2,16,10,6,53,50,0,2,1,4
E33032301,265,193,82,111,0,26,12,14,45,42,0,1,2,1
E33032302,428,296,108,188,4,25,15,10,99,92,5,1,1,4
E33032303,341,243,77,166,4,13,9,4,74,71,0,3,0,7
E33032304,697,514,185,329,3,26,13,13,144,136,3,4,1,10
E33032305,394,274,92,182,8,20,12,8,86,85,0,1,0,6
E33032306,473,301,88,213,8,85,32,53,75,71,0,4,0,4
E33032307,434,275,86,189,4,53,31,22,100,96,0,4,0,2
E33032308,528,286,80,206,10,84,50,34,144,139,1,3,1,4
E33032309,413,332,116,216,4,19,12,7,54,49,0,5,0,4
E33032310,494,253,100,153,8,59,34,25,164,160,0,4,0,10
E33032311,357,228,66,162,2,38,24,14,84,78,2,4,0,5
E33032312,666,412,143,269,7,88,48,40,157,148,1,7,1,2
E33032313,523,399,118,281,0,28,23,5,94,86,0,5,3,2
E33032314,261,132,46,86,0,48,22,26,79,77,0,0,2,2
E33032315,319,253,114,139,1,8,5,3,52,51,0,1,0,5
E33032316,325,200,52,148,5,30,24,6,86,80,1,4,1,4
E33032317,281,158,62,96,3,26,9,17,83,77,0,4,2,11
E33032318,396,239,94,145,3,38,18,20,111,104,3,3,1,5
E33032319,686,417,131,286,5,50,30,20,212,194,5,6,7,2
E33032320,432,281,82,199,1,26,19,7,117,113,1,1,2,7
E33032321,316,165,47,118,1,37,13,24,111,106,0,3,2,2
E33032322,329,221,72,149,0,24,14,10,79,74,0,5,0,5
E33032323,315,143,36,107,15,57,24,33,98,94,0,4,0,2
E33032324,633,406,109,297,2,68,37,31,139,129,2,7,1,18
E33032325,464,230,83,147,8,110,74,36,110,104,0,6,0,6
E33032326,409,318,142,176,2,17,11,6,63,62,0,1,0,9
E33032327,575,464,138,326,1,14,11,3,90,87,0,3,0,6
E33032328,561,364,119,245,6,77,38,39,108,104,1,3,0,6
E33032329,336,162,55,107,4,48,22,26,118,116,0,2,0,4
E33032330,436,212,56,156,8,77,38,39,134,132,0,1,1,5
E33032331,290,222,81,141,3,20,7,13,44,44,0,0,0,1
E33032332,313,204,65,139,0,32,17,15,76,75,0,1,0,1
E33032333,323,166,49,117,0,23,12,11,113,100,1,10,2,21
E33032334,442,283,87,196,3,33,15,18,120,114,1,4,1,3
E33032335,293,181,47,134,4,28,18,10,75,67,0,8,0,5
E33032336,364,218,46,172,2,45,30,15,93,91,0,2,0,6
E33032337,432,332,100,232,5,17,14,3,72,66,2,3,1,6
E33032338,279,191,71,120,1,28,18,10,55,52,0,3,0,4
E33032339,426,297,105,192,4,47,28,19,70,66,0,3,1,8
E33032340,401,319,107,212,2,14,6,8,65,57,2,3,3,1
E33032341,455,322,124,198,4,31,18,13,96,93,0,2,1,2
E33032342,726,506,195,311,6,59,32,27,134,111,21,2,0,21
E33032343,835,419,139,280,11,194,113,81,198,192,0,6,0,13
E33032344,658,433,147,286,5,87,56,31,120,107,6,2,5,13
E33032345,385,215,63,152,2,70,40,30,86,83,0,2,1,12
E33032346,705,367,107,260,12,138,92,46,182,178,1,2,1,6
E33032347,523,347,111,236,0,14,8,6,153,150,0,2,1,9
E33032348,293,207,75,132,4,9,5,4,73,73,0,0,0,0
E33032349,294,193,63,130,1,16,8,8,82,76,0,6,0,2
E33032350,347,177,61,116,7,49,31,18,112,107,0,5,0,2
E33032351,544,257,90,167,1,75,42,33,196,182,6,7,1,15
E33032352,350,182,71,111,1,39,25,14,121,116,0,4,1,7
E33032353,372,241,86,155,3,36,18,18,90,86,3,0,1,2
E33032354,401,275,99,176,2,29,17,12,92,88,0,3,1,3
E33032355,373,204,69,135,7,36,20,16,121,116,0,4,1,5
E33032356,395,243,70,173,6,38,18,20,104,97,2,4,1,4
E33032357,259,173,61,112,4,30,18,12,50,46,1,1,2,2
E33032358,588,326,108,218,7,73,48,25,177,167,5,5,0,5
E33032359,363,206,80,126,3,21,16,5,131,127,0,2,2,2
E33032360,260,189,71,118,2,4,3,1,65,64,0,0,1,0
E33032361,332,215,81,134,0,13,4,9,98,95,0,3,0,6
E33032362,246,191,48,143,3,13,12,1,39,34,0,4,1,0
E33032363,423,199,63,136,10,103,63,40,107,97,1,9,0,4
E33032364,430,220,46,174,2,100,74,26,107,102,0,5,0,1
E33032365,829,523,160,363,6,63,28,35,234,219,5,8,2,3
E33032366,710,398,127,271,7,138,81,57,164,154,1,4,5,3
E33032367,427,278,81,197,11,82,49,33,55,52,1,1,1,1
E33032368,373,211,55,156,3,54,29,25,101,92,1,6,2,4
E33032369,494,247,63,184,6,67,49,18,164,148,2,11,3,10
E33032370,475,285,79,206,9,28,20,8,132,127,0,3,2,21
E33032371,267,134,61,73,2,11,6,5,117,114,0,2,1,3
E33032372,303,168,68,100,1,44,27,17,89,87,0,2,0,1
E33032373,244,136,30,106,6,24,11,13,74,67,0,0,7,4
E33032374,283,157,58,99,0,18,11,7,101,93,0,5,3,7
E33032375,350,190,74,116,3,29,14,15,125,125,0,0,0,3
E33032376,756,369,111,258,11,108,72,36,248,239,2,5,2,20
E33032377,475,244,60,184,2,87,76,11,136,132,2,1,1,6
E33032378,464,216,52,164,1,62,45,17,177,173,0,3,1,8
E33032379,1699,1052,313,739,32,252,149,103,353,329,4,17,3,10
E33032380,274,173,62,111,3,21,15,6,75,72,0,3,0,2
E33032381,309,193,65,128,4,25,10,15,78,71,3,3,1,9
E33032382,577,399,126,273,4,48,17,31,123,118,1,4,0,3
E33032383,389,261,84,177,8,18,9,9,100,95,2,1,2,2
E33032384,338,227,105,122,1,21,11,10,87,79,3,4,1,2
E33032385,393,275,83,192,3,9,7,2,102,97,0,5,0,4
E33032386,511,231,59,172,11,144,84,60,118,111,1,4,2,7
E33032387,431,227,85,142,8,83,65,18,105,101,0,2,2,8
E33032388,381,168,52,116,13,110,41,69,87,83,0,4,0,3
E33032389,543,343,102,241,10,102,63,39,87,79,1,6,1,1
E33032390,306,116,47,69,3,107,68,39,78,66,2,9,1,2
E33032391,405,225,73,152,2,63,48,15,112,102,2,6,2,3
E33032392,765,443,131,312,10,79,32,47,227,221,0,2,4,6
E33032393,368,215,73,142,4,46,28,18,94,79,0,10,5,9
E33032394,461,278,83,195,2,44,23,21,135,131,2,2,0,2
E33032395,409,272,74,198,2,31,16,15,100,92,1,6,1,4
E33032396,621,344,109,235,13,70,36,34,184,176,3,5,0,10
E33032397,458,186,47,139,1,95,34,61,172,165,1,4,2,4
E33032398,331,190,87,103,2,16,9,7,110,106,0,1,3,13
E33032399,758,446,147,299,5,66,37,29,232,225,0,7,0,9
E33032400,275,187,82,105,0,7,5,2,71,67,2,2,0,10
E33032401,408,290,110,180,2,22,12,10,87,82,0,5,0,7
E33032402,282,204,97,107,1,20,10,10,48,43,0,5,0,9
E33032403,341,209,79,130,0,20,16,4,109,102,1,4,2,3
E33032404,375,251,83,168,1,11,8,3,109,107,0,2,0,3
E33032405,338,181,67,114,3,45,36,9,106,98,0,5,3,3
E33032406,280,142,40,102,3,48,31,17,84,83,1,0,0,3
E33032407,427,233,82,151,4,56,27,29,127,117,1,7,2,7
E33032408,614,313,109,204,6,59,37,22,230,223,0,7,0,6
E33032409,284,175,62,113,2,13,9,4,93,87,2,3,1,1
E33032410,565,281,114,167,7,47,23,24,226,211,2,1,12,4
E33032411,367,193,59,134,4,22,7,15,145,127,0,9,9,3
E33032412,887,598,117,481,34,68,27,41,176,166,2,7,1,11
E33032413,362,146,42,104,1,28,8,20,185,179,1,4,1,2
E33032414,634,368,93,275,13,63,43,20,186,180,1,4,1,4
E33032415,442,263,102,161,1,21,9,12,156,151,1,2,2,1
E33032416,336,171,72,99,5,28,15,13,125,113,9,3,0,7
E33032417,390,227,88,139,0,18,9,9,143,131,2,10,0,2
E33032418,364,201,35,166,3,22,6,16,135,124,4,7,0,3
E33032419,487,267,79,188,7,47,23,24,165,159,1,3,2,1
E33032420,387,213,62,151,0,41,30,11,131,126,1,2,2,2
E33032421,366,178,70,108,12,37,19,18,136,127,0,1,8,3
E33032422,456,246,88,158,3,34,20,14,164,151,2,4,7,9
E33032423,296,157,52,105,2,35,13,22,98,93,0,4,1,4
E33032424,300,177,68,109,0,32,20,12,80,74,0,2,4,11
E33032425,507,264,119,145,3,41,25,16,191,186,1,3,1,8
E33032426,287,139,51,88,4,36,28,8,99,96,1,2,0,9
E33032427,354,260,128,132,1,11,6,5,74,70,0,4,0,8
E33032428,220,146,63,83,1,31,13,18,33,31,0,2,0,9
E33032429,317,201,115,86,2,29,11,18,70,61,2,2,5,15
E33032430,234,171,82,89,1,7,4,3,51,48,0,3,0,4
E33032431,291,177,44,133,1,26,17,9,85,81,0,3,1,2
E33032432,297,179,93,86,2,20,13,7,78,75,0,0,3,18
E33032433,351,197,71,126,1,45,33,12,105,100,1,3,1,3
E33032434,308,196,69,127,9,21,16,5,77,74,0,2,1,5
E33032435,305,154,63,91,1,16,9,7,127,123,0,4,0,7
E33032436,249,159,58,101,0,10,1,9,73,68,0,5,0,7
E33032437,486,266,100,166,1,44,19,25,169,166,0,3,0,6
E33032438,261,166,68,98,1,6,5,1,83,78,2,0,3,5
E33032439,380,167,63,104,5,43,25,18,159,158,0,1,0,6
E33032440,457,239,99,140,5,44,20,24,163,148,2,6,7,6
E33032441,333,196,69,127,5,17,8,9,110,106,1,2,1,5
E33032442,295,188,98,90,1,34,21,13,63,59,0,3,1,9
E33032443,416,261,107,154,7,17,15,2,129,122,0,5,2,2
E33032444,317,212,87,125,1,17,5,12,82,78,0,3,1,5
E33032445,266,166,64,102,3,27,10,17,67,66,0,1,0,3
E33032446,364,191,65,126,7,22,11,11,141,137,1,3,0,3
E33032447,245,179,70,109,4,13,7,6,43,41,0,1,1,6
E33032448,893,458,127,331,19,79,38,41,332,323,1,6,2,5
E33032449,307,101,33,68,3,98,78,20,102,98,0,4,0,3
E33032450,351,186,51,135,2,45,30,15,116,113,1,1,1,2
E33032451,280,154,49,105,5,46,35,11,73,71,0,1,1,2
E33032452,365,184,59,125,5,31,15,16,140,133,3,3,1,5
E33032453,552,249,97,152,3,66,47,19,230,228,0,2,0,4
E33032454,259,142,46,96,1,17,13,4,94,91,0,1,2,5
E33032455,293,157,50,107,2,7,3,4,123,118,3,2,0,4
E33032456,391,223,92,131,4,14,5,9,140,134,0,5,1,10
E33032457,380,154,77,77,3,25,14,11,193,187,0,5,1,5
E33032458,493,282,120,162,1,20,9,11,182,169,0,7,6,8
E33032459,286,185,65,120,3,16,9,7,75,74,0,1,0,7
E33032460,344,192,77,115,7,16,7,9,124,110,5,7,2,5
E33032461,470,274,129,145,6,51,26,25,122,119,1,2,0,17
E33032462,339,185,55,130,4,37,19,18,107,100,0,5,2,6
E33032463,511,274,97,177,3,50,23,27,180,173,1,5,1,4
E33032464,332,157,55,102,0,28,13,15,146,139,0,5,2,1
E33032465,246,145,77,68,1,33,18,15,59,56,1,0,2,8
E33032466,274,181,67,114,1,13,6,7,76,74,1,1,0,3
E33032467,539,314,138,176,5,69,34,35,144,137,0,4,3,7
E33032468,425,236,67,169,4,54,35,19,129,123,1,5,0,2
E33032469,304,126,37,89,4,60,32,28,112,110,0,1,1,2
E33032470,595,191,56,135,3,107,57,50,286,270,1,6,9,8
E33032471,5414,3009,1071,1938,61,935,535,400,1355,1292,7,38,18,54
E33032472,517,237,76,161,11,136,72,64,133,125,3,5,0,0
E33032473,332,155,45,110,2,68,40,28,106,104,0,2,0,1
E33032474,395,223,85,138,0,23,10,13,147,138,2,2,5,2
E33032475,280,144,62,82,1,36,18,18,96,92,0,3,1,3
E33032476,345,171,65,106,4,14,11,3,147,140,0,6,1,9
E33032477,317,125,46,79,8,55,24,31,125,124,0,1,0,4
E33032478,415,195,73,122,6,76,56,20,130,126,1,3,0,8
E33032479,428,192,72,120,5,54,39,15,171,165,2,4,0,6
E33032480,310,144,65,79,0,45,26,19,116,98,2,13,3,5
E33032481,291,155,84,71,2,34,26,8,86,83,0,2,1,14
E33032482,685,405,57,348,2,74,20,54,200,181,0,17,2,4
E33032483,420,270,62,208,3,77,18,59,69,59,0,4,6,1
E33032484,373,209,51,158,1,108,18,90,51,44,1,3,3,4
E33032485,349,172,47,125,1,137,15,122,37,34,0,3,0,2
E33032486,443,242,51,191,4,87,16,71,110,100,0,10,0,0
E33032487,345,246,47,199,1,29,5,24,66,60,2,3,1,3
E33032488,623,436,120,316,7,78,23,55,99,83,0,9,7,3
E33032489,433,267,68,199,2,63,21,42,98,90,0,4,4,3
E33032490,682,453,98,355,2,99,36,63,122,114,0,7,1,6
E33032491,549,311,89,222,17,118,28,90,100,84,1,9,6,3
E33032492,350,208,43,165,12,69,10,59,58,55,2,1,0,3
E33032493,441,302,85,217,4,56,15,41,78,71,0,7,0,1
E33032494,573,375,100,275,8,86,33,53,101,96,1,4,0,3
E33032495,259,151,36,115,5,45,11,34,54,50,0,3,1,4
E33032496,385,299,82,217,1,36,3,33,41,32,5,3,1,8
E33032497,333,257,65,192,4,20,4,16,50,47,0,3,0,2
E33032498,283,190,62,128,4,38,11,27,46,38,0,8,0,5
E33032499,291,231,70,161,3,23,8,15,32,31,0,1,0,2
E33032500,541,457,130,327,4,29,7,22,49,40,2,6,1,2
E33032501,486,372,120,252,8,44,17,27,57,53,1,2,1,5
E33032502,607,468,107,361,10,50,9,41,75,68,1,5,1,4
E33032503,512,380,85,295,7,76,21,55,43,36,0,2,5,6
E33032504,358,305,89,216,1,32,9,23,18,17,0,1,0,2
E33032505,539,368,94,274,6,76,23,53,85,80,1,4,0,4
E33032506,462,272,58,214,2,91,27,64,95,89,0,2,4,2
E33032507,628,422,127,295,5,120,29,91,77,68,0,7,2,4
E33032508,426,249,71,178,3,136,27,109,37,35,1,1,0,1
E33032509,528,373,81,292,6,82,24,58,66,61,0,2,3,1
E33032510,734,469,115,354,9,149,48,101,103,98,0,4,1,4
E33032511,416,368,70,298,3,25,5,20,19,19,0,0,0,1
E33032512,442,395,109,286,4,17,4,13,25,21,0,3,1,1
E33032513,377,351,96,255,1,6,3,3,19,19,0,0,0,0
E33032514,285,218,51,167,1,32,14,18,33,28,0,4,1,1
E33032515,379,240,44,196,6,96,22,74,37,33,0,4,0,0
E33032516,830,534,111,423,17,130,44,86,144,137,1,4,2,5
E33032517,345,225,62,163,2,95,29,66,22,19,2,1,0,1
E33032518,556,462,128,334,2,46,13,33,42,38,0,3,1,4
E33032519,389,348,94,254,1,21,3,18,16,15,0,1,0,3
E33032520,421,362,94,268,3,15,8,7,38,35,0,3,0,3
E33032521,418,372,99,273,1,12,1,11,30,25,0,5,0,3
E33032522,555,459,115,344,7,33,12,21,53,47,0,6,0,3
E33032523,429,318,84,234,0,63,18,45,44,39,0,3,2,4
E33032524,554,484,115,369,6,32,9,23,31,28,0,3,0,1
E33032525,583,481,126,355,3,52,21,31,46,38,0,7,1,1
E33032526,335,270,67,203,3,18,5,13,41,35,0,4,2,3
E33032527,274,215,61,154,1,22,7,15,32,29,0,3,0,4
E33032528,505,384,133,251,2,46,20,26,64,61,0,3,0,9
E33032529,419,316,117,199,1,30,10,20,69,61,2,6,0,3
E33032530,296,245,61,184,1,28,8,20,21,19,0,1,1,1
E33032531,308,243,71,172,2,12,5,7,50,47,0,2,1,1
E33032532,389,289,74,215,4,41,11,30,53,42,0,8,3,2
E33032533,409,357,97,260,0,15,7,8,34,32,1,1,0,3
E33032534,553,467,113,354,3,16,5,11,64,57,1,6,0,3
E33032535,314,260,74,186,3,22,8,14,27,24,0,2,1,2
E33032536,784,641,107,534,12,43,12,31,86,79,0,7,0,2
E33032537,362,311,77,234,5,24,2,22,19,17,0,1,1,3
E33032538,645,465,126,339,9,85,27,58,85,67,10,3,5,1
E33032539,478,350,67,283,4,54,16,38,68,63,0,5,0,2
E33032540,520,421,98,323,4,27,9,18,67,57,1,9,0,1
E33032541,632,487,126,361,2,52,13,39,86,83,0,3,0,5
E33032542,849,746,203,543,5,30,6,24,63,56,2,4,1,5
E33032543,689,509,117,392,4,98,30,68,70,67,0,3,0,8
E33032544,285,235,67,168,3,21,4,17,21,20,0,1,0,5
E33032545,537,415,89,326,1,48,14,34,68,63,2,3,0,5
E33032546,504,346,75,271,5,68,25,43,83,77,0,6,0,2
E33032547,543,434,142,292,3,37,7,30,67,63,0,4,0,2
E33032548,429,372,119,253,3,21,5,16,32,29,0,3,0,1
E33032549,276,231,68,163,6,11,3,8,27,24,1,2,0,1
E33032550,373,305,103,202,4,24,8,16,37,34,0,2,1,3
E33032551,518,465,122,343,4,26,7,19,19,17,1,1,0,4
E33032552,372,313,79,234,0,19,9,10,39,30,2,6,1,1
E33032553,552,451,121,330,3,31,7,24,64,59,0,5,0,3
E33032554,346,291,71,220,2,14,4,10,36,35,0,1,0,3
E33032555,490,381,110,271,5,48,14,34,52,42,0,8,2,4
E33032556,366,328,75,253,4,8,1,7,24,23,0,1,0,2
E33032557,395,347,99,248,3,16,6,10,28,24,0,3,1,1
E33032558,435,356,111,245,2,15,4,11,59,55,0,4,0,3
E33032559,272,213,60,153,1,19,10,9,35,34,1,0,0,4
E33032560,431,304,69,235,3,57,28,29,63,59,0,4,0,4
E33032561,395,350,103,247,1,13,1,12,26,23,0,3,0,5
E33032562,354,289,95,194,2,14,0,14,43,37,0,5,1,6
E33032563,508,392,115,277,3,34,13,21,74,71,0,2,1,5
E33032564,421,327,92,235,6,40,20,20,44,37,2,5,0,4
E33032565,321,252,78,174,1,15,8,7,50,40,5,3,2,3
E33032566,317,270,70,200,1,14,5,9,32,28,0,3,1,0
E33032567,537,483,132,351,1,6,1,5,45,43,0,2,0,2
E33032568,387,351,98,253,1,22,4,18,12,12,0,0,0,1
E33032569,403,328,96,232,3,34,10,24,36,30,1,5,0,2
E33032570,412,314,101,213,4,46,16,30,47,43,0,3,1,1
E33032571,400,295,86,209,6,15,4,11,82,71,1,9,1,2
E33032572,258,198,53,145,1,30,4,26,28,28,0,0,0,1
E33032573,541,403,103,300,6,35,13,22,92,85,4,3,0,5
E33032574,283,225,60,165,3,25,12,13,27,20,2,5,0,3
E33032575,434,325,93,232,4,31,12,19,74,69,1,3,1,0
E33032576,363,288,106,182,6,20,3,17,48,43,0,4,1,1
E33032577,450,373,109,264,6,21,5,16,47,44,0,3,0,3
E33032578,451,336,113,223,2,49,19,30,58,54,1,2,1,6
E33032579,457,311,105,206,6,63,22,41,70,60,1,5,4,7
E33032580,370,338,115,223,0,9,4,5,23,22,0,1,0,0
E33032581,507,412,133,279,4,40,8,32,47,45,0,2,0,4
E33032582,439,301,91,210,4,58,17,41,72,67,2,3,0,4
E33032583,267,192,59,133,1,28,3,25,40,34,0,6,0,6
E33032584,374,269,80,189,11,63,14,49,28,27,0,1,0,3
E33032585,741,509,137,372,15,124,34,90,90,81,0,8,1,3
E33032586,469,334,79,255,5,74,19,55,53,46,2,3,2,3
E33032587,434,273,114,159,1,23,11,12,131,128,0,3,0,6
E33032588,516,266,87,179,10,37,8,29,198,195,0,3,0,5
E33032589,376,198,71,127,1,34,9,25,137,136,1,0,0,6
E33032590,345,218,82,136,5,44,12,32,75,72,0,3,0,3
E33032591,880,476,180,296,8,164,83,81,222,214,0,6,2,10
E33032592,382,234,76,158,3,14,4,10,128,116,0,4,8,3
E33032593,679,420,135,285,8,86,39,47,161,150,0,7,4,4
E33032594,809,437,107,330,5,87,52,35,277,261,0,14,2,3
E33032595,587,315,103,212,3,66,27,39,195,191,1,2,1,8
E33032596,369,166,49,117,2,40,27,13,156,154,1,1,0,5
E33032597,357,215,94,121,1,25,15,10,114,106,1,7,0,2
E33032598,306,140,42,98,0,42,21,21,120,115,0,4,1,4
E33032599,622,393,130,263,12,60,14,46,155,147,2,5,1,2
E33032600,555,370,156,214,12,46,25,21,119,108,4,6,1,8
E33032601,439,223,82,141,4,41,12,29,166,156,0,3,7,5
E33032602,607,334,119,215,6,39,15,24,224,221,1,0,2,4
E33032603,346,265,101,164,1,10,6,4,65,55,1,8,1,5
E33032604,506,341,118,223,5,22,10,12,132,131,0,1,0,6
E33032605,494,299,93,206,2,34,15,19,147,142,4,0,1,12
E33032606,579,421,170,251,5,34,18,16,109,98,6,5,0,10
E33032607,428,230,94,136,5,17,7,10,175,171,2,1,1,1
E33032608,444,260,86,174,3,34,14,20,146,139,0,6,1,1
E33032609,467,313,114,199,2,30,14,16,116,110,0,5,1,6
E33032610,394,209,48,161,10,47,23,24,124,118,1,3,2,4
E33032611,287,156,49,107,2,31,19,12,96,86,0,7,3,2
E33032612,657,354,118,236,11,77,33,44,211,198,1,8,4,4
E33032613,331,162,57,105,1,29,12,17,137,130,1,4,2,2
E33032614,417,237,84,153,0,20,8,12,157,150,0,4,3,3
E33032615,456,211,86,125,0,20,3,17,220,212,0,4,4,5
E33032616,476,222,76,146,6,49,20,29,197,192,2,2,1,2
E33032617,419,222,86,136,2,28,11,17,160,149,0,5,6,7
E33032618,419,198,61,137,5,37,16,21,173,158,3,0,12,6
E33032619,485,190,72,118,11,48,17,31,229,219,1,6,3,7
E33032620,972,484,140,344,17,161,78,83,299,271,4,19,5,11
E33032621,344,248,82,166,0,10,3,7,86,82,0,2,2,0
E33032622,557,360,135,225,8,35,15,20,151,141,4,4,2,3
E33032623,344,234,83,151,3,45,10,35,58,55,2,1,0,4
E33032624,317,231,97,134,3,17,5,12,61,58,3,0,0,5
E33032625,414,145,41,104,11,105,23,82,148,145,0,2,1,5
E33032626,373,201,64,137,1,26,21,5,141,135,0,6,0,4
E33032627,374,151,45,106,6,72,30,42,142,134,1,3,4,3
E33032628,276,158,56,102,8,38,19,19,68,66,0,1,1,4
E33032629,511,299,126,173,7,55,21,34,150,138,5,4,3,0
E33032630,627,323,137,186,7,52,23,29,240,223,1,9,7,5
E33032631,565,228,68,160,9,75,18,57,250,234,5,10,1,3
E33032632,690,364,126,238,8,87,31,56,230,223,1,4,2,1
E33032633,1098,524,153,371,29,198,116,82,338,326,0,11,1,9
E33032634,446,243,98,145,5,70,39,31,121,115,0,5,1,7
E33032635,475,252,79,173,5,62,29,33,155,140,0,11,4,1
E33032636,555,330,119,211,12,43,14,29,167,155,2,8,2,3
E33032637,389,207,63,144,1,36,15,21,134,129,0,3,2,11
E33032638,390,210,75,135,17,47,16,31,114,104,3,5,2,2
E33032639,478,221,51,170,7,38,19,19,205,194,1,10,0,7
E33032640,511,181,54,127,4,38,14,24,282,268,1,11,2,6
E33032641,409,236,67,169,6,58,17,41,106,100,0,4,2,3
E33032642,607,375,92,283,11,59,35,24,156,154,0,2,0,6
E33032643,423,193,76,117,5,44,20,24,178,168,3,6,1,3
E33032644,368,141,31,110,3,37,14,23,184,175,0,8,1,3
E33032645,1126,672,212,460,22,163,66,97,261,254,0,6,1,8
E33032646,414,212,75,137,5,45,22,23,152,141,0,8,3,0
E33032647,578,351,93,258,12,83,39,44,128,124,0,2,2,4
E33032648,458,196,70,126,5,47,16,31,208,207,0,0,1,2
E33032649,342,190,86,104,5,32,11,21,114,114,0,0,0,1
E33032650,349,153,44,109,5,46,21,25,135,125,1,4,5,10
E33032651,477,249,90,159,8,74,44,30,141,134,0,7,0,5
E33032652,480,157,50,107,3,50,23,27,266,260,0,4,2,4
E33032653,405,197,71,126,4,65,25,40,137,131,2,3,1,2
E33032654,663,212,74,138,5,102,39,63,335,318,3,9,5,9
E33032655,821,416,124,292,11,54,24,30,329,321,0,7,1,11
E33032656,326,185,69,116,2,20,8,12,110,108,0,2,0,9
E33032657,495,212,58,154,5,57,28,29,217,207,5,3,2,4
E33032658,520,195,67,128,28,64,34,30,231,215,6,6,4,2
E33032659,155,92,17,75,2,17,9,8,43,41,0,0,2,1
E33032660,406,242,88,154,4,54,22,32,104,100,3,1,0,2
E33032661,680,420,114,306,8,66,34,32,182,178,0,3,1,4
E33032662,466,234,94,140,1,40,14,26,187,180,1,4,2,4
E33032663,332,149,73,76,3,46,12,34,122,121,0,1,0,12
E33032664,558,258,98,160,7,62,21,41,230,224,0,6,0,1
E33032665,1019,567,174,393,8,83,38,45,346,323,7,13,3,15
E33032666,488,218,69,149,5,62,21,41,198,189,0,9,0,5
E33032667,501,259,92,167,4,28,15,13,209,195,2,11,1,1
E33032668,406,218,70,148,9,55,20,35,121,115,1,5,0,3
E33032669,436,238,82,156,6,49,21,28,138,125,3,8,2,5
E33032670,1131,664,178,486,32,138,59,79,288,276,3,8,1,9
E33032671,494,238,91,147,6,55,20,35,188,180,4,4,0,7
E33032672,291,151,46,105,11,42,11,31,86,80,2,3,1,1
E33032673,558,349,136,213,14,64,26,38,128,126,0,1,1,3
E33032674,1156,624,174,450,14,216,119,97,293,281,3,8,1,9
E33032675,405,203,75,128,1,37,23,14,161,153,0,6,2,3
E33032676,382,123,38,85,3,184,130,54,69,67,0,1,1,3
E33032677,359,135,34,101,10,96,22,74,113,106,0,6,1,5
E33032678,673,332,112,220,8,130,56,74,196,183,1,8,4,7
E33032679,508,271,93,178,9,114,72,42,106,101,0,5,0,8
E33032680,350,167,56,111,0,36,15,21,142,140,1,0,1,5
E33032681,567,208,76,132,2,90,29,61,262,250,1,5,6,5
E33032682,284,120,39,81,5,45,18,27,111,108,0,3,0,3
E33032683,608,242,99,143,6,71,22,49,283,277,1,3,2,6
E33032684,450,186,63,123,10,87,36,51,160,147,2,5,6,7
E33032685,700,256,111,145,7,109,68,41,313,304,1,4,4,15
E33032686,241,128,46,82,1,34,20,14,75,72,2,1,0,3
E33032687,469,202,78,124,5,58,15,43,201,189,0,8,4,3
E33032688,305,117,39,78,9,58,27,31,116,114,0,0,2,5
E33032689,476,144,31,113,9,57,12,45,262,255,0,4,3,4
E33032690,536,262,83,179,23,145,53,92,105,99,0,6,0,1
E33032691,498,234,72,162,12,93,32,61,153,150,0,1,2,6
E33032692,576,245,87,158,11,139,50,89,175,168,3,4,0,6
E33032693,415,168,67,101,3,78,39,39,158,155,0,2,1,8
E33032694,320,129,54,75,4,75,18,57,108,106,0,1,1,4
E33032695,343,131,28,103,8,102,30,72,99,96,0,1,2,3
E33032696,315,116,35,81,2,66,25,41,128,122,0,2,4,3
E33032697,414,199,73,126,9,71,35,36,130,123,0,6,1,5
E33032698,666,325,99,226,11,179,80,99,142,140,0,2,0,9
E33032699,403,206,59,147,3,72,30,42,119,116,0,0,3,3
E33032700,338,134,37,97,9,97,21,76,94,94,0,0,0,4
E33032701,600,338,95,243,7,67,36,31,184,164,5,12,3,4
E33032702,395,190,42,148,10,73,31,42,119,111,0,8,0,3
E33032703,697,373,102,271,4,53,27,26,259,245,2,11,1,8
E33032704,983,492,144,348,10,215,82,133,258,250,0,7,1,8
E33032705,1454,866,196,670,19,73,42,31,486,466,3,14,3,10
E33032706,271,105,33,72,5,104,48,56,54,53,0,0,1,3
E33032707,305,124,45,79,4,86,27,59,81,75,0,6,0,10
E33032708,282,103,32,71,2,134,56,78,42,42,0,0,0,1
E33032709,431,177,45,132,4,93,41,52,151,143,0,7,1,6
E33032710,326,173,79,94,0,39,13,26,112,110,0,2,0,2
E33032711,815,333,103,230,2,140,67,73,333,316,2,8,7,7
E33032712,399,195,68,127,1,27,7,20,172,163,0,7,2,4
E33032713,271,89,29,60,0,33,12,21,142,133,0,6,3,7
E33032714,505,193,62,131,11,136,75,61,162,158,0,4,0,3
E33032715,406,189,67,122,4,43,22,21,160,159,0,1,0,10
E33032716,294,190,62,128,5,18,8,10,75,68,0,5,2,6
E33032717,475,208,54,154,12,59,27,32,190,176,0,4,10,6
E33032718,241,150,56,94,0,13,9,4,72,65,0,4,3,6
E33032719,399,225,72,153,5,26,8,18,137,120,0,5,12,6
E33032720,371,186,55,131,2,31,15,16,152,136,7,9,0,0
E33032721,245,142,55,87,1,43,16,27,59,55,3,1,0,0
E33032722,763,377,128,249,12,144,68,76,217,213,0,3,1,13
E33032723,330,219,88,131,2,21,7,14,83,79,0,3,1,5
E33032724,416,243,78,165,2,38,17,21,128,121,2,4,1,5
E33032725,231,118,46,72,1,27,12,15,83,80,2,1,0,2
E33032726,501,207,54,153,10,106,36,70,173,167,0,6,0,5
E33032727,495,146,43,103,7,129,49,80,209,201,0,6,2,4
E33032728,472,208,60,148,3,83,29,54,173,167,0,4,2,5
E33032729,484,184,59,125,5,102,40,62,191,177,1,7,6,2
E33032730,382,130,42,88,6,92,31,61,151,138,3,4,6,3
E33032731,637,244,76,168,7,129,51,78,252,244,1,3,4,5
E33032732,386,162,36,126,5,66,27,39,145,136,0,5,4,8
E33032733,384,195,76,119,12,74,27,47,101,101,0,0,0,2
E33032734,400,133,37,96,8,108,20,88,147,144,0,2,1,4
E33032735,371,165,36,129,7,74,37,37,125,120,0,4,1,0
E33032736,393,198,76,122,4,38,18,20,153,147,1,5,0,0
E33032737,425,158,50,108,5,48,23,25,211,203,0,6,2,3
E33032738,643,339,114,225,9,74,38,36,216,211,0,4,1,5
E33032739,330,145,55,90,2,61,28,33,120,115,0,4,1,2
E33032740,374,161,37,124,1,54,26,28,155,151,2,2,0,3
E33032741,325,196,83,113,3,25,13,12,91,88,2,1,0,10
E33032742,371,174,58,116,2,69,28,41,121,114,1,5,1,5
E33032743,399,253,70,183,5,33,8,25,105,98,0,7,0,3
E33032744,698,333,126,207,5,56,24,32,299,289,0,7,3,5
E33032745,433,203,69,134,2,67,22,45,156,153,0,3,0,5
E33032746,395,185,54,131,4,60,18,42,142,134,1,5,2,4
E33032747,591,152,45,107,9,211,150,61,211,206,0,2,3,8
E33032748,388,134,50,84,8,133,67,66,108,96,2,5,5,5
E33032749,324,107,26,81,4,156,113,43,56,53,0,0,3,1
E33032750,360,96,30,66,15,168,123,45,75,74,1,0,0,6
E33032751,278,147,45,102,3,87,23,64,38,31,4,2,1,3
E33032752,395,235,47,188,5,106,16,90,46,42,2,1,1,3
E33032753,428,311,111,200,4,60,34,26,39,36,0,3,0,14
E33032754,311,201,59,142,4,68,14,54,37,36,0,0,1,1
E33032755,280,222,59,163,2,16,2,14,40,37,0,2,1,0
E33032756,324,225,63,162,2,23,3,20,73,67,1,5,0,1
E33032757,288,220,48,172,1,42,8,34,24,22,0,2,0,1
E33032758,338,255,79,176,0,33,6,27,49,46,1,2,0,1
E33032759,347,220,72,148,0,50,12,38,72,70,0,2,0,5
E33032760,303,193,60,133,5,39,11,28,66,61,1,4,0,0
E33032761,371,253,71,182,5,28,6,22,83,79,2,2,0,2
E33032762,369,251,54,197,6,34,10,24,75,74,0,1,0,3
E33032763,404,213,61,152,6,104,30,74,75,71,1,2,1,6
E33032764,369,191,44,147,1,50,9,41,123,118,1,3,1,4
E33032765,531,329,108,221,6,86,30,56,105,101,1,3,0,5
E33032766,456,169,43,126,9,91,21,70,183,174,1,8,0,4
E33032767,337,147,37,110,1,68,19,49,119,111,0,5,3,2
E33032768,359,150,30,120,1,69,14,55,133,124,0,9,0,6
E33032769,308,178,60,118,6,46,18,28,72,69,1,2,0,6
E33032770,249,176,58,118,1,29,9,20,38,35,1,2,0,5
E33032771,333,202,61,141,2,30,4,26,94,91,0,2,1,5
E33032772,331,164,55,109,2,76,9,67,85,81,0,3,1,4
E33032773,553,364,111,253,2,66,18,48,117,112,1,3,1,4
E33032774,511,318,89,229,2,77,15,62,112,102,0,8,2,2
E33032775,275,221,75,146,2,18,6,12,30,29,0,1,0,4
E33032776,366,273,91,182,6,38,14,24,43,40,0,3,0,6
E33032777,345,270,90,180,6,42,10,32,25,23,0,2,0,2
E33032778,371,315,85,230,1,23,10,13,32,29,0,3,0,0
E33032779,359,271,85,186,1,15,5,10,67,62,1,3,1,5
E33032780,291,231,58,173,2,24,1,23,29,26,0,3,0,5
E33032781,257,185,62,123,1,28,3,25,40,37,0,2,1,3
E33032782,238,201,82,119,2,10,5,5,23,21,0,1,1,2
E33032783,250,183,70,113,1,24,3,21,39,37,0,1,1,3
E33032784,449,314,93,221,4,43,10,33,82,75,3,3,1,6
E33032785,251,159,45,114,2,30,4,26,57,47,0,4,6,3
E33032786,663,489,136,353,4,66,27,39,97,89,2,5,1,7
E33032787,363,268,84,184,5,31,5,26,56,52,0,4,0,3
E33032788,276,188,57,131,2,28,9,19,56,53,1,2,0,2
E33032789,226,134,42,92,3,40,12,28,48,46,0,2,0,1
E33032790,364,228,51,177,4,55,13,42,72,68,0,4,0,5
E33032791,285,137,35,102,5,45,10,35,94,86,7,1,0,4
E33032792,351,170,46,124,3,100,15,85,75,71,1,1,2,3
E33032793,369,152,33,119,6,107,12,95,97,88,1,8,0,7
E33032794,495,278,65,213,7,144,28,116,63,57,1,4,1,3
E33032795,511,186,44,142,8,197,45,152,116,108,0,8,0,4
E33032796,331,162,51,111,3,86,23,63,76,73,1,2,0,4
E33032797,650,445,167,278,4,85,29,56,93,80,7,5,1,23
E33032798,283,251,94,157,2,16,4,12,11,11,0,0,0,3
E33032799,412,301,57,244,6,67,10,57,37,35,0,1,1,1
E33032800,547,366,102,264,5,62,24,38,113,97,12,4,0,1
E33032801,293,201,48,153,1,20,5,15,68,62,1,3,2,3
E33032802,528,408,155,253,2,27,8,19,87,83,0,3,1,4
E33032803,479,332,99,233,3,33,7,26,107,101,1,3,2,4
E33032804,264,215,82,133,1,9,4,5,34,32,0,1,1,5
E33032805,553,365,120,245,6,60,14,46,119,109,0,10,0,3
E33032806,219,156,47,109,2,19,11,8,40,37,0,3,0,2
E33032807,302,232,78,154,3,25,10,15,40,37,0,2,1,2
E33032808,386,279,93,186,4,40,15,25,62,60,0,1,1,1
E33032809,336,230,56,174,0,54,9,45,47,46,0,1,0,5
E33032810,372,279,96,183,2,41,13,28,45,42,1,2,0,5
E33032811,583,419,98,321,14,55,19,36,93,89,0,3,1,2
E33032812,348,254,76,178,4,41,6,35,44,43,0,1,0,5
E33032813,343,227,72,155,3,39,11,28,69,61,1,6,1,5
E33032814,455,313,71,242,4,77,15,62,58,50,2,6,0,3
E33032815,360,245,60,185,4,72,20,52,37,35,0,2,0,2
E33032816,270,159,47,112,6,64,12,52,39,35,0,4,0,2
E33032817,251,137,31,106,4,79,9,70,28,27,0,0,1,3
E33032818,307,222,57,165,4,51,13,38,30,30,0,0,0,0
E33032819,419,273,60,213,5,55,14,41,85,78,0,7,0,1
E33032820,286,206,46,160,4,31,9,22,43,39,0,3,1,2
E33032821,765,528,150,378,16,95,23,72,121,110,1,10,0,5
E33032822,384,319,116,203,2,20,6,14,42,38,0,3,1,1
E33032823,403,255,89,166,4,52,25,27,88,84,0,4,0,4
E33032824,289,190,60,130,7,31,6,25,59,56,1,2,0,2
E33032825,412,300,97,203,5,49,15,34,56,53,0,3,0,2
E33032826,420,261,51,210,5,75,30,45,76,69,0,4,3,3
E33032827,579,395,135,260,5,102,27,75,72,64,5,2,1,5
E33032828,710,515,125,390,7,111,34,77,74,68,1,4,1,3
E33032829,777,574,171,403,15,46,12,34,136,126,0,10,0,6
E33032830,688,514,159,355,3,54,12,42,105,96,0,9,0,12
E33032831,403,302,108,194,0,36,11,25,63,60,0,2,1,2
E33032832,474,302,73,229,5,60,24,36,97,90,2,4,1,10
E33032833,339,207,54,153,4,47,15,32,78,68,6,4,0,3
E33032834,376,266,80,186,1,42,14,28,66,64,0,2,0,1
E33032835,330,255,85,170,0,21,2,19,51,49,1,1,0,3
E33032836,303,180,38,142,10,72,18,54,39,28,11,0,0,2
E33032837,413,248,72,176,0,76,14,62,87,72,11,2,2,2
E33032838,740,549,161,388,12,96,19,77,80,69,0,11,0,3
E33032839,254,162,44,118,3,45,11,34,40,38,0,2,0,4
E33032840,437,311,87,224,13,45,15,30,65,60,0,4,1,3
E33032841,382,277,85,192,3,39,11,28,61,59,1,1,0,2
E33032842,129,81,23,58,0,15,5,10,30,28,0,2,0,3
E33032843,280,213,56,157,2,22,6,16,39,37,0,2,0,4
E33032844,379,281,69,212,2,36,10,26,57,53,0,4,0,3
E33032845,301,254,75,179,1,14,1,13,32,24,0,8,0,0
E33032846,844,604,153,451,15,89,22,67,125,115,1,8,1,11
E33032847,285,192,47,145,3,41,20,21,47,40,3,4,0,2
E33032848,492,454,155,299,2,6,5,1,27,23,0,3,1,3
E33032849,340,263,80,183,4,28,7,21,45,45,0,0,0,0
E33032850,416,339,108,231,1,18,5,13,56,52,0,3,1,2
E33032851,393,317,111,206,4,24,5,19,43,42,0,1,0,5
E33032852,371,283,71,212,6,35,15,20,47,39,0,5,3,0
E33032853,350,314,107,207,2,6,3,3,22,22,0,0,0,6
E33032854,301,244,90,154,2,16,3,13,37,36,0,1,0,2
E33032855,412,303,88,215,4,48,21,27,55,53,0,2,0,2
E33032856,328,266,72,194,5,23,2,21,32,29,2,1,0,2
E33032857,437,346,85,261,7,55,14,41,26,25,0,1,0,3
E33032858,378,230,53,177,3,98,9,89,43,35,0,8,0,4
E33032859,445,367,93,274,2,20,6,14,48,46,0,2,0,8
E33032860,1434,926,242,684,22,242,94,148,232,216,6,10,0,12
E33032861,730,573,146,427,11,49,16,33,93,88,2,3,0,4
E33032862,428,334,93,241,4,31,13,18,58,49,1,4,4,1
E33032863,716,610,231,379,2,37,6,31,61,54,0,7,0,6
E33032864,461,399,115,284,2,15,2,13,44,42,0,2,0,1
E33032865,367,238,72,166,4,92,25,67,33,31,1,1,0,0
E33032866,296,201,53,148,4,54,12,42,35,35,0,0,0,2
E33032867,397,308,92,216,0,60,20,40,22,21,0,1,0,7
E33032868,279,251,89,162,0,4,1,3,16,15,1,0,0,8
E33032869,482,425,96,329,2,27,3,24,26,23,1,2,0,2
E33032870,419,396,107,289,0,4,1,3,18,18,0,0,0,1
E33032871,291,252,92,160,0,11,6,5,26,26,0,0,0,2
E33032872,302,260,80,180,2,23,6,17,16,12,0,4,0,1
E33032873,605,459,135,324,10,52,9,43,78,73,0,2,3,6
E33032874,250,172,58,114,4,31,9,22,40,28,0,4,8,3
E33032875,541,400,112,288,4,59,16,43,74,69,1,3,1,4
E33032876,757,603,178,425,10,63,18,45,77,66,1,9,1,4
E33032877,355,281,84,197,5,41,7,34,28,28,0,0,0,0
E33032878,256,212,78,134,3,7,1,6,33,31,0,1,1,1
E33032879,566,404,119,285,1,74,30,44,82,76,0,5,1,5
E33032880,313,265,90,175,3,18,7,11,23,23,0,0,0,4
E33032881,486,416,129,287,1,21,2,19,42,36,0,1,5,6
E33032882,499,402,145,257,2,34,13,21,55,50,1,3,1,6
E33032883,506,398,129,269,4,40,23,17,59,51,0,8,0,5
E33032884,345,293,85,208,0,29,17,12,20,13,1,4,2,3
E33032885,376,335,111,224,1,9,1,8,26,23,0,3,0,5
E33032886,650,526,146,380,4,41,11,30,78,69,1,5,3,1
E33032887,433,383,122,261,2,12,5,7,35,30,0,5,0,1
E33032888,405,335,107,228,1,27,4,23,37,32,0,5,0,5
E33032889,688,509,157,352,7,115,8,107,56,52,0,4,0,1
E33032890,280,215,75,140,1,15,3,12,42,39,0,3,0,7
E33032891,254,194,61,133,3,16,3,13,37,36,0,0,1,4
E33032892,435,273,82,191,2,63,31,32,94,84,1,3,6,3
E33032893,377,314,96,218,0,19,8,11,44,40,0,3,1,0
E33032894,339,266,63,203,7,27,2,25,35,33,0,0,2,4
E33032895,809,630,211,419,7,92,18,74,73,64,1,5,3,7
E33032896,581,413,112,301,10,91,32,59,63,56,0,3,4,4
E33032897,409,283,85,198,5,53,20,33,63,54,6,3,0,5
E33032898,312,223,69,154,0,32,19,13,51,44,4,2,1,6
E33032899,334,310,96,214,0,3,1,2,20,16,1,3,0,1
E33032900,453,324,92,232,7,48,28,20,71,64,1,4,2,3
E33032901,473,399,113,286,3,23,11,12,45,40,2,2,1,3
E33032902,372,299,100,199,3,26,15,11,41,40,0,1,0,3
E33032903,436,344,111,233,4,43,17,26,42,38,0,3,1,3
E33032904,390,334,106,228,3,18,3,15,31,26,1,3,1,4
E33032905,344,307,98,209,3,9,2,7,23,21,1,1,0,2
E33032906,305,256,56,200,2,22,7,15,23,20,3,0,0,2
E33032907,482,375,141,234,6,39,9,30,57,48,0,7,2,5
E33032908,400,323,88,235,3,33,6,27,35,29,3,3,0,6
E33032909,701,526,160,366,4,100,12,88,67,61,0,3,3,4
E33032910,300,272,78,194,3,9,1,8,15,12,0,2,1,1
E33032911,585,468,116,352,5,42,6,36,64,57,0,7,0,6
E33032912,336,264,90,174,3,28,3,25,37,34,0,0,3,4
E33032913,582,449,149,300,6,73,18,55,52,45,2,0,5,2
E33032914,716,502,166,336,11,115,37,78,86,79,0,7,0,2
E33032915,345,277,90,187,2,28,3,25,36,32,0,3,1,2
E33032916,378,347,84,263,2,13,3,10,15,14,0,1,0,1
E33032917,478,393,105,288,2,19,13,6,59,53,4,1,1,5
E33032918,342,314,85,229,1,11,3,8,15,10,2,3,0,1
E33032919,340,268,62,206,4,34,16,18,33,28,1,3,1,1
E33032920,255,132,24,108,1,69,40,29,51,46,1,4,0,2
E33032921,400,201,68,133,5,71,49,22,122,114,3,4,1,1
E33032922,314,200,89,111,1,29,16,13,79,73,6,0,0,5
E33032923,244,148,74,74,0,39,27,12,50,48,0,1,1,7
E33032924,244,93,32,61,1,104,90,14,41,41,0,0,0,5
E33032925,571,319,124,195,12,101,62,39,126,118,0,6,2,13
E33032926,360,217,111,106,6,56,47,9,74,71,0,2,1,7
E33032927,246,134,78,56,1,34,26,8,70,68,0,2,0,7
E33032928,389,190,79,111,9,63,35,28,116,112,1,3,0,11
E33032929,296,163,95,68,1,23,15,8,106,102,1,2,1,3
E33032930,266,167,98,69,1,22,16,6,71,67,0,3,1,5
E33032931,343,206,110,96,4,37,20,17,91,85,0,2,4,5
E33032932,248,125,59,66,3,26,16,10,91,87,0,4,0,3
E33032933,335,154,69,85,3,59,32,27,113,110,2,1,0,6
E33032934,294,156,67,89,3,39,22,17,93,86,2,3,2,3
E33032935,219,128,84,44,0,14,7,7,68,66,1,1,0,9
E33032936,350,180,65,115,7,89,45,44,70,63,0,7,0,4
E33032937,320,196,114,82,0,47,36,11,73,67,2,4,0,4
E33032938,252,118,51,67,2,74,39,35,53,51,0,1,1,5
E33032939,455,191,63,128,7,80,39,41,174,169,2,3,0,3
E33032940,327,194,87,107,7,52,30,22,73,67,2,3,1,1
E33032941,248,123,50,73,1,74,43,31,46,43,1,2,0,4
E33032942,227,103,51,52,2,22,10,12,91,89,0,1,1,9
E33032943,231,131,64,67,2,33,22,11,55,53,0,2,0,10
E33032944,313,163,62,101,2,44,27,17,97,93,0,4,0,7
E33032945,523,284,116,168,13,52,32,20,161,150,1,8,2,13
E33032946,250,145,77,68,2,23,13,10,74,71,0,3,0,6
E33032947,259,161,98,63,3,14,9,5,67,61,1,2,3,14
E33032948,270,170,92,78,3,18,11,7,74,72,1,1,0,5
E33032949,401,233,88,145,8,39,16,23,120,112,0,8,0,1
E33032950,423,153,52,101,5,67,47,20,194,189,0,4,1,4
E33032951,336,179,83,96,0,35,18,17,119,113,1,3,2,3
E33032952,278,182,50,132,3,31,18,13,62,59,2,0,1,0
E33032953,286,181,92,89,1,19,10,9,81,81,0,0,0,4
E33032954,257,127,58,69,2,19,9,10,107,99,2,4,2,2
E33032955,276,146,45,101,2,39,17,22,82,78,2,1,1,7
E33032956,310,161,83,78,3,51,42,9,91,87,0,1,3,4
E33032957,445,229,77,152,1,52,39,13,158,147,0,10,1,5
E33032958,507,284,114,170,6,61,40,21,154,147,0,5,2,2
E33032959,418,197,55,142,2,115,63,52,100,96,1,3,0,4
E33032960,259,131,60,71,2,65,49,16,54,51,1,2,0,7
E33032961,371,176,83,93,1,106,60,46,82,75,0,4,3,6
E33032962,822,460,95,365,17,155,91,64,175,167,0,6,2,15
E33032963,577,291,108,183,7,141,88,53,136,125,2,8,1,2
E33032964,332,137,31,106,3,138,117,21,51,49,1,0,1,3
E33032965,422,147,45,102,3,192,141,51,74,69,0,5,0,6
E33032966,442,195,69,126,10,112,68,44,122,119,0,2,1,3
E33032967,329,108,34,74,11,144,88,56,63,60,0,3,0,3
E33032968,258,129,51,78,4,51,22,29,69,65,0,4,0,5
E33032969,473,255,79,176,8,51,26,25,157,148,1,8,0,2
E33032970,393,197,79,118,9,60,35,25,122,118,0,3,1,5
E33032971,694,450,156,294,10,86,46,40,145,139,1,3,2,3
E33032972,224,111,49,62,5,36,26,10,67,63,0,2,2,5
E33032973,379,159,48,111,1,76,44,32,134,130,0,3,1,9
E33032974,328,161,67,94,6,59,36,23,92,91,0,1,0,10
E33032975,233,127,51,76,1,24,14,10,74,72,1,1,0,7
E33032976,339,164,80,84,6,32,23,9,132,130,0,2,0,5
E33032977,401,208,75,133,8,39,22,17,140,136,0,2,2,6
E33032978,333,198,67,131,10,40,22,18,84,82,0,1,1,1
E33032979,363,172,90,82,5,43,29,14,136,133,1,2,0,7
E33032980,685,394,113,281,8,54,28,26,220,204,3,8,5,9
E33032981,287,131,41,90,7,72,55,17,75,67,1,6,1,2
E33032982,487,247,100,147,3,77,49,28,158,154,0,2,2,2
E33032983,256,118,47,71,6,57,42,15,72,64,3,1,4,3
E33032984,257,119,39,80,3,74,58,16,57,55,0,2,0,4
E33032985,377,176,61,115,4,100,65,35,94,93,0,1,0,3
E33032986,298,138,48,90,3,94,59,35,60,55,1,4,0,3
E33032987,413,190,70,120,4,112,81,31,105,98,1,6,0,2
E33032988,435,223,52,171,12,58,27,31,134,129,0,2,3,8
E33032989,639,275,86,189,12,139,76,63,197,192,0,4,1,16
E33032990,342,204,80,124,2,31,18,13,104,96,0,5,3,1
E33032991,471,170,51,119,8,62,29,33,226,221,1,3,1,5
E33032992,351,186,85,101,2,44,35,9,115,104,1,9,1,4
E33032993,347,153,55,98,4,42,31,11,146,143,0,3,0,2
E33032994,265,159,90,69,3,22,4,18,78,75,0,2,1,3
E33032995,251,150,91,59,2,24,9,15,69,67,0,2,0,6
E33032996,427,185,61,124,4,50,30,20,183,180,0,1,2,5
E33032997,468,205,79,126,1,72,35,37,182,171,1,9,1,8
E33032998,618,346,135,211,8,56,27,29,203,189,4,6,4,5
E33032999,260,120,46,74,3,48,37,11,86,80,0,6,0,3
E33033000,738,233,70,163,14,163,125,38,326,317,1,6,2,2
E33033001,414,222,84,138,7,57,44,13,121,113,2,5,1,7
E33033002,265,101,30,71,1,85,67,18,74,72,1,1,0,4
E33033003,671,278,87,191,9,221,185,36,150,142,0,8,0,13
E33033004,252,86,37,49,2,95,42,53,63,60,0,2,1,6
E33033005,464,196,68,128,7,118,70,48,142,132,0,6,4,1
E33033006,379,142,42,100,6,97,66,31,128,120,1,5,2,6
E33033007,378,159,57,102,1,62,41,21,153,145,2,5,1,3
E33033008,385,183,46,137,4,56,29,27,135,131,0,2,2,7
E33033009,329,131,43,88,4,80,39,41,104,100,1,2,1,10
E33033010,322,174,72,102,0,78,73,5,65,63,1,1,0,5
E33033011,481,216,83,133,3,96,59,37,159,155,1,3,0,7
E33033012,395,201,84,117,3,49,35,14,132,127,0,4,1,10
E33033013,280,95,36,59,7,51,42,9,125,114,0,6,5,2
E33033014,353,126,46,80,8,100,67,33,110,99,0,9,2,9
E33033015,277,101,26,75,1,107,89,18,65,61,0,4,0,3
E33033016,349,160,64,96,6,73,49,24,104,91,0,13,0,6
E33033017,408,200,89,111,6,112,60,52,86,74,0,7,5,4
E33033018,493,233,98,135,3,90,57,33,158,146,0,6,6,9
E33033019,284,144,51,93,0,44,23,21,96,90,2,2,2,0
E33033020,300,166,93,73,3,22,6,16,103,99,0,2,2,6
E33033021,346,157,68,89,3,67,38,29,114,111,0,3,0,5
E33033022,349,159,54,105,3,56,23,33,126,118,1,1,6,5
E33033023,589,275,86,189,5,131,83,48,176,168,0,8,0,2
E33033024,615,285,101,184,6,113,82,31,205,199,1,4,1,6
E33033025,478,252,133,119,4,74,51,23,129,127,0,2,0,19
E33033026,304,132,46,86,4,51,40,11,109,103,1,5,0,8
E33033027,461,245,87,158,4,55,26,29,151,143,0,4,4,6
E33033028,305,140,49,91,1,68,50,18,94,80,6,6,2,2
E33033029,323,118,39,79,2,71,47,24,126,117,0,4,5,6
E33033030,230,108,54,54,1,33,15,18,86,82,2,2,0,2
E33033031,508,259,118,141,5,58,35,23,179,167,0,12,0,7
E33033032,961,457,147,310,18,162,77,85,316,300,0,12,4,8
E33033033,326,183,89,94,6,25,14,11,106,97,3,6,0,6
E33033034,842,396,99,297,17,99,58,41,324,312,2,9,1,6
E33033035,380,127,36,91,15,132,79,53,101,96,0,2,3,5
E33033036,483,258,93,165,8,60,35,25,157,147,0,8,2,0
E33033037,282,112,37,75,7,104,68,36,56,54,0,1,1,3
E33033038,474,201,59,142,15,118,73,45,135,128,0,6,1,5
E33033039,951,466,124,342,19,96,49,47,360,351,0,8,1,10
E33033040,443,204,58,146,2,112,81,31,120,119,0,1,0,5
E33033041,560,274,86,188,6,89,59,30,188,175,1,11,1,3
E33033042,662,323,98,225,15,168,109,59,154,142,5,6,1,2
E33033043,284,93,34,59,2,69,53,16,113,109,0,3,1,7
E33033044,290,110,28,82,0,112,68,44,67,63,0,3,1,1
E33033045,240,105,36,69,4,65,54,11,61,52,0,9,0,5
E33033046,298,132,48,84,3,84,50,34,76,74,0,2,0,3
E33033047,310,123,33,90,3,83,59,24,98,96,0,1,1,3
E33033048,473,163,45,118,15,136,109,27,156,148,1,3,4,3
E33033049,726,351,111,240,11,93,65,28,257,243,2,10,2,14
E33033050,254,134,53,81,1,56,36,20,61,59,1,0,1,2
E33033051,304,162,99,63,7,44,25,19,72,60,5,0,7,19
E33033052,361,122,36,86,2,126,94,32,107,98,3,6,0,4
E33033053,504,202,51,151,13,178,107,71,104,100,0,3,1,7
E33033054,264,90,32,58,3,106,78,28,59,58,0,1,0,6
E33033055,377,221,48,173,4,59,31,28,91,84,0,5,2,2
E33033056,874,422,99,323,11,154,101,53,279,272,2,5,0,8
E33033057,362,148,45,103,7,132,88,44,73,67,3,3,0,2
E33033058,406,124,42,82,5,192,125,67,81,71,0,7,3,4
E33033059,335,154,22,132,4,89,80,9,87,82,0,3,2,1
E33033060,697,326,90,236,12,161,107,54,192,174,1,16,1,6
E33033061,768,390,113,277,16,153,98,55,203,193,0,9,1,6
E33033062,365,140,26,114,11,103,63,40,98,92,0,5,1,13
E33033063,279,137,30,107,4,63,22,41,68,59,0,8,1,7
E33033064,364,149,46,103,3,91,56,35,121,116,1,4,0,0
E33033065,514,252,87,165,14,107,53,54,133,127,0,3,3,8
E33033066,298,91,33,58,6,79,50,29,120,118,0,2,0,2
E33033067,625,323,106,217,11,104,61,43,180,175,2,2,1,7
E33033068,366,160,60,100,4,59,38,21,134,129,0,5,0,9
E33033069,428,133,39,94,2,105,53,52,181,168,7,3,3,7
E33033070,576,329,101,228,10,63,31,32,168,161,2,5,0,6
E33033071,372,179,57,122,8,79,52,27,84,77,0,7,0,22
E33033072,321,108,30,78,5,141,71,70,59,56,0,2,1,8
E33033073,490,271,90,181,7,73,38,35,139,132,0,5,2,0
E33033074,656,378,79,299,8,28,16,12,236,230,1,5,0,6
E33033075,476,136,52,84,7,142,96,46,187,178,3,6,0,4
E33033076,310,134,44,90,6,64,24,40,105,104,0,1,0,1
E33033077,551,297,80,217,9,90,47,43,151,132,3,16,0,4
E33033078,590,279,59,220,7,85,68,17,216,198,1,16,1,3
E33033079,233,81,29,52,7,57,34,23,87,85,0,2,0,1
E33033080,548,278,86,192,7,69,38,31,187,179,0,8,0,7
E33033081,466,193,56,137,13,136,77,59,116,113,0,2,1,8
E33033082,538,279,75,204,5,74,35,39,173,159,3,9,2,7
E33033083,307,170,51,119,3,54,36,18,74,67,0,5,2,6
E33033084,558,304,76,228,10,92,45,47,146,135,1,7,3,6
E33033085,320,153,35,118,5,58,24,34,97,86,2,6,3,7
E33033086,381,247,69,178,5,67,36,31,61,60,0,1,0,1
E33033087,731,372,108,264,8,107,50,57,235,222,5,3,5,9
E33033088,331,204,45,159,8,41,27,14,75,70,0,5,0,3
E33033089,323,244,70,174,1,15,6,9,58,55,0,2,1,5
E33033090,303,211,86,125,2,27,16,11,60,56,0,4,0,3
E33033091,352,246,71,175,1,21,8,13,83,78,1,3,1,1
E33033092,359,251,71,180,9,28,9,19,70,66,0,1,3,1
E33033093,436,268,73,195,2,39,20,19,124,117,1,4,2,3
E33033094,879,540,137,403,10,73,29,44,251,241,1,5,4,5
E33033095,495,281,69,212,9,97,62,35,107,95,1,11,0,1
E33033096,562,296,88,208,11,78,60,18,172,165,0,6,1,5
E33033097,346,185,44,141,2,44,27,17,112,110,0,2,0,3
E33033098,308,171,60,111,3,27,8,19,102,93,2,4,3,5
E33033099,281,150,35,115,1,32,14,18,96,90,0,6,0,2
E33033100,324,192,50,142,3,37,16,21,88,87,0,1,0,4
E33033101,386,251,55,196,9,41,13,28,84,76,0,4,4,1
E33033102,489,277,79,198,1,104,55,49,105,103,1,1,0,2
E33033103,511,324,94,230,9,66,22,44,109,99,3,5,2,3
E33033104,294,175,49,126,1,43,17,26,75,71,0,2,2,0
E33033105,626,433,97,336,3,35,13,22,146,131,3,12,0,9
E33033106,599,331,79,252,8,88,31,57,166,160,1,5,0,6
E33033107,772,406,108,298,4,111,44,67,248,236,2,7,3,3
E33033108,364,251,57,194,0,38,17,21,73,69,0,4,0,2
E33033109,694,465,81,384,17,77,26,51,126,121,1,4,0,9
E33033110,397,276,81,195,6,37,17,20,77,70,0,5,2,1
E33033111,287,135,42,93,1,74,36,38,72,67,0,5,0,5
E33033112,256,161,32,129,3,35,17,18,55,50,0,5,0,2
E33033113,378,185,27,158,7,60,18,42,119,109,0,9,1,7
E33033114,287,157,27,130,1,57,24,33,72,70,1,1,0,0
E33033115,382,232,58,174,3,54,22,32,90,88,0,1,1,3
E33033116,563,357,112,245,8,62,30,32,129,121,1,7,0,7
E33033117,418,273,85,188,2,18,10,8,115,110,0,3,2,10
E33033118,386,235,55,180,5,30,17,13,111,105,0,5,1,5
E33033119,509,293,75,218,8,92,51,41,110,107,0,3,0,6
E33033120,414,223,72,151,2,76,36,40,109,106,0,3,0,4
E33033121,379,233,66,167,1,72,42,30,68,64,0,3,1,5
E33033122,509,311,89,222,16,68,30,38,110,105,1,4,0,4
E33033123,467,267,72,195,9,60,22,38,127,114,3,5,5,4
E33033124,481,282,75,207,15,65,31,34,118,112,0,3,3,1
E33033125,396,248,77,171,1,26,12,14,113,105,0,8,0,8
E33033126,360,230,62,168,2,39,17,22,86,83,0,3,0,3
E33033127,284,177,56,121,4,36,11,25,62,60,1,1,0,5
E33033128,797,476,118,358,12,101,58,43,201,194,1,6,0,7
E33033129,313,179,48,131,5,48,20,28,80,80,0,0,0,1
E33033130,381,221,48,173,1,69,35,34,89,83,0,5,1,1
E33033131,307,175,41,134,4,54,27,27,69,63,1,3,2,5
E33033132,391,225,61,164,5,63,31,32,95,90,0,4,1,3
E33033133,367,226,65,161,3,69,35,34,67,62,0,4,1,2
E33033134,864,550,120,430,20,142,51,91,148,139,0,9,0,4
E33033135,884,498,121,377,13,182,84,98,184,175,1,8,0,7
E33033136,285,135,28,107,0,63,46,17,87,81,3,2,1,0
E33033137,383,244,75,169,7,55,21,34,74,72,0,1,1,3
E33033138,326,185,46,139,14,74,12,62,53,49,0,3,1,0
E33033139,330,218,69,149,4,49,15,34,55,53,0,2,0,4
E33033140,300,231,42,189,3,23,10,13,42,39,0,2,1,1
E33033141,575,386,94,292,6,94,55,39,87,82,0,3,2,2
E33033142,271,173,53,120,7,29,17,12,58,52,1,2,3,4
E33033143,303,179,50,129,11,32,6,26,80,77,0,2,1,1
E33033144,264,142,31,111,4,43,19,24,70,67,0,1,2,5
E33033145,308,176,47,129,4,46,30,16,79,77,0,2,0,3
E33033146,2979,1845,496,1349,57,415,185,230,647,614,8,21,4,15
E33033147,372,204,57,147,20,60,33,27,85,81,2,0,2,3
E33033148,301,166,31,135,1,49,8,41,82,75,0,6,1,3
E33033149,446,279,70,209,6,38,13,25,120,112,1,5,2,3
E33033150,441,234,71,163,4,85,46,39,116,105,1,2,8,2
E33033151,252,153,45,108,2,36,13,23,61,57,0,4,0,0
E33033152,369,251,60,191,7,41,19,22,68,65,1,1,1,2
E33033153,398,270,69,201,6,53,19,34,61,55,1,5,0,8
E33033154,298,198,49,149,4,30,10,20,66,64,0,1,1,0
E33033155,301,203,60,143,6,27,10,17,64,61,0,2,1,1
E33033156,502,424,122,302,0,28,12,16,47,42,0,4,1,3
E33033157,482,392,86,306,2,36,12,24,50,43,3,4,0,2
E33033158,364,313,78,235,1,26,10,16,24,23,0,1,0,0
E33033159,437,269,80,189,4,84,39,45,80,73,0,7,0,0
E33033160,303,145,43,102,7,30,14,16,116,110,0,6,0,5
E33033161,424,208,48,160,3,74,44,30,135,129,0,4,2,4
E33033162,454,303,78,225,7,57,34,23,84,82,0,2,0,3
E33033163,328,178,52,126,11,49,28,21,88,79,0,5,4,2
E33033164,240,131,27,104,4,27,13,14,75,70,2,1,2,3
E33033165,665,390,78,312,6,73,26,47,188,181,1,4,2,8
E33033166,831,585,148,437,8,87,42,45,146,139,0,6,1,5
E33033167,270,134,28,106,7,42,16,26,85,79,0,6,0,2
E33033168,969,513,138,375,12,191,114,77,247,227,4,12,4,6
E33033169,307,146,47,99,4,39,15,24,116,113,0,3,0,2
E33033170,390,195,48,147,5,67,41,26,120,113,0,5,2,3
E33033171,349,285,69,216,2,19,7,12,39,36,1,2,0,4
E33033172,348,242,73,169,8,38,14,24,59,57,0,2,0,1
E33033173,358,272,77,195,4,27,9,18,54,49,0,4,1,1
E33033174,392,276,90,186,7,22,9,13,80,76,1,2,1,7
E33033175,307,168,53,115,5,45,27,18,83,77,0,4,2,6
E33033176,333,184,61,123,1,51,25,26,92,80,2,5,5,5
E33033177,290,161,49,112,9,18,1,17,94,90,2,2,0,8
E33033178,438,249,63,186,6,70,32,38,112,107,0,4,1,1
E33033179,823,461,127,334,14,79,35,44,260,249,1,9,1,9
E33033180,300,126,25,101,2,29,12,17,137,134,0,3,0,6
E33033181,345,162,35,127,6,41,18,23,131,122,1,6,2,5
E33033182,297,140,54,86,2,12,5,7,140,134,0,5,1,3
E33033183,550,358,140,218,2,41,16,25,136,131,1,4,0,13
E33033184,394,264,98,166,4,40,25,15,84,82,0,2,0,2
E33033185,377,232,45,187,3,39,16,23,95,88,1,5,1,8
E33033186,241,136,38,98,4,31,15,16,69,65,0,2,2,1
E33033187,1799,897,241,656,17,376,220,156,498,469,1,24,4,11
E33033188,463,328,87,241,5,42,21,21,83,80,0,2,1,5
E33033189,459,268,80,188,14,62,34,28,112,104,1,6,1,3
E33033190,591,415,111,304,5,49,20,29,117,101,3,11,2,5
E33033191,309,186,55,131,4,45,27,18,74,70,0,4,0,0
E33033192,421,295,85,210,1,54,21,33,64,57,2,1,4,7
E33033193,602,410,129,281,3,145,108,37,36,34,1,0,1,8
E33033194,322,274,92,182,0,19,8,11,21,21,0,0,0,8
E33033195,291,222,68,154,0,25,14,11,39,37,0,0,2,5
E33033196,286,246,56,190,1,13,5,8,26,25,0,1,0,0
E33033197,403,280,84,196,2,44,14,30,72,68,0,3,1,5
E33033198,295,216,84,132,3,30,25,5,40,36,2,1,1,6
E33033199,401,302,101,201,4,44,15,29,47,46,1,0,0,4
E33033200,241,120,34,86,4,43,28,15,74,74,0,0,0,0
E33033201,339,196,49,147,5,24,12,12,113,105,2,6,0,1
E33033202,723,500,124,376,13,52,28,24,154,146,0,6,2,4
E33033203,275,144,32,112,3,33,25,8,95,87,1,6,1,0
E33033204,332,184,48,136,3,29,11,18,113,107,2,4,0,3
E33033205,613,317,85,232,7,66,29,37,213,195,1,13,4,10
E33033206,289,151,51,100,4,30,11,19,100,96,0,4,0,4
E33033207,259,138,41,97,6,49,21,28,65,62,1,1,1,1
E33033208,638,382,103,279,11,114,47,67,125,114,1,6,4,6
E33033209,638,403,92,311,11,89,38,51,131,127,0,4,0,4
E33033210,379,231,57,174,4,45,26,19,97,93,0,2,2,2
E33033211,948,680,160,520,6,107,54,53,152,142,5,5,0,3
E33033212,356,215,49,166,5,99,71,28,33,31,0,2,0,4
E33033213,314,167,39,128,0,67,50,17,75,72,1,0,2,5
E33033214,550,341,94,247,9,63,32,31,126,98,25,1,2,11
E33033215,544,332,78,254,13,93,36,57,101,92,2,4,3,5
E33033216,490,316,74,242,5,44,19,25,117,110,1,4,2,8
E33033217,476,288,86,202,7,89,50,39,92,91,0,1,0,0
E33033218,416,269,65,204,5,52,32,20,87,85,0,0,2,3
E33033219,243,170,72,98,3,28,12,16,36,36,0,0,0,6
E33033220,299,192,71,121,1,24,12,12,76,69,3,2,2,6
E33033221,320,227,61,166,4,35,15,20,50,42,4,4,0,4
E33033222,526,292,67,225,4,85,38,47,141,134,0,6,1,4
E33033223,756,349,93,256,6,342,261,81,55,51,0,3,1,4
E33033224,230,149,48,101,1,31,14,17,45,38,1,3,3,4
E33033225,640,441,99,342,13,77,37,40,109,99,1,9,0,0
E33033226,490,316,110,206,5,61,22,39,105,99,0,6,0,3
E33033227,668,472,128,344,12,50,22,28,131,125,0,6,0,3
E33033228,344,244,81,163,0,26,12,14,73,71,0,1,1,1
E33033229,486,343,91,252,7,28,12,16,101,97,0,3,1,7
E33033230,371,253,60,193,1,81,48,33,35,34,0,1,0,1
E33033231,392,276,72,204,3,86,60,26,26,22,0,4,0,1
E33033232,766,476,122,354,3,201,129,72,81,78,0,3,0,5
E33033233,283,251,97,154,0,19,12,7,12,11,0,1,0,1
E33033234,343,292,66,226,1,9,6,3,40,40,0,0,0,1
E33033235,257,221,62,159,0,18,9,9,17,13,1,3,0,1
E33033236,271,212,56,156,0,20,11,9,36,29,6,0,1,3
E33033237,682,523,185,338,3,64,38,26,87,84,1,2,0,5
E33033238,318,214,56,158,4,43,29,14,49,46,1,2,0,8
E33033239,667,434,115,319,6,131,87,44,93,80,2,11,0,3
E33033240,305,234,55,179,6,23,14,9,41,35,0,6,0,1
E33033241,463,403,123,280,2,25,7,18,31,26,2,3,0,2
E33033242,354,283,63,220,1,17,9,8,52,46,0,5,1,1
E33033243,312,285,109,176,0,7,2,5,20,16,2,2,0,0
E33033244,447,318,102,216,4,45,27,18,73,69,3,1,0,7
E33033245,356,304,111,193,1,22,12,10,21,20,0,1,0,8
E33033246,465,361,128,233,3,19,9,10,78,77,0,1,0,4
E33033247,417,250,78,172,9,107,69,38,48,43,1,4,0,3
E33033248,411,233,50,183,6,107,72,35,60,55,1,4,0,5
E33033249,796,424,97,327,4,245,152,93,112,107,1,3,1,11
E33033250,358,249,81,168,0,30,15,15,73,73,0,0,0,6
E33033251,311,235,89,146,3,27,18,9,45,42,2,1,0,1
E33033252,266,240,81,159,0,8,2,6,15,15,0,0,0,3
E33033253,257,173,50,123,2,25,16,9,55,53,0,2,0,2
E33033254,421,319,82,237,8,25,15,10,65,60,1,4,0,4
E33033255,419,300,90,210,14,31,9,22,74,72,0,2,0,0
E33033256,284,212,62,150,9,20,13,7,34,32,1,1,0,9
E33033257,431,280,87,193,6,47,17,30,90,89,1,0,0,8
E33033258,389,345,101,244,2,15,6,9,25,22,0,2,1,2
E33033259,392,306,104,202,1,20,6,14,61,52,2,6,1,4
E33033260,355,258,91,167,4,37,17,20,53,52,0,1,0,3
E33033261,612,461,138,323,6,55,36,19,88,74,1,5,8,2
E33033262,313,249,73,176,3,21,9,12,37,31,0,5,1,3
E33033263,297,236,75,161,2,26,15,11,32,32,0,0,0,1
E33033264,370,291,74,217,2,45,33,12,28,22,4,2,0,4
E33033265,366,292,81,211,0,30,22,8,38,36,0,2,0,6
E33033266,268,212,77,135,2,21,11,10,30,30,0,0,0,3
E33033267,469,353,88,265,4,46,22,24,63,60,2,1,0,3
E33033268,432,344,63,281,4,40,21,19,42,38,0,4,0,2
E33033269,305,230,57,173,3,39,25,14,30,25,0,5,0,3
E33033270,247,165,55,110,5,21,12,9,53,48,0,4,1,3
E33033271,274,222,60,162,4,12,5,7,31,24,0,5,2,5
E33033272,341,259,72,187,5,18,5,13,56,53,0,3,0,3
E33033273,347,255,66,189,7,41,24,17,37,31,0,5,1,7
E33033274,646,486,127,359,11,65,36,29,78,75,0,3,0,6
E33033275,496,377,85,292,1,35,16,19,82,80,2,0,0,1
E33033276,345,259,80,179,2,28,14,14,55,51,0,4,0,1
E33033277,491,395,123,272,1,31,15,16,63,60,0,2,1,1
E33033278,356,264,60,204,7,40,25,15,45,42,0,3,0,0
E33033279,351,304,83,221,6,17,14,3,24,23,0,1,0,0
E33033280,303,233,85,148,3,32,11,21,35,33,1,1,0,0
E33033281,338,290,62,228,0,26,15,11,22,22,0,0,0,0
E33033282,562,451,125,326,8,35,21,14,67,64,1,2,0,1
E33033283,306,265,82,183,4,18,10,8,17,16,0,1,0,2
E33033284,352,292,80,212,1,20,6,14,37,28,6,2,1,2
E33033285,315,271,79,192,5,12,4,8,26,22,2,1,1,1
E33033286,435,326,81,245,6,56,36,20,43,39,1,3,0,4
E33033287,303,233,63,170,1,25,20,5,39,34,3,2,0,5
E33033288,438,268,72,196,6,34,18,16,129,117,0,10,2,1
E33033289,418,205,52,153,3,26,19,7,184,179,0,5,0,0
E33033290,482,263,80,183,7,52,33,19,158,150,3,5,0,2
E33033291,1054,540,128,412,11,118,65,53,375,361,1,9,4,10
E33033292,466,227,52,175,6,17,10,7,214,212,0,0,2,2
E33033293,325,202,62,140,3,22,12,10,96,95,0,1,0,2
E33033294,390,197,58,139,4,24,13,11,162,155,3,3,1,3
E33033295,554,251,67,184,2,31,17,14,266,255,1,7,3,4
E33033296,593,355,97,258,14,85,54,31,136,131,0,5,0,3
E33033297,433,246,64,182,7,78,40,38,100,90,0,6,4,2
E33033298,641,337,76,261,9,126,90,36,167,165,1,1,0,2
E33033299,269,148,27,121,4,34,19,15,77,72,2,1,2,6
E33033300,284,165,43,122,5,32,20,12,80,74,3,3,0,2
E33033301,571,358,111,247,9,57,29,28,137,129,1,7,0,10
E33033302,966,616,160,456,8,109,54,55,216,207,0,8,1,17
E33033303,748,399,93,306,5,47,28,19,291,264,1,22,4,6
E33033304,597,380,102,278,12,42,26,16,155,140,0,14,1,8
E33033305,511,301,101,200,1,20,10,10,189,183,0,4,2,0
E33033306,335,155,50,105,3,69,33,36,105,99,1,5,0,3
E33033307,415,272,86,186,7,44,33,11,90,84,0,1,5,2
E33033308,408,221,71,150,3,43,29,14,137,132,1,3,1,4
E33033309,476,233,63,170,3,38,20,18,197,191,0,4,2,5
E33033310,383,226,56,170,2,13,6,7,132,125,0,7,0,10
E33033311,379,172,52,120,4,25,16,9,172,156,7,6,3,6
E33033312,448,273,85,188,5,27,15,12,142,132,1,9,0,1
E33033313,414,217,62,155,4,27,9,18,159,150,0,9,0,7
E33033314,740,388,99,289,21,94,51,43,234,220,1,8,5,3
E33033315,474,218,31,187,7,131,83,48,112,109,0,0,3,6
E33033316,342,248,79,169,5,41,28,13,41,40,0,1,0,7
E33033317,492,278,78,200,4,78,64,14,127,118,1,5,3,5
E33033318,344,194,48,146,3,79,62,17,66,66,0,0,0,2
E33033319,459,267,79,188,5,54,30,24,130,122,3,5,0,3
E33033320,303,180,41,139,2,57,29,28,61,61,0,0,0,3
E33033321,369,128,20,108,16,50,12,38,173,164,0,5,4,2
E33033322,509,278,79,199,10,58,31,27,158,144,2,11,1,5
E33033323,281,151,34,117,4,49,33,16,75,67,0,8,0,2
E33033324,388,176,44,132,3,24,14,10,180,178,0,1,1,5
E33033325,786,272,81,191,21,67,37,30,413,401,0,9,3,13
E33033326,286,162,56,106,3,11,5,6,106,103,1,2,0,4
E33033327,315,200,86,114,5,24,9,15,85,81,2,2,0,1
E33033328,524,270,79,191,11,43,27,16,195,186,1,8,0,5
E33033329,504,238,85,153,12,86,63,23,161,156,0,4,1,7
E33033330,358,187,59,128,5,24,11,13,139,131,2,2,4,3
E33033331,293,200,62,138,1,23,14,9,61,55,0,1,5,8
E33033332,351,264,99,165,1,8,2,6,76,72,0,3,1,2
E33033333,317,196,79,117,1,28,19,9,90,88,0,2,0,2
E33033334,333,205,59,146,3,42,29,13,80,78,1,1,0,3
E33033335,450,281,85,196,8,18,8,10,134,129,0,5,0,9
E33033336,679,373,105,268,12,45,25,20,242,229,0,12,1,7
E33033337,592,204,56,148,8,95,46,49,274,269,3,1,1,11
E33033338,400,173,48,125,5,51,14,37,168,156,3,8,1,3
E33033339,768,395,113,282,14,124,68,56,234,219,1,8,6,1
E33033340,339,150,41,109,4,48,24,24,134,131,1,2,0,3
E33033341,646,341,94,247,7,67,19,48,227,211,3,13,0,4
E33033342,631,331,97,234,26,26,12,14,240,225,1,13,1,8
E33033343,2033,1095,233,862,27,210,88,122,688,657,3,24,4,13
E33033344,172,88,24,64,3,25,9,16,56,54,0,2,0,0
E33033345,619,296,87,209,8,64,32,32,242,232,0,7,3,9
E33033346,506,246,54,192,6,96,79,17,149,141,0,8,0,9
E33033347,558,314,77,237,4,79,66,13,156,152,0,2,2,5
E33033348,398,223,53,170,8,66,45,21,98,92,1,4,1,3
E33033349,296,207,76,131,5,24,11,13,53,50,1,2,0,7
E33033350,328,210,80,130,9,27,20,7,76,62,0,12,2,6
E33033351,358,210,72,138,2,26,16,10,117,108,1,6,2,3
E33033352,298,184,63,121,5,22,13,9,82,81,0,0,1,5
E33033353,248,179,61,118,4,14,11,3,44,40,0,2,2,7
E33033354,304,215,78,137,3,20,12,8,63,61,0,2,0,3
E33033355,517,267,84,183,10,107,88,19,130,121,2,6,1,3
E33033356,237,136,44,92,0,25,11,14,74,73,1,0,0,2
E33033357,640,353,114,239,7,94,35,59,182,177,2,1,2,4
E33033358,291,141,38,103,14,45,20,25,91,87,2,2,0,0
E33033359,310,210,90,120,3,23,3,20,74,69,1,4,0,0
E33033360,559,326,117,209,15,55,33,22,161,152,0,3,6,2
E33033361,284,145,73,72,4,23,15,8,108,102,0,4,2,4
E33033362,620,346,116,230,4,62,32,30,200,185,10,2,3,8
E33033363,299,226,90,136,3,12,4,8,54,51,0,1,2,4
E33033364,265,183,60,123,2,13,4,9,60,59,0,1,0,7
E33033365,375,202,97,105,3,37,20,17,125,116,9,0,0,8
E33033366,302,167,69,98,4,28,9,19,101,99,0,2,0,2
E33033367,1044,467,163,304,14,196,108,88,361,349,1,10,1,6
E33033368,356,201,68,133,6,25,9,16,117,113,0,3,1,7
E33033369,363,193,77,116,3,36,22,14,128,123,3,2,0,3
E33033370,287,162,58,104,3,29,7,22,91,86,2,3,0,2
E33033371,989,530,176,354,17,105,49,56,323,314,2,5,2,14
E33033372,292,144,49,95,1,22,4,18,123,116,0,7,0,2
E33033373,261,147,60,87,0,22,12,10,90,90,0,0,0,2
E33033374,385,214,88,126,2,20,7,13,147,143,0,2,2,2
E33033375,333,155,59,96,4,48,24,24,121,117,0,4,0,5
E33033376,386,177,60,117,6,35,6,29,166,144,0,21,1,2
E33033377,311,136,43,93,6,43,21,22,126,120,4,1,1,0
E33033378,549,322,108,214,6,43,25,18,171,161,0,6,4,7
E33033379,722,431,103,328,11,63,39,24,215,206,0,6,3,2
E33033380,519,315,96,219,7,55,19,36,132,121,3,5,3,10
E33033381,567,430,136,294,13,36,16,20,81,72,1,6,2,7
E33033382,249,167,60,107,5,28,12,16,48,45,1,0,2,1
E33033383,398,220,91,129,10,43,33,10,118,110,1,6,1,7
E33033384,313,214,65,149,8,25,20,5,62,60,0,0,2,4
E33033385,581,247,87,160,8,90,46,44,226,206,4,10,6,10
E33033386,353,126,40,86,11,63,35,28,150,137,1,1,11,3
E33033387,300,150,46,104,11,45,26,19,89,84,0,3,2,5
E33033388,647,296,96,200,11,109,65,44,224,213,1,4,6,7
E33033389,506,256,59,197,29,67,26,41,150,140,0,10,0,4
E33033390,361,197,63,134,1,39,12,27,121,109,0,10,2,3
E33033391,335,137,37,100,7,59,17,42,130,127,0,2,1,2
E33033392,319,120,39,81,9,70,37,33,113,107,1,5,0,7
E33033393,432,204,66,138,9,74,45,29,141,140,0,1,0,4
E33033394,351,188,65,123,7,38,13,25,118,113,1,3,1,0
E33033395,308,180,61,119,8,37,10,27,70,67,0,0,3,13
E33033396,594,377,140,237,6,76,42,34,132,103,19,3,7,3
E33033397,315,179,60,119,6,36,23,13,90,81,1,4,4,4
E33033398,358,195,72,123,7,45,13,32,106,96,3,4,3,5
E33033399,391,231,85,146,5,36,16,20,111,106,1,3,1,8
E33033400,559,292,98,194,13,65,38,27,186,183,0,3,0,3
E33033401,401,216,81,135,4,34,23,11,138,130,0,7,1,9
E33033402,821,433,152,281,8,58,23,35,305,295,1,7,2,17
E33033403,433,183,56,127,4,42,13,29,200,196,1,3,0,4
E33033404,304,136,50,86,10,33,16,17,120,119,0,1,0,5
E33033405,326,116,30,86,5,95,69,26,106,105,0,0,1,4
E33033406,597,267,88,179,10,116,64,52,201,192,1,6,2,3
E33033407,618,323,115,208,10,92,51,41,182,176,1,5,0,11
E33033408,436,203,70,133,7,72,37,35,151,144,0,7,0,3
E33033409,391,167,43,124,7,63,33,30,150,146,0,4,0,4
E33033410,953,515,152,363,19,94,50,44,307,300,2,2,3,18
E33033411,397,251,76,175,1,13,8,5,131,129,0,2,0,1
E33033412,573,281,83,198,12,146,115,31,126,121,1,3,1,8
E33033413,407,207,83,124,8,64,26,38,126,118,0,8,0,2
E33033414,424,239,75,164,13,97,64,33,71,65,0,6,0,4
E33033415,4080,2527,632,1895,101,546,275,271,884,829,9,38,8,22
E33033416,627,290,94,196,5,77,44,33,247,238,3,5,1,8
E33033417,438,244,68,176,4,59,34,25,129,127,0,2,0,2
E33033418,354,196,58,138,12,37,21,16,106,104,0,0,2,3
E33033419,1003,708,183,525,10,78,51,27,199,181,1,16,1,8
E33033420,491,281,85,196,11,52,30,22,145,141,0,3,1,2
E33033421,384,210,68,142,7,46,39,7,115,110,0,5,0,6
E33033422,310,184,73,111,3,22,14,8,96,93,1,1,1,5
E33033423,352,227,69,158,4,29,13,16,90,85,1,0,4,2
E33033424,296,135,44,91,5,21,11,10,132,129,0,3,0,3
E33033425,458,213,58,155,7,72,46,26,158,152,3,2,1,8
E33033426,299,201,68,133,0,16,11,5,82,77,0,4,1,0
E33033427,334,229,89,140,3,12,7,5,82,80,0,2,0,8
E33033428,409,217,68,149,2,27,12,15,158,151,0,5,2,5
E33033429,526,301,91,210,2,50,31,19,170,157,6,6,1,3
E33033430,321,187,77,110,4,36,19,17,89,86,0,1,2,5
E33033431,458,208,67,141,9,131,88,43,99,93,0,5,1,11
E33033432,701,385,126,259,18,138,78,60,157,151,0,4,2,3
E33033433,298,153,47,106,3,53,25,28,84,78,1,4,1,5
E33033434,543,278,87,191,8,111,85,26,139,131,0,7,1,7
E33033435,361,167,59,108,3,93,69,24,97,95,0,2,0,1
E33033436,473,224,79,145,6,117,67,50,123,117,1,3,2,3
E33033437,282,199,74,125,3,14,6,8,61,58,2,1,0,5
E33033438,295,188,79,109,4,24,13,11,78,76,0,2,0,1
E33033439,265,174,81,93,2,14,9,5,73,70,2,1,0,2
E33033440,412,197,52,145,5,38,19,19,170,168,0,2,0,2
E33033441,498,293,90,203,11,34,18,16,157,153,1,2,1,3
E33033442,355,236,91,145,6,17,9,8,88,87,0,1,0,8
E33033443,340,224,73,151,0,25,11,14,90,90,0,0,0,1
E33033444,310,192,44,148,2,28,11,17,85,84,0,1,0,3
E33033445,789,439,110,329,13,112,66,46,221,213,0,7,1,4
E33033446,276,185,59,126,4,17,7,10,59,57,0,2,0,11
E33033447,475,264,74,190,9,71,48,23,123,115,1,5,2,8
E33033448,307,159,64,95,4,31,9,22,108,97,1,3,7,5
E33033449,406,259,80,179,8,27,12,15,103,95,0,7,1,9
E33033450,314,164,56,108,7,47,23,24,93,86,2,4,1,3
E33033451,413,239,64,175,3,30,18,12,141,129,0,9,3,0
E33033452,377,228,79,149,5,30,15,15,104,94,0,6,4,10
E33033453,348,189,68,121,8,32,18,14,118,106,1,9,2,1
E33033454,461,261,70,191,4,41,19,22,146,138,2,6,0,9
E33033455,667,388,133,255,13,74,40,34,186,170,4,5,7,6
E33033456,324,223,66,157,7,20,10,10,68,67,0,0,1,6
E33033457,237,136,41,95,5,34,12,22,62,49,7,0,6,0
E33033458,270,153,46,107,0,19,10,9,95,90,4,1,0,3
E33033459,421,189,57,132,8,60,42,18,158,149,2,4,3,6
E33033460,333,198,73,125,6,45,25,20,78,74,1,2,1,6
E33033461,334,182,49,133,1,28,19,9,117,107,2,7,1,6
E33033462,325,203,55,148,1,20,14,6,99,90,0,9,0,2
E33033463,324,227,54,173,7,32,21,11,54,49,0,2,3,4
E33033464,416,302,92,210,9,39,16,23,61,57,1,2,1,5
E33033465,406,271,68,203,3,44,23,21,84,73,0,10,1,4
E33033466,308,180,41,139,1,70,50,20,54,49,1,3,1,3
E33033467,545,334,88,246,9,113,74,39,87,84,0,3,0,2
E33033468,450,223,66,157,2,114,94,20,102,100,0,1,1,9
E33033469,434,285,54,231,7,49,14,35,89,82,2,3,2,4
E33033470,556,383,97,286,9,82,51,31,79,74,0,4,1,3
E33033471,399,230,55,175,5,80,55,25,81,77,0,4,0,3
E33033472,274,161,40,121,1,60,20,40,52,49,1,1,1,0
E33033473,618,418,85,333,11,61,32,29,123,112,2,8,1,5
E33033474,334,267,73,194,1,27,17,10,33,31,0,2,0,6
E33033475,287,217,74,143,2,33,19,14,33,30,1,2,0,2
E33033476,279,176,53,123,8,40,37,3,52,46,0,6,0,3
E33033477,296,219,72,147,1,34,20,14,42,38,3,1,0,0
E33033478,506,387,120,267,6,49,34,15,56,53,0,3,0,8
E33033479,397,267,54,213,2,69,56,13,55,52,0,3,0,4
E33033480,408,240,64,176,5,72,51,21,84,78,0,6,0,7
E33033481,372,244,58,186,2,33,20,13,92,89,0,3,0,1
E33033482,636,424,140,284,6,96,51,45,105,102,1,0,2,5
E33033483,404,316,93,223,6,37,29,8,42,39,3,0,0,3
E33033484,396,215,59,156,5,87,56,31,87,80,2,3,2,2
E33033485,311,204,32,172,5,69,53,16,31,26,0,3,2,2
E33033486,303,188,53,135,1,54,42,12,59,59,0,0,0,1
E33033487,531,352,107,245,5,84,54,30,89,82,0,5,2,1
E33033488,295,171,53,118,1,52,38,14,71,66,1,4,0,0
E33033489,478,357,106,251,3,55,35,20,62,54,0,8,0,1
E33033490,802,460,136,324,9,149,98,51,181,167,1,6,7,3
E33033491,345,239,79,160,1,44,27,17,60,56,0,1,3,1
E33033492,378,248,78,170,3,38,20,18,84,78,2,4,0,5
E33033493,338,248,75,173,1,25,13,12,61,53,0,6,2,3
E33033494,554,443,135,308,5,32,19,13,74,70,0,4,0,0
E33033495,257,200,59,141,3,15,8,7,38,34,0,4,0,1
E33033496,428,327,99,228,5,44,27,17,51,45,1,2,3,1
E33033497,597,394,118,276,6,61,37,24,128,120,3,5,0,8
E33033498,391,321,98,223,3,19,16,3,44,39,3,2,0,4
E33033499,575,385,99,286,6,77,43,34,101,87,2,6,6,6
E33033500,433,345,105,240,2,23,12,11,58,52,1,5,0,5
E33033501,310,204,74,130,4,27,18,9,71,65,0,5,1,4
E33033502,4027,2761,775,1986,43,456,248,208,746,677,29,23,17,21
E33033503,322,234,76,158,1,23,15,8,62,52,1,8,1,2
E33033504,295,219,59,160,1,10,8,2,56,55,0,0,1,9
E33033505,532,396,124,272,3,37,23,14,91,89,0,1,1,5
E33033506,354,225,86,139,3,41,30,11,82,75,3,3,1,3
E33033507,562,404,146,258,13,45,24,21,93,89,2,2,0,7
E33033508,497,309,80,229,1,52,33,19,133,126,2,5,0,2
E33033509,332,272,116,156,1,19,11,8,34,33,0,1,0,6
E33033510,228,186,62,124,0,11,8,3,29,27,1,1,0,2
E33033511,614,472,173,299,4,44,26,18,85,81,1,1,2,9
E33033512,443,299,80,219,5,68,48,20,70,64,0,4,2,1
E33033513,346,227,69,158,4,60,46,14,52,47,1,3,1,3
E33033514,563,402,124,278,5,83,44,39,60,60,0,0,0,13
E33033515,301,181,51,130,3,40,20,20,76,74,0,1,1,1
E33033516,588,336,89,247,6,96,53,43,146,137,1,5,3,4
E33033517,468,282,68,214,2,75,49,26,102,100,1,1,0,7
E33033518,414,330,120,210,2,33,24,9,44,37,1,3,3,5
E33033519,375,337,134,203,0,7,3,4,22,20,0,2,0,9
E33033520,367,295,75,220,4,30,20,10,36,34,0,1,1,2
E33033521,367,200,42,158,9,79,47,32,74,71,2,0,1,5
E33033522,308,195,65,130,4,40,24,16,68,62,0,5,1,1
E33033523,762,346,82,264,11,133,85,48,267,257,1,9,0,5
E33033524,401,247,63,184,3,67,36,31,83,78,2,1,2,1
E33033525,346,178,45,133,8,91,76,15,67,56,2,9,0,2
E33033526,292,205,58,147,3,13,8,5,69,67,1,1,0,2
E33033527,463,298,91,207,2,52,34,18,108,102,0,5,1,3
E33033528,504,308,104,204,9,54,35,19,132,130,0,2,0,1
E33033529,494,287,80,207,1,81,40,41,121,115,1,3,2,4
E33033530,345,203,63,140,4,46,35,11,92,89,0,3,0,0
E33033531,387,229,63,166,2,87,74,13,69,66,2,1,0,0
E33033532,289,194,46,148,1,26,16,10,62,58,0,4,0,6
E33033533,295,168,39,129,5,48,25,23,71,71,0,0,0,3
E33033534,596,433,112,321,6,73,54,19,79,74,0,5,0,5
E33033535,434,308,78,230,3,32,17,15,83,82,0,1,0,8
E33033536,380,273,67,206,2,35,30,5,67,63,0,4,0,3
E33033537,327,210,52,158,3,41,29,12,70,67,0,1,2,3
E33033538,535,437,151,286,0,28,15,13,58,56,2,0,0,12
E33033539,584,481,180,301,3,22,9,13,69,59,2,4,4,9
E33033540,266,170,45,125,2,43,33,10,48,41,1,5,1,3
E33033541,337,225,57,168,3,17,10,7,86,81,0,5,0,6
E33033542,550,347,99,248,6,76,43,33,113,108,0,2,3,8
E33033543,514,366,115,251,7,55,42,13,79,76,2,0,1,7
E33033544,415,316,122,194,0,13,11,2,84,81,0,3,0,2
E33033545,633,432,127,305,5,57,24,33,133,128,2,3,0,6
E33033546,263,189,78,111,5,16,6,10,48,46,1,1,0,5
E33033547,537,306,98,208,14,88,52,36,122,116,0,6,0,7
E33033548,342,190,65,125,2,34,26,8,111,108,0,3,0,5
E33033549,351,187,59,128,2,17,15,2,140,135,1,4,0,5
E33033550,372,231,72,159,5,54,44,10,81,78,0,3,0,1
E33033551,612,388,109,279,8,45,28,17,161,158,1,2,0,10
E33033552,597,368,96,272,9,47,18,29,166,160,1,5,0,7
E33033553,273,196,68,128,1,28,20,8,44,43,0,1,0,4
E33033554,245,198,73,125,5,12,6,6,28,20,8,0,0,2
E33033555,290,238,80,158,0,16,12,4,32,32,0,0,0,4
E33033556,538,390,132,258,5,44,25,19,94,90,0,3,1,5
E33033557,347,283,98,185,0,21,14,7,42,39,0,1,2,1
E33033558,353,289,95,194,3,19,12,7,39,39,0,0,0,3
E33033559,442,332,125,207,3,38,24,14,67,64,0,2,1,2
E33033560,265,179,56,123,1,25,18,7,57,52,3,2,0,3
E33033561,397,282,86,196,1,29,15,14,75,69,4,2,0,10
E33033562,319,265,89,176,1,10,4,6,37,36,0,0,1,6
E33033563,245,174,56,118,1,33,19,14,33,32,0,0,1,4
E33033564,477,289,88,201,4,49,30,19,127,119,1,5,2,8
E33033565,465,275,77,198,10,59,36,23,116,115,0,0,1,5
E33033566,321,157,43,114,1,52,24,28,110,103,1,3,3,1
E33033567,450,277,94,183,6,69,46,23,92,87,0,3,2,6
E33033568,449,241,81,160,5,74,38,36,122,113,2,5,2,7
E33033569,284,186,59,127,4,33,28,5,57,57,0,0,0,4
E33033570,297,175,44,131,2,38,20,18,76,74,0,2,0,6
E33033571,487,251,65,186,4,58,32,26,168,160,0,4,4,6
E33033572,553,375,124,251,8,66,33,33,97,92,0,2,3,7
E33033573,494,306,75,231,7,88,58,30,91,86,0,3,2,2
E33033574,505,260,84,176,6,103,69,34,125,118,0,6,1,11
E33033575,627,358,89,269,6,112,57,55,147,142,1,2,2,4
E33033576,480,271,83,188,7,100,39,61,97,95,0,1,1,5
E33033577,678,488,142,346,10,61,42,19,115,111,0,4,0,4
E33033578,620,351,112,239,1,92,50,42,174,164,1,7,2,2
E33033579,449,305,98,207,2,29,24,5,107,104,0,3,0,6
E33033580,280,130,30,100,5,61,44,17,81,76,0,0,5,3
E33033581,486,292,93,199,13,82,59,23,93,84,3,5,1,6
E33033582,500,342,91,251,5,72,47,25,75,72,1,2,0,6
E33033583,250,122,33,89,4,37,23,14,84,77,1,3,3,3
E33033584,502,304,109,195,4,92,49,43,98,94,0,2,2,4
E33033585,486,370,137,233,1,5,2,3,108,102,0,6,0,2
E33033586,302,221,74,147,1,11,8,3,60,58,0,1,1,9
E33033587,736,487,180,307,16,58,35,23,166,162,3,0,1,9
E33033588,322,182,58,124,1,41,22,19,97,88,1,7,1,1
E33033589,274,161,47,114,0,24,10,14,89,86,1,0,2,0
E33033590,289,212,77,135,3,14,9,5,60,53,6,1,0,0
E33033591,304,214,57,157,1,21,15,6,64,62,0,2,0,4
E33033592,457,279,96,183,2,38,24,14,133,126,1,5,1,5
E33033593,326,182,65,117,5,12,8,4,127,124,0,0,3,0
E33033594,399,227,44,183,1,73,42,31,94,88,0,2,4,4
E33033595,893,590,82,508,17,125,57,68,155,141,1,11,2,6
E33033596,247,138,35,103,11,55,28,27,40,37,0,3,0,3
E33033597,686,411,117,294,8,132,87,45,133,125,1,6,1,2
E33033598,477,283,82,201,5,111,55,56,71,63,1,6,1,7
E33033599,475,209,66,143,4,148,93,55,107,103,0,3,1,7
E33033600,338,167,53,114,2,91,59,32,72,69,0,1,2,6
E33033601,448,233,65,168,3,33,24,9,178,171,2,5,0,1
E33033602,660,410,115,295,7,94,55,39,143,132,3,8,0,6
E33033603,363,257,78,179,0,19,7,12,86,79,0,3,4,1
E33033604,696,391,140,251,3,45,20,25,252,246,0,2,4,5
E33033605,525,309,97,212,1,58,35,23,146,136,5,5,0,11
E33033606,432,243,67,176,4,94,56,38,84,79,0,5,0,7
E33033607,397,175,59,116,4,64,42,22,148,141,0,6,1,6
E33033608,529,337,89,248,11,76,46,30,100,97,0,1,2,5
E33033609,379,182,52,130,5,57,45,12,126,122,0,3,1,9
E33033610,304,187,55,132,1,32,17,15,81,78,2,1,0,3
E33033611,513,245,60,185,2,106,74,32,152,143,0,5,4,8
E33033612,421,210,55,155,1,83,53,30,119,111,0,6,2,8
E33033613,529,276,61,215,11,106,68,38,131,123,1,5,2,5
E33033614,398,210,70,140,6,45,17,28,133,121,0,5,7,4
E33033615,501,343,106,237,4,53,28,25,96,93,0,2,1,5
E33033616,487,268,77,191,3,37,20,17,179,177,0,2,0,0
E33033617,499,244,87,157,6,75,39,36,172,157,2,8,5,2
E33033618,331,237,68,169,4,28,9,19,60,57,0,2,1,2
E33033619,395,211,66,145,1,10,5,5,168,160,2,4,2,5
E33033620,454,263,77,186,7,36,26,10,143,141,1,0,1,5
E33033621,341,190,57,133,6,33,19,14,102,94,0,3,5,10
E33033622,612,282,84,198,5,53,22,31,269,261,0,4,4,3
E33033623,602,386,116,270,8,64,42,22,137,129,1,7,0,7
E33033624,388,149,38,111,3,41,30,11,191,188,0,2,1,4
E33033625,784,312,50,262,10,317,40,277,142,130,1,7,4,3
E33033626,403,253,60,193,14,60,21,39,74,70,1,1,2,2
E33033627,463,207,25,182,13,47,15,32,193,183,0,10,0,3
E33033628,495,288,69,219,9,100,30,70,91,79,0,12,0,7
E33033629,1179,435,71,364,24,315,113,202,401,381,2,11,7,4
E33033630,304,148,29,119,10,46,7,39,98,97,0,1,0,2
E33033631,267,145,28,117,5,48,14,34,65,60,0,5,0,4
E33033632,368,180,47,133,4,92,62,30,90,87,0,3,0,2
E33033633,473,308,68,240,4,94,73,21,58,57,0,0,1,9
E33033634,315,178,38,140,2,80,49,31,55,51,0,4,0,0
E33033635,389,195,54,141,4,131,95,36,57,49,1,7,0,2
E33033636,254,99,22,77,3,94,64,30,58,53,0,4,1,0
E33033637,787,451,104,347,37,160,61,99,136,128,0,7,1,3
E33033638,352,143,37,106,14,76,39,37,119,115,0,4,0,0
E33033639,579,292,58,234,20,107,31,76,154,140,1,8,5,6
E33033640,339,163,29,134,7,67,35,32,102,102,0,0,0,0
E33033641,391,197,55,142,3,113,61,52,78,73,1,3,1,0
E33033642,331,181,39,142,7,50,28,22,90,85,0,5,0,3
E33033643,549,317,90,227,4,125,80,45,101,98,0,2,1,2
E33033644,387,202,48,154,7,125,82,43,50,46,0,4,0,3
E33033645,661,385,93,292,9,184,104,80,83,74,0,5,4,0
E33033646,553,303,91,212,22,79,47,32,148,144,0,4,0,1
E33033647,269,139,39,100,6,61,38,23,63,56,0,4,3,0
E33033648,316,126,33,93,4,122,78,44,54,51,0,3,0,10
E33033649,378,130,27,103,3,188,141,47,56,49,2,3,2,1
E33033650,365,119,26,93,3,158,123,35,82,74,1,3,4,3
E33033651,327,140,47,93,5,110,47,63,70,67,0,2,1,2
E33033652,396,199,42,157,5,61,37,24,128,116,0,7,5,3
E33033653,462,248,58,190,4,66,37,29,139,136,0,2,1,5
E33033654,282,145,35,110,0,46,22,24,91,85,0,5,1,0
E33033655,358,203,53,150,1,64,33,31,90,87,0,3,0,0
E33033656,663,445,77,368,9,62,30,32,142,129,1,4,8,5
E33033657,542,238,57,181,2,93,57,36,206,184,1,12,9,3
E33033658,520,330,78,252,7,58,23,35,119,115,0,4,0,6
E33033659,1050,536,142,394,12,339,196,143,158,147,1,9,1,5
E33033660,599,261,91,170,3,82,44,38,247,242,0,5,0,6
E33033661,540,225,33,192,15,106,35,71,189,179,0,8,2,5
E33033662,451,290,74,216,9,93,55,38,57,53,0,3,1,2
E33033663,387,266,52,214,2,34,15,19,84,80,0,4,0,1
E33033664,367,198,51,147,3,91,60,31,72,68,0,4,0,3
E33033665,350,168,43,125,3,80,59,21,95,88,0,5,2,4
E33033666,491,185,50,135,4,215,175,40,77,73,0,4,0,10
E33033667,634,359,117,242,11,143,86,57,119,114,0,3,2,2
E33033668,422,181,66,115,1,112,90,22,122,114,0,7,1,6
E33033669,382,195,58,137,2,106,77,29,77,76,0,1,0,2
E33033670,710,242,57,185,22,226,165,61,218,205,1,9,3,2
E33033671,393,203,52,151,1,113,56,57,75,73,0,1,1,1
E33033672,491,258,74,184,4,157,78,79,68,64,1,2,1,4
E33033673,257,141,43,98,4,66,54,12,45,42,1,2,0,1
E33033674,266,160,37,123,0,68,50,18,36,35,0,1,0,2
E33033675,321,139,29,110,4,79,39,40,97,95,0,2,0,2
E33033676,515,241,50,191,6,149,70,79,116,109,0,7,0,3
E33033677,297,202,58,144,2,39,21,18,53,48,1,1,3,1
E33033678,344,178,57,121,2,59,26,33,105,98,0,2,5,0
E33033679,535,246,55,191,9,163,123,40,111,94,11,4,2,6
E33033680,3281,1907,471,1436,51,669,354,315,643,584,22,22,15,11
E33033681,510,305,99,206,5,93,55,38,105,101,0,4,0,2
E33033682,326,194,63,131,5,67,34,33,57,56,0,1,0,3
E33033683,466,243,72,171,15,89,52,37,118,116,0,2,0,1
E33033684,448,322,69,253,9,69,33,36,42,36,0,5,1,6
E33033685,563,348,75,273,6,92,45,47,113,101,0,11,1,4
E33033686,354,199,43,156,1,99,80,19,54,47,0,7,0,1
E33033687,252,134,29,105,1,52,29,23,62,55,0,5,2,3
E33033688,355,195,60,135,3,88,58,30,65,61,0,1,3,4
E33033689,371,197,49,148,5,59,17,42,109,102,0,6,1,1
E33033690,654,422,98,324,11,111,52,59,104,97,0,7,0,6
E33033691,496,362,106,256,4,52,22,30,71,62,1,4,4,7
E33033692,388,220,69,151,3,41,23,18,117,109,2,5,1,7
E33033693,513,299,98,201,4,39,27,12,170,156,1,11,2,1
E33033694,440,252,87,165,7,65,30,35,111,107,2,2,0,5
E33033695,645,399,139,260,2,109,73,36,126,108,12,5,1,9
E33033696,666,419,119,300,4,129,85,44,105,102,0,3,0,9
E33033697,429,259,57,202,3,96,77,19,70,64,0,5,1,1
E33033698,405,293,74,219,3,54,22,32,48,44,1,1,2,7
E33033699,534,445,116,329,5,30,14,16,49,45,0,2,2,5
E33033700,358,218,47,171,4,107,71,36,27,26,0,1,0,2
E33033701,359,201,27,174,6,74,58,16,76,71,0,5,0,2
E33033702,559,291,71,220,4,176,146,30,81,69,1,11,0,7
E33033703,341,255,84,171,1,44,24,20,33,30,1,1,1,8
E33033704,261,220,56,164,0,23,13,10,17,17,0,0,0,1
E33033705,328,219,68,151,3,72,48,24,29,28,0,1,0,5
E33033706,475,328,87,241,3,73,39,34,66,62,0,4,0,5
E33033707,320,204,59,145,2,50,32,18,61,53,2,6,0,3
E33033708,474,324,78,246,5,80,46,34,61,56,0,4,1,4
E33033709,654,395,123,272,3,179,125,54,72,68,0,3,1,5
E33033710,755,571,171,400,8,61,31,30,111,103,0,6,2,4
E33033711,440,320,82,238,3,52,38,14,59,55,1,3,0,6
E33033712,474,276,89,187,3,116,87,29,72,66,1,5,0,7
E33033713,490,329,84,245,7,95,75,20,56,55,0,1,0,3
E33033714,424,177,40,137,1,177,145,32,66,60,4,2,0,3
E33033715,322,195,65,130,8,76,66,10,37,36,0,1,0,6
E33033716,905,685,185,500,12,91,38,53,107,95,1,8,3,10
E33033717,422,310,73,237,12,55,24,31,41,36,2,3,0,4
E33033718,534,363,114,249,1,50,22,28,114,102,3,8,1,6
E33033719,541,324,70,254,0,161,132,29,51,49,0,2,0,5
E33033720,332,225,64,161,1,32,19,13,73,73,0,0,0,1
E33033721,1307,873,250,623,15,165,84,81,247,231,2,12,2,7
E33033722,408,289,59,230,2,53,45,8,61,60,0,1,0,3
E33033723,448,159,54,105,11,96,47,49,179,172,0,3,4,3
E33033724,725,333,109,224,16,172,107,65,201,191,0,9,1,3
E33033725,623,250,108,142,9,97,37,60,259,249,0,6,4,8
E33033726,279,122,50,72,2,43,14,29,101,96,1,4,0,11
E33033727,449,165,55,110,9,81,42,39,193,185,0,8,0,1
E33033728,455,145,42,103,10,167,121,46,129,126,0,2,1,4
E33033729,372,162,41,121,10,111,79,32,85,85,0,0,0,4
E33033730,467,126,32,94,2,120,92,28,217,211,1,5,0,2
E33033731,469,185,83,102,4,85,41,44,186,175,0,10,1,9
E33033732,696,187,65,122,6,153,75,78,341,327,0,12,2,9
E33033733,377,151,62,89,4,87,34,53,132,121,0,11,0,3
E33033734,355,132,44,88,2,105,49,56,114,111,0,3,0,2
E33033735,309,93,41,52,0,72,41,31,134,130,0,4,0,10
E33033736,389,101,40,61,7,84,49,35,192,183,0,4,5,5
E33033737,362,114,33,81,4,119,46,73,122,108,2,9,3,3
E33033738,354,117,32,85,4,129,62,67,97,96,0,1,0,7
E33033739,342,153,74,79,2,56,22,34,128,121,0,5,2,3
E33033740,413,110,51,59,7,73,20,53,219,214,0,5,0,4
E33033741,310,87,28,59,17,56,11,45,149,136,1,10,2,1
E33033742,377,146,38,108,5,67,25,42,150,140,1,9,0,9
E33033743,327,123,43,80,8,56,26,30,134,127,0,7,0,6
E33033744,387,119,41,78,7,73,34,39,183,177,2,4,0,5
E33033745,355,119,39,80,14,50,19,31,171,159,0,12,0,1
E33033746,380,140,48,92,8,79,37,42,144,137,0,6,1,9
E33033747,308,125,47,78,1,59,31,28,108,103,4,1,0,15
E33033748,445,170,56,114,6,67,43,24,199,190,1,8,0,3
E33033749,296,123,34,89,10,84,42,42,77,72,0,3,2,2
E33033750,362,155,50,105,12,94,46,48,99,93,0,3,3,2
E33033751,384,172,58,114,3,68,23,45,133,124,2,7,0,8
E33033752,304,133,39,94,6,93,51,42,68,61,0,6,1,4
E33033753,282,191,64,127,1,19,10,9,67,64,0,2,1,4
E33033754,272,119,43,76,5,41,23,18,98,88,3,6,1,9
E33033755,246,82,31,51,1,42,21,21,118,114,0,4,0,3
E33033756,315,131,37,94,9,71,33,38,101,95,0,6,0,3
E33033757,339,139,44,95,1,79,36,43,118,109,2,7,0,2
E33033758,370,136,39,97,1,102,53,49,129,125,0,4,0,2
E33033759,604,204,48,156,12,119,59,60,265,254,4,7,0,4
E33033760,320,97,19,78,2,135,86,49,81,75,2,4,0,5
E33033761,419,156,30,126,8,123,73,50,129,116,2,2,9,3
E33033762,366,126,30,96,7,60,22,38,172,158,6,8,0,1
E33033763,306,117,32,85,2,77,40,37,108,103,0,3,2,2
E33033764,271,113,37,76,6,76,40,36,72,70,0,2,0,4
E33033765,502,201,57,144,6,148,77,71,141,132,1,8,0,6
E33033766,395,148,53,95,8,98,54,44,139,134,0,3,2,2
E33033767,340,164,55,109,4,52,25,27,116,111,0,3,2,4
E33033768,503,195,56,139,4,94,43,51,205,194,1,6,4,5
E33033769,365,177,48,129,5,65,34,31,112,104,2,3,3,6
E33033770,358,150,48,102,11,62,28,34,132,127,0,4,1,3
E33033771,377,201,64,137,4,59,30,29,112,107,0,5,0,1
E33033772,271,148,62,86,5,59,35,24,54,44,0,6,4,5
E33033773,441,187,47,140,8,105,55,50,134,123,2,9,0,7
E33033774,273,129,54,75,2,59,36,23,82,78,0,4,0,1
E33033775,573,176,48,128,6,257,91,166,122,116,0,5,1,12
E33033776,364,158,43,115,7,122,73,49,76,74,1,1,0,1
E33033777,374,165,47,118,6,79,24,55,119,116,0,3,0,5
E33033778,473,221,61,160,9,99,56,43,135,126,0,3,6,9
E33033779,294,83,28,55,7,124,88,36,79,70,6,3,0,1
E33033780,310,86,20,66,6,79,47,32,136,132,0,3,1,3
E33033781,288,110,27,83,1,87,37,50,87,80,0,2,5,3
E33033782,735,406,70,336,19,116,58,58,186,176,0,8,2,8
E33033783,492,176,40,136,13,81,46,35,217,212,1,2,2,5
E33033784,426,186,51,135,14,91,39,52,129,126,0,1,2,6
E33033785,424,189,51,138,4,81,33,48,145,134,3,5,3,5
E33033786,354,147,46,101,7,83,38,45,111,101,0,8,2,6
E33033787,384,126,42,84,10,125,44,81,116,110,0,5,1,7
E33033788,368,130,34,96,5,109,53,56,118,115,0,3,0,6
E33033789,294,116,46,70,5,86,34,52,82,80,0,2,0,5
E33033790,265,90,21,69,4,89,25,64,79,73,0,5,1,3
E33033791,311,91,24,67,5,95,52,43,114,111,2,0,1,6
E33033792,534,167,44,123,15,214,65,149,134,120,0,12,2,4
E33033793,359,119,40,79,6,86,54,32,142,136,0,3,3,6
E33033794,402,161,39,122,12,107,47,60,121,113,3,4,1,1
E33033795,320,116,26,90,6,80,27,53,118,116,1,1,0,0
E33033796,356,99,27,72,6,171,97,74,78,73,0,5,0,2
E33033797,379,181,38,143,3,128,73,55,65,59,1,5,0,2
E33033798,251,107,17,90,1,75,37,38,66,65,0,1,0,2
E33033799,390,175,56,119,3,119,63,56,93,92,0,0,1,0
E33033800,245,100,22,78,5,64,34,30,75,74,1,0,0,1
E33033801,453,215,53,162,11,112,60,52,114,108,1,5,0,1
E33033802,816,370,68,302,25,200,84,116,213,193,1,17,2,8
E33033803,795,415,100,315,24,156,54,102,199,193,0,4,2,1
E33033804,462,134,43,91,7,196,117,79,121,117,0,3,1,4
E33033805,290,101,32,69,2,135,102,33,48,45,0,2,1,4
E33033806,424,124,40,84,12,194,101,93,87,82,0,2,3,7
E33033807,267,108,39,69,12,75,54,21,71,69,0,1,1,1
E33033808,424,195,44,151,14,105,57,48,107,97,0,9,1,3
E33033809,818,256,77,179,13,325,165,160,213,197,1,10,5,11
E33033810,335,137,52,85,5,103,56,47,81,75,0,4,2,9
E33033811,355,116,35,81,11,102,41,61,124,110,1,9,4,2
E33033812,316,147,50,97,2,84,35,49,78,75,0,2,1,5
E33033813,628,342,97,245,14,185,98,87,85,81,0,1,3,2
E33033814,420,166,48,118,6,73,32,41,171,161,0,10,0,4
E33033815,321,101,35,66,4,69,29,40,146,131,1,8,6,1
E33033816,310,168,45,123,2,31,12,19,106,101,0,5,0,3
E33033817,376,116,34,82,8,105,60,45,145,140,0,4,1,2
E33033818,357,131,48,83,3,126,73,53,94,92,1,1,0,3
E33033819,279,111,33,78,9,77,47,30,79,70,0,9,0,3
E33033820,354,107,28,79,7,132,68,64,105,103,0,2,0,3
E33033821,481,168,42,126,7,128,75,53,168,160,1,7,0,10
E33033822,335,86,27,59,0,69,30,39,174,171,0,3,0,6
E33033823,359,177,58,119,6,37,20,17,133,126,0,6,1,6
E33033824,397,140,51,89,2,76,29,47,179,169,1,8,1,0
E33033825,322,106,31,75,4,140,33,107,67,63,0,3,1,5
E33033826,297,113,18,95,9,121,85,36,49,46,0,2,1,5
E33033827,506,181,49,132,10,162,65,97,144,136,0,7,1,9
E33033828,402,174,60,114,9,91,30,61,125,120,1,4,0,3
E33033829,454,176,50,126,10,92,28,64,173,164,0,8,1,3
E33033830,568,222,57,165,32,107,44,63,205,195,2,7,1,2
E33033831,294,109,29,80,8,87,49,38,87,81,0,6,0,3
E33033832,622,246,66,180,14,137,83,54,219,209,1,6,3,6
E33033833,480,213,47,166,16,147,49,98,100,91,0,8,1,4
E33033834,483,239,64,175,8,135,45,90,94,91,0,3,0,7
E33033835,325,101,27,74,19,61,28,33,142,134,1,6,1,2
E33033836,348,117,38,79,11,127,89,38,88,85,0,3,0,5
E33033837,355,89,25,64,4,146,106,40,114,108,0,3,3,2
E33033838,506,183,48,135,9,173,115,58,136,131,1,2,2,5
E33033839,311,104,13,91,7,87,58,29,107,91,0,15,1,6
E33033840,537,167,46,121,33,181,136,45,155,134,1,11,9,1
E33033841,565,165,30,135,18,140,89,51,238,229,1,4,4,4
E33033842,457,170,45,125,21,148,60,88,115,109,1,4,1,3
E33033843,428,157,44,113,7,123,49,74,139,135,0,1,3,2
E33033844,553,173,46,127,18,131,71,60,229,224,0,5,0,2
E33033845,1150,570,168,402,18,295,157,138,252,239,1,10,2,15
E33033846,465,193,65,128,4,155,91,64,110,106,1,3,0,3
E33033847,460,211,52,159,5,43,19,24,196,189,1,5,1,5
E33033848,541,259,87,172,11,107,66,41,157,152,0,4,1,7
E33033849,573,224,52,172,17,176,137,39,146,141,0,5,0,10
E33033850,598,305,68,237,6,79,46,33,203,192,0,11,0,5
E33033851,308,95,19,76,2,135,109,26,69,63,0,5,1,7
E33033852,641,268,66,202,12,170,101,69,185,178,0,4,3,6
E33033853,575,140,32,108,11,171,123,48,245,234,3,7,1,8
E33033854,997,545,122,423,10,133,81,52,304,293,0,8,3,5
E33033855,667,320,79,241,20,77,37,40,244,233,1,10,0,6
E33033856,341,116,32,84,9,88,61,27,122,117,0,5,0,6
E33033857,547,237,63,174,12,98,56,42,199,184,1,11,3,1
E33033858,380,122,43,79,12,142,114,28,102,94,3,4,1,2
E33033859,810,320,73,247,19,63,31,32,403,370,2,26,5,5
E33033860,635,241,57,184,6,148,92,56,237,228,2,5,2,3
E33033861,586,228,84,144,13,204,60,144,122,120,1,1,0,19
E33033862,239,83,23,60,12,96,31,65,48,47,0,1,0,0
E33033863,495,228,69,159,16,78,36,42,166,157,0,9,0,7
E33033864,715,295,78,217,19,171,67,104,228,219,1,8,0,2
E33033865,412,173,39,134,11,148,102,46,78,76,1,1,0,2
E33033866,413,94,35,59,5,204,180,24,101,92,3,5,1,9
E33033867,375,138,34,104,11,115,81,34,105,98,2,4,1,6
E33033868,455,202,80,122,6,70,35,35,172,165,2,4,1,5
E33033869,474,223,61,162,13,121,44,77,111,107,0,3,1,6
E33033870,300,106,35,71,4,40,18,22,149,146,0,2,1,1
E33033871,4380,1407,431,976,54,1153,673,480,1724,1651,4,48,21,42
E33033872,664,284,84,200,7,118,64,54,255,251,0,4,0,0
E33033873,6561,4357,1067,3290,109,415,180,235,1648,1576,5,57,10,32
E33033874,350,152,52,100,10,69,37,32,113,111,0,1,1,6
E33033875,298,106,38,68,4,59,20,39,126,120,0,6,0,3
E33033876,442,176,43,133,4,102,48,54,152,146,0,3,3,8
E33033877,470,216,57,159,3,91,38,53,157,154,0,3,0,3
E33033878,311,142,52,90,6,62,24,38,100,98,0,2,0,1
E33033879,271,98,34,64,10,84,32,52,74,71,1,2,0,5
E33033880,295,104,36,68,6,77,39,38,105,102,0,2,1,3
E33033881,269,138,38,100,5,34,11,23,90,89,0,1,0,2
E33033882,487,214,64,150,12,89,24,65,165,164,0,1,0,7
E33033883,307,136,42,94,3,40,13,27,123,119,1,3,0,5
E33033884,274,116,36,80,1,51,25,26,102,96,1,4,1,4
E33033885,414,190,67,123,2,66,44,22,149,143,1,5,0,7
E33033886,469,158,40,118,11,137,88,49,158,147,3,3,5,5
E33033887,496,264,80,184,6,34,13,21,188,175,1,11,1,4
E33033888,256,119,32,87,4,40,18,22,93,90,1,2,0,0
E33033889,301,122,46,76,1,36,19,17,136,130,3,3,0,6
E33033890,323,109,36,73,20,43,14,29,149,146,0,3,0,2
E33033891,269,169,78,91,0,22,12,10,77,68,0,6,3,1
E33033892,399,214,70,144,9,78,28,50,90,80,3,7,0,8
E33033893,510,245,88,157,3,94,54,40,164,156,1,6,1,4
E33033894,392,256,108,148,2,42,9,33,84,76,2,5,1,8
E33033895,233,139,43,96,4,25,17,8,58,52,0,6,0,7
E33033896,541,269,87,182,5,128,54,74,135,128,1,5,1,4
E33033897,294,126,50,76,3,60,21,39,101,98,0,3,0,4
E33033898,510,270,110,160,5,51,14,37,180,171,3,6,0,4
E33033899,258,127,53,74,6,48,20,28,74,68,0,4,2,3
E33033900,1021,545,107,438,25,175,83,92,266,244,3,12,7,10
E33033901,465,283,77,206,5,26,6,20,147,141,0,6,0,4
E33033902,290,118,46,72,3,52,18,34,116,106,0,8,2,1
E33033903,241,111,49,62,1,60,31,29,66,60,0,6,0,3
E33033904,396,175,61,114,4,70,27,43,142,137,1,2,2,5
E33033905,612,326,140,186,8,80,32,48,185,165,9,9,2,13
E33033906,331,162,64,98,7,78,41,37,80,78,0,2,0,4
E33033907,395,225,72,153,2,13,6,7,154,146,0,8,0,1
E33033908,272,161,72,89,2,14,8,6,87,83,3,1,0,8
E33033909,433,203,63,140,5,93,45,48,122,110,0,9,3,10
E33033910,359,142,43,99,5,43,17,26,166,164,0,2,0,3
E33033911,456,173,46,127,11,95,45,50,174,163,4,7,0,3
E33033912,571,279,70,209,7,66,32,34,210,202,4,3,1,9
E33033913,507,239,81,158,7,70,26,44,181,172,2,6,1,10
E33033914,482,242,86,156,3,36,16,20,199,192,0,6,1,2
E33033915,464,238,81,157,7,38,20,18,176,170,3,2,1,5
E33033916,666,352,80,272,13,94,47,47,198,187,0,5,6,9
E33033917,905,531,128,403,5,58,34,24,299,279,2,14,4,12
E33033918,1017,513,135,378,15,106,61,45,375,358,1,14,2,8
E33033919,737,424,152,272,18,114,57,57,174,163,3,5,3,7
E33033920,272,101,40,61,2,64,36,28,103,98,3,1,1,2
E33033921,962,574,142,432,9,58,34,24,316,290,0,21,5,5
E33033922,438,195,54,141,7,92,42,50,133,126,1,5,1,11
E33033923,1146,602,135,467,10,72,26,46,455,434,4,14,3,7
E33033924,296,144,50,94,3,56,28,28,91,74,4,9,4,2
E33033925,839,351,90,261,6,142,50,92,334,321,1,9,3,6
E33033926,365,145,43,102,8,56,31,25,148,142,0,5,1,8
E33033927,515,183,47,136,10,166,86,80,153,148,0,3,2,3
E33033928,279,144,77,67,2,47,23,24,80,71,1,8,0,6
E33033929,248,153,52,101,3,37,11,26,54,47,0,7,0,1
E33033930,354,161,42,119,5,57,34,23,128,122,0,6,0,3
E33033931,1168,642,156,486,25,92,49,43,404,394,2,7,1,5
E33033932,1140,515,111,404,34,202,86,116,383,369,1,9,4,6
E33033933,433,209,53,156,4,66,43,23,153,143,5,4,1,1
E33033934,1066,520,140,380,24,169,83,86,346,326,2,12,6,7
E33033935,455,200,71,129,2,52,25,27,189,171,1,13,4,12
E33033936,538,287,95,192,8,77,44,33,157,151,1,5,0,9
E33033937,426,144,38,106,3,70,39,31,199,193,1,5,0,10
E33033938,282,107,36,71,0,37,19,18,135,130,1,4,0,3
E33033939,526,184,48,136,8,200,126,74,130,125,1,4,0,4
E33033940,383,134,26,108,3,122,73,49,119,116,1,2,0,5
E33033941,383,137,52,85,0,57,31,26,184,173,5,6,0,5
E33033942,788,425,94,331,18,158,112,46,176,167,0,8,1,11
E33033943,301,141,39,102,2,45,24,21,109,100,0,7,2,4
E33033944,264,114,28,86,2,70,46,24,72,65,0,7,0,6
E33033945,264,118,27,91,4,54,14,40,85,78,1,6,0,3
E33033946,359,135,39,96,4,67,47,20,147,142,1,4,0,6
E33033947,439,203,63,140,16,69,34,35,148,136,0,11,1,3
E33033948,257,51,15,36,3,101,47,54,97,91,6,0,0,5
E33033949,621,257,73,184,9,81,32,49,268,250,0,16,2,6
E33033950,418,180,62,118,4,87,48,39,142,133,1,5,3,5
E33033951,270,142,26,116,3,35,19,16,85,77,2,6,0,5
E33033952,356,172,60,112,3,62,27,35,113,103,3,7,0,6
E33033953,271,110,41,69,1,55,27,28,101,94,0,7,0,4
E33033954,576,287,94,193,21,96,55,41,168,152,5,8,3,4
E33033955,482,205,67,138,4,52,24,28,216,211,1,3,1,5
E33033956,302,156,60,96,8,67,43,24,64,58,1,3,2,7
E33033957,333,226,75,151,3,10,4,6,87,81,0,6,0,7
E33033958,534,260,68,192,11,47,23,24,214,201,0,13,0,2
E33033959,272,157,56,101,2,48,22,26,60,57,0,3,0,5
E33033960,345,149,56,93,6,38,22,16,148,130,0,18,0,4
E33033961,369,161,44,117,5,101,60,41,99,98,1,0,0,3
E33033962,227,95,34,61,1,45,20,25,82,81,0,1,0,4
E33033963,710,303,92,211,9,84,41,43,310,293,1,16,0,4
E33033964,326,129,41,88,4,70,31,39,115,107,1,6,1,8
E33033965,266,127,53,74,0,30,14,16,106,101,0,4,1,3
E33033966,306,171,60,111,1,22,11,11,110,106,0,3,1,2
E33033967,409,188,54,134,8,44,28,16,165,157,0,8,0,4
E33033968,610,333,115,218,8,99,47,52,163,150,5,5,3,7
E33033969,281,156,60,96,0,37,21,16,85,82,0,3,0,3
E33033970,457,256,81,175,3,57,27,30,135,123,1,10,1,6
E33033971,302,162,55,107,2,47,29,18,88,80,2,6,0,3
E33033972,687,249,59,190,7,164,81,83,255,242,3,9,1,12
E33033973,1143,499,148,351,14,240,129,111,375,354,5,14,2,15
E33033974,728,351,103,248,20,75,36,39,275,263,4,8,0,7
E33033975,293,134,44,90,2,34,18,16,118,114,2,2,0,5
E33033976,287,144,69,75,4,23,12,11,106,96,0,7,3,10
E33033977,310,127,44,83,2,52,33,19,126,125,0,1,0,3
E33033978,586,335,72,263,12,98,56,42,139,127,3,8,1,2
E33033979,374,179,42,137,10,100,53,47,82,81,1,0,0,3
E33033980,371,174,67,107,2,72,53,19,117,115,0,1,1,6
E33033981,541,249,82,167,10,77,46,31,201,189,1,9,2,4
E33033982,280,139,59,80,5,49,23,26,80,76,0,4,0,7
E33033983,381,191,77,114,4,33,16,17,146,143,0,3,0,7
E33033984,410,196,55,141,8,52,34,18,151,143,0,7,1,3
E33033985,394,211,90,121,1,39,22,17,141,129,0,12,0,2
E33033986,1179,638,190,448,15,83,49,34,427,400,2,24,1,16
E33033987,334,150,63,87,6,90,61,29,85,76,0,9,0,3
E33033988,673,259,67,192,12,210,125,85,188,184,0,2,2,4
E33033989,235,74,26,48,1,25,10,15,128,123,1,2,2,7
E33033990,397,205,62,143,5,45,27,18,136,128,0,8,0,6
E33033991,273,107,32,75,8,62,22,40,92,88,0,2,2,4
E33033992,451,174,56,118,7,147,74,73,119,109,0,8,2,4
E33033993,265,121,42,79,3,28,14,14,108,101,0,7,0,5
E33033994,629,254,84,170,5,81,40,41,283,273,2,8,0,6
E33033995,294,169,88,81,3,39,21,18,77,73,2,2,0,6
E33033996,291,162,58,104,0,27,18,9,95,89,0,4,2,7
E33033997,581,287,80,207,4,43,19,24,242,236,1,5,0,5
E33033998,377,176,79,97,8,40,25,15,133,125,2,4,2,20
E33033999,413,191,59,132,3,84,54,30,130,118,0,8,4,5
E33034000,226,118,34,84,4,32,14,18,69,67,0,2,0,3
E33034001,270,139,61,78,0,38,22,16,89,79,2,7,1,4
E33034002,519,248,96,152,8,70,42,28,182,174,1,5,2,11
E33034003,459,200,67,133,10,116,67,49,130,127,0,2,1,3
E33034004,427,187,56,131,3,28,14,14,205,200,0,5,0,4
E33034005,389,165,29,136,6,65,43,22,151,143,1,6,1,2
E33034006,574,247,67,180,2,54,35,19,265,258,1,5,1,6
E33034007,367,198,48,150,3,88,43,45,70,68,1,0,1,8
E33034008,374,129,37,92,9,83,50,33,147,141,0,4,2,6
E33034009,415,147,40,107,2,131,80,51,131,129,0,2,0,4
E33034010,668,328,80,248,5,132,87,45,200,186,2,10,2,3
E33034011,471,182,61,121,12,100,46,54,175,168,2,5,0,2
E33034012,336,197,65,132,5,35,25,10,96,89,0,4,3,3
E33034013,653,394,121,273,7,74,35,39,170,159,2,8,1,8
E33034014,418,279,80,199,2,44,35,9,89,89,0,0,0,4
E33034015,450,247,69,178,7,76,57,19,116,112,1,3,0,4
E33034016,414,165,33,132,2,147,119,28,98,91,1,6,0,2
E33034017,320,132,28,104,3,102,71,31,81,80,1,0,0,2
E33034018,349,169,33,136,7,59,33,26,111,107,3,0,1,3
E33034019,633,258,55,203,7,205,145,60,158,154,0,1,3,5
E33034020,464,185,46,139,8,100,61,39,163,157,1,3,2,8
E33034021,496,278,86,192,5,74,38,36,133,130,1,2,0,6
E33034022,709,399,125,274,13,128,76,52,163,155,0,7,1,6
E33034023,585,300,116,184,7,97,65,32,173,168,1,3,1,8
E33034024,501,184,55,129,3,29,13,16,279,276,1,1,1,6
E33034025,525,185,54,131,7,67,48,19,260,258,1,0,1,6
E33034026,533,232,76,156,12,93,59,34,189,182,1,4,2,7
E33034027,546,241,61,180,7,70,44,26,223,218,0,5,0,5
E33034028,469,187,56,131,12,107,73,34,161,153,2,2,4,2
E33034029,278,205,72,133,0,17,10,7,56,56,0,0,0,0
E33034030,428,278,76,202,4,29,16,13,115,110,0,3,2,2
E33034031,630,396,125,271,9,54,26,28,162,158,3,1,0,9
E33034032,313,190,66,124,5,40,25,15,77,74,0,3,0,1
E33034033,686,240,71,169,6,113,87,26,320,309,0,7,4,7
E33034034,362,116,34,82,3,88,80,8,151,149,0,1,1,4
E33034035,451,124,37,87,0,90,52,38,227,223,0,4,0,10
E33034036,332,181,44,137,8,64,40,24,76,70,0,6,0,3
E33034037,489,201,50,151,7,105,62,43,170,161,1,8,0,6
E33034038,408,149,30,119,15,108,47,61,133,131,0,2,0,3
E33034039,385,157,43,114,3,72,38,34,147,139,0,8,0,6
E33034040,419,178,42,136,11,97,50,47,128,123,0,5,0,5
E33034041,689,387,58,329,11,127,88,39,154,148,0,4,2,10
E33034042,395,136,38,98,5,150,81,69,101,98,0,3,0,3
E33034043,641,240,72,168,12,136,74,62,243,234,0,6,3,10
E33034044,663,315,75,240,4,157,95,62,180,171,2,6,1,7
E33034045,541,281,69,212,3,100,49,51,153,139,0,12,2,4
E33034046,397,137,28,109,8,191,146,45,55,45,0,4,6,6
E33034047,555,261,72,189,6,72,45,27,212,205,2,4,1,4
E33034048,282,185,59,126,0,15,8,7,81,77,0,4,0,1
E33034049,310,175,44,131,3,20,7,13,110,102,4,3,1,2
E33034050,391,254,102,152,1,22,13,9,112,106,4,2,0,2
E33034051,481,312,98,214,1,56,33,23,105,102,2,1,0,7
E33034052,439,190,51,139,4,106,51,55,129,121,2,3,3,10
E33034053,421,187,58,129,4,90,43,47,136,134,0,2,0,4
E33034054,926,383,94,289,2,187,117,70,350,339,3,6,2,4
E33034055,649,359,78,281,10,85,42,43,190,186,0,2,2,5
E33034056,476,233,54,179,9,59,35,24,172,167,0,5,0,3
E33034057,518,241,70,171,9,71,34,37,196,190,1,4,1,1
E33034058,304,104,37,67,8,77,51,26,111,110,0,0,1,4
E33034059,305,126,38,88,1,84,51,33,90,84,1,5,0,4
E33034060,314,137,39,98,2,36,25,11,135,130,0,5,0,4
E33034061,357,216,51,165,10,67,53,14,62,56,0,6,0,2
E33034062,368,235,106,129,4,26,13,13,101,93,2,5,1,2
E33034063,291,176,61,115,2,23,13,10,85,85,0,0,0,5
E33034064,332,230,89,141,3,25,11,14,71,65,0,3,3,3
E33034065,602,241,79,162,8,116,63,53,232,228,0,3,1,5
E33034066,707,278,73,205,4,91,46,45,325,318,0,4,3,9
E33034067,545,283,112,171,7,66,43,23,187,172,0,11,4,2
E33034068,523,283,83,200,21,86,44,42,130,118,0,7,5,3
E33034069,353,146,34,112,9,51,30,21,146,142,0,2,2,1
E33034070,360,128,41,87,7,59,30,29,161,156,1,4,0,5
E33034071,393,189,50,139,9,84,57,27,110,106,0,4,0,1
E33034072,253,120,37,83,1,68,35,33,64,63,1,0,0,0
E33034073,256,157,44,113,2,25,14,11,71,67,1,3,0,1
E33034074,410,218,61,157,11,81,36,45,96,87,2,7,0,4
E33034075,701,235,55,180,10,187,120,67,263,256,0,5,2,6
E33034076,290,183,67,116,4,31,15,16,71,68,1,0,2,1
E33034077,274,177,99,78,2,8,2,6,82,74,0,6,2,5
E33034078,499,264,92,172,4,38,18,20,189,181,2,4,2,4
E33034079,369,199,60,139,2,60,40,20,103,100,0,3,0,5
E33034080,610,295,100,195,4,86,48,38,206,193,4,9,0,19
E33034081,503,319,103,216,7,73,52,21,98,94,0,3,1,6
E33034082,306,207,69,138,3,30,19,11,64,58,2,1,3,2
E33034083,310,244,76,168,1,9,4,5,54,51,1,2,0,2
E33034084,355,238,87,151,4,26,14,12,86,84,0,2,0,1
E33034085,482,178,46,132,6,104,65,39,184,173,8,2,1,10
E33034086,338,167,59,108,3,41,19,22,125,123,0,2,0,2
E33034087,528,270,59,211,2,85,43,42,168,164,0,1,3,3
E33034088,629,274,73,201,5,99,55,44,239,231,3,2,3,12
E33034089,468,203,62,141,4,96,69,27,159,150,1,4,4,6
E33034090,481,178,60,118,3,88,50,38,207,200,2,0,5,5
E33034091,355,154,43,111,5,74,24,50,117,108,2,5,2,5
E33034092,510,189,43,146,3,67,39,28,249,235,1,6,7,2
E33034093,333,154,46,108,8,54,35,19,117,116,0,0,1,0
E33034094,319,109,29,80,4,71,48,23,128,125,0,2,1,7
E33034095,380,221,43,178,10,51,35,16,97,91,0,4,2,1
E33034096,297,90,26,64,6,67,45,22,132,132,0,0,0,2
E33034097,324,131,28,103,13,79,35,44,96,93,0,3,0,5
E33034098,475,250,50,200,11,102,48,54,109,105,0,3,1,3
E33034099,452,244,73,171,5,81,55,26,121,115,0,5,1,1
E33034100,503,209,74,135,8,128,88,40,154,147,2,4,1,4
E33034101,443,155,51,104,16,110,74,36,158,155,0,3,0,4
E33034102,351,116,30,86,9,101,69,32,120,119,0,1,0,5
E33034103,359,143,44,99,5,39,25,14,165,156,5,2,2,7
E33034104,362,125,42,83,0,44,29,15,191,185,0,1,5,2
E33034105,609,274,102,172,6,74,53,21,252,244,1,3,4,3
E33034106,1508,913,251,662,32,257,134,123,300,279,1,13,7,6
E33034107,331,133,42,91,8,24,16,8,154,149,2,1,2,12
E33034108,418,260,76,184,10,56,11,45,90,88,0,1,1,2
E33034109,437,253,70,183,2,70,44,26,108,99,0,9,0,4
E33034110,519,275,71,204,14,99,44,55,126,123,0,3,0,5
E33034111,491,265,82,183,6,94,49,45,118,114,0,4,0,8
E33034112,378,150,35,115,14,49,25,24,157,152,0,4,1,8
E33034113,441,169,49,120,14,57,33,24,197,191,0,5,1,4
E33034114,635,191,61,130,7,110,65,45,324,315,0,1,8,3
E33034115,417,221,71,150,4,48,36,12,123,114,5,4,0,21
E33034116,277,166,57,109,4,33,20,13,70,69,0,1,0,4
E33034117,324,198,78,120,1,29,14,15,94,88,1,3,2,2
E33034118,297,153,64,89,3,34,19,15,103,97,2,3,1,4
E33034119,349,175,50,125,2,101,78,23,68,62,1,5,0,3
E33034120,375,258,109,149,2,27,12,15,73,66,4,3,0,15
E33034121,653,375,141,234,6,64,33,31,197,172,15,5,5,11
E33034122,424,197,62,135,4,35,22,13,184,178,0,6,0,4
E33034123,339,129,42,87,4,44,24,20,158,153,0,5,0,4
E33034124,343,159,59,100,0,50,33,17,132,124,0,6,2,2
E33034125,514,165,57,108,13,162,86,76,171,161,1,5,4,3
E33034126,760,307,95,212,13,155,103,52,279,269,0,6,4,6
E33034127,648,270,103,167,5,155,90,65,211,208,0,3,0,7
E33034128,389,113,28,85,4,118,97,21,149,138,2,2,7,5
E33034129,411,131,30,101,4,69,50,19,205,201,0,4,0,2
E33034130,308,187,97,90,0,7,0,7,111,107,2,2,0,3
E33034131,316,170,63,107,2,25,15,10,118,116,0,2,0,1
E33034132,429,269,97,172,2,44,23,21,111,107,1,3,0,3
E33034133,296,145,44,101,7,43,25,18,101,99,0,1,1,0
E33034134,337,169,53,116,10,51,31,20,104,97,2,5,0,3
E33034135,372,222,79,143,4,28,15,13,117,113,0,4,0,1
E33034136,293,174,64,110,4,44,20,24,68,66,1,0,1,3
E33034137,271,175,53,122,0,23,15,8,73,72,0,1,0,0
E33034138,349,176,58,118,2,46,19,27,123,114,0,9,0,2
E33034139,447,206,60,146,17,67,33,34,149,146,0,2,1,8
E33034140,304,137,58,79,0,26,12,14,136,133,0,3,0,5
E33034141,289,190,89,101,4,33,21,12,54,51,2,1,0,8
E33034142,279,144,58,86,0,26,8,18,108,99,2,7,0,1
E33034143,474,231,76,155,3,40,23,17,196,189,1,4,2,4
E33034144,433,256,104,152,6,32,21,11,134,127,0,5,2,5
E33034145,301,118,39,79,3,84,47,37,96,90,1,5,0,0
E33034146,304,156,54,102,1,46,28,18,101,98,0,1,2,0
E33034147,306,104,37,67,5,91,62,29,97,93,1,1,2,9
E33034148,323,159,44,115,4,60,38,22,100,93,0,6,1,0
E33034149,1460,972,293,679,23,158,65,93,293,284,2,6,1,14
E33034150,316,226,92,134,0,19,14,5,64,59,2,1,2,7
E33034151,444,259,94,165,11,59,26,33,108,103,0,4,1,7
E33034152,350,238,92,146,3,21,9,12,84,74,5,4,1,4
E33034153,342,261,101,160,3,30,16,14,48,44,0,1,3,0
E33034154,431,328,134,194,3,22,10,12,72,71,1,0,0,6
E33034155,843,569,182,387,16,66,37,29,187,165,7,13,2,5
E33034156,484,306,120,186,4,39,13,26,129,84,20,5,20,6
E33034157,363,267,99,168,0,15,7,8,79,76,0,0,3,2
E33034158,373,238,99,139,1,27,14,13,101,93,6,1,1,6
E33034159,447,314,95,219,4,30,22,8,95,88,1,4,2,4
E33034160,442,218,63,155,2,30,13,17,187,183,0,1,3,5
E33034161,350,203,79,124,5,38,24,14,100,79,12,1,8,4
E33034162,313,205,65,140,2,40,32,8,65,57,3,4,1,1
E33034163,289,226,73,153,0,16,10,6,42,42,0,0,0,5
E33034164,524,366,138,228,5,48,36,12,102,95,1,4,2,3
E33034165,462,398,137,261,0,17,10,7,43,42,0,0,1,4
E33034166,604,467,169,298,4,50,25,25,74,70,2,2,0,9
E33034167,250,195,89,106,0,4,2,2,50,47,2,0,1,1
E33034168,480,346,99,247,6,36,24,12,85,81,0,4,0,7
E33034169,335,228,81,147,10,35,22,13,59,57,0,1,1,3
E33034170,274,200,64,136,1,17,11,6,56,47,0,6,3,0
E33034171,315,234,80,154,7,14,11,3,59,58,0,1,0,1
E33034172,565,354,116,238,6,69,43,26,133,119,1,12,1,3
E33034173,305,233,86,147,0,6,5,1,57,57,0,0,0,9
E33034174,643,406,127,279,7,94,59,35,128,121,0,5,2,8
E33034175,654,447,146,301,2,59,32,27,136,124,3,7,2,10
E33034176,453,297,96,201,6,67,39,28,79,77,0,2,0,4
E33034177,408,225,79,146,2,8,7,1,171,168,2,0,1,2
E33034178,310,167,46,121,2,41,33,8,97,96,0,1,0,3
E33034179,419,182,56,126,4,33,17,16,197,172,3,20,2,3
E33034180,571,295,82,213,9,55,44,11,202,196,0,6,0,10
E33034181,667,476,153,323,3,21,12,9,162,154,0,3,5,5
E33034182,740,561,197,364,7,24,14,10,139,134,2,3,0,9
E33034183,336,276,89,187,2,15,5,10,39,34,0,5,0,4
E33034184,682,449,132,317,1,97,65,32,125,116,2,6,1,10
E33034185,305,214,71,143,3,34,22,12,50,48,0,1,1,4
E33034186,272,223,81,142,0,20,15,5,23,23,0,0,0,6
E33034187,456,301,101,200,2,23,12,11,126,119,2,4,1,4
E33034188,462,300,104,196,1,19,8,11,132,117,4,11,0,10
E33034189,437,231,83,148,9,22,10,12,173,158,2,8,5,2
E33034190,575,351,113,238,2,20,13,7,192,185,2,4,1,10
E33034191,642,358,114,244,3,85,48,37,191,182,0,4,5,5
E33034192,357,223,80,143,2,31,14,17,99,97,0,2,0,2
E33034193,343,250,78,172,10,23,10,13,59,57,1,1,0,1
E33034194,406,267,86,181,3,43,19,24,93,86,0,2,5,0
E33034195,508,361,131,230,1,14,7,7,130,126,0,4,0,2
E33034196,426,307,92,215,4,16,10,6,95,85,1,6,3,4
E33034197,543,271,76,195,7,43,18,25,220,213,0,6,1,2
E33034198,321,218,59,159,2,25,11,14,73,69,0,3,1,3
E33034199,714,464,169,295,3,59,30,29,186,176,3,2,5,2
E33034200,495,291,96,195,8,50,18,32,144,132,3,6,3,2
E33034201,428,247,67,180,12,32,13,19,136,133,1,2,0,1
E33034202,405,311,102,209,2,22,16,6,66,58,0,8,0,4
E33034203,416,310,108,202,3,28,14,14,75,70,2,1,2,0
E33034204,440,320,108,212,6,17,6,11,93,87,3,3,0,4
E33034205,236,180,68,112,2,14,6,8,32,30,0,1,1,8
E33034206,280,237,107,130,0,7,4,3,36,32,0,4,0,0
E33034207,285,232,94,138,0,10,4,6,37,32,0,1,4,6
E33034208,538,405,134,271,4,49,30,19,79,74,0,3,2,1
E33034209,498,318,138,180,0,17,5,12,155,149,0,1,5,8
E33034210,408,241,90,151,8,11,6,5,145,140,2,3,0,3
E33034211,534,331,107,224,1,65,49,16,129,120,2,6,1,8
E33034212,368,312,101,211,3,14,8,6,39,38,1,0,0,0
E33034213,298,229,78,151,3,11,7,4,52,50,0,1,1,3
E33034214,264,228,79,149,0,10,4,6,24,21,1,2,0,2
E33034215,383,264,79,185,2,22,9,13,91,89,1,1,0,4
E33034216,596,396,133,263,5,49,22,27,142,135,2,5,0,4
E33034217,292,189,64,125,3,17,5,12,82,78,0,3,1,1
E33034218,360,215,89,126,6,25,8,17,112,107,2,2,1,2
E33034219,711,430,138,292,6,72,35,37,196,187,1,8,0,7
E33034220,406,189,69,120,8,29,17,12,177,165,5,5,2,3
E33034221,725,470,167,303,8,51,22,29,187,175,4,6,2,9
E33034222,346,217,83,134,1,21,9,12,103,97,0,4,2,4
E33034223,632,382,122,260,4,41,21,20,199,192,2,4,1,6
E33034224,517,437,123,314,4,15,10,5,58,54,1,3,0,3
E33034225,287,214,73,141,2,17,12,5,44,39,0,4,1,10
E33034226,393,338,143,195,0,9,7,2,44,41,0,3,0,2
E33034227,281,210,59,151,7,16,8,8,46,44,1,1,0,2
E33034228,1470,957,263,694,12,123,56,67,371,352,3,14,2,7
E33034229,328,177,41,136,4,38,19,19,106,102,1,0,3,3
E33034230,301,163,55,108,3,26,13,13,105,102,0,2,1,4
E33034231,320,194,68,126,4,26,16,10,94,86,0,6,2,2
E33034232,308,174,66,108,6,26,9,17,100,99,0,1,0,2
E33034233,294,131,44,87,3,43,12,31,117,103,0,2,12,0
E33034234,404,264,91,173,10,24,6,18,104,94,2,3,5,2
E33034235,341,230,74,156,1,9,2,7,97,89,1,7,0,4
E33034236,365,244,72,172,1,25,13,12,92,83,0,9,0,3
E33034237,368,207,61,146,4,44,27,17,108,104,2,2,0,5
E33034238,480,354,93,261,1,29,7,22,92,89,0,3,0,4
E33034239,380,302,109,193,1,16,8,8,59,53,2,4,0,2
E33034240,546,319,92,227,9,54,17,37,158,152,1,3,2,6
E33034241,365,249,90,159,5,35,20,15,69,63,2,3,1,7
E33034242,629,437,101,336,13,59,36,23,115,101,2,9,3,5
E33034243,326,205,77,128,7,20,8,12,92,89,0,3,0,2
E33034244,404,214,61,153,3,33,15,18,148,141,2,4,1,6
E33034245,425,209,69,140,2,116,27,89,89,80,0,3,6,9
E33034246,612,421,122,299,7,58,26,32,124,116,3,4,1,2
E33034247,767,479,173,306,11,79,40,39,185,180,3,1,1,13
E33034248,287,196,69,127,4,9,8,1,76,71,0,5,0,2
E33034249,251,156,45,111,6,22,10,12,62,58,0,4,0,5
E33034250,286,187,65,122,9,11,3,8,73,63,3,4,3,6
E33034251,297,201,55,146,2,11,6,5,78,73,5,0,0,5
E33034252,485,293,73,220,3,31,22,9,151,144,1,6,0,7
E33034253,344,199,55,144,10,34,18,16,100,97,2,1,0,1
E33034254,504,325,108,217,3,37,17,20,138,133,1,2,2,1
E33034255,295,164,51,113,1,24,10,14,98,92,1,2,3,8
E33034256,334,193,40,153,2,23,10,13,115,106,0,9,0,1
E33034257,284,174,44,130,1,20,10,10,84,76,2,6,0,5
E33034258,516,334,118,216,7,57,38,19,113,107,3,3,0,5
E33034259,606,408,104,304,4,59,48,11,126,117,0,8,1,9
E33034260,746,547,144,403,8,127,105,22,61,58,2,1,0,3
E33034261,327,193,51,142,2,93,85,8,38,36,2,0,0,1
E33034262,383,254,51,203,5,70,62,8,48,43,0,5,0,6
E33034263,547,368,113,255,4,122,93,29,47,43,1,3,0,6
E33034264,502,370,76,294,3,86,82,4,39,37,0,2,0,4
E33034265,878,659,167,492,3,116,93,23,100,94,2,4,0,0
E33034266,844,667,223,444,4,76,63,13,91,76,0,10,5,6
E33034267,300,185,44,141,4,75,69,6,34,32,0,1,1,2
E33034268,544,373,81,292,2,99,82,17,65,60,0,5,0,5
E33034269,600,336,73,263,0,194,169,25,68,60,2,4,2,2
E33034270,371,245,49,196,5,77,71,6,42,40,0,2,0,2
E33034271,595,474,140,334,5,60,49,11,49,43,4,2,0,7
E33034272,331,249,59,190,2,42,28,14,37,33,2,2,0,1
E33034273,397,294,90,204,2,39,33,6,61,58,1,2,0,1
E33034274,368,304,102,202,2,42,40,2,19,18,0,1,0,1
E33034275,408,280,65,215,1,74,67,7,51,45,3,3,0,2
E33034276,381,301,64,237,2,46,41,5,26,24,1,1,0,6
E33034277,612,411,107,304,0,124,99,25,74,72,0,0,2,3
E33034278,260,200,62,138,1,29,20,9,25,22,0,3,0,5
E33034279,286,223,71,152,0,21,10,11,39,38,0,1,0,3
E33034280,539,436,133,303,3,42,28,14,57,52,0,5,0,1
E33034281,471,344,103,241,1,43,34,9,80,78,0,2,0,3
E33034282,350,315,94,221,1,14,10,4,20,19,0,1,0,0
E33034283,557,512,153,359,1,20,14,6,23,20,0,3,0,1
E33034284,345,307,81,226,1,12,7,5,23,21,0,2,0,2
E33034285,399,330,92,238,1,30,18,12,37,34,0,3,0,1
E33034286,615,514,119,395,1,34,22,12,61,60,1,0,0,5
E33034287,443,360,94,266,2,50,34,16,31,27,0,4,0,0
E33034288,464,370,116,254,1,47,35,12,40,36,0,3,1,6
E33034289,424,355,105,250,0,29,19,10,38,34,0,4,0,2
E33034290,283,231,68,163,3,17,12,5,31,30,0,1,0,1
E33034291,481,432,104,328,3,12,8,4,33,32,0,1,0,1
E33034292,415,321,78,243,4,33,21,12,56,56,0,0,0,1
E33034293,325,276,76,200,3,23,19,4,22,22,0,0,0,1
E33034294,704,538,182,356,7,75,52,23,78,72,3,3,0,6
E33034295,720,502,132,370,4,117,80,37,93,81,1,11,0,4
E33034296,402,295,83,212,4,38,23,15,62,57,1,3,1,3
E33034297,383,286,74,212,6,42,33,9,48,43,0,4,1,1
E33034298,383,290,67,223,0,53,41,12,39,38,0,1,0,1
E33034299,338,224,46,178,5,37,35,2,69,66,0,3,0,3
E33034300,451,324,89,235,1,31,24,7,95,92,0,3,0,0
E33034301,374,282,100,182,2,45,30,15,43,39,0,4,0,2
E33034302,318,253,73,180,4,26,13,13,30,29,0,1,0,5
E33034303,431,359,112,247,3,20,15,5,47,42,1,4,0,2
E33034304,328,255,76,179,1,36,29,7,33,32,0,0,1,3
E33034305,270,185,43,142,7,35,22,13,43,41,0,2,0,0
E33034306,916,560,154,406,7,190,147,43,157,147,0,8,2,2
E33034307,423,298,89,209,5,56,37,19,60,57,0,3,0,4
E33034308,241,150,44,106,2,42,38,4,44,41,0,2,1,3
E33034309,303,196,54,142,2,41,24,17,61,60,0,1,0,3
E33034310,772,535,146,389,14,85,46,39,135,123,4,7,1,3
E33034311,467,357,92,265,4,40,32,8,63,59,0,4,0,3
E33034312,455,321,101,220,5,72,53,19,55,53,0,2,0,2
E33034313,474,361,103,258,2,48,30,18,59,54,0,4,1,4
E33034314,739,615,148,467,4,45,32,13,70,63,1,6,0,5
E33034315,348,250,69,181,5,41,30,11,48,44,3,0,1,4
E33034316,342,291,89,202,0,18,16,2,31,28,0,3,0,2
E33034317,416,373,125,248,1,14,9,5,28,28,0,0,0,0
E33034318,380,324,97,227,4,12,11,1,39,33,0,6,0,1
E33034319,418,341,97,244,0,12,7,5,64,60,1,3,0,1
E33034320,281,218,69,149,1,22,18,4,38,35,2,1,0,2
E33034321,468,394,157,237,1,32,17,15,38,36,0,2,0,3
E33034322,349,317,116,201,1,13,6,7,17,15,0,2,0,1
E33034323,356,267,67,200,4,25,17,8,55,51,0,4,0,5
E33034324,1430,1066,318,748,15,160,127,33,183,173,0,8,2,6
E33034325,272,203,59,144,1,33,19,14,33,32,0,1,0,2
E33034326,268,216,64,152,1,18,10,8,30,29,0,1,0,3
E33034327,500,343,81,262,11,73,55,18,73,64,2,5,2,0
E33034328,316,249,63,186,2,28,27,1,35,32,0,2,1,2
E33034329,494,324,98,226,6,65,38,27,94,87,0,6,1,5
E33034330,413,331,58,273,4,40,29,11,37,34,0,1,2,1
E33034331,5344,3699,978,2721,57,713,440,273,858,812,3,36,7,17
E33034332,539,419,96,323,6,44,40,4,66,62,0,4,0,4
E33034333,810,602,190,412,6,103,82,21,97,88,0,7,2,2
E33034334,310,227,78,149,3,39,30,9,40,33,1,4,2,1
E33034335,497,367,87,280,4,43,25,18,81,76,1,3,1,2
E33034336,351,293,82,211,1,34,25,9,21,19,0,2,0,2
E33034337,411,324,88,236,1,32,28,4,46,43,0,3,0,8
E33034338,469,355,123,232,2,55,45,10,55,49,0,3,3,2
E33034339,299,255,71,184,2,16,14,2,26,24,0,2,0,0
E33034340,468,416,146,270,0,12,5,7,35,31,1,3,0,5
E33034341,326,256,83,173,2,34,25,9,34,30,0,4,0,0
E33034342,493,418,138,280,5,27,15,12,40,36,0,4,0,3
E33034343,350,279,88,191,4,13,11,2,53,50,2,1,0,1
E33034344,314,263,89,174,0,18,14,4,30,22,3,5,0,3
E33034345,250,176,40,136,0,36,16,20,36,35,0,1,0,2
E33034346,360,322,95,227,5,16,14,2,14,12,0,2,0,3
E33034347,595,468,151,317,3,54,43,11,64,60,0,4,0,6
E33034348,354,252,82,170,0,58,46,12,37,35,0,2,0,7
E33034349,332,253,75,178,2,38,30,8,35,31,0,4,0,4
E33034350,374,310,92,218,4,31,20,11,29,25,0,4,0,0
E33034351,457,397,96,301,3,18,8,10,38,32,0,5,1,1
E33034352,530,385,111,274,2,73,57,16,65,59,2,4,0,5
E33034353,330,280,89,191,0,9,7,2,37,34,0,3,0,4
E33034354,316,258,69,189,0,32,29,3,24,23,0,1,0,2
E33034355,238,199,71,128,2,20,20,0,16,15,0,1,0,1
E33034356,577,479,156,323,3,25,14,11,67,63,0,2,2,3
E33034357,580,449,115,334,3,50,38,12,78,71,2,5,0,0
E33034358,331,265,79,186,0,33,27,6,32,29,0,2,1,1
E33034359,294,224,54,170,0,16,14,2,51,49,0,1,1,3
E33034360,343,277,76,201,2,30,23,7,33,32,0,1,0,1
E33034361,292,232,77,155,2,22,16,6,35,34,0,1,0,1
E33034362,406,355,89,266,3,21,16,5,27,24,0,3,0,0
E33034363,301,260,77,183,0,18,15,3,21,20,0,1,0,2
E33034364,257,223,65,158,0,16,9,7,15,11,2,2,0,3
E33034365,393,362,98,264,0,8,5,3,18,18,0,0,0,5
E33034366,521,427,148,279,7,33,24,9,52,45,4,3,0,2
E33034367,675,594,190,404,3,34,27,7,40,38,0,2,0,4
E33034368,405,329,85,244,1,26,19,7,48,48,0,0,0,1
E33034369,585,465,140,325,2,51,44,7,63,60,0,3,0,4
E33034370,329,239,68,171,3,33,23,10,53,51,0,1,1,1
E33034371,342,272,69,203,3,38,29,9,27,20,0,5,2,2
E33034372,799,648,169,479,3,64,51,13,81,76,0,5,0,3
E33034373,497,423,119,304,6,32,20,12,33,30,1,2,0,3
E33034374,575,391,94,297,3,96,59,37,82,77,0,5,0,3
E33034375,365,279,70,209,0,45,38,7,33,28,1,3,1,8
E33034376,341,213,53,160,1,75,40,35,52,48,1,3,0,0
E33034377,478,355,80,275,5,60,35,25,57,55,0,2,0,1
E33034378,352,263,73,190,4,35,19,16,48,45,0,2,1,2
E33034379,760,660,195,465,0,28,8,20,66,61,2,3,0,6
E33034380,367,276,66,210,3,39,16,23,48,46,0,2,0,1
E33034381,479,341,77,264,4,51,34,17,82,77,2,3,0,1
E33034382,281,198,80,118,1,15,13,2,61,54,3,2,2,6
E33034383,353,248,100,148,3,35,8,27,63,46,3,2,12,4
E33034384,218,163,53,110,0,18,4,14,29,23,6,0,0,8
E33034385,446,360,124,236,4,27,16,11,52,43,6,2,1,3
E33034386,265,172,61,111,6,32,14,18,51,48,1,2,0,4
E33034387,299,208,62,146,3,38,27,11,46,42,1,3,0,4
E33034388,319,189,69,120,2,51,21,30,76,74,0,2,0,1
E33034389,293,222,57,165,4,17,11,6,46,44,0,1,1,4
E33034390,293,182,64,118,0,22,14,8,83,76,0,1,6,6
E33034391,267,201,64,137,2,17,10,7,45,37,0,6,2,2
E33034392,388,265,87,178,1,25,13,12,88,70,14,2,2,9
E33034393,447,292,104,188,6,27,16,11,117,105,1,11,0,5
E33034394,888,647,177,470,4,64,39,25,168,156,0,7,5,5
E33034395,299,197,53,144,6,42,27,15,48,44,0,3,1,6
E33034396,282,222,62,160,2,25,15,10,31,29,2,0,0,2
E33034397,247,153,49,104,4,52,41,11,37,32,2,1,2,1
E33034398,465,315,103,212,9,67,42,25,70,62,2,5,1,4
E33034399,295,207,63,144,2,47,38,9,34,30,2,2,0,5
E33034400,342,245,77,168,1,29,22,7,63,61,0,1,1,4
E33034401,614,406,131,275,7,75,48,27,122,112,1,8,1,4
E33034402,320,257,78,179,2,13,9,4,47,41,1,4,1,1
E33034403,273,194,55,139,2,33,26,7,42,39,1,1,1,2
E33034404,399,301,81,220,4,35,21,14,57,52,1,3,1,2
E33034405,768,548,143,405,13,83,52,31,112,104,2,3,3,12
E33034406,457,361,108,253,4,24,9,15,66,59,4,2,1,2
E33034407,337,256,57,199,4,39,21,18,35,29,0,3,3,3
E33034408,718,512,162,350,5,57,39,18,135,122,2,6,5,9
E33034409,376,324,97,227,1,22,15,7,28,26,1,1,0,1
E33034410,476,327,91,236,10,55,32,23,83,75,1,6,1,1
E33034411,433,355,164,191,0,18,9,9,59,53,1,3,2,1
E33034412,395,264,78,186,5,46,15,31,73,65,1,1,6,7
E33034413,803,562,175,387,6,81,43,38,152,139,5,5,3,2
E33034414,293,230,67,163,3,21,13,8,37,29,5,2,1,2
E33034415,685,422,117,305,5,89,48,41,157,143,7,5,2,12
E33034416,328,299,96,203,2,7,3,4,18,16,2,0,0,2
E33034417,335,278,83,195,2,13,11,2,40,36,3,0,1,2
E33034418,405,354,92,262,0,17,11,6,33,33,0,0,0,1
E33034419,685,493,143,350,7,60,42,18,120,112,2,4,2,5
E33034420,279,197,57,140,2,20,9,11,57,53,0,4,0,3
E33034421,458,372,105,267,5,26,9,17,52,47,2,3,0,3
E33034422,269,108,27,81,2,20,7,13,137,110,12,0,15,2
E33034423,289,219,55,164,1,16,13,3,51,41,3,2,5,2
E33034424,404,276,65,211,4,39,27,12,79,68,3,7,1,6
E33034425,293,207,53,154,2,20,13,7,63,59,1,2,1,1
E33034426,635,446,92,354,12,65,34,31,111,105,0,3,3,1
E33034427,480,358,107,251,14,39,17,22,66,58,4,2,2,3
E33034428,363,285,68,217,2,26,13,13,49,45,1,2,1,1
E33034429,524,437,117,320,2,19,9,10,60,46,0,11,3,6
E33034430,285,257,83,174,1,8,5,3,18,16,2,0,0,1
E33034431,511,404,115,289,5,35,25,10,63,55,4,4,0,4
E33034432,647,469,143,326,12,53,33,20,102,90,2,7,3,11
E33034433,350,288,99,189,1,9,7,2,50,33,5,7,5,2
E33034434,351,296,76,220,3,16,8,8,35,28,5,1,1,1
E33034435,339,253,71,182,3,31,14,17,51,45,5,1,0,1
E33034436,439,332,84,248,4,39,20,19,63,62,0,1,0,1
E33034437,419,326,116,210,0,26,13,13,62,56,0,3,3,5
E33034438,314,263,93,170,1,18,3,15,30,26,1,3,0,2
E33034439,539,393,147,246,8,61,36,25,74,69,3,1,1,3
E33034440,321,245,64,181,2,39,31,8,31,28,1,2,0,4
E33034441,415,335,68,267,9,15,10,5,50,47,2,1,0,6
E33034442,399,315,102,213,6,34,24,10,42,39,0,3,0,2
E33034443,985,711,168,543,18,67,40,27,183,170,3,9,1,6
E33034444,369,221,71,150,9,37,20,17,100,87,9,2,2,2
E33034445,457,270,81,189,10,58,29,29,113,105,1,4,3,6
E33034446,622,472,157,315,12,58,26,32,74,66,1,6,1,6
E33034447,560,378,107,271,7,70,43,27,99,79,15,1,4,6
E33034448,232,152,45,107,3,22,15,7,54,49,0,3,2,1
E33034449,845,498,127,371,21,105,48,57,214,199,5,6,4,7
E33034450,303,200,52,148,4,45,27,18,52,50,0,2,0,2
E33034451,523,313,83,230,12,63,42,21,130,122,0,7,1,5
E33034452,1446,911,233,678,23,162,93,69,316,286,7,19,4,34
E33034453,247,176,47,129,5,21,8,13,42,37,1,3,1,3
E33034454,1028,728,164,564,15,86,48,38,191,177,2,10,2,8
E33034455,331,231,83,148,1,52,35,17,47,42,0,3,2,0
E33034456,322,251,68,183,3,18,7,11,48,47,0,0,1,2
E33034457,3127,2072,542,1530,55,417,159,258,571,533,9,20,9,12
E33034458,397,273,70,203,6,49,25,24,62,59,0,3,0,7
E33034459,282,172,51,121,5,41,26,15,63,56,3,2,2,1
E33034460,385,275,73,202,12,41,20,21,54,48,3,3,0,3
E33034461,367,241,60,181,11,43,26,17,68,60,1,7,0,4
E33034462,471,342,89,253,7,45,26,19,73,68,4,1,0,4
E33034463,331,258,84,174,3,13,7,6,54,53,0,1,0,3
E33034464,338,233,49,184,6,37,19,18,59,56,0,3,0,3
E33034465,699,470,137,333,8,114,61,53,100,97,1,2,0,7
E33034466,362,199,56,143,1,67,44,23,94,89,0,4,1,1
E33034467,285,151,42,109,4,51,39,12,73,70,0,3,0,6
E33034468,300,215,52,163,6,36,21,15,41,34,2,2,3,2
E33034469,304,213,44,169,8,49,34,15,34,32,1,1,0,0
E33034470,1009,574,143,431,18,177,115,62,223,212,1,7,3,17
E33034471,647,379,103,276,16,130,88,42,115,112,0,0,3,7
E33034472,716,463,136,327,3,34,19,15,209,178,3,15,13,7
E33034473,291,215,55,160,2,18,11,7,55,54,1,0,0,1
E33034474,386,255,51,204,10,43,28,15,77,73,0,2,2,1
E33034475,337,198,53,145,7,61,34,27,69,67,0,1,1,2
E33034476,777,509,116,393,11,114,74,40,141,126,2,11,2,2
E33034477,399,252,57,195,13,53,31,22,79,76,0,3,0,2
E33034478,404,261,70,191,19,47,23,24,76,72,1,3,0,1
E33034479,311,231,70,161,1,37,24,13,38,36,0,2,0,4
E33034480,327,197,40,157,9,66,45,21,55,51,0,2,2,0
E33034481,607,351,101,250,10,101,21,80,140,132,1,7,0,5
E33034482,438,310,80,230,13,42,19,23,69,67,0,2,0,4
E33034483,454,256,61,195,8,87,61,26,101,97,2,2,0,2
E33034484,386,235,59,176,15,76,55,21,59,57,0,2,0,1
E33034485,303,169,42,127,2,45,34,11,84,78,0,5,1,3
E33034486,348,235,53,182,4,42,27,15,64,57,1,3,3,3
E33034487,275,169,43,126,7,50,34,16,47,43,1,2,1,2
E33034488,444,271,55,216,15,72,41,31,84,80,0,3,1,2
E33034489,284,170,55,115,8,60,38,22,40,38,0,2,0,6
E33034490,332,218,37,181,4,57,41,16,50,48,0,0,2,3
E33034491,365,261,66,195,7,30,19,11,66,59,0,7,0,1
E33034492,405,219,69,150,18,83,60,23,82,79,0,1,2,3
E33034493,270,139,28,111,9,58,40,18,63,62,0,1,0,1
E33034494,416,269,81,188,8,71,39,32,65,57,0,5,3,3
E33034495,396,246,72,174,5,59,30,29,78,76,2,0,0,8
E33034496,730,452,112,340,12,119,73,46,141,134,0,7,0,6
E33034497,338,229,77,152,9,44,25,19,53,50,0,2,1,3
E33034498,419,241,44,197,4,62,41,21,108,100,1,3,4,4
E33034499,659,395,97,298,7,101,53,48,141,133,3,5,0,15
E33034500,292,174,43,131,1,44,27,17,65,54,2,5,4,8
E33034501,446,261,60,201,6,75,31,44,102,93,0,9,0,2
E33034502,1122,654,142,512,34,190,92,98,239,229,2,5,3,5
E33034503,438,237,37,200,12,78,50,28,108,100,2,6,0,3
E33034504,348,189,43,146,1,99,72,27,59,52,2,4,1,0
E33034505,399,250,67,183,8,51,30,21,86,82,1,2,1,4
E33034506,360,247,58,189,6,46,20,26,60,56,0,3,1,1
E33034507,472,261,58,203,14,82,35,47,114,106,2,4,2,1
E33034508,1012,726,197,529,14,78,38,40,189,174,1,11,3,5
E33034509,372,222,53,169,6,32,19,13,110,105,2,3,0,2
E33034510,432,296,83,213,9,32,15,17,94,89,4,0,1,1
E33034511,1366,846,202,644,26,83,46,37,404,391,0,9,4,7
E33034512,329,179,41,138,10,39,21,18,101,96,0,2,3,0
E33034513,233,187,42,145,0,17,11,6,26,25,0,1,0,3
E33034514,494,324,97,227,5,59,26,33,106,98,4,2,2,0
E33034515,369,248,66,182,2,39,16,23,80,71,2,7,0,0
E33034516,318,172,25,147,1,21,12,9,124,119,2,3,0,0
E33034517,299,168,54,114,8,34,24,10,87,81,1,2,3,2
E33034518,335,207,65,142,7,39,16,23,78,71,0,4,3,4
E33034519,315,165,32,133,11,28,17,11,102,99,0,1,2,9
E33034520,465,258,71,187,2,72,47,25,127,118,1,6,2,6
E33034521,261,144,42,102,1,27,14,13,88,84,0,3,1,1
E33034522,851,488,128,360,16,74,44,30,264,245,3,14,2,9
E33034523,492,239,81,158,5,48,28,20,193,179,8,6,0,7
E33034524,389,206,77,129,5,34,15,19,143,137,0,3,3,1
E33034525,632,362,118,244,3,99,47,52,168,159,0,8,1,0
E33034526,588,286,82,204,9,84,53,31,206,193,0,10,3,3
E33034527,462,275,109,166,7,59,31,28,114,109,0,5,0,7
E33034528,657,303,102,201,9,72,43,29,268,256,1,9,2,5
E33034529,243,167,77,90,2,10,1,9,60,56,0,3,1,4
E33034530,290,162,59,103,3,35,24,11,88,82,0,5,1,2
E33034531,673,347,80,267,21,124,93,31,176,170,0,1,5,5
E33034532,327,174,61,113,9,52,36,16,92,85,0,7,0,0
E33034533,339,161,48,113,6,74,40,34,98,94,2,2,0,0
E33034534,332,132,37,95,8,102,94,8,87,80,1,3,3,3
E33034535,362,128,33,95,9,138,100,38,87,79,0,7,1,0
E33034536,502,329,85,244,8,51,22,29,112,103,2,6,1,2
E33034537,381,212,77,135,3,53,44,9,113,104,2,3,4,0
E33034538,599,314,105,209,14,105,60,45,163,154,1,6,2,3
E33034539,455,318,102,216,2,39,25,14,93,90,0,3,0,3
E33034540,464,263,71,192,9,85,62,23,104,93,1,6,4,3
E33034541,424,243,74,169,5,85,61,24,87,83,0,3,1,4
E33034542,609,321,67,254,22,119,82,37,144,137,3,1,3,3
E33034543,483,293,86,207,8,89,56,33,85,83,1,1,0,8
E33034544,409,214,76,138,9,44,27,17,131,129,0,1,1,11
E33034545,561,335,108,227,8,55,36,19,155,144,1,6,4,8
E33034546,278,134,39,95,19,52,25,27,71,66,0,5,0,2
E33034547,441,211,64,147,3,109,82,27,109,98,3,8,0,9
E33034548,328,187,59,128,3,32,17,15,106,101,0,2,3,0
E33034549,331,209,61,148,5,46,22,24,69,64,0,2,3,2
E33034550,315,167,49,118,0,25,14,11,122,119,0,1,2,1
E33034551,299,196,73,123,0,32,18,14,69,69,0,0,0,2
E33034552,381,240,110,130,1,41,18,23,96,94,0,1,1,3
E33034553,591,377,104,273,8,29,11,18,172,163,2,7,0,5
E33034554,370,195,64,131,3,42,24,18,127,124,0,2,1,3
E33034555,413,242,80,162,4,53,28,25,111,109,0,2,0,3
E33034556,400,216,92,124,6,77,53,24,97,91,1,3,2,4
E33034557,267,129,36,93,4,69,51,18,60,54,2,4,0,5
E33034558,377,210,57,153,2,34,18,16,125,121,0,4,0,6
E33034559,301,167,47,120,3,33,26,7,98,94,0,4,0,0
E33034560,307,209,77,132,2,25,17,8,68,60,0,8,0,3
E33034561,315,213,73,140,1,18,8,10,78,75,0,2,1,5
E33034562,384,216,69,147,2,42,22,20,122,120,0,2,0,2
E33034563,266,155,51,104,3,59,31,28,46,45,0,1,0,3
E33034564,256,129,52,77,4,24,12,12,90,77,10,3,0,9
E33034565,835,494,158,336,24,110,61,49,198,190,2,5,1,9
E33034566,382,235,85,150,10,32,14,18,102,101,1,0,0,3
E33034567,375,176,45,131,1,26,17,9,171,164,4,3,0,1
E33034568,275,151,51,100,4,31,14,17,76,69,3,1,3,13
E33034569,283,194,76,118,4,17,7,10,64,61,1,1,1,4
E33034570,337,189,69,120,3,15,6,9,127,120,0,4,3,3
E33034571,342,232,85,147,0,16,8,8,91,81,2,6,2,3
E33034572,533,367,121,246,1,46,35,11,112,102,4,5,1,7
E33034573,386,222,81,141,2,59,25,34,101,85,5,8,3,2
E33034574,374,214,53,161,4,34,18,16,120,115,0,5,0,2
E33034575,1012,618,202,416,21,93,46,47,270,251,6,10,3,10
E33034576,456,260,85,175,4,26,6,20,163,160,1,2,0,3
E33034577,598,270,110,160,2,33,23,10,289,283,0,6,0,4
E33034578,572,294,94,200,11,54,30,24,211,192,2,13,4,2
E33034579,994,572,143,429,16,109,65,44,285,267,2,9,7,12
E33034580,726,456,135,321,9,45,28,17,213,204,0,5,4,3
E33034581,380,208,70,138,3,26,15,11,137,123,2,4,8,6
E33034582,675,459,100,359,14,58,25,33,136,112,10,4,10,8
E33034583,598,350,99,251,17,102,79,23,126,118,3,5,0,3
E33034584,2676,1598,448,1150,71,479,219,260,517,478,3,27,9,11
E33034585,432,283,85,198,3,62,29,33,81,76,2,3,0,3
E33034586,334,201,56,145,8,50,36,14,69,63,2,3,1,6
E33034587,362,216,62,154,8,62,34,28,75,66,0,5,4,1
E33034588,359,192,46,146,9,38,20,18,118,110,0,3,5,2
E33034589,284,131,44,87,2,52,31,21,97,94,1,1,1,2
E33034590,272,158,52,106,15,42,21,21,55,51,0,3,1,2
E33034591,442,261,61,200,4,48,26,22,119,109,0,6,4,10
E33034592,450,272,97,175,13,93,64,29,70,69,1,0,0,2
E33034593,349,213,63,150,21,33,21,12,78,74,1,3,0,4
E33034594,577,267,71,196,10,76,42,34,220,206,2,8,4,4
E33034595,292,139,39,100,4,40,23,17,108,105,0,0,3,1
E33034596,366,162,60,102,10,56,35,21,138,131,2,4,1,0
E33034597,530,311,96,215,6,81,44,37,125,120,0,5,0,7
E33034598,470,287,65,222,8,50,29,21,119,114,0,4,1,6
E33034599,349,166,61,105,6,26,6,20,147,142,0,4,1,4
E33034600,555,280,83,197,6,65,32,33,202,196,2,2,2,2
E33034601,330,123,25,98,5,90,31,59,109,99,6,1,3,3
E33034602,509,316,99,217,3,50,31,19,137,130,1,5,1,3
E33034603,401,237,86,151,12,31,18,13,113,108,0,2,3,8
E33034604,711,398,133,265,12,64,33,31,231,221,0,5,5,6
E33034605,347,173,59,114,7,50,33,17,115,106,0,0,9,2
E33034606,374,205,60,145,5,50,38,12,113,105,0,4,4,1
E33034607,277,150,40,110,1,33,25,8,90,80,3,2,5,3
E33034608,369,200,54,146,9,45,23,22,114,108,2,4,0,1
E33034609,536,233,51,182,10,81,49,32,209,200,1,4,4,3
E33034610,352,200,42,158,3,25,7,18,122,118,1,2,1,2
E33034611,483,240,58,182,7,46,19,27,189,172,9,7,1,1
E33034612,633,345,89,256,13,48,19,29,223,214,1,5,3,4
E33034613,847,449,110,339,19,56,28,28,319,304,2,12,1,4
E33034614,432,292,88,204,1,32,15,17,105,100,0,4,1,2
E33034615,938,623,159,464,19,52,32,20,241,234,0,5,2,3
E33034616,351,212,69,143,8,36,20,16,86,84,2,0,0,9
E33034617,403,259,65,194,0,55,34,21,85,78,1,3,3,4
E33034618,315,226,65,161,3,26,12,14,59,54,2,2,1,1
E33034619,738,360,97,263,16,200,147,53,155,151,0,3,1,7
E33034620,323,142,32,110,5,119,94,25,54,50,0,2,2,3
E33034621,330,232,73,159,6,37,29,8,53,49,0,2,2,2
E33034622,809,459,146,313,22,76,33,43,247,237,0,7,3,5
E33034623,610,346,103,243,11,62,35,27,186,128,24,11,23,5
E33034624,348,163,42,121,4,64,32,32,113,109,1,3,0,4
E33034625,800,476,127,349,10,126,79,47,185,178,3,4,0,3
E33034626,497,318,96,222,5,72,50,22,102,88,5,5,4,0
E33034627,2155,1451,330,1121,37,263,132,131,391,369,3,16,3,13
E33034628,408,291,62,229,10,42,27,15,64,61,0,3,0,1
E33034629,430,281,87,194,7,57,30,27,82,79,0,3,0,3
E33034630,335,197,36,161,13,80,46,34,43,41,0,1,1,2
E33034631,389,233,69,164,15,66,23,43,72,66,0,6,0,3
E33034632,363,161,41,120,33,83,41,42,79,73,0,5,1,7
E33034633,304,193,45,148,5,36,22,14,65,60,0,5,0,5
E33034634,450,264,56,208,5,77,41,36,99,94,0,5,0,5
E33034635,663,389,111,278,14,101,56,45,153,146,1,4,2,6
E33034636,325,203,44,159,2,68,39,29,50,48,0,1,1,2
E33034637,460,304,81,223,4,40,33,7,105,99,4,1,1,7
E33034638,533,305,87,218,11,75,45,30,137,126,3,5,3,5
E33034639,728,486,110,376,18,90,43,47,130,125,1,1,3,4
E33034640,983,435,98,337,42,231,122,109,268,259,1,7,1,7
E33034641,784,456,123,333,13,162,116,46,150,141,0,9,0,3
E33034642,557,328,75,253,17,124,62,62,85,80,3,2,0,3
E33034643,489,298,72,226,6,101,69,32,81,78,0,3,0,3
E33034644,1249,820,193,627,24,152,78,74,247,233,2,10,2,6
E33034645,584,317,82,235,6,153,50,103,107,100,0,5,2,1
E33034646,536,331,85,246,12,92,42,50,94,86,0,8,0,7
E33034647,516,229,59,170,7,153,111,42,120,119,0,0,1,7
E33034648,950,596,120,476,22,136,56,80,184,159,14,7,4,12
E33034649,424,275,64,211,10,51,27,24,87,78,0,8,1,1
E33034650,1126,780,193,587,18,123,53,70,200,185,1,8,6,5
E33034651,642,353,82,271,19,65,36,29,200,192,1,5,2,5
E33034652,351,203,39,164,24,39,15,24,85,77,3,3,2,0
E33034653,285,200,54,146,4,32,21,11,45,40,1,3,1,4
E33034654,265,165,54,111,5,63,49,14,29,25,2,1,1,3
E33034655,709,473,107,366,10,100,72,28,120,110,2,5,3,6
E33034656,291,119,38,81,2,130,95,35,39,34,0,4,1,1
E33034657,530,242,68,174,4,138,79,59,140,127,1,11,1,6
E33034658,391,172,46,126,2,127,103,24,86,78,0,8,0,4
E33034659,554,209,78,131,9,195,144,51,138,128,0,7,3,3
E33034660,270,105,31,74,10,97,57,40,55,52,0,3,0,3
E33034661,520,252,98,154,11,89,50,39,160,149,1,9,1,8
E33034662,376,208,77,131,1,60,28,32,107,103,0,4,0,0
E33034663,424,198,65,133,7,133,101,32,86,84,0,2,0,0
E33034664,353,190,72,118,5,65,49,16,89,84,0,5,0,4
E33034665,297,141,33,108,0,50,25,25,104,103,0,1,0,2
E33034666,357,165,41,124,8,101,66,35,78,72,0,6,0,5
E33034667,462,162,50,112,3,124,63,61,165,157,0,7,1,8
E33034668,297,122,31,91,6,80,55,25,88,81,4,1,2,1
E33034669,326,131,40,91,2,86,39,47,102,101,0,1,0,5
E33034670,525,212,66,146,8,147,89,58,147,145,0,0,2,11
E33034671,257,116,45,71,4,80,51,29,55,52,1,2,0,2
E33034672,278,110,27,83,6,111,71,40,49,47,1,1,0,2
E33034673,292,117,37,80,0,94,25,69,79,76,0,3,0,2
E33034674,718,433,133,300,8,124,75,49,145,139,1,4,1,8
E33034675,854,333,93,240,10,323,191,132,182,178,2,2,0,6
E33034676,388,164,48,116,5,110,77,33,107,101,0,4,2,2
E33034677,468,148,39,109,3,142,75,67,153,141,6,3,3,22
E33034678,454,167,33,134,10,170,124,46,98,91,2,5,0,9
E33034679,475,173,65,108,13,184,99,85,99,95,0,3,1,6
E33034680,614,287,59,228,6,192,127,65,125,120,0,4,1,4
E33034681,359,127,39,88,6,87,50,37,133,130,0,3,0,6
E33034682,951,409,116,293,13,251,135,116,275,256,0,14,5,3
E33034683,404,190,69,121,3,82,51,31,122,120,0,1,1,7
E33034684,311,121,36,85,3,118,78,40,65,59,1,3,2,4
E33034685,566,290,98,192,3,138,79,59,131,123,1,5,2,4
E33034686,422,222,72,150,15,86,36,50,95,86,1,6,2,4
E33034687,378,170,61,109,6,85,56,29,110,108,0,2,0,7
E33034688,300,113,34,79,3,111,66,45,72,65,2,4,1,1
E33034689,337,111,34,77,5,99,60,39,118,113,0,4,1,4
E33034690,375,181,67,114,3,81,43,38,108,101,1,5,1,2
E33034691,310,148,33,115,2,95,60,35,59,57,0,2,0,6
E33034692,585,279,82,197,7,130,77,53,159,155,1,2,1,10
E33034693,325,205,97,108,3,44,21,23,71,66,0,4,1,2
E33034694,335,151,53,98,7,94,53,41,82,81,0,1,0,1
E33034695,343,148,50,98,4,50,17,33,133,126,3,3,1,8
E33034696,437,279,107,172,6,91,39,52,57,56,0,1,0,4
E33034697,382,237,70,167,0,47,18,29,89,85,0,3,1,9
E33034698,322,147,65,82,3,85,59,26,84,81,0,3,0,3
E33034699,264,161,48,113,6,51,34,17,43,41,1,1,0,3
E33034700,289,156,60,96,1,61,41,20,69,65,1,3,0,2
E33034701,311,142,55,87,4,81,59,22,79,76,0,2,1,5
E33034702,727,349,109,240,9,125,65,60,232,229,0,2,1,12
E33034703,452,165,49,116,4,146,98,48,135,132,1,1,1,2
E33034704,278,106,38,68,6,110,58,52,50,49,0,1,0,6
E33034705,876,399,105,294,27,277,153,124,163,153,0,6,4,10
E33034706,318,102,30,72,6,127,96,31,82,74,0,3,5,1
E33034707,431,175,64,111,4,118,87,31,128,118,0,9,1,6
E33034708,453,207,64,143,15,104,66,38,117,110,0,6,1,10
E33034709,574,214,59,155,5,217,146,71,132,130,0,2,0,6
E33034710,388,157,50,107,10,72,36,36,146,139,2,3,2,3
E33034711,260,105,43,62,2,74,41,33,77,73,0,2,2,2
E33034712,304,123,21,102,10,84,42,42,84,79,0,5,0,3
E33034713,320,123,42,81,7,37,24,13,151,139,0,10,2,2
E33034714,530,239,85,154,10,137,78,59,136,129,1,4,2,8
E33034715,318,119,36,83,4,114,84,30,79,70,2,3,4,2
E33034716,278,111,23,88,4,83,46,37,73,68,1,4,0,7
E33034717,498,218,68,150,4,123,77,46,148,139,1,5,3,5
E33034718,403,169,49,120,6,118,85,33,105,100,1,4,0,5
E33034719,251,102,30,72,2,69,45,24,77,75,0,2,0,1
E33034720,525,244,62,182,14,154,74,80,112,107,1,3,1,1
E33034721,324,158,71,87,7,87,48,39,71,69,0,2,0,1
E33034722,424,177,62,115,8,133,66,67,103,95,1,5,2,3
E33034723,452,173,56,117,7,148,96,52,117,112,0,4,1,7
E33034724,422,222,84,138,5,92,54,38,99,96,1,0,2,4
E33034725,478,268,101,167,4,79,42,37,120,108,1,8,3,7
E33034726,614,251,76,175,11,166,103,63,176,162,3,10,1,10
E33034727,301,133,42,91,3,89,63,26,74,73,0,1,0,2
E33034728,261,87,25,62,5,89,47,42,77,73,1,3,0,3
E33034729,469,218,73,145,7,116,79,37,125,123,0,2,0,3
E33034730,305,138,40,98,5,91,68,23,65,60,2,3,0,6
E33034731,639,266,76,190,10,152,99,53,206,195,0,11,0,5
E33034732,523,174,44,130,14,242,135,107,84,82,1,1,0,9
E33034733,522,234,54,180,7,176,67,109,100,95,1,2,2,5
E33034734,1161,666,134,532,24,246,136,110,216,192,8,12,4,9
E33034735,262,116,35,81,4,70,49,21,65,60,1,3,1,7
E33034736,553,268,95,173,14,140,76,64,129,125,2,1,1,2
E33034737,276,138,41,97,11,61,34,27,64,62,0,1,1,2
E33034738,1185,540,159,381,16,204,110,94,416,398,2,15,1,9
E33034739,346,143,43,100,7,52,32,20,140,133,2,4,1,4
E33034740,389,189,58,131,3,50,35,15,143,138,0,3,2,4
E33034741,365,189,46,143,3,57,40,17,102,91,4,2,5,14
E33034742,316,116,39,77,2,105,36,69,83,78,1,3,1,10
E33034743,308,134,53,81,4,69,50,19,93,89,0,3,1,8
E33034744,449,138,52,86,14,141,96,45,150,145,0,5,0,6
E33034745,288,115,35,80,1,95,51,44,76,70,1,4,1,1
E33034746,302,162,68,94,4,72,43,29,59,57,1,1,0,5
E33034747,454,220,74,146,4,81,30,51,147,143,1,1,2,2
E33034748,267,149,64,85,2,23,11,12,88,83,0,5,0,5
E33034749,304,172,75,97,1,52,30,22,77,76,0,1,0,2
E33034750,280,153,70,83,1,51,19,32,68,67,0,1,0,7
E33034751,290,116,48,68,2,58,22,36,112,104,0,6,2,2
E33034752,256,102,26,76,1,50,27,23,103,96,2,4,1,0
E33034753,626,288,106,182,14,149,96,53,166,156,0,8,2,9
E33034754,471,216,57,159,12,110,67,43,132,123,3,5,1,1
E33034755,307,151,45,106,4,94,64,30,55,53,1,1,0,3
E33034756,242,90,36,54,1,88,65,23,60,57,1,2,0,3
E33034757,271,138,42,96,2,63,36,27,64,63,0,1,0,4
E33034758,267,101,25,76,8,94,61,33,62,57,3,1,1,2
E33034759,318,98,35,63,3,132,87,45,83,80,0,3,0,2
E33034760,410,120,31,89,5,155,95,60,126,119,1,3,3,4
E33034761,406,137,51,86,10,164,55,109,92,83,0,9,0,3
E33034762,446,177,53,124,10,146,53,93,108,104,0,2,2,5
E33034763,609,314,95,219,6,80,54,26,203,188,2,11,2,6
E33034764,329,169,57,112,9,60,31,29,83,79,0,3,1,8
E33034765,403,205,76,129,6,60,26,34,122,113,0,8,1,10
E33034766,392,280,60,220,5,47,37,10,56,52,0,4,0,4
E33034767,454,216,91,125,5,91,52,39,136,127,3,6,0,6
E33034768,805,384,86,298,12,101,61,40,297,282,2,12,1,11
E33034769,453,205,64,141,10,59,39,20,169,157,2,8,2,10
E33034770,318,179,72,107,3,47,24,23,85,81,1,2,1,4
E33034771,726,390,100,290,14,96,56,40,219,208,1,8,2,7
E33034772,1330,697,100,597,40,268,127,141,316,302,1,10,3,9
E33034773,345,174,52,122,4,83,59,24,83,83,0,0,0,1
E33034774,594,253,64,189,12,185,113,72,143,136,1,6,0,1
E33034775,1376,794,175,619,25,109,67,42,436,415,2,17,2,12
E33034776,568,318,86,232,13,67,39,28,164,161,0,3,0,6
E33034777,493,204,62,142,9,92,59,33,185,174,1,9,1,3
E33034778,506,238,65,173,7,103,61,42,156,150,1,3,2,2
E33034779,450,246,66,180,2,68,48,20,131,124,0,3,4,3
E33034780,372,213,60,153,2,48,25,23,106,100,2,4,0,3
E33034781,1429,846,253,593,33,177,107,70,365,330,5,14,16,8
E33034782,610,384,87,297,5,48,30,18,170,153,11,6,0,3
E33034783,348,192,67,125,13,62,40,22,75,74,0,1,0,6
E33034784,1016,560,140,420,25,77,36,41,349,336,4,8,1,5
E33034785,478,279,112,167,10,119,86,33,62,57,0,5,0,8
E33034786,885,450,110,340,14,108,80,28,308,300,1,5,2,5
E33034787,292,107,27,80,6,80,61,19,95,90,0,5,0,4
E33034788,454,177,32,145,12,91,69,22,171,166,0,3,2,3
E33034789,552,285,78,207,3,121,49,72,137,126,0,11,0,6
E33034790,367,135,46,89,5,137,92,45,89,86,0,0,3,1
E33034791,481,167,57,110,8,167,120,47,133,124,0,5,4,6
E33034792,485,198,59,139,12,170,98,72,104,98,0,6,0,1
E33034793,1016,440,143,297,25,226,106,120,314,299,0,11,4,11
E33034794,881,369,113,256,8,227,136,91,270,253,2,11,4,7
E33034795,297,103,31,72,7,105,46,59,79,78,0,1,0,3
E33034796,193,64,23,41,3,68,28,40,56,52,1,2,1,2
E33034797,267,60,17,43,4,155,43,112,46,46,0,0,0,2
E33034798,395,130,39,91,11,170,100,70,81,73,0,4,4,3
E33034799,649,260,81,179,25,210,72,138,138,124,2,6,6,16
E33034800,598,185,57,128,14,223,32,191,166,159,0,6,1,10
E33034801,233,88,26,62,6,71,32,39,62,56,0,2,4,6
E33034802,291,154,59,95,10,54,17,37,68,67,0,1,0,5
E33034803,438,182,66,116,11,120,69,51,122,111,0,9,2,3
E33034804,250,90,44,46,3,71,29,42,82,76,2,4,0,4
E33034805,374,222,62,160,4,44,18,26,98,91,0,5,2,6
E33034806,259,107,31,76,5,54,24,30,89,85,2,2,0,4
E33034807,282,107,42,65,4,84,13,71,80,72,1,4,3,7
E33034808,262,127,62,65,9,56,12,44,69,69,0,0,0,1
E33034809,521,214,61,153,4,103,50,53,192,185,1,4,2,8
E33034810,308,161,60,101,3,58,12,46,84,79,0,4,1,2
E33034811,280,110,45,65,14,85,22,63,66,61,0,5,0,5
E33034812,512,178,74,104,11,105,39,66,212,207,1,4,0,6
E33034813,327,143,58,85,1,52,9,43,129,124,2,3,0,2
E33034814,428,183,73,110,2,83,36,47,153,141,3,7,2,7
E33034815,285,112,53,59,5,83,12,71,81,75,0,4,2,4
E33034816,258,88,39,49,3,69,13,56,97,90,0,6,1,1
E33034817,407,154,54,100,6,119,45,74,122,114,0,6,2,6
E33034818,327,142,56,86,4,62,13,49,118,116,0,0,2,1
E33034819,716,336,95,241,11,181,75,106,181,175,1,4,1,7
E33034820,374,163,71,92,9,106,48,58,92,86,0,6,0,4
E33034821,466,175,46,129,11,122,56,66,155,149,0,6,0,3
E33034822,349,116,37,79,8,143,75,68,75,65,2,4,4,7
E33034823,269,106,37,69,3,96,38,58,63,60,1,2,0,1
E33034824,363,121,44,77,8,151,106,45,77,68,2,5,2,6
E33034825,309,117,46,71,7,115,55,60,67,62,0,5,0,3
E33034826,256,164,99,65,5,25,9,16,50,44,0,4,2,12
E33034827,311,152,62,90,4,27,10,17,125,112,6,7,0,3
E33034828,238,89,37,52,3,37,15,22,108,104,0,2,2,1
E33034829,475,126,36,90,12,64,26,38,267,263,0,4,0,6
E33034830,298,130,59,71,6,31,10,21,128,123,0,3,2,3
E33034831,348,160,60,100,7,47,28,19,127,118,1,4,4,7
E33034832,305,171,89,82,1,37,11,26,94,88,1,2,3,2
E33034833,241,132,78,54,2,29,13,16,72,61,5,5,1,6
E33034834,300,128,55,73,3,56,21,35,104,100,0,3,1,9
E33034835,610,184,88,96,6,103,50,53,304,294,1,7,2,13
E33034836,474,285,134,151,7,57,19,38,116,109,0,5,2,9
E33034837,350,186,99,87,4,38,15,23,111,103,3,5,0,11
E33034838,320,136,67,69,6,62,23,39,101,98,3,0,0,15
E33034839,334,172,82,90,1,40,16,24,113,108,1,4,0,8
E33034840,380,187,84,103,2,52,21,31,130,121,0,6,3,9
E33034841,262,137,77,60,3,34,8,26,77,71,3,2,1,11
E33034842,292,154,88,66,2,30,11,19,103,92,3,8,0,3
E33034843,269,145,73,72,2,36,20,16,71,64,0,6,1,15
E33034844,492,233,108,125,4,56,31,25,187,177,1,7,2,12
E33034845,464,221,83,138,3,45,19,26,186,181,0,4,1,9
E33034846,595,297,100,197,7,50,20,30,230,216,3,10,1,11
E33034847,267,123,61,62,2,38,22,16,93,80,6,3,4,11
E33034848,354,170,56,114,8,31,20,11,139,128,0,7,4,6
E33034849,278,167,88,79,3,15,8,7,87,83,0,4,0,6
E33034850,262,128,64,64,2,23,14,9,106,98,2,2,4,3
E33034851,303,151,67,84,7,33,11,22,107,101,1,5,0,5
E33034852,247,136,80,56,2,26,22,4,79,71,1,6,1,4
E33034853,376,154,48,106,8,53,14,39,160,151,0,3,6,1
E33034854,363,151,74,77,3,39,16,23,155,150,2,2,1,15
E33034855,305,163,74,89,1,33,11,22,94,89,0,3,2,14
E33034856,418,161,66,95,5,50,21,29,196,189,0,7,0,6
E33034857,313,172,100,72,3,25,12,13,98,87,1,3,7,15
E33034858,297,163,78,85,6,33,15,18,88,83,0,4,1,7
E33034859,812,406,126,280,7,63,32,31,327,308,1,13,5,9
E33034860,455,172,70,102,7,52,27,25,209,193,2,10,4,15
E33034861,298,138,67,71,6,22,8,14,114,109,0,3,2,18
E33034862,280,135,47,88,8,22,12,10,110,107,1,1,1,5
E33034863,246,104,38,66,3,31,14,17,103,93,3,5,2,5
E33034864,385,127,56,71,2,44,21,23,180,169,5,4,2,32
E33034865,564,290,90,200,5,30,19,11,216,203,1,11,1,23
E33034866,289,145,61,84,4,27,19,8,107,102,2,3,0,6
E33034867,316,129,49,80,4,32,16,16,136,128,2,3,3,15
E33034868,250,130,59,71,1,20,7,13,88,79,1,4,4,11
E33034869,316,149,63,86,4,26,17,9,126,118,2,2,4,11
E33034870,250,142,69,73,5,8,3,5,92,82,4,4,2,3
E33034871,466,318,91,227,12,43,23,20,84,81,0,2,1,9
E33034872,343,185,81,104,7,54,24,30,93,91,0,2,0,4
E33034873,451,191,64,127,6,38,22,16,206,197,0,5,4,10
E33034874,374,187,66,121,3,50,21,29,127,119,1,7,0,7
E33034875,344,190,71,119,4,34,19,15,110,104,0,4,2,6
E33034876,278,140,65,75,2,34,21,13,98,93,1,1,3,4
E33034877,539,197,68,129,9,82,42,40,242,237,1,4,0,9
E33034878,340,176,79,97,1,22,8,14,133,121,3,5,4,8
E33034879,230,115,39,76,1,19,8,11,79,76,1,2,0,16
E33034880,268,97,39,58,4,36,14,22,118,116,0,2,0,13
E33034881,372,147,57,90,6,32,17,15,158,148,2,5,3,29
E33034882,277,121,55,66,4,18,7,11,97,88,1,6,2,37
E33034883,439,245,122,123,2,26,15,11,152,143,0,8,1,14
E33034884,261,97,50,47,2,15,6,9,114,109,1,3,1,33
E33034885,323,126,45,81,4,31,16,15,147,142,0,2,3,15
E33034886,216,121,54,67,1,15,7,8,62,59,1,0,2,17
E33034887,231,100,43,57,1,43,14,29,86,80,2,2,2,1
E33034888,269,119,46,73,2,38,17,21,100,91,2,7,0,10
E33034889,360,158,69,89,8,39,16,23,145,139,2,2,2,10
E33034890,829,434,156,278,21,107,52,55,256,245,0,9,2,11
E33034891,277,139,64,75,2,30,11,19,97,91,1,3,2,9
E33034892,407,149,61,88,2,57,26,31,194,187,0,5,2,5
E33034893,449,225,89,136,4,29,14,15,176,168,0,7,1,15
E33034894,247,108,55,53,5,34,17,17,94,88,1,2,3,6
E33034895,674,368,101,267,5,114,45,69,168,165,0,2,1,19
E33034896,1374,641,166,475,15,100,45,55,600,584,2,9,5,18
E33034897,549,244,103,141,3,87,44,43,206,195,1,7,3,9
E33034898,249,120,44,76,6,53,21,32,65,60,0,0,5,5
E33034899,384,175,41,134,18,95,53,42,93,91,0,1,1,3
E33034900,433,191,65,126,4,94,33,61,137,125,1,9,2,7
E33034901,323,137,46,91,6,75,25,50,93,91,0,1,1,12
E33034902,310,132,51,81,7,26,23,3,132,121,4,4,3,13
E33034903,263,134,50,84,1,23,12,11,100,85,0,6,9,5
E33034904,356,130,43,87,7,47,20,27,161,155,0,3,3,11
E33034905,283,73,18,55,8,114,55,59,86,78,1,5,2,2
E33034906,326,140,64,76,5,61,18,43,114,110,0,3,1,6
E33034907,539,206,60,146,16,143,56,87,171,159,1,7,4,3
E33034908,456,194,59,135,2,84,21,63,171,165,0,4,2,5
E33034909,252,111,58,53,3,24,7,17,110,103,0,5,2,4
E33034910,202,108,54,54,1,16,6,10,70,66,3,1,0,7
E33034911,353,194,76,118,4,28,18,10,124,117,1,6,0,3
E33034912,292,178,70,108,2,21,14,7,87,82,3,2,0,4
E33034913,272,133,49,84,4,20,10,10,109,104,0,5,0,6
E33034914,455,206,77,129,6,44,16,28,188,181,0,7,0,11
E33034915,222,106,43,63,1,19,9,10,84,79,3,1,1,12
E33034916,250,89,29,60,4,45,16,29,109,102,0,5,2,3
E33034917,241,94,37,57,3,35,17,18,102,101,0,1,0,7
E33034918,386,179,65,114,4,55,28,27,136,126,0,4,6,12
E33034919,330,140,56,84,2,35,17,18,147,139,4,4,0,6
E33034920,298,168,87,81,2,43,19,24,68,65,1,2,0,17
E33034921,323,150,51,99,4,40,10,30,125,116,3,4,2,4
E33034922,263,115,48,67,3,41,17,24,94,85,4,5,0,10
E33034923,323,125,41,84,2,80,33,47,107,97,3,5,2,9
E33034924,428,183,70,113,6,60,29,31,177,163,1,12,1,2
E33034925,229,98,37,61,9,33,16,17,85,83,0,2,0,4
E33034926,271,159,72,87,2,14,4,10,81,70,1,10,0,15
E33034927,356,154,61,93,3,66,41,25,124,124,0,0,0,9
E33034928,759,369,101,268,5,131,66,65,237,216,5,13,3,17
E33034929,391,174,89,85,1,48,21,27,147,137,8,2,0,21
E33034930,526,254,120,134,6,109,62,47,147,117,24,1,5,10
E33034931,335,131,49,82,6,71,35,36,119,112,0,7,0,8
E33034932,240,113,57,56,0,23,13,10,92,86,1,4,1,12
E33034933,241,131,57,74,3,39,21,18,64,58,0,5,1,4
E33034934,215,105,53,52,3,29,9,20,68,66,0,2,0,10
E33034935,243,136,81,55,3,11,3,8,76,74,1,1,0,17
E33034936,347,177,77,100,4,43,29,14,115,108,2,5,0,8
E33034937,440,162,57,105,1,47,28,19,216,211,0,3,2,14
E33034938,252,140,61,79,0,50,27,23,58,55,0,2,1,4
E33034939,361,161,77,84,7,42,22,20,144,135,0,9,0,7
E33034940,250,137,80,57,5,40,19,21,56,55,0,1,0,12
E33034941,359,136,57,79,3,67,46,21,139,132,1,5,1,14
E33034942,472,237,88,149,5,52,30,22,171,156,2,13,0,7
E33034943,217,82,39,43,0,26,11,15,103,99,0,4,0,6
E33034944,263,131,53,78,7,58,30,28,66,64,0,1,1,1
E33034945,423,189,76,113,6,63,41,22,158,147,0,9,2,7
E33034946,413,208,100,108,3,52,40,12,134,126,0,7,1,16
E33034947,249,139,61,78,8,21,12,9,70,64,0,5,1,11
E33034948,399,192,85,107,4,68,35,33,132,125,2,3,2,3
E33034949,386,188,79,109,4,38,17,21,148,138,5,5,0,8
E33034950,260,114,56,58,4,25,7,18,100,93,1,4,2,17
E33034951,414,179,72,107,6,102,36,66,123,116,1,3,3,4
E33034952,352,171,89,82,4,59,40,19,114,103,1,10,0,4
E33034953,306,109,42,67,4,92,61,31,95,84,5,6,0,6
E33034954,308,136,74,62,1,89,67,22,77,73,1,2,1,5
E33034955,1001,483,167,316,13,97,56,41,400,383,1,15,1,8
E33034956,507,407,109,298,6,14,10,4,79,68,1,8,2,1
E33034957,415,295,96,199,11,26,7,19,80,72,2,4,2,3
E33034958,476,344,117,227,6,34,11,23,89,89,0,0,0,3
E33034959,707,476,160,316,5,47,23,24,174,168,1,5,0,5
E33034960,342,234,73,161,3,20,13,7,80,74,6,0,0,5
E33034961,767,538,203,335,7,51,27,24,162,152,3,6,1,9
E33034962,286,229,96,133,6,18,9,9,30,28,1,1,0,3
E33034963,295,202,87,115,1,22,14,8,65,62,1,1,1,5
E33034964,384,223,79,144,4,39,27,12,111,109,0,1,1,7
E33034965,468,261,89,172,2,78,58,20,123,113,6,4,0,4
E33034966,359,257,87,170,0,27,19,8,72,68,1,3,0,3
E33034967,3055,1921,536,1385,41,356,190,166,720,681,7,28,4,17
E33034968,468,264,77,187,5,39,19,20,140,120,7,10,3,20
E33034969,378,257,82,175,4,27,20,7,87,81,4,2,0,3
E33034970,336,193,54,139,0,34,18,16,105,101,1,3,0,4
E33034971,270,187,58,129,4,24,9,15,53,44,6,0,3,2
E33034972,230,153,53,100,4,36,27,9,36,34,0,0,2,1
E33034973,441,211,39,172,7,46,19,27,168,160,2,4,2,9
E33034974,323,226,65,161,0,49,35,14,44,43,0,1,0,4
E33034975,263,168,59,109,0,18,10,8,67,60,1,5,1,10
E33034976,805,417,130,287,11,85,56,29,288,277,0,9,2,4
E33034977,270,194,68,126,1,20,8,12,50,47,2,1,0,5
E33034978,575,367,93,274,9,66,45,21,118,111,1,5,1,15
E33034979,556,335,99,236,5,50,31,19,162,144,13,5,0,4
E33034980,873,489,133,356,7,135,81,54,238,225,3,8,2,4
E33034981,396,219,63,156,1,54,32,22,117,110,1,4,2,5
E33034982,494,266,77,189,4,94,77,17,125,117,1,6,1,5
E33034983,1195,724,229,495,18,145,84,61,302,285,3,11,3,6
E33034984,358,224,66,158,4,49,38,11,81,78,0,2,1,0
E33034985,582,310,93,217,9,131,61,70,127,119,0,8,0,5
E33034986,395,218,52,166,8,76,53,23,92,89,1,2,0,1
E33034987,356,198,65,133,5,48,33,15,100,92,0,7,1,5
E33034988,391,293,94,199,1,29,17,12,62,53,1,7,1,6
E33034989,499,321,105,216,4,56,35,21,112,101,2,4,5,6
E33034990,808,524,126,398,12,33,11,22,228,218,0,9,1,11
E33034991,364,256,90,166,3,19,6,13,84,80,0,3,1,2
E33034992,471,342,121,221,12,38,16,22,74,68,2,3,1,5
E33034993,665,440,137,303,9,55,24,31,150,139,3,6,2,11
E33034994,272,191,60,131,4,15,6,9,62,59,0,2,1,0
E33034995,239,168,65,103,2,34,21,13,34,32,0,1,1,1
E33034996,317,239,86,153,7,20,19,1,49,48,0,1,0,2
E33034997,490,361,111,250,6,32,21,11,89,84,0,2,3,2
E33034998,517,335,84,251,7,38,24,14,135,122,4,8,1,2
E33034999,294,182,60,122,2,16,9,7,88,81,1,4,2,6
E33035000,1522,975,297,678,14,84,49,35,436,418,2,11,5,13
E33035001,544,212,69,143,9,71,34,37,243,234,2,7,0,9
E33035002,394,220,66,154,1,29,20,9,143,131,1,7,4,1
E33035003,467,308,100,208,6,41,23,18,111,101,2,8,0,1
E33035004,281,186,58,128,0,15,4,11,79,72,0,4,3,1
E33035005,472,316,89,227,6,36,22,14,111,97,2,6,6,3
E33035006,405,228,56,172,2,19,13,6,154,148,1,5,0,2
E33035007,448,278,120,158,5,29,19,10,131,107,14,10,0,5
E33035008,423,290,100,190,3,11,7,4,116,110,0,6,0,3
E33035009,482,281,69,212,5,47,24,23,143,135,1,6,1,6
E33035010,412,256,82,174,1,22,9,13,129,118,5,3,3,4
E33035011,240,127,29,98,1,18,8,10,89,86,0,3,0,5
E33035012,603,325,107,218,6,48,26,22,214,197,6,8,3,10
E33035013,425,255,66,189,3,39,24,15,120,110,2,6,2,8
E33035014,338,267,92,175,2,21,18,3,47,44,0,3,0,1
E33035015,481,337,79,258,4,52,36,16,83,75,2,3,3,5
E33035016,608,447,151,296,7,39,17,22,111,97,3,6,5,4
E33035017,295,163,57,106,0,29,22,7,98,85,4,5,4,5
E33035018,448,265,69,196,7,53,32,21,117,108,0,4,5,6
E33035019,361,195,67,128,1,24,4,20,141,134,0,6,1,0
E33035020,761,470,137,333,7,48,23,25,229,222,1,6,0,7
E33035021,262,155,46,109,5,24,9,15,78,77,0,1,0,0
E33035022,328,289,65,224,1,4,2,2,32,28,0,4,0,2
E33035023,278,205,53,152,0,21,13,8,49,46,0,3,0,3
E33035024,327,289,108,181,0,13,8,5,25,25,0,0,0,0
E33035025,298,234,79,155,2,13,9,4,44,35,6,3,0,5
E33035026,432,277,77,200,7,32,21,11,114,112,1,1,0,2
E33035027,459,341,97,244,2,26,16,10,87,86,0,1,0,3
E33035028,364,300,97,203,0,19,10,9,41,40,0,1,0,4
E33035029,357,270,104,166,1,16,9,7,68,64,0,3,1,2
E33035030,314,210,76,134,1,35,19,16,61,58,0,3,0,7
E33035031,390,295,82,213,5,20,9,11,67,66,0,1,0,3
E33035032,414,270,55,215,4,45,13,32,92,86,1,3,2,3
E33035033,328,213,75,138,1,21,17,4,90,84,3,2,1,3
E33035034,390,278,88,190,1,32,26,6,78,71,0,6,1,1
E33035035,639,481,159,322,9,60,29,31,82,76,0,1,5,7
E33035036,313,218,56,162,7,24,9,15,59,52,0,6,1,5
E33035037,512,364,105,259,6,28,9,19,113,111,0,1,1,1
E33035038,617,363,89,274,10,89,62,27,154,147,2,3,2,1
E33035039,596,410,96,314,7,52,36,16,125,116,4,2,3,2
E33035040,381,283,90,193,4,44,36,8,45,40,3,2,0,5
E33035041,689,500,125,375,8,75,40,35,101,91,1,8,1,5
E33035042,532,393,85,308,5,34,26,8,95,88,0,7,0,5
E33035043,368,259,74,185,2,33,20,13,71,65,2,2,2,3
E33035044,588,444,128,316,9,32,19,13,100,90,0,10,0,3
E33035045,383,307,73,234,3,22,11,11,51,44,0,7,0,0
E33035046,728,454,110,344,7,64,27,37,200,187,2,10,1,3
E33035047,341,262,59,203,4,21,13,8,50,50,0,0,0,4
E33035048,324,243,60,183,1,30,19,11,41,36,0,4,1,9
E33035049,316,227,68,159,3,45,32,13,41,38,0,3,0,0
E33035050,344,234,58,176,6,60,19,41,40,34,2,4,0,4
E33035051,1607,1102,242,860,26,137,62,75,328,290,4,27,7,14
E33035052,299,96,26,70,3,136,119,17,60,56,0,3,1,4
E33035053,407,204,78,126,12,70,33,37,112,105,1,5,1,9
E33035054,343,134,41,93,5,131,95,36,73,69,0,4,0,0
E33035055,567,231,49,182,16,193,132,61,123,114,2,1,6,4
E33035056,1404,777,221,556,18,163,97,66,428,399,1,21,7,18
E33035057,316,129,36,93,14,86,48,38,81,77,0,1,3,6
E33035058,279,113,25,88,10,101,72,29,54,50,0,3,1,1
E33035059,575,277,64,213,12,66,50,16,214,205,0,8,1,6
E33035060,327,130,32,98,3,75,65,10,115,105,2,7,1,4
E33035061,2482,1428,375,1053,44,251,142,109,741,706,1,30,4,18
E33035062,719,472,129,343,15,89,42,47,138,129,4,2,3,5
E33035063,334,118,35,83,2,94,45,49,117,111,2,4,0,3
E33035064,725,342,107,235,10,109,70,39,254,246,0,7,1,10
E33035065,712,270,75,195,16,100,52,48,320,309,3,6,2,6
E33035066,929,458,112,346,39,162,69,93,253,237,1,11,4,17
E33035067,314,143,40,103,10,86,37,49,71,68,0,3,0,4
E33035068,366,131,36,95,3,90,30,60,138,131,0,6,1,4
E33035069,374,156,40,116,12,78,42,36,124,115,0,7,2,4
E33035070,406,241,74,167,3,85,56,29,74,69,0,3,2,3
E33035071,1103,528,124,404,17,181,95,86,369,349,1,13,6,8
E33035072,507,260,68,192,4,131,67,64,110,108,0,2,0,2
E33035073,1204,588,159,429,21,180,91,89,407,387,1,15,4,8
E33035074,321,132,43,89,1,76,43,33,106,99,1,5,1,6
E33035075,391,174,69,105,2,96,51,45,117,114,0,3,0,2
E33035076,548,258,62,196,7,62,28,34,219,209,1,7,2,2
E33035077,524,231,52,179,5,143,97,46,139,115,1,17,6,6
E33035078,468,167,41,126,3,155,68,87,141,127,0,10,4,2
E33035079,337,101,24,77,2,125,38,87,106,102,0,4,0,3
E33035080,298,141,56,85,5,66,27,39,81,78,0,1,2,5
E33035081,684,194,56,138,7,258,158,100,214,202,0,9,3,11
E33035082,351,97,28,69,3,133,89,44,113,105,1,4,3,5
E33035083,752,274,81,193,7,260,162,98,203,191,0,9,3,8
E33035084,269,89,18,71,6,98,38,60,75,70,1,3,1,1
E33035085,538,213,63,150,6,140,99,41,176,168,0,7,1,3
E33035086,325,113,40,73,1,123,104,19,83,80,1,2,0,5
E33035087,581,310,42,268,15,142,97,45,108,99,0,5,4,6
E33035088,406,125,29,96,12,130,60,70,136,129,0,5,2,3
E33035089,769,254,60,194,7,309,167,142,197,183,0,8,6,2
E33035090,487,209,58,151,10,150,109,41,114,110,0,4,0,4
E33035091,529,144,35,109,3,285,208,77,93,75,3,9,6,4
E33035092,355,109,25,84,0,144,101,43,102,88,1,13,0,0
E33035093,291,132,30,102,6,75,45,30,76,69,0,6,1,2
E33035094,324,114,37,77,11,129,36,93,69,68,0,1,0,1
E33035095,304,110,37,73,2,111,43,68,78,78,0,0,0,3
E33035096,289,112,24,88,8,65,35,30,102,96,0,5,1,2
E33035097,373,161,51,110,8,92,43,49,103,101,0,2,0,9
E33035098,606,296,59,237,7,173,105,68,127,119,0,6,2,3
E33035099,380,138,43,95,3,94,66,28,142,132,3,5,2,3
E33035100,271,79,10,69,10,120,70,50,57,56,0,0,1,5
E33035101,286,92,18,74,6,108,70,38,75,70,0,5,0,5
E33035102,403,142,43,99,5,157,51,106,96,87,0,6,3,3
E33035103,506,202,39,163,6,195,107,88,97,92,0,5,0,6
E33035104,338,108,19,89,2,136,66,70,86,77,1,7,1,6
E33035105,434,193,47,146,4,71,37,34,160,151,2,4,3,6
E33035106,297,146,47,99,2,56,37,19,89,87,0,2,0,4
E33035107,281,130,36,94,5,47,18,29,95,93,1,1,0,4
E33035108,420,166,34,132,16,72,51,21,164,154,1,8,1,2
E33035109,418,207,72,135,4,87,61,26,112,100,0,7,5,8
E33035110,285,121,41,80,7,71,50,21,85,80,0,5,0,1
E33035111,449,214,68,146,8,61,33,28,162,157,1,3,1,4
E33035112,318,161,51,110,6,63,43,20,88,83,1,3,1,0
E33035113,305,129,51,78,3,63,45,18,105,97,1,5,2,5
E33035114,373,207,57,150,3,36,24,12,120,114,2,4,0,7
E33035115,636,335,80,255,7,49,25,24,243,239,0,4,0,2
E33035116,336,199,72,127,4,46,22,24,83,74,1,7,1,4
E33035117,319,119,30,89,2,82,62,20,116,107,1,8,0,0
E33035118,484,198,50,148,13,104,53,51,145,137,0,3,5,24
E33035119,358,213,70,143,0,45,17,28,93,89,0,2,2,7
E33035120,520,235,59,176,5,143,70,73,133,128,0,3,2,4
E33035121,292,155,41,114,2,66,46,20,68,66,0,2,0,1
E33035122,488,219,44,175,7,78,28,50,182,173,1,4,4,2
E33035123,305,164,59,105,1,68,31,37,67,65,0,2,0,5
E33035124,608,249,67,182,13,144,80,64,192,183,3,6,0,10
E33035125,263,94,25,69,3,57,46,11,109,106,0,3,0,0
E33035126,463,174,45,129,3,84,23,61,198,188,2,7,1,4
E33035127,320,157,41,116,5,39,17,22,116,109,0,5,2,3
E33035128,480,204,54,150,11,104,57,47,157,143,0,13,1,4
E33035129,462,226,50,176,6,91,52,39,131,126,0,5,0,8
E33035130,504,161,43,118,2,212,100,112,115,107,0,5,3,14
E33035131,310,120,35,85,4,103,58,45,79,76,0,1,2,4
E33035132,556,189,55,134,13,165,98,67,181,170,0,7,4,8
E33035133,513,275,55,220,8,125,64,61,102,96,0,5,1,3
E33035134,537,175,53,122,6,165,76,89,185,179,0,3,3,6
E33035135,499,153,41,112,5,129,67,62,204,199,0,4,1,8
E33035136,331,154,51,103,6,89,56,33,80,73,0,5,2,2
E33035137,249,112,24,88,3,42,21,21,84,79,0,3,2,8
E33035138,321,115,41,74,9,120,86,34,75,70,0,5,0,2
E33035139,402,189,43,146,7,75,42,33,127,118,6,3,0,4
E33035140,284,120,28,92,2,76,46,30,83,76,2,4,1,3
E33035141,479,194,62,132,9,105,59,46,168,164,0,4,0,3
E33035142,555,185,58,127,4,152,77,75,208,195,0,9,4,6
E33035143,460,221,66,155,4,74,34,40,158,152,0,6,0,3
E33035144,379,104,21,83,0,183,52,131,81,74,0,4,3,11
E33035145,390,198,54,144,10,100,49,51,79,75,0,4,0,3
E33035146,259,131,33,98,1,44,27,17,82,77,1,4,0,1
E33035147,281,204,91,113,2,20,8,12,54,52,0,2,0,1
E33035148,279,151,55,96,2,63,44,19,62,60,0,1,1,1
E33035149,379,172,61,111,4,59,32,27,142,141,0,1,0,2
E33035150,654,304,90,214,8,150,84,66,186,173,4,9,0,6
E33035151,633,262,63,199,8,177,98,79,182,177,0,3,2,4
E33035152,352,190,48,142,3,61,24,37,94,90,0,4,0,4
E33035153,438,198,48,150,4,68,26,42,164,158,0,4,2,4
E33035154,327,157,44,113,5,70,32,38,93,83,5,5,0,2
E33035155,466,222,64,158,11,88,42,46,139,131,0,6,2,6
E33035156,294,103,30,73,2,92,49,43,93,83,0,10,0,4
E33035157,319,113,32,81,3,98,68,30,104,96,0,6,2,1
E33035158,1169,568,122,446,18,292,167,125,285,268,5,10,2,6
E33035159,377,125,34,91,3,104,73,31,143,126,1,5,11,2
E33035160,393,174,49,125,12,100,54,46,104,99,0,4,1,3
E33035161,434,171,44,127,8,109,65,44,142,134,2,4,2,4
E33035162,1113,328,83,245,6,428,190,238,333,319,1,6,7,18
E33035163,329,167,48,119,8,77,45,32,74,71,0,3,0,3
E33035164,338,175,43,132,4,67,34,33,85,81,0,4,0,7
E33035165,362,164,32,132,4,63,46,17,131,124,1,4,2,0
E33035166,520,266,77,189,2,77,32,45,171,168,0,2,1,4
E33035167,277,155,52,103,5,38,16,22,77,74,0,3,0,2
E33035168,333,107,25,82,3,116,23,93,105,98,0,5,2,2
E33035169,302,105,34,71,6,109,72,37,78,75,1,1,1,4
E33035170,304,107,26,81,3,121,56,65,70,64,0,4,2,3
E33035171,409,156,31,125,2,164,134,30,85,83,0,2,0,2
E33035172,306,187,71,116,3,45,22,23,68,68,0,0,0,3
E33035173,260,128,34,94,2,74,53,21,53,53,0,0,0,3
E33035174,492,196,59,137,4,167,48,119,121,118,0,1,2,4
E33035175,384,205,62,143,6,79,33,46,91,81,0,10,0,3
E33035176,455,180,37,143,6,105,36,69,162,152,0,6,4,2
E33035177,574,274,58,216,5,112,62,50,177,172,0,5,0,6
E33035178,366,135,28,107,3,113,86,27,110,100,0,4,6,5
E33035179,321,194,63,131,3,21,5,16,103,96,1,4,2,0
E33035180,565,229,60,169,6,137,85,52,184,173,2,6,3,9
E33035181,520,260,65,195,6,60,27,33,188,180,1,6,1,6
E33035182,597,253,53,200,5,144,72,72,188,180,2,5,1,7
E33035183,592,309,83,226,7,81,43,38,192,178,3,10,1,3
E33035184,380,184,45,139,6,95,50,45,89,76,3,7,3,6
E33035185,382,174,61,113,7,76,44,32,122,113,0,5,4,3
E33035186,481,263,87,176,7,64,39,25,144,128,0,14,2,3
E33035187,515,276,67,209,2,77,48,29,159,153,0,1,5,1
E33035188,497,251,65,186,5,119,53,66,121,117,0,2,2,1
E33035189,582,268,64,204,7,131,58,73,170,164,2,4,0,6
E33035190,298,186,65,121,1,48,26,22,60,58,1,1,0,3
E33035191,277,148,42,106,3,37,18,19,88,85,0,2,1,1
E33035192,621,253,72,181,4,78,50,28,277,263,2,8,4,9
E33035193,570,237,64,173,8,101,54,47,221,213,2,6,0,3
E33035194,494,266,91,175,5,65,36,29,157,145,1,11,0,1
E33035195,414,157,44,113,3,66,30,36,183,178,0,5,0,5
E33035196,643,334,99,235,13,83,55,28,205,195,0,9,1,8
E33035197,530,281,88,193,8,75,38,37,162,155,0,4,3,4
E33035198,413,255,64,191,6,45,25,20,104,100,0,4,0,3
E33035199,296,141,34,107,7,74,56,18,73,71,0,2,0,1
E33035200,425,192,49,143,13,116,74,42,102,93,3,2,4,2
E33035201,383,192,44,148,8,106,66,40,76,73,0,0,3,1
E33035202,306,155,29,126,2,88,54,34,61,57,0,4,0,0
E33035203,327,180,39,141,7,26,10,16,111,104,1,6,0,3
E33035204,492,245,57,188,3,74,38,36,164,152,2,8,2,6
E33035205,760,298,65,233,7,162,83,79,290,284,0,4,2,3
E33035206,320,99,25,74,2,72,44,28,144,136,0,4,4,3
E33035207,535,242,63,179,5,74,40,34,209,201,1,6,1,5
E33035208,341,170,62,108,5,28,10,18,136,128,1,7,0,2
E33035209,362,157,28,129,5,54,29,25,143,138,0,4,1,3
E33035210,293,111,22,89,0,68,36,32,106,101,2,3,0,8
E33035211,349,192,33,159,4,75,58,17,78,71,2,5,0,0
E33035212,285,127,25,102,5,41,13,28,99,93,3,2,1,13
E33035213,573,260,59,201,8,141,97,44,156,143,3,8,2,8
E33035214,382,230,81,149,1,30,16,14,114,112,0,2,0,7
E33035215,378,161,37,124,2,63,27,36,150,148,0,2,0,2
E33035216,333,166,48,118,3,43,19,24,117,112,0,1,4,4
E33035217,397,192,60,132,0,32,15,17,171,169,1,1,0,2
E33035218,393,150,37,113,5,50,19,31,184,183,0,1,0,4
E33035219,492,225,68,157,18,40,26,14,207,203,0,3,1,2
E33035220,327,168,42,126,2,31,8,23,123,118,0,5,0,3
E33035221,314,113,40,73,2,73,42,31,122,115,0,5,2,4
E33035222,262,89,17,72,12,105,43,62,54,51,0,3,0,2
E33035223,400,118,27,91,22,166,95,71,89,83,0,5,1,5
E33035224,488,163,38,125,8,174,112,62,137,127,1,6,3,6
E33035225,342,129,38,91,14,130,90,40,63,58,1,3,1,6
E33035226,383,117,37,80,10,144,101,43,109,105,1,2,1,3
E33035227,471,208,35,173,5,160,106,54,96,81,3,10,2,2
E33035228,468,191,54,137,6,135,78,57,130,111,1,18,0,6
E33035229,653,325,73,252,12,134,74,60,179,170,0,7,2,3
E33035230,381,154,36,118,16,100,53,47,109,98,0,10,1,2
E33035231,756,364,91,273,16,193,122,71,177,165,2,9,1,6
E33035232,358,125,26,99,4,104,78,26,122,118,0,3,1,3
E33035233,344,128,38,90,12,68,40,28,135,124,2,9,0,1
E33035234,320,139,44,95,5,47,22,25,124,112,0,12,0,5
E33035235,315,131,46,85,7,79,52,27,96,92,1,3,0,2
E33035236,455,184,46,138,8,89,40,49,171,162,0,9,0,3
E33035237,349,126,32,94,5,126,58,68,90,88,1,1,0,2
E33035238,651,298,84,214,7,186,99,87,151,139,3,7,2,9
E33035239,363,164,50,114,7,82,59,23,99,93,0,5,1,11
E33035240,391,208,73,135,2,88,44,44,89,84,0,4,1,4
E33035241,428,175,45,130,7,136,74,62,106,104,0,1,1,4
E33035242,732,344,103,241,11,166,103,63,210,200,0,6,4,1
E33035243,310,192,79,113,3,31,26,5,79,74,0,5,0,5
E33035244,442,174,45,129,3,162,128,34,101,96,0,4,1,2
E33035245,393,185,60,125,8,104,70,34,91,85,0,6,0,5
E33035246,623,383,110,273,11,97,52,45,128,122,1,4,1,4
E33035247,376,155,35,120,7,56,42,14,153,137,0,16,0,5
E33035248,428,184,52,132,6,77,41,36,157,142,4,8,3,4
E33035249,867,470,123,347,34,161,73,88,194,180,2,11,1,8
E33035250,385,148,38,110,11,109,65,44,114,109,0,4,1,3
E33035251,392,179,49,130,3,85,34,51,118,116,0,2,0,7
E33035252,536,336,116,220,4,94,58,36,101,94,2,4,1,1
E33035253,223,130,49,81,2,44,28,16,45,44,1,0,0,2
E33035254,375,195,75,120,3,56,34,22,120,114,0,4,2,1
E33035255,301,178,65,113,1,51,29,22,67,64,0,3,0,4
E33035256,419,142,33,109,14,200,166,34,62,59,0,1,2,1
E33035257,490,232,63,169,3,95,39,56,154,147,0,7,0,6
E33035258,731,320,83,237,8,126,76,50,271,165,1,105,0,6
E33035259,326,147,31,116,6,83,48,35,85,77,1,6,1,5
E33035260,426,187,48,139,5,95,35,60,139,110,0,26,3,0
E33035261,483,306,99,207,3,67,28,39,105,79,3,22,1,2
E33035262,380,153,35,118,1,87,32,55,136,115,1,20,0,3
E33035263,599,308,75,233,14,142,56,86,133,126,1,6,0,2
E33035264,438,204,55,149,10,101,52,49,117,108,1,5,3,6
E33035265,1216,741,190,551,25,252,134,118,194,181,0,9,4,4
E33035266,2900,1699,392,1307,50,568,261,307,570,536,2,28,4,13
E33035267,534,228,56,172,6,124,64,60,169,162,1,5,1,7
E33035268,308,124,39,85,14,48,23,25,122,117,2,3,0,0
E33035269,288,117,29,88,3,95,50,45,70,70,0,0,0,3
E33035270,405,181,52,129,8,54,29,25,155,150,0,2,3,7
E33035271,599,313,81,232,5,160,89,71,115,112,0,2,1,6
E33035272,261,157,52,105,1,25,14,11,77,68,0,8,1,1
E33035273,314,217,64,153,2,44,23,21,51,49,1,1,0,0
E33035274,595,284,77,207,11,97,50,47,198,190,0,6,2,5
E33035275,351,201,43,158,2,67,37,30,73,68,0,5,0,8
E33035276,558,280,85,195,6,93,49,44,169,156,0,12,1,10
E33035277,437,217,59,158,2,88,27,61,119,114,0,4,1,11
E33035278,376,254,76,178,8,32,5,27,77,72,0,1,4,5
E33035279,346,176,47,129,3,64,30,34,100,95,0,5,0,3
E33035280,534,271,64,207,6,97,45,52,157,149,0,6,2,3
E33035281,456,232,58,174,5,112,53,59,104,96,5,3,0,3
E33035282,261,172,53,119,2,35,17,18,48,44,0,3,1,4
E33035283,512,281,90,191,10,114,67,47,107,99,3,4,1,0
E33035284,423,307,94,213,5,36,16,20,74,66,0,6,2,1
E33035285,282,193,68,125,2,28,13,15,57,50,0,7,0,2
E33035286,344,127,29,98,3,94,45,49,117,109,0,6,2,3
E33035287,362,157,42,115,0,84,37,47,119,113,0,5,1,2
E33035288,296,146,30,116,6,48,18,30,94,93,0,0,1,2
E33035289,380,208,49,159,7,82,36,46,82,74,0,6,2,1
E33035290,490,264,67,197,3,90,41,49,125,118,0,7,0,8
E33035291,459,235,62,173,4,109,44,65,110,109,1,0,0,1
E33035292,354,180,44,136,1,65,34,31,103,98,0,2,3,5
E33035293,477,190,37,153,4,128,49,79,150,138,2,10,0,5
E33035294,318,168,40,128,3,68,38,30,75,73,0,2,0,4
E33035295,987,532,131,401,20,170,70,100,261,247,2,8,4,4
E33035296,413,224,65,159,2,52,28,24,129,124,0,5,0,6
E33035297,583,345,88,257,5,109,64,45,117,109,0,7,1,7
E33035298,309,194,61,133,1,39,21,18,74,73,0,1,0,1
E33035299,407,228,61,167,1,92,53,39,82,75,1,4,2,4
E33035300,412,269,84,185,5,39,16,23,94,91,0,3,0,5
E33035301,556,260,73,187,6,152,63,89,133,124,0,8,1,5
E33035302,404,212,50,162,4,120,74,46,60,55,0,1,4,8
E33035303,361,181,38,143,3,71,27,44,102,99,0,3,0,4
E33035304,385,166,39,127,4,78,29,49,136,129,0,6,1,1
E33035305,408,191,52,139,4,82,37,45,130,121,0,7,2,1
E33035306,371,156,47,109,1,103,54,49,108,102,0,6,0,3
E33035307,344,204,87,117,8,44,12,32,85,82,0,1,2,3
E33035308,372,227,62,165,1,51,27,24,91,87,3,1,0,2
E33035309,293,162,47,115,2,51,22,29,69,66,0,3,0,9
E33035310,418,294,65,229,1,43,17,26,78,71,0,5,2,2
E33035311,449,281,94,187,1,95,47,48,69,65,0,3,1,3
E33035312,363,215,34,181,3,51,17,34,92,90,0,2,0,2
E33035313,717,436,123,313,4,129,34,95,144,125,5,12,2,4
E33035314,836,541,142,399,7,104,30,74,174,166,0,6,2,10
E33035315,358,170,33,137,3,60,32,28,121,118,0,3,0,4
E33035316,331,189,38,151,7,32,4,28,100,92,0,6,2,3
E33035317,559,310,85,225,9,83,38,45,153,145,3,3,2,4
E33035318,260,165,36,129,3,40,11,29,52,47,0,5,0,0
E33035319,336,224,44,180,1,40,9,31,66,66,0,0,0,5
E33035320,636,383,94,289,1,134,60,74,114,110,0,4,0,4
E33035321,295,184,47,137,0,36,15,21,75,71,0,1,3,0
E33035322,315,198,43,155,2,35,15,20,80,78,0,2,0,0
E33035323,477,275,46,229,3,118,44,74,79,69,3,4,3,2
E33035324,320,213,57,156,1,31,11,20,74,69,0,4,1,1
E33035325,278,146,43,103,4,63,33,30,58,56,0,2,0,7
E33035326,368,198,41,157,5,95,61,34,69,61,0,8,0,1
E33035327,291,165,44,121,6,44,11,33,76,71,0,5,0,0
E33035328,417,201,53,148,11,91,51,40,110,105,2,2,1,4
E33035329,357,190,39,151,2,82,57,25,77,72,1,4,0,6
E33035330,322,145,37,108,6,105,47,58,51,49,0,2,0,15
E33035331,413,214,75,139,9,72,29,43,111,110,0,0,1,7
E33035332,484,271,61,210,7,87,47,40,115,107,1,7,0,4
E33035333,523,272,68,204,3,152,61,91,94,87,0,5,2,2
E33035334,728,367,99,268,11,213,94,119,135,128,1,6,0,2
E33035335,332,203,61,142,6,69,35,34,50,48,0,2,0,4
E33035336,309,144,41,103,2,78,36,42,84,77,3,3,1,1
E33035337,559,405,102,303,10,57,20,37,81,77,1,3,0,6
E33035338,331,170,47,123,2,99,28,71,59,59,0,0,0,1
E33035339,310,191,50,141,1,48,19,29,70,65,0,4,1,0
E33035340,394,187,44,143,3,148,69,79,52,48,0,4,0,4
E33035341,400,219,44,175,4,109,27,82,63,59,0,1,3,5
E33035342,638,345,80,265,8,131,51,80,151,143,0,7,1,3
E33035343,404,219,60,159,3,86,45,41,87,82,0,4,1,9
E33035344,240,125,34,91,1,53,38,15,60,56,0,4,0,1
E33035345,369,181,39,142,4,95,49,46,78,71,0,3,4,11
E33035346,473,257,64,193,4,114,42,72,93,87,0,6,0,5
E33035347,643,367,101,266,4,132,67,65,133,126,1,5,1,7
E33035348,274,128,36,92,4,88,67,21,50,47,0,3,0,4
E33035349,373,182,49,133,8,133,51,82,48,44,0,4,0,2
E33035350,429,216,57,159,3,129,50,79,77,74,1,2,0,4
E33035351,352,175,48,127,3,94,42,52,77,75,0,2,0,3
E33035352,319,192,44,148,0,46,24,22,79,74,1,3,1,2
E33035353,277,151,48,103,2,54,21,33,68,64,1,2,1,2
E33035354,349,206,55,151,3,55,29,26,80,72,0,6,2,5
E33035355,636,327,77,250,8,130,62,68,164,151,4,9,0,7
E33035356,561,262,75,187,4,72,39,33,218,212,0,4,2,5
E33035357,508,315,125,190,2,36,21,15,146,139,0,6,1,9
E33035358,366,271,106,165,2,13,7,6,77,73,2,2,0,3
E33035359,823,408,126,282,18,152,68,84,239,230,1,5,3,6
E33035360,714,339,86,253,21,99,42,57,247,227,1,14,5,8
E33035361,242,168,72,96,2,12,3,9,53,50,3,0,0,7
E33035362,638,414,176,238,7,77,37,40,122,112,3,7,0,18
E33035363,255,178,80,98,3,6,4,2,60,60,0,0,0,8
E33035364,655,425,151,274,3,34,17,17,185,176,2,5,2,8
E33035365,617,432,169,263,3,39,17,22,129,105,15,9,0,14
E33035366,237,128,34,94,4,26,16,10,73,70,0,3,0,6
E33035367,247,156,53,103,1,12,3,9,76,75,0,1,0,2
E33035368,235,126,50,76,5,14,5,9,88,84,0,4,0,2
E33035369,245,110,30,80,8,51,27,24,76,67,2,7,0,0
E33035370,332,207,78,129,0,27,13,14,95,92,1,1,1,3
E33035371,495,302,73,229,5,29,14,15,157,151,0,3,3,2
E33035372,239,154,64,90,1,9,1,8,73,69,0,4,0,2
E33035373,220,138,57,81,1,6,3,3,69,64,3,0,2,6
E33035374,264,159,66,93,2,24,10,14,77,70,0,6,1,2
E33035375,617,341,101,240,2,43,18,25,221,215,1,2,3,10
E33035376,249,141,40,101,3,24,7,17,75,71,0,2,2,6
E33035377,285,169,57,112,2,19,8,11,89,83,3,3,0,6
E33035378,623,310,87,223,5,38,15,23,265,253,1,9,2,5
E33035379,259,164,57,107,2,15,6,9,74,68,0,6,0,4
E33035380,417,193,54,139,3,42,19,23,174,168,2,4,0,5
E33035381,285,150,31,119,0,21,4,17,113,110,0,3,0,1
E33035382,487,206,62,144,5,55,25,30,217,196,3,12,6,4
E33035383,373,176,52,124,4,33,13,20,159,157,1,0,1,1
E33035384,1056,500,146,354,15,252,101,151,282,273,1,7,1,7
E33035385,563,277,74,203,4,97,34,63,185,181,0,4,0,0
E33035386,960,494,111,383,9,225,106,119,229,221,0,7,1,3
E33035387,326,190,56,134,3,33,14,19,98,96,1,0,1,2
E33035388,290,189,48,141,1,19,10,9,74,73,0,1,0,7
E33035389,313,170,44,126,2,24,13,11,113,106,0,5,2,4
E33035390,268,123,28,95,4,59,17,42,80,74,0,5,1,2
E33035391,376,202,67,135,5,45,18,27,120,111,4,5,0,4
E33035392,332,195,44,151,3,20,6,14,113,106,0,6,1,1
E33035393,467,205,75,130,0,31,11,20,224,209,5,10,0,7
E33035394,474,177,54,123,1,29,15,14,259,251,3,3,2,8
E33035395,743,460,148,312,6,66,40,26,204,192,1,9,2,7
E33035396,405,165,37,128,4,60,21,39,174,168,1,4,1,2
E33035397,454,213,44,169,5,50,20,30,184,181,1,0,2,2
E33035398,445,189,47,142,4,67,25,42,185,181,1,3,0,0
E33035399,585,287,56,231,5,42,19,23,246,222,1,21,2,5
E33035400,270,141,41,100,2,29,17,12,96,94,1,1,0,2
E33035401,386,219,69,150,2,39,14,25,123,117,2,4,0,3
E33035402,247,160,37,123,1,15,9,6,71,69,0,2,0,0
E33035403,372,219,63,156,1,47,26,21,103,96,1,6,0,2
E33035404,310,172,57,115,2,26,7,19,105,101,3,1,0,5
E33035405,422,237,51,186,4,33,22,11,146,134,1,11,0,2
E33035406,365,182,58,124,4,47,23,24,130,127,0,2,1,2
E33035407,580,291,83,208,3,37,26,11,244,237,1,5,1,5
E33035408,353,257,97,160,5,22,8,14,66,62,2,1,1,3
E33035409,418,294,90,204,1,22,11,11,94,86,2,4,2,7
E33035410,255,174,71,103,2,20,8,12,59,55,0,4,0,0
E33035411,384,256,98,158,5,38,12,26,83,79,0,2,2,2
E33035412,285,173,62,111,5,26,13,13,77,74,0,3,0,4
E33035413,270,199,64,135,1,16,10,6,52,49,1,2,0,2
E33035414,279,172,75,97,4,21,6,15,73,71,0,1,1,9
E33035415,310,182,78,104,4,17,5,12,106,105,0,1,0,1
E33035416,705,473,116,357,7,64,31,33,156,148,2,5,1,5
E33035417,293,165,39,126,2,21,8,13,105,99,2,4,0,0
E33035418,300,209,66,143,4,28,7,21,57,53,0,3,1,2
E33035419,349,148,32,116,5,111,27,84,81,77,1,1,2,4
E33035420,363,179,50,129,6,90,41,49,86,83,0,2,1,2
E33035421,1301,737,183,554,21,163,87,76,368,354,0,13,1,12
E33035422,527,215,52,163,6,96,26,70,205,200,0,3,2,5
E33035423,1048,678,178,500,13,154,53,101,200,183,4,11,2,3
E33035424,439,225,78,147,2,80,32,48,126,122,1,2,1,6
E33035425,354,178,45,133,7,69,33,36,98,91,0,7,0,2
E33035426,638,347,78,269,4,97,33,64,180,171,1,8,0,10
E33035427,381,195,55,140,7,33,13,20,144,142,0,2,0,2
E33035428,590,301,78,223,9,88,29,59,183,177,1,4,1,9
E33035429,434,234,48,186,10,77,24,53,106,101,0,5,0,7
E33035430,364,246,96,150,0,23,11,12,95,88,6,1,0,0
E33035431,298,178,52,126,2,33,11,22,83,79,0,4,0,2
E33035432,451,342,125,217,0,27,12,15,77,75,0,2,0,5
E33035433,345,253,91,162,2,13,4,9,74,73,0,1,0,3
E33035434,309,209,66,143,3,28,7,21,64,60,0,2,2,5
E33035435,604,375,93,282,1,63,32,31,161,147,6,5,3,4
E33035436,737,447,108,339,9,72,37,35,205,194,4,5,2,4
E33035437,665,439,131,308,4,86,45,41,132,127,0,4,1,4
E33035438,284,158,42,116,7,31,13,18,82,75,0,6,1,6
E33035439,242,104,31,73,2,55,25,30,80,77,1,1,1,1
E33035440,574,339,132,207,4,28,16,12,197,182,1,13,1,6
E33035441,302,168,52,116,1,48,25,23,76,68,0,7,1,9
E33035442,331,199,63,136,0,25,13,12,105,101,0,3,1,2
E33035443,393,261,64,197,2,22,10,12,107,105,0,0,2,1
E33035444,353,197,60,137,11,30,9,21,114,109,1,4,0,1
E33035445,367,238,56,182,1,28,10,18,99,95,0,4,0,1
E33035446,404,230,70,160,3,93,38,55,71,64,0,6,1,7
E33035447,298,168,33,135,3,54,16,38,71,69,0,2,0,2
E33035448,314,126,32,94,1,105,37,68,80,78,0,2,0,2
E33035449,449,211,54,157,7,101,27,74,127,125,0,1,1,3
E33035450,513,251,65,186,5,107,37,70,138,128,0,4,6,12
E33035451,459,281,55,226,4,91,8,83,83,82,0,0,1,0
E33035452,623,354,100,254,10,102,19,83,150,138,4,7,1,7
E33035453,488,353,97,256,5,16,8,8,112,106,0,6,0,2
E33035454,294,217,70,147,1,5,4,1,65,62,0,3,0,6
E33035455,337,260,81,179,3,13,3,10,57,53,1,2,1,4
E33035456,707,437,121,316,8,42,20,22,217,206,4,4,3,3
E33035457,352,289,84,205,0,15,6,9,47,41,1,5,0,1
E33035458,418,327,99,228,0,18,5,13,69,65,0,4,0,4
E33035459,309,252,79,173,1,15,10,5,41,39,0,2,0,0
E33035460,313,167,41,126,2,48,22,26,96,92,0,4,0,0
E33035461,361,234,66,168,4,37,22,15,86,78,0,6,2,0
E33035462,613,340,92,248,9,115,38,77,145,142,0,3,0,4
E33035463,385,204,48,156,6,64,26,38,110,102,0,8,0,1
E33035464,574,370,94,276,6,70,23,47,121,115,0,6,0,7
E33035465,594,365,82,283,10,88,27,61,123,113,5,4,1,8
E33035466,454,267,63,204,6,64,33,31,116,114,0,2,0,1
E33035467,405,250,78,172,6,63,17,46,81,76,0,5,0,5
E33035468,612,329,85,244,0,93,28,65,186,178,3,3,2,4
E33035469,554,270,49,221,2,96,44,52,180,166,2,8,4,6
E33035470,419,207,28,179,1,76,31,45,132,126,0,3,3,3
E33035471,398,227,55,172,1,104,25,79,62,59,0,2,1,4
E33035472,370,178,44,134,3,50,23,27,132,120,1,6,5,7
E33035473,288,183,48,135,6,46,16,30,49,44,0,2,3,4
E33035474,385,221,49,172,1,74,27,47,87,78,0,8,1,2
E33035475,573,403,120,283,10,76,31,45,78,68,0,7,3,6
E33035476,311,230,62,168,3,19,11,8,56,54,0,1,1,3
E33035477,351,267,52,215,3,34,16,18,43,42,0,1,0,4
E33035478,299,229,51,178,3,31,10,21,30,29,0,1,0,6
E33035479,386,312,66,246,2,19,8,11,48,46,1,1,0,5
E33035480,470,165,49,116,16,64,37,27,223,218,0,3,2,2
E33035481,427,172,50,122,4,77,42,35,168,152,1,1,14,6
E33035482,670,312,78,234,6,94,41,53,253,247,0,5,1,5
E33035483,364,145,37,108,5,75,54,21,134,127,1,5,1,5
E33035484,396,188,58,130,6,48,25,23,149,143,0,5,1,5
E33035485,510,226,61,165,4,77,54,23,201,190,0,10,1,2
E33035486,521,219,72,147,6,91,47,44,195,186,2,4,3,10
E33035487,382,142,43,99,3,40,25,15,189,179,3,6,1,8
E33035488,344,169,52,117,6,48,22,26,118,105,3,6,4,3
E33035489,341,157,43,114,0,59,38,21,125,116,0,7,2,0
E33035490,351,179,68,111,0,32,19,13,136,131,0,5,0,4
E33035491,450,246,69,177,4,57,32,25,137,127,4,4,2,6
E33035492,679,309,86,223,10,116,51,65,238,225,1,9,3,6
E33035493,1053,552,148,404,8,212,145,67,273,262,2,8,1,8
E33035494,513,203,62,141,3,105,49,56,198,192,1,4,1,4
E33035495,315,113,27,86,0,56,26,30,140,135,0,3,2,6
E33035496,568,188,42,146,21,90,37,53,269,261,0,7,1,0
E33035497,463,136,29,107,9,97,40,57,214,207,1,2,4,7
E33035498,354,135,52,83,4,30,14,16,182,178,0,3,1,3
E33035499,300,158,55,103,2,31,22,9,106,97,0,1,8,3
E33035500,436,217,62,155,5,46,28,18,165,157,0,5,3,3
E33035501,336,182,63,119,2,47,21,26,101,97,0,3,1,4
E33035502,941,604,134,470,11,89,49,40,231,213,2,12,4,6
E33035503,481,196,53,143,6,78,38,40,198,191,0,5,2,3
E33035504,417,186,57,129,17,35,17,18,173,167,0,4,2,6
E33035505,302,146,51,95,6,35,18,17,109,105,0,0,4,6
E33035506,421,167,55,112,6,77,36,41,165,156,0,7,2,6
E33035507,607,286,78,208,3,80,33,47,231,225,2,3,1,7
E33035508,300,101,27,74,6,58,30,28,133,125,1,3,4,2
E33035509,367,129,50,79,4,67,17,50,166,161,0,5,0,1
E33035510,1228,618,189,429,16,114,42,72,469,459,0,7,3,11
E33035511,448,135,34,101,11,75,38,37,223,213,0,9,1,4
E33035512,374,163,35,128,2,34,17,17,173,151,5,11,6,2
E33035513,464,230,94,136,3,48,25,23,176,166,0,4,6,7
E33035514,463,232,71,161,3,36,21,15,185,171,12,1,1,7
E33035515,746,481,153,328,10,96,48,48,151,144,1,2,4,8
E33035516,474,220,62,158,5,37,18,19,204,193,2,9,0,8
E33035517,586,262,90,172,7,48,25,23,268,258,2,6,2,1
E33035518,843,420,134,286,12,78,35,43,321,296,1,17,7,12
E33035519,428,169,61,108,13,90,41,49,154,148,0,3,3,2
E33035520,507,169,39,130,12,83,50,33,239,230,1,6,2,4
E33035521,762,372,114,258,22,137,57,80,221,213,0,7,1,10
E33035522,317,106,24,82,4,66,48,18,134,133,0,1,0,7
E33035523,710,332,87,245,17,126,65,61,227,221,0,5,1,8
E33035524,542,278,77,201,29,74,37,37,160,153,0,6,1,1
E33035525,498,127,44,83,5,62,49,13,295,290,0,2,3,9
E33035526,541,234,64,170,15,103,51,52,187,177,2,6,2,2
E33035527,624,261,59,202,22,106,42,64,231,222,1,5,3,4
E33035528,399,219,43,176,10,34,23,11,134,127,1,3,3,2
E33035529,576,306,76,230,10,116,70,46,139,135,0,4,0,5
E33035530,499,242,59,183,3,106,72,34,146,137,0,7,2,2
E33035531,648,287,112,175,4,41,19,22,313,294,2,11,6,3
E33035532,609,288,89,199,9,69,37,32,235,227,0,7,1,8
E33035533,644,318,107,211,4,66,39,27,252,241,2,5,4,4
E33035534,405,209,82,127,1,20,16,4,172,163,0,6,3,3
E33035535,593,266,84,182,8,31,10,21,283,264,0,19,0,5
E33035536,826,295,91,204,2,98,36,62,420,406,3,8,3,11
E33035537,381,147,49,98,8,31,11,20,194,183,0,11,0,1
E33035538,338,142,50,92,2,44,23,21,147,142,1,3,1,3
E33035539,282,138,49,89,0,24,15,9,118,108,0,8,2,2
E33035540,404,186,79,107,2,29,15,14,185,178,0,4,3,2
E33035541,785,409,119,290,2,102,64,38,265,252,5,6,2,7
E33035542,531,271,89,182,3,84,34,50,166,160,1,3,2,7
E33035543,370,158,38,120,2,31,21,10,173,170,0,1,2,6
E33035544,827,428,128,300,5,99,55,44,291,280,1,8,2,4
E33035545,458,121,36,85,4,27,15,12,302,294,0,6,2,4
E33035546,544,259,80,179,3,66,38,28,214,202,1,11,0,2
E33035547,657,278,62,216,6,200,132,68,169,164,1,4,0,4
E33035548,448,242,66,176,8,102,78,24,96,95,0,1,0,0
E33035549,365,150,40,110,6,46,29,17,159,157,0,0,2,4
E33035550,370,160,65,95,7,53,33,20,144,143,0,1,0,6
E33035551,404,182,40,142,4,65,46,19,150,142,2,6,0,3
E33035552,480,146,36,110,3,94,68,26,232,229,0,2,1,5
E33035553,371,178,51,127,6,60,36,24,124,120,1,3,0,3
E33035554,307,126,31,95,5,59,44,15,111,104,0,5,2,6
E33035555,516,259,64,195,4,134,94,40,117,113,0,1,3,2
E33035556,294,126,36,90,8,79,51,28,79,71,2,6,0,2
E33035557,470,168,41,127,25,119,79,40,151,146,0,3,2,7
E33035558,618,173,53,120,5,149,99,50,287,279,0,4,4,4
E33035559,363,176,41,135,4,56,30,26,123,117,1,1,4,4
E33035560,390,200,82,118,4,48,26,22,136,134,0,0,2,2
E33035561,308,128,25,103,6,61,38,23,108,105,0,3,0,5
E33035562,343,190,52,138,5,26,14,12,122,117,0,4,1,0
E33035563,549,291,117,174,6,86,45,41,163,156,0,5,2,3
E33035564,418,216,54,162,9,45,33,12,144,140,0,3,1,4
E33035565,599,293,91,202,3,172,132,40,124,116,0,4,4,7
E33035566,430,221,52,169,7,53,42,11,148,144,0,4,0,1
E33035567,605,272,67,205,4,81,50,31,246,233,0,8,5,2
E33035568,372,174,33,141,6,56,34,22,131,128,0,3,0,5
E33035569,1232,664,169,495,22,303,199,104,230,221,0,5,4,13
E33035570,405,216,79,137,6,75,45,30,104,93,0,9,2,4
E33035571,288,151,44,107,3,44,27,17,87,83,0,4,0,3
E33035572,594,284,75,209,11,140,94,46,153,142,0,9,2,6
E33035573,475,219,53,166,2,34,15,19,217,210,2,5,0,3
E33035574,386,207,49,158,10,19,9,10,145,138,0,5,2,5
E33035575,503,191,64,127,6,74,44,30,220,212,0,3,5,12
E33035576,910,424,121,303,15,176,91,85,290,270,0,13,7,5
E33035577,532,226,41,185,5,91,56,35,205,193,1,9,2,5
E33035578,255,124,33,91,2,58,38,20,69,65,1,3,0,2
E33035579,553,158,29,129,6,172,108,64,204,199,0,2,3,13
E33035580,621,224,46,178,8,133,80,53,247,235,1,11,0,9
E33035581,411,206,40,166,3,42,29,13,160,156,0,3,1,0
E33035582,758,333,96,237,18,148,84,64,256,244,0,9,3,3
E33035583,811,435,109,326,9,142,74,68,219,209,2,6,2,6
E33035584,389,210,52,158,8,71,44,27,97,95,1,1,0,3
E33035585,394,154,46,108,1,73,50,23,165,153,0,5,7,1
E33035586,277,151,32,119,3,39,33,6,79,72,0,7,0,5
E33035587,553,273,67,206,3,68,43,25,204,196,0,4,4,5
E33035588,454,178,41,137,7,119,72,47,140,129,1,5,5,10
E33035589,375,130,25,105,2,88,60,28,150,140,5,0,5,5
E33035590,321,132,34,98,10,80,47,33,99,94,2,2,1,0
E33035591,305,120,40,80,12,88,58,30,81,74,1,6,0,4
E33035592,343,152,41,111,4,77,55,22,106,103,1,1,1,4
E33035593,342,142,28,114,4,80,49,31,111,104,1,5,1,5
E33035594,595,257,75,182,6,162,104,58,166,158,1,4,3,4
E33035595,400,154,31,123,7,64,31,33,174,168,0,6,0,1
E33035596,818,436,88,348,8,119,76,43,247,237,1,9,0,8
E33035597,469,119,36,83,0,75,49,26,272,267,0,4,1,3
E33035598,568,188,45,143,6,136,71,65,236,233,0,2,1,2
E33035599,612,229,48,181,3,72,35,37,297,292,0,4,1,11
E33035600,496,233,48,185,8,89,46,43,166,159,1,5,1,0
E33035601,444,219,45,174,5,76,46,30,140,132,0,4,4,4
E33035602,635,306,72,234,9,122,52,70,195,192,0,3,0,3
E33035603,554,243,66,177,2,161,80,81,143,125,3,5,10,5
E33035604,332,109,18,91,0,102,31,71,115,110,0,5,0,6
E33035605,1201,722,206,516,24,198,105,93,251,234,0,13,4,6
E33035606,856,364,94,270,8,211,121,90,267,248,4,14,1,6
E33035607,419,132,28,104,13,102,65,37,171,166,1,2,2,1
E33035608,546,221,50,171,10,133,72,61,174,167,0,4,3,8
E33035609,493,107,30,77,25,53,17,36,299,295,0,2,2,9
E33035610,370,119,31,88,5,129,97,32,115,107,3,1,4,2
E33035611,730,366,112,254,19,117,80,37,222,215,0,5,2,6
E33035612,563,290,74,216,12,107,70,37,151,149,0,1,1,3
E33035613,362,158,33,125,5,57,34,23,140,137,2,1,0,2
E33035614,755,329,57,272,10,79,35,44,333,324,2,6,1,4
E33035615,362,156,48,108,6,53,25,28,143,140,0,1,2,4
E33035616,486,166,29,137,21,111,78,33,180,173,0,4,3,8
E33035617,704,329,64,265,17,171,111,60,177,165,0,11,1,10
E33035618,549,194,43,151,6,152,87,65,194,192,0,1,1,3
E33035619,385,150,40,110,3,115,82,33,115,109,0,6,0,2
E33035620,558,258,78,180,5,161,122,39,122,120,0,1,1,12
E33035621,770,376,84,292,6,149,77,72,236,222,9,3,2,3
E33035622,501,159,30,129,3,73,41,32,263,261,0,2,0,3
E33035623,525,230,62,168,7,133,78,55,151,144,0,5,2,4
E33035624,378,164,49,115,5,54,24,30,154,147,1,6,0,1
E33035625,811,631,214,417,9,42,31,11,112,106,3,2,1,17
E33035626,287,228,72,156,5,25,12,13,27,25,0,1,1,2
E33035627,294,253,104,149,1,5,4,1,35,35,0,0,0,0
E33035628,320,238,82,156,4,26,11,15,47,43,1,2,1,5
E33035629,558,394,133,261,3,39,24,15,112,107,2,2,1,10
E33035630,390,291,113,178,0,26,18,8,70,66,1,1,2,3
E33035631,638,386,124,262,7,82,49,33,152,142,1,8,1,11
E33035632,346,240,63,177,6,49,44,5,44,43,0,1,0,7
E33035633,372,275,76,199,3,46,34,12,47,46,0,0,1,1
E33035634,255,165,42,123,2,34,28,6,49,48,0,1,0,5
E33035635,268,187,40,147,2,50,38,12,28,25,1,2,0,1
E33035636,391,264,90,174,5,61,41,20,58,50,0,8,0,3
E33035637,690,471,104,367,7,88,64,24,118,111,0,7,0,6
E33035638,692,441,144,297,5,62,46,16,178,167,2,8,1,6
E33035639,442,340,90,250,6,27,14,13,65,62,0,3,0,4
E33035640,761,508,133,375,5,115,82,33,129,121,3,3,2,4
E33035641,382,289,69,220,3,26,19,7,61,57,0,3,1,3
E33035642,255,173,35,138,2,29,22,7,49,44,0,5,0,2
E33035643,483,356,114,242,7,30,28,2,78,71,0,3,4,12
E33035644,537,407,99,308,6,37,24,13,82,75,1,6,0,5
E33035645,329,228,82,146,4,14,12,2,82,80,0,1,1,1
E33035646,488,338,112,226,3,42,33,9,101,95,0,4,2,4
E33035647,277,213,60,153,3,19,12,7,42,40,0,2,0,0
E33035648,801,565,148,417,3,75,52,23,147,130,0,15,2,11
E33035649,277,216,57,159,1,17,12,5,42,40,0,2,0,1
E33035650,577,390,100,290,5,43,26,17,132,126,0,6,0,7
E33035651,260,192,55,137,2,11,9,2,54,51,1,2,0,1
E33035652,366,259,88,171,0,16,6,10,86,85,0,1,0,5
E33035653,643,453,142,311,4,58,39,19,122,120,0,2,0,6
E33035654,246,176,62,114,0,25,17,8,43,40,1,2,0,2
E33035655,314,232,75,157,2,21,12,9,50,49,0,0,1,9
E33035656,470,378,124,254,1,20,11,9,71,57,11,2,1,0
E33035657,318,180,51,129,18,34,8,26,83,80,0,3,0,3
E33035658,463,270,87,183,15,44,32,12,130,123,0,6,1,4
E33035659,387,303,90,213,4,33,25,8,45,42,2,1,0,2
E33035660,419,358,112,246,0,10,8,2,49,47,0,2,0,2
E33035661,338,251,64,187,3,35,26,9,48,42,0,6,0,1
E33035662,361,198,34,164,1,86,72,14,75,69,2,3,1,1
E33035663,505,381,103,278,2,27,16,11,90,84,0,5,1,5
E33035664,453,309,96,213,4,26,14,12,107,103,0,3,1,7
E33035665,378,247,77,170,4,42,28,14,78,74,0,4,0,7
E33035666,544,323,80,243,8,46,29,17,162,158,0,4,0,5
E33035667,553,402,111,291,5,50,26,24,94,91,0,3,0,2
E33035668,414,309,80,229,2,42,24,18,60,58,1,1,0,1
E33035669,383,251,68,183,1,54,35,19,76,71,0,4,1,1
E33035670,476,342,84,258,8,30,16,14,91,82,0,9,0,5
E33035671,382,308,105,203,1,7,3,4,66,61,1,4,0,0
E33035672,596,395,114,281,6,55,32,23,135,124,5,6,0,5
E33035673,483,341,112,229,3,51,31,20,78,78,0,0,0,10
E33035674,341,225,74,151,9,23,20,3,83,76,0,5,2,1
E33035675,538,409,127,282,12,30,16,14,83,80,0,3,0,4
E33035676,658,440,144,296,4,89,59,30,113,107,0,5,1,12
E33035677,546,339,103,236,7,64,39,25,128,125,0,3,0,8
E33035678,448,301,116,185,6,50,42,8,89,83,0,5,1,2
E33035679,533,334,115,219,5,47,28,19,141,127,3,9,2,6
E33035680,409,280,79,201,10,25,10,15,84,77,2,5,0,10
E33035681,290,180,59,121,5,30,14,16,72,70,0,2,0,3
E33035682,374,277,98,179,1,15,8,7,74,73,0,1,0,7
E33035683,270,162,49,113,2,25,13,12,79,76,0,3,0,2
E33035684,330,199,64,135,1,39,25,14,88,87,0,1,0,3
E33035685,549,413,146,267,5,38,19,19,91,88,3,0,0,2
E33035686,569,340,100,240,4,47,30,17,174,161,1,9,3,4
E33035687,353,257,87,170,9,24,13,11,57,53,0,3,1,6
E33035688,313,183,53,130,8,36,24,12,84,78,0,6,0,2
E33035689,287,190,52,138,2,28,21,7,63,61,1,1,0,4
E33035690,369,235,74,161,9,25,14,11,95,86,3,4,2,5
E33035691,427,289,95,194,6,37,23,14,89,87,0,2,0,6
E33035692,385,229,67,162,8,37,21,16,111,109,2,0,0,0
E33035693,522,374,123,251,1,44,20,24,100,84,8,7,1,3
E33035694,440,320,116,204,1,38,21,17,78,73,0,4,1,3
E33035695,554,368,97,271,15,59,33,26,107,100,0,4,3,5
E33035696,378,247,64,183,3,44,25,19,74,67,0,2,5,10
E33035697,649,446,92,354,11,61,26,35,121,115,0,5,1,10
E33035698,414,320,80,240,1,32,16,16,60,56,0,4,0,1
E33035699,371,277,72,205,7,21,14,7,64,56,0,8,0,2
E33035700,397,277,66,211,9,32,18,14,74,71,1,2,0,5
E33035701,350,248,59,189,6,27,16,11,67,60,0,1,6,2
E33035702,443,304,91,213,5,36,18,18,93,88,1,2,2,5
E33035703,325,225,56,169,4,12,7,5,81,77,0,4,0,3
E33035704,321,193,64,129,0,18,13,5,109,100,0,5,4,1
E33035705,322,168,55,113,0,23,14,9,123,117,0,5,1,8
E33035706,337,218,62,156,5,35,23,12,77,75,0,2,0,2
E33035707,295,206,57,149,2,34,23,11,50,46,0,4,0,3
E33035708,388,299,95,204,6,29,17,12,54,47,1,3,3,0
E33035709,505,318,98,220,4,65,46,19,116,113,0,3,0,2
E33035710,447,294,73,221,11,23,15,8,113,110,0,0,3,6
E33035711,302,149,40,109,6,46,16,30,96,91,1,4,0,5
E33035712,811,603,205,398,12,49,33,16,140,136,0,3,1,7
E33035713,240,152,37,115,3,22,16,6,60,56,0,3,1,3
E33035714,475,278,76,202,1,25,18,7,170,154,1,12,3,1
E33035715,399,290,93,197,1,13,6,7,91,87,0,4,0,4
E33035716,469,265,82,183,3,31,20,11,170,166,0,4,0,0
E33035717,266,211,80,131,1,8,5,3,44,42,1,1,0,2
E33035718,384,268,95,173,0,20,8,12,94,88,0,4,2,2
E33035719,598,314,83,231,3,61,33,28,213,202,1,8,2,7
E33035720,365,253,72,181,4,29,19,10,77,73,0,3,1,2
E33035721,547,372,122,250,1,47,39,8,113,106,0,5,2,14
E33035722,331,233,83,150,1,32,21,11,63,60,1,2,0,2
E33035723,779,439,124,315,2,63,27,36,272,263,3,5,1,3
E33035724,443,234,76,158,5,56,27,29,143,137,0,5,1,5
E33035725,355,165,60,105,7,18,11,7,163,153,0,6,4,2
E33035726,370,189,40,149,5,36,22,14,139,132,0,5,2,1
E33035727,653,419,104,315,4,64,38,26,161,143,1,14,3,5
E33035728,340,216,65,151,3,14,6,8,102,98,1,3,0,5
E33035729,645,460,83,377,7,62,36,26,115,110,0,5,0,1
E33035730,266,161,46,115,5,17,5,12,76,74,1,0,1,7
E33035731,567,402,102,300,9,59,34,25,91,81,0,10,0,6
E33035732,451,250,69,181,3,21,14,7,170,162,0,8,0,7
E33035733,294,157,65,92,13,22,15,7,100,89,0,6,5,2
E33035734,395,219,61,158,6,22,17,5,147,140,1,4,2,1
E33035735,895,578,144,434,12,79,47,32,224,215,3,4,2,2
E33035736,525,397,109,288,1,29,14,15,94,83,0,4,7,4
E33035737,577,415,120,295,6,57,43,14,99,98,0,1,0,0
E33035738,503,319,81,238,2,27,17,10,149,130,0,6,13,6
E33035739,397,225,64,161,12,29,14,15,130,127,0,2,1,1
E33035740,710,422,129,293,7,95,59,36,177,170,1,3,3,9
E33035741,330,161,45,116,13,53,14,39,100,95,0,3,2,3
E33035742,332,200,53,147,1,14,10,4,115,106,0,8,1,2
E33035743,358,173,48,125,6,39,22,17,137,128,0,8,1,3
E33035744,340,183,51,132,6,44,12,32,106,101,0,5,0,1
E33035745,312,183,60,123,1,21,13,8,100,90,0,9,1,7
E33035746,355,162,49,113,3,45,25,20,140,132,0,8,0,5
E33035747,343,209,76,133,4,35,17,18,87,78,1,6,2,8
E33035748,376,199,91,108,3,29,12,17,139,128,0,4,7,6
E33035749,282,192,89,103,0,29,12,17,57,57,0,0,0,4
E33035750,324,183,77,106,2,16,8,8,118,113,0,5,0,5
E33035751,421,266,105,161,2,39,22,17,109,103,2,3,1,5
E33035752,395,192,76,116,2,110,30,80,84,76,2,6,0,7
E33035753,302,179,66,113,3,20,6,14,90,83,1,3,3,10
E33035754,650,339,147,192,3,65,29,36,231,163,57,10,1,12
E33035755,420,271,103,168,9,31,7,24,104,98,0,5,1,5
E33035756,403,196,52,144,11,42,18,24,138,129,2,4,3,16
E33035757,554,346,123,223,3,82,39,43,121,114,0,6,1,2
E33035758,257,182,56,126,3,15,9,6,55,54,0,1,0,2
E33035759,477,278,115,163,3,47,21,26,145,143,0,2,0,4
E33035760,246,151,77,74,2,24,10,14,69,66,0,2,1,0
E33035761,464,270,96,174,3,39,22,17,140,134,0,6,0,12
E33035762,264,151,49,102,1,19,9,10,93,91,1,1,0,0
E33035763,268,165,70,95,2,14,2,12,83,76,0,7,0,4
E33035764,230,151,56,95,2,13,7,6,64,61,0,3,0,0
E33035765,288,183,63,120,7,39,20,19,56,50,1,5,0,3
E33035766,542,302,87,215,4,40,17,23,194,188,1,4,1,2
E33035767,298,205,88,117,2,24,7,17,61,56,0,3,2,6
E33035768,340,217,59,158,2,38,16,22,80,77,0,2,1,3
E33035769,290,141,30,111,1,72,29,43,69,63,2,1,3,7
E33035770,530,274,101,173,6,116,44,72,133,124,1,4,4,1
E33035771,497,296,123,173,9,62,36,26,123,114,5,3,1,7
E33035772,468,281,112,169,7,25,6,19,150,144,0,4,2,5
E33035773,271,145,43,102,2,28,7,21,92,86,0,6,0,4
E33035774,243,144,70,74,2,44,17,27,53,51,0,2,0,0
E33035775,353,193,56,137,2,48,10,38,103,97,1,5,0,7
E33035776,257,102,29,73,7,72,31,41,75,67,3,4,1,1
E33035777,376,233,71,162,4,44,17,27,93,88,0,5,0,2
E33035778,257,152,47,105,2,35,18,17,64,63,0,1,0,4
E33035779,855,476,164,312,31,115,54,61,225,218,1,6,0,8
E33035780,421,235,56,179,6,80,41,39,95,94,0,0,1,5
E33035781,430,280,66,214,7,17,7,10,122,117,0,3,2,4
E33035782,341,189,73,116,1,76,34,42,72,69,0,2,1,3
E33035783,412,276,88,188,4,53,22,31,75,67,2,5,1,4
E33035784,261,182,74,108,1,22,15,7,54,52,0,2,0,2
E33035785,296,193,56,137,4,24,4,20,74,70,0,4,0,1
E33035786,227,162,43,119,5,34,17,17,24,24,0,0,0,2
E33035787,251,174,55,119,1,21,10,11,52,50,0,2,0,3
E33035788,381,227,81,146,0,45,22,23,102,96,2,4,0,7
E33035789,469,282,101,181,3,33,18,15,143,137,0,4,2,8
E33035790,335,155,52,103,2,101,48,53,74,70,0,3,1,3
E33035791,244,101,41,60,2,89,10,79,50,45,4,1,0,2
E33035792,440,266,61,205,2,25,9,16,139,132,1,5,1,8
E33035793,477,315,105,210,6,42,14,28,109,103,4,1,1,5
E33035794,615,383,122,261,5,47,15,32,172,164,0,6,2,8
E33035795,534,271,81,190,6,83,28,55,172,166,1,5,0,2
E33035796,364,270,104,166,5,16,6,10,68,66,0,2,0,5
E33035797,326,208,69,139,5,23,13,10,80,74,1,4,1,10
E33035798,486,290,90,200,13,36,10,26,143,137,0,5,1,4
E33035799,369,234,72,162,1,20,8,12,100,91,0,8,1,14
E33035800,523,337,100,237,3,32,9,23,140,134,0,4,2,11
E33035801,403,236,93,143,5,38,13,25,119,112,3,4,0,5
E33035802,311,190,94,96,2,13,0,13,103,98,1,3,1,3
E33035803,323,169,62,107,4,42,21,21,97,81,8,6,2,11
E33035804,513,225,63,162,5,50,17,33,227,199,12,11,5,6
E33035805,329,214,89,125,0,17,8,9,96,92,1,3,0,2
E33035806,311,180,63,117,4,20,8,12,104,100,1,1,2,3
E33035807,407,275,91,184,4,30,11,19,95,90,0,4,1,3
E33035808,324,181,49,132,4,25,13,12,109,109,0,0,0,5
E33035809,379,258,93,165,3,24,8,16,86,81,2,2,1,8
E33035810,295,202,78,124,0,11,6,5,81,71,2,8,0,1
E33035811,319,179,62,117,2,22,9,13,116,113,1,2,0,0
E33035812,391,262,80,182,7,36,19,17,81,77,3,1,0,5
E33035813,395,281,69,212,6,43,8,35,62,55,0,7,0,3
E33035814,271,212,73,139,0,26,10,16,30,27,2,1,0,3
E33035815,518,316,77,239,8,65,31,34,127,113,0,12,2,2
E33035816,286,172,63,109,2,23,9,14,85,34,24,4,23,4
E33035817,293,199,55,144,5,39,17,22,49,46,0,3,0,1
E33035818,718,460,134,326,10,98,50,48,144,133,4,1,6,6
E33035819,327,210,61,149,4,21,7,14,90,83,0,5,2,2
E33035820,837,612,213,399,13,88,35,53,119,107,1,9,2,5
E33035821,615,378,93,285,8,57,37,20,169,156,2,7,4,3
E33035822,304,210,65,145,6,22,10,12,59,56,1,0,2,7
E33035823,451,303,118,185,4,43,17,26,94,89,2,2,1,7
E33035824,267,172,64,108,5,28,13,15,49,41,1,4,3,13
E33035825,381,302,135,167,0,11,2,9,62,59,0,3,0,6
E33035826,596,373,134,239,5,58,22,36,147,134,1,8,4,13
E33035827,338,207,47,160,2,55,23,32,70,65,0,4,1,4
E33035828,393,257,77,180,3,67,25,42,59,53,0,6,0,7
E33035829,368,254,75,179,9,61,17,44,43,39,0,4,0,1
E33035830,370,285,105,180,2,26,16,10,56,51,1,1,3,1
E33035831,371,273,75,198,5,31,11,20,61,56,1,4,0,1
E33035832,312,224,50,174,1,23,9,14,61,61,0,0,0,3
E33035833,511,310,91,219,9,55,24,31,133,127,0,6,0,4
E33035834,362,232,70,162,8,33,17,16,86,78,0,4,4,3
E33035835,594,400,97,303,9,33,13,20,149,139,1,8,1,3
E33035836,428,271,70,201,7,39,18,21,108,106,0,2,0,3
E33035837,230,171,45,126,0,12,3,9,43,41,0,2,0,4
E33035838,345,249,92,157,3,23,6,17,69,63,2,4,0,1
E33035839,609,342,82,260,16,80,30,50,168,161,1,6,0,3
E33035840,498,285,100,185,2,107,51,56,101,96,2,3,0,3
E33035841,404,269,71,198,2,34,19,15,97,94,0,2,1,2
E33035842,333,272,69,203,3,17,6,11,37,33,3,1,0,4
E33035843,313,221,59,162,5,43,18,25,42,37,1,4,0,2
E33035844,347,224,48,176,1,41,17,24,79,72,1,3,3,2
E33035845,304,234,84,150,1,14,3,11,53,51,0,2,0,2
E33035846,306,223,78,145,2,32,18,14,48,43,2,3,0,1
E33035847,788,539,173,366,4,61,24,37,177,168,2,7,0,7
E33035848,395,279,108,171,3,22,5,17,88,86,0,0,2,3
E33035849,433,290,97,193,8,59,30,29,72,71,0,1,0,4
E33035850,319,231,89,142,2,10,4,6,69,64,1,4,0,7
E33035851,297,209,75,134,5,22,8,14,58,50,2,6,0,3
E33035852,447,294,99,195,8,54,15,39,89,83,0,5,1,2
E33035853,404,241,77,164,9,68,32,36,76,68,1,6,1,10
E33035854,361,274,77,197,5,25,11,14,57,46,1,9,1,0
E33035855,238,187,74,113,1,11,3,8,37,33,2,2,0,2
E33035856,307,230,75,155,2,18,8,10,57,55,0,1,1,0
E33035857,260,184,52,132,2,33,14,19,37,36,0,0,1,4
E33035858,518,362,109,253,10,29,11,18,113,103,1,9,0,4
E33035859,266,171,58,113,0,19,5,14,75,69,2,4,0,1
E33035860,271,179,40,139,2,20,10,10,70,68,0,2,0,0
E33035861,234,144,55,89,1,30,18,12,58,51,0,5,2,1
E33035862,352,258,62,196,2,19,5,14,70,68,0,1,1,3
E33035863,258,195,70,125,2,23,12,11,38,37,0,0,1,0
E33035864,489,343,99,244,3,30,14,16,112,108,0,2,2,1
E33035865,297,223,56,167,2,23,7,16,42,38,0,2,2,7
E33035866,358,221,67,154,10,71,19,52,55,50,0,4,1,1
E33035867,724,506,176,330,9,58,24,34,137,130,3,3,1,14
E33035868,574,359,112,247,12,107,54,53,88,83,2,3,0,8
E33035869,419,297,103,194,4,37,8,29,74,68,0,5,1,7
E33035870,441,285,89,196,7,84,32,52,58,58,0,0,0,7
E33035871,469,309,85,224,11,37,17,20,108,101,0,6,1,4
E33035872,296,204,56,148,2,16,6,10,74,68,0,3,3,0
E33035873,287,191,67,124,4,32,19,13,59,56,0,3,0,1
E33035874,657,433,160,273,12,59,25,34,148,133,4,7,4,5
E33035875,353,245,68,177,8,25,9,16,75,70,0,5,0,0
E33035876,228,169,53,116,2,19,6,13,37,36,0,1,0,1
E33035877,643,334,89,245,5,81,35,46,218,210,1,3,4,5
E33035878,397,243,61,182,6,32,10,22,112,102,9,1,0,4
E33035879,242,179,64,115,3,19,8,11,40,37,2,1,0,1
E33035880,276,193,60,133,2,30,14,16,47,42,0,0,5,4
E33035881,348,239,95,144,5,26,7,19,76,72,1,3,0,2
E33035882,339,233,79,154,3,31,10,21,68,67,0,1,0,4
E33035883,258,145,47,98,6,39,22,17,67,61,1,5,0,1
E33035884,385,258,99,159,1,35,15,20,82,77,1,4,0,9
E33035885,638,433,135,298,4,29,10,19,160,151,4,4,1,12
E33035886,593,428,114,314,12,31,9,22,116,107,1,7,1,6
E33035887,357,274,97,177,2,28,11,17,52,46,2,4,0,1
E33035888,401,280,67,213,7,41,19,22,73,66,1,5,1,0
E33035889,447,279,84,195,4,62,21,41,99,94,0,2,3,3
E33035890,283,197,83,114,5,9,3,6,62,56,4,2,0,10
E33035891,326,232,56,176,4,39,20,19,47,45,1,1,0,4
E33035892,261,212,92,120,1,17,5,12,29,28,0,1,0,2
E33035893,364,278,84,194,3,25,10,15,47,44,1,0,2,11
E33035894,322,238,57,181,6,24,11,13,53,52,0,1,0,1
E33035895,297,200,56,144,8,35,18,17,51,47,0,4,0,3
E33035896,434,192,65,127,14,54,20,34,168,155,0,9,4,6
E33035897,647,287,73,214,17,212,99,113,128,121,0,3,4,3
E33035898,704,368,89,279,26,67,38,29,238,238,0,0,0,5
E33035899,510,293,71,222,2,37,27,10,172,165,2,3,2,6
E33035900,493,298,73,225,11,38,20,18,142,138,1,3,0,4
E33035901,280,135,49,86,2,79,58,21,62,59,1,2,0,2
E33035902,229,115,41,74,9,52,18,34,52,47,0,5,0,1
E33035903,349,170,40,130,8,53,31,22,116,104,3,8,1,2
E33035904,2845,1543,373,1170,45,249,146,103,1001,954,8,32,7,7
E33035905,582,319,77,242,7,66,25,41,187,181,0,6,0,3
E33035906,2495,1606,384,1222,26,171,97,74,682,651,1,25,5,10
E33035907,251,159,49,110,3,18,8,10,67,60,0,6,1,4
E33035908,410,239,52,187,7,33,14,19,129,122,1,5,1,2
E33035909,2574,1535,373,1162,58,470,275,195,457,423,6,25,3,54
E33035910,1296,506,95,411,26,333,217,116,425,395,0,26,4,6
E33035911,256,96,27,69,1,89,70,19,68,66,0,1,1,2
E33035912,640,323,72,251,7,84,56,28,221,207,1,11,2,5
E33035913,352,195,45,150,11,18,11,7,122,114,2,2,4,6
E33035914,519,309,77,232,6,42,31,11,151,139,0,7,5,11
E33035915,1110,597,155,442,23,103,58,45,382,368,1,12,1,5
E33035916,930,470,133,337,18,111,50,61,325,312,0,11,2,6
E33035917,682,316,82,234,8,113,67,46,243,228,2,9,4,2
E33035918,407,200,52,148,2,49,39,10,155,153,0,1,1,1
E33035919,554,274,56,218,17,45,18,27,213,208,0,5,0,5
E33035920,635,365,101,264,8,67,26,41,189,174,2,12,1,6
E33035921,457,197,54,143,4,61,30,31,192,184,1,5,2,3
E33035922,643,349,64,285,5,75,47,28,211,195,2,12,2,3
E33035923,307,141,27,114,9,98,77,21,56,50,0,6,0,3
E33035924,304,153,43,110,17,76,38,38,57,55,0,2,0,1
E33035925,280,125,32,93,9,93,61,32,51,47,0,3,1,2
E33035926,635,309,72,237,24,174,103,71,118,111,0,6,1,10
E33035927,299,112,42,70,3,107,74,33,76,73,0,0,3,1
E33035928,302,109,25,84,10,105,74,31,78,75,1,2,0,0
E33035929,215,85,26,59,18,65,56,9,46,45,0,1,0,1
E33035930,347,133,34,99,7,118,79,39,85,79,1,4,1,4
E33035931,400,191,60,131,12,94,64,30,97,95,0,2,0,6
E33035932,510,191,49,142,4,170,111,59,137,126,5,6,0,8
E33035933,391,163,48,115,8,137,111,26,80,74,1,5,0,3
E33035934,258,115,21,94,2,73,38,35,64,62,1,1,0,4
E33035935,352,158,39,119,7,76,44,32,104,99,1,3,1,7
E33035936,469,217,51,166,8,92,68,24,148,140,1,7,0,4
E33035937,422,176,36,140,17,142,97,45,85,77,1,5,2,2
E33035938,506,196,56,140,9,164,123,41,124,112,10,2,0,13
E33035939,326,131,47,84,8,114,60,54,71,61,2,2,6,2
E33035940,403,119,35,84,4,163,135,28,115,109,2,4,0,2
E33035941,394,139,30,109,10,95,66,29,142,136,0,6,0,8
E33035942,503,216,48,168,12,135,93,42,139,134,0,4,1,1
E33035943,287,108,37,71,3,70,25,45,101,97,0,2,2,5
E33035944,330,171,52,119,12,27,10,17,116,103,0,12,1,4
E33035945,285,134,43,91,3,79,37,42,66,66,0,0,0,3
E33035946,750,380,89,291,14,193,132,61,156,150,0,4,2,7
E33035947,276,115,29,86,8,77,31,46,73,71,0,2,0,3
E33035948,378,164,39,125,5,108,61,47,100,97,0,2,1,1
E33035949,410,180,52,128,6,147,106,41,65,62,0,2,1,12
E33035950,649,389,78,311,18,110,67,43,128,118,1,7,2,4
E33035951,403,119,26,93,3,149,115,34,125,118,3,2,2,7
E33035952,673,310,96,214,20,94,61,33,178,160,8,6,4,71
E33035953,426,148,38,110,8,173,134,39,94,90,0,4,0,3
E33035954,822,384,99,285,17,254,174,80,161,151,0,8,2,6
E33035955,407,127,24,103,23,78,21,57,174,165,0,8,1,5
E33035956,311,138,39,99,7,75,46,29,82,74,0,6,2,9
E33035957,629,216,40,176,21,202,116,86,187,179,0,7,1,3
E33035958,397,154,32,122,9,135,95,40,90,86,0,4,0,9
E33035959,833,357,85,272,13,184,142,42,271,262,0,7,2,8
E33035960,292,97,29,68,5,142,116,26,45,42,0,2,1,3
E33035961,535,263,75,188,3,156,73,83,108,101,0,5,2,5
E33035962,232,76,12,64,10,100,44,56,45,44,0,1,0,1
E33035963,365,127,26,101,5,169,124,45,64,59,0,4,1,0
E33035964,344,91,20,71,4,154,97,57,90,85,0,4,1,5
E33035965,425,151,32,119,9,175,119,56,88,84,0,2,2,2
E33035966,372,100,27,73,12,141,88,53,112,102,2,7,1,7
E33035967,767,263,74,189,9,316,200,116,175,160,1,6,8,4
E33035968,463,186,38,148,7,141,75,66,128,125,0,1,2,1
E33035969,496,161,41,120,7,182,125,57,143,134,0,9,0,3
E33035970,535,164,38,126,12,270,169,101,85,75,0,4,6,4
E33035971,402,99,28,71,10,168,91,77,121,115,0,5,1,4
E33035972,271,85,23,62,3,94,80,14,87,85,0,2,0,2
E33035973,398,109,32,77,7,166,133,33,111,100,1,7,3,5
E33035974,356,165,40,125,8,87,58,29,94,94,0,0,0,2
E33035975,502,271,65,206,7,108,65,43,113,106,0,6,1,3
E33035976,435,155,38,117,8,152,77,75,115,105,1,7,2,5
E33035977,265,76,20,56,7,95,60,35,82,80,0,2,0,5
E33035978,409,124,29,95,5,199,155,44,80,73,1,5,1,1
E33035979,468,139,40,99,4,244,224,20,78,75,0,1,2,3
E33035980,382,99,21,78,2,174,131,43,100,97,0,2,1,7
E33035981,517,140,39,101,5,214,134,80,152,147,0,5,0,6
E33035982,522,175,37,138,10,260,217,43,74,71,0,2,1,3
E33035983,238,115,22,93,10,87,68,19,26,25,0,0,1,0
E33035984,371,115,27,88,4,155,108,47,90,89,0,1,0,7
E33035985,550,221,61,160,7,182,145,37,132,127,1,3,1,8
E33035986,488,248,66,182,2,128,73,55,102,99,0,2,1,8
E33035987,270,81,18,63,8,111,70,41,68,63,0,5,0,2
E33035988,461,166,43,123,6,175,155,20,112,111,0,1,0,2
E33035989,313,74,18,56,3,157,127,30,77,72,0,4,1,2
E33035990,399,97,16,81,9,216,168,48,71,66,1,2,2,6
E33035991,573,266,65,201,9,191,110,81,104,102,0,1,1,3
E33035992,477,204,67,137,2,191,131,60,78,70,0,6,2,2
E33035993,290,104,21,83,6,124,77,47,53,47,0,4,2,3
E33035994,719,248,60,188,8,280,210,70,172,168,0,4,0,11
E33035995,464,176,30,146,18,140,86,54,126,120,0,3,3,4
E33035996,515,146,28,118,13,254,178,76,96,87,0,4,5,6
E33035997,637,209,54,155,18,315,229,86,90,85,0,3,2,5
E33035998,587,265,46,219,6,204,121,83,106,97,2,6,1,6
E33035999,493,270,46,224,8,102,66,36,108,104,0,4,0,5
E33036000,349,119,33,86,8,115,89,26,104,98,0,6,0,3
E33036001,488,156,46,110,3,219,150,69,101,96,0,4,1,9
E33036002,385,156,31,125,2,116,84,32,101,96,0,4,1,10
E33036003,489,173,31,142,10,185,132,53,118,111,0,6,1,3
E33036004,508,187,43,144,6,158,79,79,152,144,2,3,3,5
E33036005,566,189,44,145,6,228,150,78,137,134,0,3,0,6
E33036006,1082,383,76,307,18,467,265,202,209,194,1,10,4,5
E33036007,304,123,29,94,7,97,51,46,71,62,2,5,2,6
E33036008,297,81,13,68,18,153,117,36,40,36,0,3,1,5
E33036009,496,192,57,135,4,159,101,58,128,123,0,5,0,13
E33036010,273,52,13,39,1,130,93,37,86,85,1,0,0,4
E33036011,463,209,50,159,13,140,84,56,99,90,0,7,2,2
E33036012,649,230,48,182,10,252,181,71,155,151,1,3,0,2
E33036013,447,161,30,131,12,166,123,43,99,98,0,1,0,9
E33036014,308,135,35,100,1,85,42,43,86,81,1,4,0,1
E33036015,354,140,25,115,4,124,97,27,79,77,0,2,0,7
E33036016,346,149,40,109,6,86,47,39,103,101,0,2,0,2
E33036017,497,160,31,129,15,148,92,56,168,162,0,5,1,6
E33036018,349,135,30,105,6,106,87,19,100,94,3,2,1,2
E33036019,719,375,88,287,8,142,78,64,185,171,2,7,5,9
E33036020,351,154,45,109,3,98,69,29,93,88,0,4,1,3
E33036021,344,185,54,131,3,56,41,15,95,91,0,4,0,5
E33036022,326,161,36,125,4,55,34,21,103,100,0,2,1,3
E33036023,369,136,33,103,5,118,71,47,105,91,0,13,1,5
E33036024,317,149,36,113,1,65,26,39,92,81,1,4,6,10
E33036025,485,208,55,153,9,130,84,46,136,128,0,6,2,2
E33036026,415,206,43,163,14,105,70,35,86,77,0,8,1,4
E33036027,517,269,79,190,9,116,55,61,118,96,0,11,11,5
E33036028,270,119,27,92,1,74,43,31,71,67,0,4,0,5
E33036029,330,166,55,111,2,84,42,42,73,64,0,3,6,5
E33036030,285,106,19,87,4,80,53,27,91,87,0,4,0,4
E33036031,405,160,37,123,13,143,67,76,86,84,0,2,0,3
E33036032,334,135,42,93,10,111,67,44,73,70,0,3,0,5
E33036033,494,218,52,166,18,187,137,50,67,63,0,4,0,4
E33036034,365,154,40,114,5,113,68,45,86,81,1,2,2,7
E33036035,321,70,19,51,6,181,144,37,59,55,0,4,0,5
E33036036,479,182,43,139,4,189,121,68,101,95,0,5,1,3
E33036037,282,143,42,101,1,34,27,7,64,58,2,3,1,40
E33036038,464,209,60,149,7,157,118,39,90,81,0,6,3,1
E33036039,320,149,43,106,3,30,13,17,135,129,1,5,0,3
E33036040,293,166,43,123,0,57,24,33,66,59,0,7,0,4
E33036041,454,231,44,187,4,71,25,46,139,135,0,4,0,9
E33036042,241,136,38,98,6,36,20,16,61,59,0,2,0,2
E33036043,391,165,53,112,5,125,61,64,90,81,0,9,0,6
E33036044,418,231,59,172,5,84,40,44,94,88,0,4,2,4
E33036045,300,161,38,123,4,55,36,19,72,69,0,1,2,8
E33036046,395,195,42,153,9,90,61,29,97,90,0,6,1,4
E33036047,387,231,71,160,2,76,58,18,78,75,0,3,0,0
E33036048,369,214,51,163,3,68,40,28,79,75,0,3,1,5
E33036049,355,179,39,140,6,88,51,37,79,76,0,3,0,3
E33036050,739,369,78,291,13,130,77,53,221,207,3,9,2,6
E33036051,273,171,43,128,1,37,31,6,60,57,1,1,1,4
E33036052,292,162,42,120,0,48,21,27,76,72,0,3,1,6
E33036053,441,311,99,212,3,53,36,17,71,55,10,2,4,3
E33036054,375,208,65,143,6,89,58,31,68,65,0,1,2,4
E33036055,315,191,63,128,0,43,39,4,81,76,2,2,1,0
E33036056,311,220,84,136,1,29,16,13,59,55,0,3,1,2
E33036057,258,160,56,104,3,20,9,11,74,74,0,0,0,1
E33036058,361,212,68,144,3,49,25,24,94,91,1,2,0,3
E33036059,459,278,97,181,3,55,28,27,118,117,1,0,0,5
E33036060,271,182,69,113,5,37,24,13,43,42,1,0,0,4
E33036061,685,444,155,289,4,118,80,38,110,98,3,6,3,9
E33036062,543,316,82,234,5,81,42,39,135,124,1,10,0,6
E33036063,432,229,43,186,3,113,33,80,85,79,0,4,2,2
E33036064,370,194,55,139,2,63,41,22,104,99,0,4,1,7
E33036065,310,179,47,132,6,49,32,17,69,62,5,2,0,7
E33036066,664,353,119,234,8,148,102,46,149,127,14,6,2,6
E33036067,248,151,59,92,5,33,22,11,56,53,0,3,0,3
E33036068,370,206,55,151,4,79,63,16,70,66,0,4,0,11
E33036069,449,261,88,173,6,67,40,27,112,108,0,4,0,3
E33036070,358,209,60,149,3,62,34,28,81,79,0,2,0,3
E33036071,944,553,126,427,9,259,191,68,110,102,0,6,2,13
E33036072,405,275,57,218,3,78,59,19,49,41,0,6,2,0
E33036073,597,318,67,251,17,105,63,42,154,148,0,5,1,3
E33036074,3817,2551,714,1837,64,594,371,223,591,569,4,15,3,17
E33036075,370,295,80,215,2,23,12,11,48,42,0,6,0,2
E33036076,448,357,94,263,5,24,11,13,62,56,0,6,0,0
E33036077,682,508,139,369,3,62,37,25,107,97,0,9,1,2
E33036078,1006,711,194,517,6,136,80,56,150,147,0,3,0,3
E33036079,362,273,76,197,5,7,3,4,74,66,2,6,0,3
E33036080,639,505,145,360,5,60,40,20,69,66,0,3,0,0
E33036081,536,323,70,253,8,72,54,18,129,113,1,9,6,4
E33036082,560,397,96,301,2,55,29,26,103,91,2,5,5,3
E33036083,329,235,51,184,6,43,24,19,44,42,0,2,0,1
E33036084,546,352,72,280,7,107,64,43,80,74,0,5,1,0
E33036085,351,264,50,214,3,41,31,10,39,36,0,3,0,4
E33036086,446,343,86,257,2,36,22,14,64,61,1,2,0,1
E33036087,448,384,113,271,2,23,12,11,35,31,0,4,0,4
E33036088,474,364,81,283,4,34,27,7,69,66,0,3,0,3
E33036089,294,168,38,130,4,30,7,23,90,85,0,4,1,2
E33036090,511,358,103,255,3,42,24,18,102,90,2,3,7,6
E33036091,438,314,104,210,4,36,25,11,83,77,0,6,0,1
E33036092,470,360,83,277,3,41,22,19,66,61,0,5,0,0
E33036093,342,256,70,186,0,19,14,5,64,57,0,6,1,3
E33036094,358,250,63,187,1,40,23,17,65,61,1,2,1,2
E33036095,369,266,65,201,6,17,9,8,77,63,9,5,0,3
E33036096,724,568,198,370,3,38,23,15,111,109,0,2,0,4
E33036097,502,391,108,283,7,26,14,12,71,68,1,1,1,7
E33036098,529,444,140,304,4,34,17,17,45,45,0,0,0,2
E33036099,378,340,103,237,0,8,2,6,26,26,0,0,0,4
E33036100,455,337,86,251,5,34,14,20,77,75,0,2,0,2
E33036101,538,453,117,336,3,17,10,7,62,56,0,4,2,3
E33036102,329,260,78,182,0,25,12,13,43,43,0,0,0,1
E33036103,387,334,113,221,1,9,4,5,41,35,1,5,0,2
E33036104,417,358,79,279,4,20,11,9,31,26,0,5,0,4
E33036105,305,229,56,173,7,25,18,7,43,38,3,2,0,1
E33036106,403,294,86,208,1,51,35,16,55,49,0,6,0,2
E33036107,456,309,85,224,4,58,30,28,84,79,0,3,2,1
E33036108,425,314,76,238,6,42,21,21,61,57,0,4,0,2
E33036109,370,315,72,243,0,19,9,10,36,29,3,4,0,0
E33036110,390,330,87,243,0,21,12,9,38,36,1,0,1,1
E33036111,435,322,112,210,1,33,16,17,77,67,3,7,0,2
E33036112,246,175,40,135,4,22,7,15,44,42,0,2,0,1
E33036113,348,246,63,183,5,44,19,25,51,47,1,3,0,2
E33036114,415,294,85,209,5,47,27,20,63,61,1,1,0,6
E33036115,545,382,120,262,5,66,38,28,92,82,0,8,2,0
E33036116,343,231,53,178,0,29,12,17,82,79,0,1,2,1
E33036117,736,491,133,358,10,90,47,43,133,124,0,9,0,12
E33036118,595,368,101,267,8,95,46,49,118,107,0,11,0,6
E33036119,302,167,41,126,3,69,48,21,60,55,1,3,1,3
E33036120,577,379,94,285,2,92,69,23,98,94,0,2,2,6
E33036121,462,368,94,274,5,20,10,10,69,65,0,3,1,0
E33036122,365,285,63,222,1,35,28,7,41,34,0,5,2,3
E33036123,647,362,76,286,6,92,48,44,185,181,0,3,1,2
E33036124,473,340,94,246,5,38,23,15,88,82,0,6,0,2
E33036125,531,361,115,246,4,106,72,34,56,56,0,0,0,4
E33036126,476,352,88,264,1,25,12,13,97,92,1,3,1,1
E33036127,403,316,78,238,3,16,11,5,67,62,0,5,0,1
E33036128,284,227,44,183,1,23,11,12,33,30,0,3,0,0
E33036129,296,203,47,156,0,38,17,21,54,48,1,5,0,1
E33036130,299,223,80,143,0,12,5,7,62,60,0,2,0,2
E33036131,331,210,51,159,1,47,26,21,66,63,2,1,0,7
E33036132,391,303,66,237,2,19,9,10,66,64,1,1,0,1
E33036133,558,423,133,290,3,56,35,21,71,65,0,5,1,5
E33036134,407,318,96,222,3,24,8,16,60,56,2,2,0,2
E33036135,374,320,95,225,2,13,10,3,38,38,0,0,0,1
E33036136,405,310,85,225,6,23,15,8,63,61,1,1,0,3
E33036137,449,376,87,289,2,24,11,13,45,44,0,1,0,2
E33036138,526,388,104,284,5,40,22,18,89,82,2,5,0,4
E33036139,350,268,84,184,5,19,11,8,55,52,2,1,0,3
E33036140,240,171,52,119,4,23,13,10,40,37,0,3,0,2
E33036141,462,326,89,237,4,61,28,33,67,61,1,5,0,4
E33036142,714,532,153,379,5,87,42,45,88,81,1,5,1,2
E33036143,412,259,73,186,7,52,27,25,92,86,0,5,1,2
E33036144,796,504,126,378,9,88,39,49,191,180,0,11,0,4
E33036145,378,299,86,213,3,26,12,14,47,47,0,0,0,3
E33036146,243,146,42,104,0,29,19,10,65,58,6,1,0,3
E33036147,441,283,84,199,5,39,22,17,114,103,3,6,2,0
E33036148,291,176,46,130,2,21,13,8,92,90,1,0,1,0
E33036149,273,173,43,130,3,13,8,5,78,74,1,3,0,6
E33036150,244,159,38,121,1,30,19,11,54,50,3,0,1,0
E33036151,318,175,41,134,1,49,26,23,93,89,0,4,0,0
E33036152,363,234,79,155,3,29,15,14,91,88,0,3,0,6
E33036153,325,240,80,160,7,19,9,10,58,55,0,2,1,1
E33036154,362,140,33,107,6,165,40,125,50,42,1,7,0,1
E33036155,510,380,105,275,9,65,25,40,54,51,0,3,0,2
E33036156,309,198,52,146,1,55,17,38,54,51,0,3,0,1
E33036157,299,151,34,117,10,115,32,83,21,20,0,1,0,2
E33036158,526,410,118,292,0,61,35,26,53,51,0,2,0,2
E33036159,412,298,88,210,3,39,16,23,67,63,3,1,0,5
E33036160,321,255,78,177,3,19,12,7,41,38,0,2,1,3
E33036161,322,250,71,179,2,27,2,25,40,38,0,2,0,3
E33036162,436,286,90,196,9,74,39,35,65,60,2,2,1,2
E33036163,283,174,52,122,0,24,11,13,80,78,0,1,1,5
E33036164,404,205,43,162,1,69,31,38,123,116,0,5,2,6
E33036165,419,210,56,154,2,44,23,21,161,151,0,10,0,2
E33036166,316,279,96,183,0,12,10,2,23,22,0,1,0,2
E33036167,344,260,82,178,2,23,14,9,59,57,0,2,0,0
E33036168,438,340,117,223,1,36,25,11,50,47,1,2,0,11
E33036169,2097,1578,419,1159,18,128,61,67,353,341,3,9,0,20
E33036170,334,271,89,182,3,22,9,13,36,32,4,0,0,2
E33036171,527,374,103,271,6,81,61,20,64,45,8,5,6,2
E33036172,386,318,94,224,1,19,10,9,43,32,6,5,0,5
E33036173,360,299,92,207,2,12,4,8,45,41,1,3,0,2
E33036174,282,108,32,76,6,112,48,64,54,52,0,2,0,2
E33036175,272,124,27,97,8,73,27,46,63,58,0,4,1,4
E33036176,309,99,34,65,2,147,41,106,56,54,0,1,1,5
E33036177,274,90,31,59,5,115,49,66,62,61,0,1,0,2
E33036178,484,190,41,149,8,159,84,75,123,116,0,5,2,4
E33036179,456,251,69,182,8,72,30,42,120,113,0,4,3,5
E33036180,327,118,34,84,9,93,43,50,105,101,2,2,0,2
E33036181,348,111,21,90,7,106,64,42,120,112,1,5,2,4
E33036182,293,106,25,81,11,92,32,60,81,76,0,4,1,3
E33036183,408,208,46,162,9,89,65,24,99,94,1,3,1,3
E33036184,363,150,50,100,8,121,56,65,79,78,0,0,1,5
E33036185,755,343,80,263,15,226,94,132,162,148,1,10,3,9
E33036186,399,203,62,141,6,76,33,43,112,109,0,3,0,2
E33036187,269,125,38,87,1,83,41,42,57,56,0,1,0,3
E33036188,368,141,39,102,9,107,25,82,103,97,0,6,0,8
E33036189,431,200,69,131,9,96,38,58,118,110,2,6,0,8
E33036190,366,156,45,111,8,68,29,39,132,123,0,9,0,2
E33036191,275,119,26,93,7,66,22,44,83,82,0,1,0,0
E33036192,369,155,42,113,12,74,22,52,122,112,0,9,1,6
E33036193,531,258,57,201,17,127,48,79,125,124,0,0,1,4
E33036194,771,356,82,274,16,208,92,116,183,178,0,4,1,8
E33036195,289,121,42,79,4,77,24,53,86,81,0,4,1,1
E33036196,301,122,27,95,5,64,20,44,109,105,0,4,0,1
E33036197,447,234,45,189,3,104,57,47,103,100,0,2,1,3
E33036198,398,230,64,166,9,88,41,47,71,70,0,1,0,0
E33036199,660,322,78,244,10,152,76,76,172,157,1,13,1,4
E33036200,353,161,65,96,7,122,66,56,57,54,0,3,0,6
E33036201,419,141,42,99,4,85,38,47,185,176,5,2,2,4
E33036202,410,184,49,135,15,90,50,40,116,109,0,7,0,5
E33036203,513,180,51,129,12,84,56,28,231,213,1,17,0,6
E33036204,417,182,53,129,5,109,60,49,118,112,0,3,3,3
E33036205,604,276,83,193,5,141,54,87,180,156,3,12,9,2
E33036206,293,114,39,75,4,96,71,25,77,76,0,1,0,2
E33036207,419,211,44,167,9,102,45,57,94,89,0,4,1,3
E33036208,355,123,34,89,7,107,64,43,114,104,4,5,1,4
E33036209,498,212,44,168,9,170,77,93,99,92,1,4,2,8
E33036210,439,195,65,130,13,111,59,52,113,100,0,12,1,7
E33036211,450,150,35,115,8,192,56,136,93,88,2,2,1,7
E33036212,596,268,54,214,12,171,88,83,137,133,0,3,1,8
E33036213,660,295,63,232,5,147,68,79,206,191,4,8,3,7
E33036214,587,217,45,172,10,245,85,160,103,93,0,10,0,12
E33036215,363,126,28,98,3,112,88,24,111,105,0,2,4,11
E33036216,334,123,43,80,8,97,49,48,105,98,0,4,3,1
E33036217,431,204,59,145,6,122,72,50,98,91,0,6,1,1
E33036218,675,250,81,169,6,103,43,60,310,291,0,18,1,6
E33036219,454,172,51,121,3,90,42,48,185,177,0,5,3,4
E33036220,383,154,56,98,2,88,52,36,134,130,0,3,1,5
E33036221,544,214,64,150,8,162,108,54,159,149,0,7,3,1
E33036222,3037,1662,517,1145,49,386,185,201,918,842,6,35,35,22
E33036223,345,145,43,102,1,98,65,33,92,89,0,2,1,9
E33036224,242,109,44,65,6,70,40,30,57,56,0,1,0,0
E33036225,318,121,21,100,3,130,60,70,62,58,0,4,0,2
E33036226,293,106,40,66,4,96,76,20,84,81,0,0,3,3
E33036227,445,171,55,116,6,170,82,88,94,89,0,2,3,4
E33036228,551,292,67,225,9,122,58,64,126,117,1,7,1,2
E33036229,855,495,73,422,25,177,60,117,151,139,0,10,2,7
E33036230,303,130,39,91,2,109,56,53,59,58,0,1,0,3
E33036231,437,192,44,148,5,119,47,72,112,106,0,6,0,9
E33036232,394,180,33,147,9,121,55,66,81,76,0,3,2,3
E33036233,422,190,44,146,5,136,64,72,88,82,0,6,0,3
E33036234,401,167,39,128,14,138,67,71,80,77,0,3,0,2
E33036235,272,104,27,77,3,61,32,29,103,96,0,7,0,1
E33036236,276,135,42,93,3,87,35,52,49,44,0,2,3,2
E33036237,388,122,31,91,5,154,88,66,105,98,0,7,0,2
E33036238,264,99,28,71,3,79,47,32,78,78,0,0,0,5
E33036239,565,296,83,213,7,118,53,65,135,127,2,5,1,9
E33036240,427,144,27,117,3,122,80,42,152,147,1,3,1,6
E33036241,379,164,49,115,6,76,38,38,130,123,0,7,0,3
E33036242,265,105,27,78,4,72,36,36,77,72,0,5,0,7
E33036243,330,133,23,110,4,131,60,71,60,58,0,1,1,2
E33036244,312,121,37,84,2,83,27,56,105,101,0,3,1,1
E33036245,427,235,73,162,7,80,22,58,104,100,0,4,0,1
E33036246,372,122,26,96,11,169,54,115,66,62,0,3,1,4
E33036247,765,327,72,255,11,165,86,79,255,242,0,9,4,7
E33036248,377,143,25,118,6,129,71,58,93,85,0,7,1,6
E33036249,285,120,23,97,7,20,8,12,137,132,0,4,1,1
E33036250,380,179,48,131,6,94,47,47,98,91,0,5,2,3
E33036251,347,126,33,93,4,150,75,75,64,62,0,2,0,3
E33036252,350,120,26,94,12,124,55,69,91,87,1,3,0,3
E33036253,396,158,50,108,3,125,66,59,106,93,2,2,9,4
E33036254,606,256,76,180,7,181,86,95,148,134,1,9,4,14
E33036255,256,128,43,85,1,81,41,40,44,42,0,1,1,2
E33036256,753,330,70,260,13,213,125,88,191,179,1,5,6,6
E33036257,485,213,45,168,12,116,62,54,141,132,2,6,1,3
E33036258,568,260,65,195,11,142,68,74,151,147,1,2,1,4
E33036259,576,320,68,252,17,113,54,59,116,114,0,2,0,10
E33036260,383,189,47,142,6,93,39,54,92,82,0,10,0,3
E33036261,549,221,61,160,12,183,77,106,130,121,1,7,1,3
E33036262,258,89,21,68,8,88,25,63,72,66,1,2,3,1
E33036263,358,166,45,121,3,124,47,77,64,60,0,2,2,1
E33036264,475,185,48,137,9,195,107,88,84,78,0,5,1,2
E33036265,291,102,31,71,12,130,51,79,45,37,0,2,6,2
E33036266,463,192,59,133,18,171,61,110,80,74,0,4,2,2
E33036267,422,127,25,102,30,181,68,113,81,80,0,1,0,3
E33036268,268,121,38,83,2,78,32,46,63,60,0,2,1,4
E33036269,300,111,24,87,9,111,55,56,64,57,2,3,2,5
E33036270,543,173,38,135,20,228,87,141,117,113,1,1,2,5
E33036271,283,107,25,82,2,111,34,77,63,59,0,2,2,0
E33036272,591,235,48,187,10,213,92,121,133,130,0,2,1,0
E33036273,402,154,49,105,7,91,34,57,146,134,6,5,1,4
E33036274,401,208,57,151,11,82,30,52,99,97,0,1,1,1
E33036275,333,143,41,102,5,90,49,41,91,86,0,3,2,4
E33036276,606,371,112,259,19,56,34,22,153,143,1,8,1,7
E33036277,271,106,28,78,2,72,33,39,90,84,0,3,3,1
E33036278,366,164,50,114,1,110,51,59,90,84,2,1,3,1
E33036279,324,157,45,112,3,65,28,37,96,93,0,3,0,3
E33036280,266,106,33,73,11,104,41,63,40,37,0,2,1,5
E33036281,683,285,73,212,18,197,100,97,180,169,1,8,2,3
E33036282,325,112,23,89,10,121,42,79,77,73,0,1,3,5
E33036283,750,312,80,232,19,215,79,136,200,189,0,7,4,4
E33036284,285,134,39,95,4,64,43,21,80,71,2,4,3,3
E33036285,490,201,66,135,4,120,69,51,163,156,1,6,0,2
E33036286,250,107,34,73,6,76,42,34,54,50,1,3,0,7
E33036287,367,193,68,125,6,36,17,19,125,114,1,10,0,7
E33036288,237,96,27,69,3,87,55,32,51,50,0,1,0,0
E33036289,351,96,24,72,16,104,42,62,134,128,1,5,0,1
E33036290,293,131,36,95,4,102,55,47,54,49,0,2,3,2
E33036291,356,134,32,102,4,114,64,50,98,94,0,4,0,6
E33036292,738,409,75,334,14,146,76,70,159,147,1,11,0,10
E33036293,365,144,54,90,3,55,31,24,160,155,0,3,2,3
E33036294,437,158,33,125,8,166,95,71,94,88,0,5,1,11
E33036295,379,174,50,124,12,99,34,65,86,84,0,1,1,8
E33036296,1338,782,185,597,18,80,56,24,449,433,0,15,1,9
E33036297,445,232,53,179,8,93,63,30,106,100,0,6,0,6
E33036298,420,166,41,125,3,121,51,70,126,118,1,6,1,4
E33036299,398,183,55,128,12,61,35,26,140,134,1,4,1,2
E33036300,416,238,74,164,4,53,22,31,113,108,3,1,1,8
E33036301,361,198,52,146,10,62,40,22,78,72,1,4,1,13
E33036302,269,157,43,114,1,36,21,15,74,71,0,1,2,1
E33036303,365,196,60,136,0,52,25,27,111,109,0,2,0,6
E33036304,737,361,103,258,12,61,20,41,297,288,1,8,0,6
E33036305,1285,683,156,527,15,199,114,85,374,353,3,16,2,14
E33036306,474,201,42,159,15,98,46,52,155,146,0,7,2,5
E33036307,460,250,53,197,7,106,50,56,97,96,0,1,0,0
E33036308,578,219,50,169,6,211,83,128,136,131,0,3,2,6
E33036309,357,206,31,175,9,71,39,32,68,63,0,2,3,3
E33036310,394,108,24,84,10,78,29,49,194,191,0,3,0,4
E33036311,824,439,87,352,25,136,61,75,218,210,1,3,4,6
E33036312,395,190,38,152,10,83,55,28,108,101,0,5,2,4
E33036313,902,528,110,418,12,101,50,51,258,244,1,12,1,3
E33036314,256,114,23,91,8,80,26,54,52,50,0,2,0,2
E33036315,447,149,42,107,3,152,46,106,142,133,2,2,5,1
E33036316,513,247,58,189,12,122,35,87,127,124,1,1,1,5
E33036317,348,114,35,79,4,114,32,82,111,106,0,3,2,5
E33036318,428,191,43,148,3,25,6,19,198,189,0,7,2,11
E33036319,335,123,36,87,8,56,17,39,146,141,1,3,1,2
E33036320,303,123,31,92,5,36,13,23,133,123,0,4,6,6
E33036321,386,282,77,205,5,52,33,19,44,40,0,2,2,3
E33036322,379,261,67,194,3,40,22,18,75,71,4,0,0,0
E33036323,352,280,65,215,3,35,24,11,31,28,2,0,1,3
E33036324,672,490,148,342,6,88,53,35,85,78,5,2,0,3
E33036325,441,316,115,201,4,42,19,23,72,62,6,3,1,7
E33036326,267,201,54,147,2,28,19,9,31,30,0,1,0,5
E33036327,612,435,137,298,2,65,35,30,105,100,0,3,2,5
E33036328,549,378,120,258,6,66,34,32,92,87,2,3,0,7
E33036329,343,282,63,219,0,24,8,16,32,31,0,1,0,5
E33036330,528,407,130,277,6,49,27,22,65,62,1,2,0,1
E33036331,801,518,161,357,16,142,94,48,120,112,1,6,1,5
E33036332,888,623,174,449,5,137,103,34,119,113,1,4,1,4
E33036333,419,296,77,219,5,52,28,24,58,55,0,3,0,8
E33036334,364,272,83,189,5,47,17,30,40,40,0,0,0,0
E33036335,366,266,87,179,7,49,21,28,42,40,0,2,0,2
E33036336,291,209,57,152,1,35,27,8,45,43,0,2,0,1
E33036337,345,206,52,154,4,51,32,19,84,77,0,5,2,0
E33036338,706,421,134,287,5,118,55,63,155,146,1,4,4,7
E33036339,489,381,100,281,3,36,18,18,69,66,1,2,0,0
E33036340,433,322,87,235,3,41,22,19,61,55,0,6,0,6
E33036341,385,308,92,216,1,24,12,12,51,44,3,4,0,1
E33036342,354,266,71,195,1,26,13,13,56,52,1,2,1,5
E33036343,704,418,106,312,5,115,60,55,161,148,4,8,1,5
E33036344,763,417,122,295,15,154,72,82,166,155,0,11,0,11
E33036345,410,290,89,201,3,77,25,52,39,36,0,3,0,1
E33036346,390,294,103,191,3,34,21,13,57,54,1,1,1,2
E33036347,859,632,222,410,11,80,59,21,133,125,3,4,1,3
E33036348,357,266,55,211,3,38,30,8,47,43,0,4,0,3
E33036349,306,244,76,168,2,20,18,2,37,36,0,1,0,3
E33036350,402,289,78,211,1,47,27,20,64,63,0,1,0,1
E33036351,431,279,52,227,4,50,28,22,96,89,0,7,0,2
E33036352,570,343,73,270,9,97,66,31,114,107,1,4,2,7
E33036353,510,348,100,248,9,36,15,21,109,107,0,1,1,8
E33036354,259,142,43,99,4,36,25,11,75,74,0,1,0,2
E33036355,402,205,45,160,3,47,30,17,140,133,0,6,1,7
E33036356,581,342,94,248,7,113,71,42,118,110,0,4,4,1
E33036357,453,263,67,196,7,62,47,15,117,112,0,3,2,4
E33036358,381,184,37,147,1,111,61,50,82,79,0,2,1,3
E33036359,353,235,56,179,4,27,11,16,85,79,2,3,1,2
E33036360,421,250,68,182,12,46,26,20,110,108,0,2,0,3
E33036361,785,440,118,322,7,123,69,54,208,197,0,9,2,7
E33036362,521,318,84,234,6,49,25,24,143,133,0,9,1,5
E33036363,390,193,45,148,2,57,18,39,137,132,0,3,2,1
E33036364,422,172,47,125,4,53,31,22,187,182,0,4,1,6
E33036365,463,244,74,170,12,61,27,34,142,134,3,5,0,4
E33036366,442,255,71,184,6,57,30,27,123,118,0,2,3,1
E33036367,423,261,64,197,4,47,22,25,108,105,0,1,2,3
E33036368,289,110,34,76,6,73,30,43,97,94,0,3,0,3
E33036369,306,129,34,95,3,86,39,47,86,85,0,0,1,2
E33036370,466,258,78,180,3,34,18,16,167,160,0,7,0,4
E33036371,630,290,91,199,11,74,44,30,252,246,0,5,1,3
E33036372,561,298,81,217,10,59,26,33,192,181,1,8,2,2
E33036373,215,105,35,70,3,37,23,14,70,63,4,2,1,0
E33036374,434,282,84,198,7,54,30,24,86,81,0,3,2,5
E33036375,485,271,77,194,5,77,50,27,127,123,0,1,3,5
E33036376,426,216,58,158,5,73,49,24,130,120,0,7,3,2
E33036377,574,292,74,218,5,110,76,34,162,151,2,7,2,5
E33036378,341,169,44,125,8,92,76,16,63,58,0,3,2,9
E33036379,301,141,29,112,4,70,52,18,84,79,1,3,1,2
E33036380,779,368,92,276,13,109,69,40,283,274,0,7,2,6
E33036381,349,153,34,119,10,29,16,13,155,153,0,0,2,2
E33036382,474,267,72,195,7,61,39,22,137,131,0,6,0,2
E33036383,437,167,40,127,5,46,20,26,209,200,0,7,2,10
E33036384,504,205,46,159,7,58,34,24,230,222,0,6,2,4
E33036385,336,146,32,114,2,60,38,22,123,121,0,0,2,5
E33036386,463,296,108,188,7,67,33,34,87,82,1,1,3,6
E33036387,321,155,47,108,7,39,23,16,115,111,0,3,1,5
E33036388,405,213,64,149,3,77,60,17,111,106,0,4,1,1
E33036389,512,311,102,209,5,62,31,31,129,106,17,6,0,5
E33036390,467,229,65,164,8,79,45,34,147,140,1,4,2,4
E33036391,720,442,114,328,11,83,44,39,175,168,1,4,2,9
E33036392,464,229,64,165,3,55,28,27,177,174,0,1,2,0
E33036393,503,243,81,162,4,25,13,12,230,221,0,6,3,1
E33036394,299,147,47,100,7,33,15,18,107,98,2,5,2,5
E33036395,304,180,44,136,4,36,14,22,83,79,3,1,0,1
E33036396,669,296,81,215,3,71,31,40,292,282,0,8,2,7
E33036397,480,208,55,153,8,80,41,39,179,171,1,7,0,5
E33036398,400,181,46,135,5,82,43,39,132,129,0,3,0,0
E33036399,452,230,58,172,10,64,29,35,141,135,5,1,0,7
E33036400,519,268,79,189,8,67,31,36,173,163,2,7,1,3
E33036401,451,219,60,159,4,61,39,22,165,162,2,1,0,2
E33036402,760,322,105,217,4,165,98,67,266,255,2,7,2,3
E33036403,358,176,53,123,1,29,17,12,149,145,0,3,1,3
E33036404,588,273,78,195,17,100,46,54,192,182,1,8,1,6
E33036405,439,288,90,198,1,24,12,12,125,118,0,6,1,1
E33036406,398,197,65,132,1,89,42,47,108,98,1,8,1,3
E33036407,702,381,159,222,9,79,31,48,227,216,1,8,2,6
E33036408,480,199,55,144,3,53,25,28,220,216,0,0,4,5
E33036409,4104,2410,628,1782,74,569,297,272,1026,965,8,42,11,25
E33036410,423,233,64,169,3,64,29,35,118,114,0,3,1,5
E33036411,376,148,56,92,3,54,24,30,166,153,1,6,6,5
E33036412,380,188,53,135,4,77,36,41,110,104,0,3,3,1
E33036413,413,164,49,115,6,125,48,77,111,104,1,4,2,7
E33036414,797,350,121,229,5,84,45,39,352,340,0,12,0,6
E33036415,696,313,101,212,10,69,35,34,299,290,2,6,1,5
E33036416,447,193,60,133,2,65,22,43,186,184,0,0,2,1
E33036417,350,168,54,114,3,44,17,27,132,128,0,4,0,3
E33036418,716,340,105,235,14,121,58,63,229,215,1,9,4,12
E33036419,629,339,118,221,6,65,21,44,210,206,2,2,0,9
E33036420,418,190,31,159,4,49,24,25,175,171,0,2,2,0
E33036421,411,197,50,147,6,66,32,34,139,130,5,4,0,3
E33036422,355,171,46,125,1,36,23,13,145,137,0,5,3,2
E33036423,451,219,65,154,3,61,26,35,163,157,0,6,0,5
E33036424,515,238,67,171,1,69,35,34,206,196,0,2,8,1
E33036425,504,265,95,170,8,91,54,37,134,129,3,2,0,6
E33036426,383,144,42,102,2,29,13,16,206,197,1,5,3,2
E33036427,461,253,59,194,8,49,17,32,149,138,0,11,0,2
E33036428,421,159,64,95,3,56,26,30,200,192,0,7,1,3
E33036429,443,190,34,156,6,23,9,14,221,217,1,2,1,3
E33036430,343,196,58,138,1,40,18,22,103,99,0,4,0,3
E33036431,562,302,93,209,36,82,35,47,139,135,0,3,1,3
E33036432,403,205,62,143,5,52,18,34,140,132,0,7,1,1
E33036433,490,213,68,145,20,79,38,41,175,165,2,6,2,3
E33036434,339,146,45,101,2,63,43,20,125,121,0,4,0,3
E33036435,308,141,27,114,3,102,73,29,61,59,0,2,0,1
E33036436,967,537,131,406,16,141,83,58,267,249,2,15,1,6
E33036437,565,221,65,156,1,38,18,20,299,285,5,6,3,6
E33036438,407,172,58,114,3,44,13,31,184,179,0,2,3,4
E33036439,655,214,72,142,6,42,19,23,389,383,2,2,2,4
E33036440,411,172,55,117,3,75,19,56,157,149,2,3,3,4
E33036441,531,252,71,181,7,154,98,56,118,112,0,5,1,0
E33036442,476,189,56,133,7,59,30,29,219,210,1,8,0,2
E33036443,458,198,74,124,2,46,18,28,211,200,0,3,8,1
E33036444,442,185,58,127,9,75,18,57,169,162,4,3,0,4
E33036445,593,241,85,156,2,85,37,48,259,249,1,9,0,6
E33036446,391,166,37,129,2,101,44,57,121,116,1,4,0,1
E33036447,258,99,29,70,2,73,39,34,82,80,0,2,0,2
E33036448,691,214,67,147,5,146,47,99,323,313,3,5,2,3
E33036449,415,199,68,131,9,72,47,25,131,123,0,4,4,4
E33036450,503,201,48,153,1,69,36,33,227,217,0,8,2,5
E33036451,413,176,46,130,1,46,16,30,186,176,1,9,0,4
E33036452,641,301,91,210,8,86,45,41,241,227,2,11,1,5
E33036453,644,260,74,186,2,46,19,27,331,322,1,7,1,5
E33036454,278,158,70,88,2,31,24,7,81,77,0,2,2,6
E33036455,472,278,70,208,8,70,41,29,113,102,2,8,1,3
E33036456,280,140,64,76,1,17,11,6,116,110,0,4,2,6
E33036457,272,157,53,104,1,22,9,13,90,83,2,5,0,2
E33036458,382,213,72,141,5,33,15,18,125,117,0,8,0,6
E33036459,286,135,39,96,4,48,36,12,92,83,0,5,4,7
E33036460,1700,754,194,560,25,102,50,52,804,781,0,17,6,15
E33036461,267,103,34,69,7,62,44,18,90,81,0,8,1,5
E33036462,291,155,45,110,9,37,24,13,87,83,1,3,0,3
E33036463,680,295,83,212,12,181,118,63,192,182,0,7,3,0
E33036464,383,161,47,114,4,85,39,46,130,112,3,13,2,3
E33036465,752,350,100,250,11,98,63,35,284,264,1,14,5,9
E33036466,300,75,26,49,7,87,70,17,129,126,0,1,2,2
E33036467,240,116,35,81,17,12,9,3,95,91,1,2,1,0
E33036468,534,215,50,165,13,138,91,47,167,160,0,6,1,1
E33036469,501,191,77,114,9,143,111,32,149,142,1,6,0,9
E33036470,619,318,94,224,13,118,86,32,162,154,0,7,1,8
E33036471,498,182,58,124,7,185,134,51,121,118,0,2,1,3
E33036472,647,368,100,268,10,57,30,27,205,196,0,8,1,7
E33036473,380,208,80,128,2,50,24,26,117,111,1,5,0,3
E33036474,420,249,67,182,3,33,20,13,133,123,0,7,3,2
E33036475,335,132,34,98,6,44,23,21,145,135,5,4,1,8
E33036476,266,130,34,96,1,50,37,13,82,76,2,3,1,3
E33036477,470,245,71,174,9,29,17,12,185,168,2,13,2,2
E33036478,264,125,40,85,1,69,21,48,68,63,2,1,2,1
E33036479,334,136,37,99,4,62,41,21,126,113,3,6,4,6
E33036480,475,216,55,161,11,49,29,20,198,191,3,3,1,1
E33036481,309,119,43,76,7,96,68,28,84,76,1,5,2,3
E33036482,276,98,25,73,1,61,41,20,113,109,1,2,1,3
E33036483,619,317,97,220,4,98,50,48,198,191,2,5,0,2
E33036484,639,280,83,197,6,229,78,151,120,113,1,5,1,4
E33036485,255,101,33,68,3,53,7,46,95,91,0,4,0,3
E33036486,265,161,55,106,1,25,15,10,76,75,0,1,0,2
E33036487,324,206,90,116,3,30,23,7,80,78,1,1,0,5
E33036488,283,165,65,100,1,24,17,7,90,87,1,2,0,3
E33036489,347,230,88,142,1,30,15,15,84,81,3,0,0,2
E33036490,554,336,131,205,6,59,36,23,147,128,9,8,2,6
E33036491,262,135,57,78,1,25,18,7,99,91,1,6,1,2
E33036492,386,215,80,135,1,25,11,14,141,127,6,6,2,4
E33036493,341,126,32,94,1,135,117,18,73,66,0,3,4,6
E33036494,578,213,60,153,15,194,160,34,150,149,0,1,0,6
E33036495,317,120,32,88,5,34,20,14,155,148,1,5,1,3
E33036496,277,124,41,83,1,62,41,21,90,86,0,3,1,0
E33036497,309,164,41,123,3,48,27,21,91,85,1,5,0,3
E33036498,310,178,62,116,3,37,23,14,90,87,0,3,0,2
E33036499,457,177,35,142,6,131,90,41,138,131,2,3,2,5
E33036500,336,177,43,134,2,27,13,14,125,115,0,8,2,5
E33036501,278,128,43,85,4,41,17,24,103,99,2,2,0,2
E33036502,325,135,43,92,1,64,32,32,114,111,0,2,1,11
E33036503,408,242,85,157,2,37,15,22,123,114,0,6,3,4
E33036504,287,178,63,115,2,22,7,15,83,82,0,1,0,2
E33036505,304,177,64,113,11,32,16,16,79,74,0,5,0,5
E33036506,297,160,59,101,3,16,5,11,118,108,0,10,0,0
E33036507,466,264,75,189,17,32,12,20,149,139,1,7,2,4
E33036508,379,209,49,160,9,48,29,19,113,105,0,5,3,0
E33036509,943,425,108,317,10,214,129,85,290,275,2,13,0,4
E33036510,499,217,51,166,5,92,57,35,184,175,0,7,2,1
E33036511,300,147,51,96,3,49,29,20,99,84,5,8,2,2
E33036512,716,434,94,340,7,38,23,15,230,217,0,13,0,7
E33036513,452,283,92,191,5,39,18,21,124,121,0,3,0,1
E33036514,530,291,82,209,8,33,20,13,194,189,1,2,2,4
E33036515,249,145,59,86,5,42,29,13,56,48,4,3,1,1
E33036516,352,265,139,126,1,17,14,3,62,61,0,1,0,7
E33036517,384,228,84,144,11,61,33,28,81,79,0,1,1,3
E33036518,430,232,76,156,3,58,46,12,130,123,0,5,2,7
E33036519,342,162,57,105,6,40,27,13,132,125,0,4,3,2
E33036520,486,258,78,180,7,68,36,32,149,142,1,6,0,4
E33036521,261,138,40,98,3,43,19,24,76,67,3,5,1,1
E33036522,457,227,74,153,8,71,37,34,145,141,2,2,0,6
E33036523,409,196,59,137,9,81,36,45,119,112,1,6,0,4
E33036524,283,110,19,91,4,101,19,82,67,60,0,6,1,1
E33036525,371,184,56,128,16,53,14,39,115,110,1,4,0,3
E33036526,361,173,61,112,8,64,50,14,115,107,1,6,1,1
E33036527,476,189,67,122,9,120,99,21,146,139,3,2,2,12
E33036528,868,448,124,324,12,136,93,43,266,249,0,9,8,6
E33036529,294,132,50,82,3,56,32,24,102,100,1,1,0,1
E33036530,268,166,69,97,2,21,13,8,71,65,1,3,2,8
E33036531,288,169,77,92,2,18,11,7,94,92,0,2,0,5
E33036532,523,252,85,167,10,92,61,31,161,141,10,9,1,8
E33036533,417,204,61,143,5,53,32,21,149,134,0,11,4,6
E33036534,443,234,63,171,10,29,14,15,164,156,0,7,1,6
E33036535,335,191,63,128,4,39,18,21,100,95,0,5,0,1
E33036536,362,183,67,116,4,47,20,27,119,119,0,0,0,9
E33036537,381,206,81,125,5,41,21,20,126,119,3,3,1,3
E33036538,265,152,49,103,3,27,11,16,76,74,0,2,0,7
E33036539,292,182,79,103,3,23,8,15,79,74,2,1,2,5
E33036540,299,195,63,132,0,31,18,13,72,67,0,4,1,1
E33036541,433,194,66,128,3,91,58,33,133,129,1,3,0,12
E33036542,1077,587,171,416,29,200,131,69,257,246,2,1,8,4
E33036543,343,192,58,134,5,58,51,7,88,85,0,2,1,0
E33036544,324,153,68,85,0,53,41,12,114,111,0,2,1,4
E33036545,325,232,102,130,0,21,7,14,66,65,0,0,1,6
E33036546,322,205,81,124,1,28,15,13,84,80,0,4,0,4
E33036547,308,167,65,102,3,27,14,13,96,92,3,1,0,15
E33036548,495,252,94,158,4,99,53,46,138,130,2,4,2,2
E33036549,353,235,82,153,7,22,15,7,86,78,2,4,2,3
E33036550,340,151,39,112,0,82,42,40,103,100,0,2,1,4
E33036551,354,136,43,93,5,88,61,27,121,115,0,3,3,4
E33036552,553,269,59,210,13,78,51,27,190,177,1,10,2,3
E33036553,428,157,50,107,4,176,111,65,88,84,0,3,1,3
E33036554,905,445,146,299,31,190,112,78,236,223,3,8,2,3
E33036555,666,331,80,251,12,115,49,66,204,199,1,1,3,4
E33036556,422,178,50,128,3,59,31,28,181,169,4,8,0,1
E33036557,286,160,49,111,5,44,15,29,77,74,1,2,0,0
E33036558,257,127,41,86,2,76,37,39,52,51,0,1,0,0
E33036559,368,216,76,140,0,59,36,23,91,85,1,3,2,2
E33036560,290,163,61,102,5,39,10,29,80,78,0,1,1,3
E33036561,262,158,56,102,5,33,20,13,65,63,0,1,1,1
E33036562,385,248,100,148,3,48,21,27,83,77,1,3,2,3
E33036563,642,351,105,246,6,107,59,48,172,166,0,5,1,6
E33036564,318,197,65,132,3,39,20,19,78,76,0,1,1,1
E33036565,393,219,80,139,2,31,18,13,127,118,5,3,1,14
E33036566,489,305,95,210,6,43,24,19,131,125,2,4,0,4
E33036567,306,193,72,121,7,29,20,9,74,70,0,1,3,3
E33036568,539,337,114,223,5,23,12,11,169,145,14,5,5,5
E33036569,308,169,52,117,7,25,15,10,106,101,0,5,0,1
E33036570,247,135,38,97,3,15,9,6,90,84,0,6,0,4
E33036571,271,173,66,107,1,24,7,17,72,64,2,3,3,1
E33036572,383,216,72,144,2,42,27,15,115,110,0,4,1,8
E33036573,623,259,69,190,13,129,61,68,209,199,4,4,2,13
E33036574,367,200,72,128,9,65,47,18,91,87,0,4,0,2
E33036575,254,153,60,93,1,31,11,20,66,65,0,1,0,3
E33036576,415,141,38,103,5,85,77,8,183,175,2,3,3,1
E33036577,908,395,100,295,12,189,119,70,307,262,21,21,3,5
E33036578,294,167,52,115,2,41,29,12,79,76,0,2,1,5
E33036579,668,289,80,209,5,130,94,36,238,223,7,7,1,6
E33036580,309,98,26,72,4,81,67,14,124,122,0,1,1,2
E33036581,476,182,57,125,3,120,88,32,169,162,0,6,1,2
E33036582,290,191,67,124,6,18,11,7,71,70,1,0,0,4
E33036583,263,120,38,82,4,52,40,12,85,84,1,0,0,2
E33036584,515,217,64,153,10,110,69,41,171,159,0,10,2,7
E33036585,273,121,32,89,8,43,13,30,99,93,0,5,1,2
E33036586,347,198,61,137,5,32,16,16,112,107,0,4,1,0
E33036587,507,282,68,214,5,77,53,24,136,133,0,2,1,7
E33036588,487,302,66,236,8,90,37,53,85,75,2,5,3,2
E33036589,243,141,51,90,5,31,11,20,64,58,2,2,2,2
E33036590,298,134,40,94,6,30,19,11,125,118,0,4,3,3
E33036591,305,186,58,128,10,22,10,12,84,77,3,4,0,3
E33036592,274,202,60,142,0,8,3,5,64,59,0,5,0,0
E33036593,391,212,67,145,9,50,27,23,120,113,0,5,2,0
E33036594,292,172,42,130,2,24,18,6,92,88,0,4,0,2
E33036595,434,234,77,157,1,53,29,24,138,131,0,7,0,8
E33036596,429,179,46,133,10,61,31,30,177,169,0,7,1,2
E33036597,340,171,52,119,4,45,15,30,117,114,0,3,0,3
E33036598,291,172,67,105,1,31,15,16,86,81,0,5,0,1
E33036599,425,218,69,149,5,63,29,34,131,123,1,7,0,8
E33036600,424,225,49,176,3,55,26,29,138,131,3,2,2,3
E33036601,461,257,85,172,5,89,41,48,109,101,1,6,1,1
E33036602,271,208,73,135,2,10,2,8,48,46,1,1,0,3
E33036603,307,177,59,118,5,19,8,11,103,95,0,8,0,3
E33036604,2139,1331,318,1013,30,371,194,177,399,362,13,17,7,8
E33036605,521,279,66,213,9,31,13,18,194,184,2,7,1,8
E33036606,365,207,69,138,4,32,29,3,116,111,0,4,1,6
E33036607,560,282,90,192,4,77,59,18,191,182,2,7,0,6
E33036608,640,309,100,209,5,120,95,25,202,189,2,8,3,4
E33036609,280,151,58,93,1,55,10,45,70,68,0,2,0,3
E33036610,272,151,49,102,3,40,20,20,76,70,1,5,0,2
E33036611,268,126,30,96,3,30,13,17,106,101,3,2,0,3
E33036612,298,160,46,114,2,27,12,15,105,103,0,2,0,4
E33036613,376,185,62,123,2,41,17,24,140,135,0,5,0,8
E33036614,512,266,67,199,10,100,48,52,132,120,1,10,1,4
E33036615,373,167,63,104,3,60,21,39,142,137,0,2,3,1
E33036616,360,193,60,133,3,59,24,35,102,97,0,4,1,3
E33036617,250,149,45,104,1,39,25,14,51,49,0,0,2,10
E33036618,343,175,57,118,2,64,22,42,98,94,2,1,1,4
E33036619,427,244,64,180,5,55,29,26,119,113,0,6,0,4
E33036620,295,162,41,121,4,40,22,18,85,81,0,2,2,4
E33036621,254,139,48,91,2,34,15,19,79,69,5,5,0,0
E33036622,311,191,56,135,4,45,18,27,71,68,0,1,2,0
E33036623,365,196,71,125,2,44,20,24,118,115,1,2,0,5
E33036624,457,193,67,126,6,66,36,30,188,172,0,11,5,4
E33036625,365,177,55,122,5,47,25,22,131,120,2,9,0,5
E33036626,281,125,34,91,3,74,57,17,76,71,2,3,0,3
E33036627,295,159,63,96,5,43,22,21,84,78,1,5,0,4
E33036628,323,157,73,84,2,42,34,8,116,112,0,4,0,6
E33036629,763,309,71,238,5,110,58,52,320,312,0,7,1,19
E33036630,296,122,31,91,3,41,21,20,125,119,0,5,1,5
E33036631,446,193,55,138,3,103,62,41,145,138,1,4,2,2
E33036632,327,155,48,107,1,35,14,21,136,129,0,3,4,0
E33036633,304,151,57,94,8,57,28,29,83,81,0,2,0,5
E33036634,326,150,43,107,3,34,16,18,136,131,0,3,2,3
E33036635,447,192,40,152,4,46,19,27,199,190,0,9,0,6
E33036636,679,371,107,264,10,82,39,43,212,206,0,6,0,4
E33036637,488,217,58,159,10,83,40,43,164,160,0,3,1,14
E33036638,256,137,28,109,3,50,17,33,63,61,0,1,1,3
E33036639,663,406,122,284,11,76,46,30,168,156,4,8,0,2
E33036640,441,266,96,170,1,46,20,26,124,119,2,3,0,4
E33036641,427,255,86,169,3,33,15,18,131,128,0,3,0,5
E33036642,382,158,44,114,0,64,29,35,158,148,0,7,3,2
E33036643,634,308,114,194,16,74,30,44,228,214,0,12,2,8
E33036644,314,171,53,118,4,41,10,31,94,90,1,3,0,4
E33036645,241,123,66,57,0,31,20,11,73,72,0,0,1,14
E33036646,840,419,152,267,14,77,38,39,316,302,2,12,0,14
E33036647,307,162,83,79,4,27,17,10,98,92,3,3,0,16
E33036648,650,311,99,212,15,81,42,39,231,213,6,10,2,12
E33036649,255,109,39,70,1,31,18,13,103,66,24,2,11,11
E33036650,342,184,64,120,1,35,20,15,117,106,1,5,5,5
E33036651,767,382,116,266,18,119,54,65,239,225,7,3,4,9
E33036652,663,279,104,175,19,91,45,46,263,245,3,9,6,11
E33036653,498,218,84,134,4,135,63,72,127,125,1,1,0,14
E33036654,508,273,115,158,1,47,30,17,166,155,3,8,0,21
E33036655,327,123,41,82,10,107,58,49,81,75,5,1,0,6
E33036656,276,137,49,88,3,40,17,23,86,81,0,3,2,10
E33036657,313,136,46,90,2,53,36,17,115,111,1,2,1,7
E33036658,306,198,94,104,1,29,8,21,72,69,0,2,1,6
E33036659,515,291,89,202,7,68,41,27,142,134,4,4,0,7
E33036660,257,137,67,70,0,47,26,21,58,56,0,2,0,15
E33036661,417,206,83,123,7,49,21,28,138,127,0,7,4,17
E33036662,338,137,53,84,12,61,24,37,118,113,2,2,1,10
E33036663,264,122,47,75,1,41,14,27,97,87,4,3,3,3
E33036664,420,203,100,103,4,69,41,28,127,117,1,6,3,17
E33036665,278,125,49,76,1,88,54,34,63,60,1,1,1,1
E33036666,289,100,42,58,1,128,79,49,56,51,2,3,0,4
E33036667,507,229,71,158,7,139,98,41,127,120,1,4,2,5
E33036668,497,183,55,128,19,159,70,89,130,126,0,4,0,6
E33036669,302,97,32,65,2,82,28,54,116,109,0,7,0,5
E33036670,317,111,41,70,4,101,40,61,95,85,0,8,2,6
E33036671,347,113,39,74,8,114,46,68,109,100,0,8,1,3
E33036672,284,80,24,56,3,125,46,79,70,65,0,4,1,6
E33036673,419,154,47,107,8,113,43,70,141,134,2,5,0,3
E33036674,306,98,42,56,4,84,39,45,116,110,4,1,1,4
E33036675,365,151,39,112,4,86,22,64,121,115,0,4,2,3
E33036676,352,160,41,119,15,50,29,21,123,120,0,1,2,4
E33036677,315,117,50,67,5,90,44,46,96,91,0,5,0,7
E33036678,297,147,45,102,1,35,10,25,112,107,0,5,0,2
E33036679,291,178,67,111,2,22,7,15,78,76,0,1,1,11
E33036680,288,112,43,69,0,47,23,24,124,116,0,4,4,5
E33036681,396,168,46,122,2,99,48,51,124,117,1,3,3,3
E33036682,328,202,66,136,6,17,12,5,99,95,0,4,0,4
E33036683,417,224,87,137,5,56,27,29,121,117,4,0,0,11
E33036684,261,137,55,82,2,39,14,25,82,80,0,2,0,1
E33036685,297,137,66,71,4,56,27,29,93,76,0,17,0,7
E33036686,336,143,51,92,4,76,30,46,104,100,0,3,1,9
E33036687,345,162,79,83,5,17,5,12,152,151,0,1,0,9
E33036688,321,148,68,80,4,38,11,27,123,120,0,3,0,8
E33036689,273,129,49,80,1,48,28,20,85,78,3,4,0,10
E33036690,246,111,37,74,3,22,13,9,104,100,0,4,0,6
E33036691,240,109,50,59,4,38,14,24,84,77,2,2,3,5
E33036692,693,421,108,313,12,103,51,52,153,144,1,7,1,4
E33036693,440,190,59,131,8,65,40,25,167,160,0,7,0,10
E33036694,559,337,106,231,3,35,19,16,183,174,0,8,1,1
E33036695,320,127,51,76,7,56,27,29,123,114,1,7,1,7
E33036696,526,252,106,146,8,76,32,44,180,173,1,5,1,10
E33036697,280,126,48,78,6,59,26,33,87,81,0,4,2,2
E33036698,366,157,45,112,1,128,84,44,75,73,0,2,0,5
E33036699,377,150,51,99,2,148,92,56,73,70,0,2,1,4
E33036700,261,105,33,72,6,85,46,39,60,58,0,1,1,5
E33036701,279,90,35,55,4,127,79,48,53,44,2,7,0,5
E33036702,414,178,68,110,6,98,63,35,122,117,0,4,1,10
E33036703,282,85,25,60,4,111,27,84,80,73,0,6,1,2
E33036704,463,183,43,140,5,170,108,62,99,93,1,3,2,6
E33036705,329,102,21,81,9,124,72,52,90,81,4,0,5,4
E33036706,540,212,56,156,17,168,95,73,133,125,0,7,1,10
E33036707,300,174,44,130,3,44,28,16,77,74,0,1,2,2
E33036708,248,104,20,84,4,60,23,37,77,74,0,2,1,3
E33036709,372,142,38,104,13,97,30,67,112,109,0,2,1,8
E33036710,607,228,66,162,13,173,79,94,188,178,1,6,3,5
E33036711,640,263,98,165,12,127,69,58,227,221,0,6,0,11
E33036712,513,327,135,192,4,53,17,36,119,108,6,3,2,10
E33036713,450,214,64,150,4,32,21,11,188,177,2,8,1,12
E33036714,404,204,85,119,2,26,11,15,165,157,0,7,1,7
E33036715,276,155,63,92,3,23,13,10,81,71,2,6,2,14
E33036716,410,174,59,115,8,50,23,27,172,166,0,3,3,6
E33036717,272,125,47,78,1,17,10,7,119,114,1,4,0,10
E33036718,516,337,79,258,4,70,35,35,103,96,0,7,0,2
E33036719,365,196,68,128,4,63,33,30,96,94,0,1,1,6
E33036720,424,176,58,118,5,28,11,17,212,207,0,3,2,3
E33036721,255,127,59,68,0,16,9,7,107,103,4,0,0,5
E33036722,742,277,81,196,8,116,70,46,334,328,1,5,0,7
E33036723,560,310,67,243,14,60,18,42,170,162,0,8,0,6
E33036724,235,113,44,69,2,41,27,14,67,61,2,2,2,12
E33036725,385,249,76,173,4,23,14,9,105,97,0,7,1,4
E33036726,791,423,98,325,13,54,22,32,295,276,2,16,1,6
E33036727,369,166,58,108,12,54,27,27,133,127,0,6,0,4
E33036728,321,154,84,70,1,37,11,26,127,114,2,7,4,2
E33036729,364,117,43,74,4,51,34,17,180,176,0,3,1,12
E33036730,400,161,67,94,4,75,31,44,151,143,2,5,1,9
E33036731,366,177,59,118,1,36,18,18,145,137,1,6,1,7
E33036732,428,226,63,163,6,59,17,42,135,129,0,5,1,2
E33036733,237,96,53,43,2,55,11,44,69,67,1,1,0,15
E33036734,320,161,66,95,2,77,34,43,78,77,0,1,0,2
E33036735,540,281,102,179,6,60,31,29,185,179,0,5,1,8
E33036736,281,125,46,79,3,41,16,25,102,94,1,5,2,10
E33036737,266,119,55,64,1,26,11,15,117,112,2,2,1,3
E33036738,300,135,53,82,1,32,16,16,121,114,2,3,2,11
E33036739,298,95,28,67,8,51,27,24,143,134,2,3,4,1
E33036740,516,209,63,146,5,68,32,36,222,214,1,4,3,12
E33036741,215,97,56,41,2,37,21,16,69,65,1,1,2,10
E33036742,286,120,65,55,2,24,17,7,112,105,1,3,3,28
E33036743,272,131,48,83,0,39,24,15,88,84,1,2,1,14
E33036744,349,156,52,104,0,17,8,9,169,164,0,4,1,7
E33036745,342,120,28,92,4,77,41,36,136,132,0,3,1,5
E33036746,238,95,36,59,5,22,10,12,113,106,1,4,2,3
E33036747,274,115,63,52,1,24,12,12,130,115,2,10,3,4
E33036748,329,133,61,72,4,47,28,19,141,138,2,0,1,4
E33036749,249,79,33,46,3,53,43,10,113,110,1,1,1,1
E33036750,361,139,57,82,2,54,28,26,161,156,2,1,2,5
E33036751,436,160,63,97,2,50,29,21,218,210,2,3,3,6
E33036752,325,136,41,95,2,57,28,29,117,109,3,5,0,13
E33036753,266,85,31,54,2,19,11,8,152,147,4,1,0,8
E33036754,284,157,57,100,4,30,13,17,81,75,0,5,1,12
E33036755,341,104,33,71,5,76,35,41,148,142,0,4,2,8
E33036756,599,302,78,224,4,60,40,20,227,219,0,6,2,6
E33036757,289,119,51,68,3,56,36,20,102,96,0,4,2,9
E33036758,133,66,34,32,0,12,5,7,49,46,1,1,1,6
E33036759,278,96,41,55,5,33,19,14,138,128,0,5,5,6
E33036760,350,162,71,91,7,18,10,8,151,146,1,3,1,12
E33036761,331,124,51,73,3,40,18,22,153,148,1,3,1,11
E33036762,297,158,44,114,2,44,21,23,86,79,0,0,7,7
E33036763,556,216,96,120,9,57,30,27,237,195,28,13,1,37
E33036764,299,113,53,60,3,29,12,17,126,117,1,3,5,28
E33036765,173,84,45,39,2,13,5,8,46,46,0,0,0,28
E33036766,410,202,65,137,7,39,16,23,132,119,5,4,4,30
E33036767,264,139,53,86,2,21,6,15,94,85,3,5,1,8
E33036768,293,124,51,73,1,23,9,14,116,114,1,1,0,29
E33036769,577,275,123,152,5,52,30,22,214,192,1,20,1,31
E33036770,364,220,94,126,6,24,12,12,96,92,2,2,0,18
E33036771,370,118,53,65,4,32,11,21,178,175,0,1,2,38
E33036772,261,138,28,110,4,62,27,35,44,41,0,3,0,13
E33036773,515,306,79,227,7,41,18,23,156,133,7,9,7,5
E33036774,766,444,118,326,11,47,23,24,253,243,2,8,0,11
E33036775,264,132,37,95,3,60,19,41,69,65,1,3,0,0
E33036776,841,467,132,335,8,80,32,48,280,265,2,12,1,6
E33036777,212,108,23,85,6,30,8,22,66,63,0,3,0,2
E33036778,411,217,66,151,6,38,7,31,150,135,3,11,1,0
E33036779,500,287,85,202,8,92,42,50,109,104,0,3,2,4
E33036780,5053,3593,952,2641,87,395,196,199,947,910,8,26,3,31
E33036781,6067,4345,1034,3311,110,436,210,226,1129,1073,12,37,7,47
E33036782,902,515,120,395,9,36,13,23,335,325,3,6,1,7
E33036783,1320,658,183,475,24,178,77,101,451,427,1,22,1,9
E33036784,2349,1627,492,1135,53,275,143,132,390,358,5,19,8,4
E33036785,266,127,39,88,6,55,25,30,75,71,0,3,1,3
E33036786,332,129,40,89,3,90,62,28,101,91,1,8,1,9
E33036787,373,174,54,120,5,108,74,34,80,75,0,3,2,6
E33036788,280,132,46,86,2,94,74,20,50,47,0,3,0,2
E33036789,353,191,73,118,10,25,15,10,120,107,0,8,5,7
E33036790,325,114,73,41,3,85,17,68,117,111,0,6,0,6
E33036791,653,255,58,197,12,160,82,78,222,213,1,6,2,4
E33036792,254,101,49,52,2,66,17,49,81,80,0,1,0,4
E33036793,424,245,101,144,9,46,24,22,119,113,0,5,1,5
E33036794,331,175,58,117,3,41,13,28,101,98,1,1,1,11
E33036795,424,206,79,127,6,75,44,31,128,122,1,5,0,9
E33036796,258,123,38,85,0,24,11,13,107,98,1,7,1,4
E33036797,316,123,55,68,3,105,43,62,75,69,0,5,1,10
E33036798,532,336,74,262,19,63,28,35,109,101,1,6,1,5
E33036799,267,140,58,82,2,33,10,23,85,78,3,2,2,7
E33036800,687,251,82,169,16,193,81,112,218,196,2,20,0,9
E33036801,345,178,49,129,6,59,39,20,100,96,0,3,1,2
E33036802,500,285,77,208,7,60,30,30,145,135,0,6,4,3
E33036803,301,64,27,37,3,32,15,17,200,196,1,3,0,2
E33036804,208,65,30,35,3,59,41,18,79,77,1,1,0,2
E33036805,310,109,46,63,1,116,93,23,83,78,3,1,1,1
E33036806,442,202,76,126,12,87,44,43,133,126,1,4,2,8
E33036807,377,150,63,87,6,99,18,81,113,108,0,4,1,9
E33036808,512,404,106,298,3,53,8,45,47,40,1,6,0,5
E33036809,352,243,84,159,0,32,11,21,75,71,0,3,1,2
E33036810,422,288,84,204,6,74,11,63,51,42,1,8,0,3
E33036811,444,277,63,214,5,98,33,65,61,59,0,2,0,3
E33036812,477,268,61,207,3,139,43,96,62,56,0,3,3,5
E33036813,452,241,60,181,7,111,41,70,91,89,0,2,0,2
E33036814,369,223,57,166,5,64,21,43,75,67,1,5,2,2
E33036815,356,211,62,149,1,75,30,45,67,64,0,3,0,2
E33036816,537,306,62,244,4,136,37,99,88,81,1,5,1,3
E33036817,798,634,176,458,6,73,11,62,80,70,0,9,1,5
E33036818,638,379,92,287,13,115,60,55,124,117,1,1,5,7
E33036819,316,198,45,153,0,54,36,18,62,53,0,6,3,2
E33036820,282,210,50,160,3,34,8,26,31,30,0,1,0,4
E33036821,296,247,87,160,3,14,5,9,30,30,0,0,0,2
E33036822,372,280,68,212,2,36,9,27,49,47,2,0,0,5
E33036823,291,246,63,183,1,14,2,12,28,25,1,2,0,2
E33036824,427,323,101,222,4,48,16,32,49,49,0,0,0,3
E33036825,320,227,52,175,3,50,13,37,39,35,0,3,1,1
E33036826,517,363,88,275,5,68,37,31,75,67,2,6,0,6
E33036827,297,154,29,125,6,87,64,23,46,43,0,2,1,4
E33036828,299,183,39,144,2,69,48,21,45,39,0,5,1,0
E33036829,425,322,113,209,0,44,8,36,52,48,0,3,1,7
E33036830,326,272,100,172,4,14,1,13,33,30,2,0,1,3
E33036831,453,390,122,268,4,31,15,16,26,22,2,2,0,2
E33036832,690,556,164,392,8,44,19,25,74,54,10,5,5,8
E33036833,520,392,98,294,6,42,14,28,79,64,10,2,3,1
E33036834,323,192,75,117,9,16,11,5,104,99,0,5,0,2
E33036835,418,218,78,140,4,54,32,22,135,126,0,7,2,7
E33036836,430,213,62,151,4,53,26,27,154,148,1,5,0,6
E33036837,248,98,29,69,1,44,26,18,105,94,7,4,0,0
E33036838,579,286,71,215,8,46,28,18,228,222,0,5,1,11
E33036839,1368,817,200,617,23,114,60,54,406,398,2,5,1,8
E33036840,869,482,128,354,18,67,36,31,297,275,2,20,0,5
E33036841,270,182,71,111,2,14,4,10,70,68,0,1,1,2
E33036842,637,343,98,245,12,56,34,22,223,215,1,6,1,3
E33036843,295,151,53,98,2,19,9,10,117,110,4,3,0,6
E33036844,263,143,55,88,7,20,9,11,90,88,0,0,2,3
E33036845,569,266,89,177,11,108,59,49,180,163,2,13,2,4
E33036846,2204,1049,286,763,22,350,172,178,760,718,3,29,10,23
E33036847,386,177,53,124,2,36,14,22,171,161,5,5,0,0
E33036848,650,389,131,258,3,108,75,33,144,137,0,5,2,6
E33036849,483,166,37,129,2,143,82,61,168,162,0,3,3,4
E33036850,459,199,60,139,1,125,85,40,129,121,0,6,2,5
E33036851,298,131,36,95,5,79,54,25,78,73,0,4,1,5
E33036852,328,151,45,106,6,93,50,43,76,70,0,3,3,2
E33036853,422,189,56,133,4,125,91,34,97,90,1,4,2,7
E33036854,881,361,85,276,19,186,104,82,306,294,1,10,1,9
E33036855,433,215,44,171,14,94,35,59,106,101,0,2,3,4
E33036856,515,382,124,258,4,14,7,7,113,107,0,2,4,2
E33036857,657,385,127,258,2,31,12,19,231,220,0,9,2,8
E33036858,730,478,137,341,11,48,26,22,192,180,3,7,2,1
E33036859,381,287,69,218,3,31,21,10,60,59,0,1,0,0
E33036860,396,299,88,211,7,27,14,13,58,54,2,2,0,5
E33036861,386,263,73,190,2,49,32,17,63,58,1,2,2,9
E33036862,423,282,78,204,2,32,23,9,103,95,1,6,1,4
E33036863,355,140,32,108,5,115,77,38,92,84,2,6,0,3
E33036864,342,111,24,87,2,149,87,62,75,71,0,2,2,5
E33036865,368,185,50,135,5,87,52,35,86,80,0,6,0,5
E33036866,840,395,108,287,14,178,104,74,247,233,0,14,0,6
E33036867,354,179,41,138,3,86,62,24,84,81,2,1,0,2
E33036868,516,208,57,151,4,142,75,67,154,151,0,3,0,8
E33036869,434,263,54,209,3,76,64,12,90,81,0,7,2,2
E33036870,395,228,51,177,4,92,74,18,69,63,0,5,1,2
E33036871,415,215,63,152,2,70,44,26,127,120,3,2,2,1
E33036872,462,266,64,202,6,89,67,22,98,95,1,1,1,3
E33036873,319,173,54,119,4,22,16,6,116,110,0,6,0,4
E33036874,522,360,93,267,6,46,23,23,107,102,1,4,0,3
E33036875,631,398,127,271,4,52,35,17,174,165,2,6,1,3
E33036876,456,264,65,199,1,29,19,10,157,148,0,9,0,5
E33036877,358,177,56,121,5,39,27,12,135,130,0,4,1,2
E33036878,447,283,69,214,25,55,34,21,80,74,2,3,1,4
E33036879,288,140,35,105,3,76,51,25,67,57,1,3,6,2
E33036880,1096,680,183,497,16,115,56,59,273,255,5,12,1,12
E33036881,385,183,66,117,2,65,20,45,128,123,0,5,0,7
E33036882,471,236,58,178,12,134,82,52,84,80,2,2,0,5
E33036883,281,171,31,140,2,47,27,20,59,56,0,3,0,2
E33036884,1073,561,176,385,13,170,64,106,314,296,1,16,1,15
E33036885,2488,1503,373,1130,14,142,78,64,809,774,11,19,5,20
E33036886,2066,1173,216,957,48,290,128,162,540,498,1,37,4,15
E33036887,986,428,105,323,15,128,79,49,401,385,1,12,3,14
E33036888,273,99,22,77,4,56,20,36,112,101,6,3,2,2
E33036889,716,372,118,254,16,155,82,73,157,148,1,6,2,16
E33036890,912,470,132,338,19,154,84,70,267,250,1,12,4,2
E33036891,1361,781,155,626,28,117,58,59,425,395,6,23,1,10
E33036892,320,155,46,109,6,53,38,15,99,93,0,4,2,7
E33036893,576,292,78,214,13,94,58,36,174,166,0,7,1,3
E33036894,1523,926,221,705,28,206,121,85,351,330,2,17,2,12
E33036895,324,142,53,89,7,81,59,22,87,79,4,4,0,7
E33036896,446,217,57,160,5,81,50,31,141,134,0,7,0,2
E33036897,240,89,21,68,5,76,37,39,68,59,0,7,2,2
E33036898,242,196,67,129,2,9,4,5,33,27,3,3,0,2
E33036899,292,239,108,131,3,8,6,2,37,36,0,1,0,5
E33036900,285,220,46,174,3,14,10,4,47,46,0,1,0,1
E33036901,381,291,87,204,4,24,12,12,59,56,0,2,1,3
E33036902,236,176,44,132,1,17,9,8,38,35,0,0,3,4
E33036903,280,205,70,135,2,25,8,17,45,42,2,1,0,3
E33036904,522,213,53,160,12,94,29,65,195,185,0,6,4,8
E33036905,546,215,48,167,12,122,44,78,191,183,0,6,2,6
E33036906,366,152,43,109,3,97,25,72,109,101,0,8,0,5
E33036907,708,401,91,310,14,96,46,50,190,179,0,8,3,7
E33036908,7120,3742,795,2947,76,342,153,189,2920,2815,11,78,16,40
E33036909,436,180,54,126,16,74,30,44,164,158,0,5,1,2
E33036910,334,111,35,76,7,48,25,23,158,150,4,4,0,10
E33036911,400,224,50,174,4,53,23,30,113,105,2,5,1,6
E33036912,580,275,85,190,10,88,45,43,205,195,3,5,2,2
E33036913,360,238,77,161,2,21,13,8,97,94,0,3,0,2
E33036914,425,287,103,184,3,27,16,11,106,100,1,5,0,2
E33036915,325,210,46,164,2,8,0,8,102,97,0,2,3,3
E33036916,287,220,76,144,2,11,8,3,45,42,0,3,0,9
E33036917,359,258,93,165,9,13,9,4,73,71,0,2,0,6
E33036918,379,213,94,119,3,8,4,4,155,151,0,2,2,0
E33036919,375,265,77,188,4,22,15,7,82,80,1,1,0,2
E33036920,352,115,40,75,8,59,17,42,169,162,2,3,2,1
E33036921,367,134,32,102,9,91,32,59,131,121,0,6,4,2
E33036922,350,103,30,73,9,110,54,56,123,118,0,3,2,5
E33036923,381,127,27,100,5,105,71,34,139,128,0,9,2,5
E33036924,387,98,39,59,4,120,37,83,156,146,2,4,4,9
E33036925,351,137,62,75,0,85,38,47,128,121,0,5,2,1
E33036926,348,104,42,62,3,110,72,38,130,123,1,5,1,1
E33036927,411,260,81,179,19,18,8,10,107,103,0,3,1,7
E33036928,466,311,92,219,6,53,31,22,93,89,1,3,0,3
E33036929,361,240,74,166,2,7,4,3,112,105,0,3,4,0
E33036930,368,264,86,178,2,10,8,2,91,85,0,6,0,1
E33036931,328,227,75,152,3,20,6,14,76,74,1,1,0,2
E33036932,643,499,119,380,8,53,36,17,80,78,0,2,0,3
E33036933,490,291,99,192,7,43,24,19,149,139,5,2,3,0
E33036934,343,281,84,197,2,15,11,4,41,36,0,5,0,4
E33036935,360,303,83,220,0,12,9,3,43,39,0,3,1,2
E33036936,381,309,108,201,2,11,6,5,56,54,1,1,0,3
E33036937,318,214,80,134,4,26,14,12,73,68,0,5,0,1
E33036938,363,303,105,198,0,10,9,1,46,46,0,0,0,4
E33036939,316,179,40,139,1,92,62,30,41,40,0,1,0,3
E33036940,270,182,63,119,1,45,39,6,39,36,1,2,0,3
E33036941,621,399,98,301,12,92,51,41,112,106,0,2,4,6
E33036942,353,197,69,128,3,84,60,24,69,63,1,5,0,0
E33036943,505,330,118,212,2,72,54,18,96,89,1,6,0,5
E33036944,535,290,67,223,16,135,87,48,86,83,1,1,1,8
E33036945,417,195,44,151,10,104,69,35,102,101,0,1,0,6
E33036946,542,148,23,125,9,182,129,53,193,189,0,0,4,10
E33036947,434,187,54,133,13,88,42,46,142,133,1,8,0,4
E33036948,526,331,71,260,13,83,51,32,96,92,2,1,1,3
E33036949,588,278,89,189,9,144,77,67,149,142,0,5,2,8
E33036950,1065,445,126,319,20,168,100,68,424,404,3,14,3,8
E33036951,594,216,65,151,5,186,118,68,179,165,7,6,1,8
E33036952,835,511,160,351,10,107,42,65,201,183,1,13,4,6
E33036953,276,156,41,115,2,75,56,19,41,41,0,0,0,2
E33036954,255,120,33,87,7,48,23,25,79,71,1,6,1,1
E33036955,292,149,39,110,1,53,28,25,86,82,0,4,0,3
E33036956,373,209,51,158,6,65,38,27,90,86,0,4,0,3
E33036957,273,118,32,86,5,58,20,38,90,84,0,2,4,2
E33036958,699,267,70,197,12,211,111,100,204,195,0,7,2,5
E33036959,335,197,60,137,5,44,23,21,87,84,1,2,0,2
E33036960,323,154,32,122,7,52,32,20,107,95,0,12,0,3
E33036961,329,129,42,87,2,94,51,43,96,91,0,4,1,8
E33036962,492,227,67,160,9,144,82,62,106,99,1,3,3,6
E33036963,445,243,61,182,17,73,53,20,108,104,0,3,1,4
E33036964,373,159,33,126,2,117,78,39,87,84,2,1,0,8
E33036965,300,166,51,115,3,62,39,23,67,62,0,4,1,2
E33036966,642,304,67,237,3,147,93,54,180,176,1,3,0,8
E33036967,317,166,48,118,5,63,35,28,77,71,0,5,1,6
E33036968,720,348,104,244,10,145,78,67,205,191,4,7,3,12
E33036969,354,249,69,180,8,47,23,24,49,46,0,1,2,1
E33036970,1836,1476,396,1080,14,110,56,54,229,208,4,15,2,7
E33036971,1082,872,215,657,13,62,20,42,131,123,1,7,0,4
E33036972,293,238,74,164,1,8,5,3,42,39,1,2,0,4
E33036973,632,480,152,328,4,58,39,19,86,76,1,9,0,4
E33036974,328,235,72,163,3,32,5,27,56,52,1,2,1,2
E33036975,389,229,58,171,5,54,12,42,91,77,3,6,5,10
E33036976,377,279,82,197,4,25,3,22,64,60,0,2,2,5
E33036977,355,221,65,156,5,46,15,31,83,76,3,3,1,0
E33036978,388,270,75,195,9,30,8,22,77,67,1,9,0,2
E33036979,823,661,137,524,20,26,7,19,106,100,1,4,1,10
E33036980,386,276,72,204,7,37,15,22,66,65,0,1,0,0
E33036981,402,298,88,210,4,26,5,21,71,71,0,0,0,3
E33036982,788,555,132,423,12,86,28,58,133,122,1,10,0,2
E33036983,491,361,81,280,10,26,4,22,92,84,2,3,3,2
E33036984,1141,873,267,606,15,57,17,40,192,173,4,9,6,4
E33036985,231,173,40,133,6,10,2,8,42,39,2,0,1,0
E33036986,1333,1036,251,785,22,81,19,62,189,172,3,11,3,5
E33036987,348,242,60,182,3,34,13,21,67,61,0,6,0,2
E33036988,423,323,74,249,6,30,8,22,63,59,1,3,0,1
E33036989,1952,1638,410,1228,27,66,15,51,213,192,1,19,1,8
E33036990,637,446,125,321,11,75,18,57,105,101,0,4,0,0
E33036991,353,245,62,183,5,33,7,26,66,63,1,1,1,4
E33036992,477,320,101,219,4,30,2,28,114,103,3,5,3,9
E33036993,390,267,66,201,4,34,11,23,83,73,0,9,1,2
E33036994,356,247,84,163,3,53,9,44,50,47,0,3,0,3
E33036995,288,204,59,145,7,21,4,17,48,41,1,4,2,8
E33036996,292,219,44,175,3,31,14,17,37,34,0,3,0,2
E33036997,742,536,132,404,6,66,19,47,133,125,2,5,1,1
E33036998,953,719,162,557,19,69,26,43,141,132,0,9,0,5
E33036999,408,279,66,213,4,40,12,28,84,76,0,8,0,1
E33037000,220,173,43,130,3,21,9,12,22,21,0,1,0,1
E33037001,274,220,44,176,5,17,10,7,32,30,0,2,0,0
E33037002,262,196,39,157,3,25,9,16,38,35,0,3,0,0
E33037003,154,105,22,83,1,14,5,9,34,31,3,0,0,0
E33037004,504,387,87,300,7,40,16,24,70,64,1,5,0,0
E33037005,650,461,113,348,11,55,14,41,118,109,0,7,2,5
E33037006,228,162,28,134,3,25,13,12,38,36,0,2,0,0
E33037007,529,381,91,290,5,36,9,27,106,96,5,5,0,1
E33037008,243,163,47,116,3,22,5,17,55,52,0,3,0,0
E33037009,393,300,98,202,9,32,8,24,51,50,0,1,0,1
E33037010,727,519,154,365,8,82,19,63,116,103,2,8,3,2
E33037011,487,301,70,231,7,71,11,60,105,95,3,7,0,3
E33037012,324,232,61,171,3,22,5,17,67,59,0,6,2,0
E33037013,586,427,122,305,15,63,12,51,78,73,0,5,0,3
E33037014,538,374,106,268,9,57,15,42,94,90,0,4,0,4
E33037015,359,260,56,204,7,33,10,23,56,47,1,5,3,3
E33037016,1367,990,219,771,10,106,44,62,257,242,0,12,3,4
E33037017,702,462,108,354,12,62,24,38,164,153,0,10,1,2
E33037018,249,171,46,125,2,29,8,21,46,45,0,1,0,1
E33037019,412,315,84,231,7,34,19,15,55,51,0,4,0,1
E33037020,735,585,130,455,10,37,12,25,100,92,2,6,0,3
E33037021,264,182,65,117,6,18,3,15,37,32,2,1,2,21
E33037022,867,669,207,462,6,19,6,13,166,153,8,5,0,7
E33037023,642,474,105,369,6,52,16,36,107,97,2,7,1,3
E33037024,250,170,39,131,6,22,7,15,50,49,0,1,0,2
E33037025,834,650,158,492,7,43,7,36,130,119,2,9,0,4
E33037026,1380,948,209,739,29,144,54,90,255,189,42,15,9,4
E33037027,1169,926,183,743,13,69,20,49,157,149,1,7,0,4
E33037028,276,219,42,177,4,13,2,11,40,36,2,2,0,0
E33037029,3694,2735,527,2208,51,326,124,202,565,518,10,30,7,17
E33037030,967,722,144,578,16,60,21,39,167,157,4,4,2,2
E33037031,684,506,96,410,11,42,8,34,124,119,0,3,2,1
E33037032,416,279,56,223,7,54,15,39,71,64,1,5,1,5
E33037033,333,219,42,177,2,43,13,30,64,59,1,4,0,5
E33037034,328,227,49,178,7,62,15,47,31,27,0,4,0,1
E33037035,881,692,107,585,11,47,20,27,129,118,2,8,1,2
E33037036,1288,984,172,812,19,70,27,43,213,197,2,12,2,2
E33037037,612,451,83,368,10,46,15,31,102,85,4,7,6,3
E33037038,526,395,111,284,5,49,11,38,73,63,3,3,4,4
E33037039,360,256,89,167,6,55,6,49,40,37,0,2,1,3
E33037040,254,206,59,147,5,17,2,15,25,24,0,1,0,1
E33037041,233,184,38,146,6,9,2,7,34,30,0,1,3,0
E33037042,372,292,77,215,5,23,2,21,49,48,0,1,0,3
E33037043,385,248,73,175,6,30,6,24,89,85,2,1,1,12
E33037044,1342,991,272,719,17,129,35,94,197,181,3,10,3,8
E33037045,399,287,62,225,5,22,5,17,83,73,0,8,2,2
E33037046,254,163,42,121,1,31,14,17,55,47,4,4,0,4
E33037047,422,275,81,194,4,56,11,45,75,68,2,2,3,12
E33037048,377,240,71,169,16,35,5,30,79,67,3,3,6,7
E33037049,660,348,81,267,16,57,5,52,232,88,87,5,52,7
E33037050,828,597,121,476,10,33,4,29,183,169,7,7,0,5
E33037051,525,383,77,306,10,33,6,27,94,72,18,1,3,5
E33037052,313,232,58,174,2,25,5,20,47,42,2,3,0,7
E33037053,985,623,167,456,13,122,16,106,222,209,3,8,2,5
E33037054,903,598,150,448,23,134,11,123,143,131,5,5,2,5
E33037055,229,159,42,117,2,16,1,15,52,50,0,2,0,0
E33037056,490,365,117,248,4,53,6,47,64,53,5,5,1,4
E33037057,461,311,98,213,4,54,8,46,73,63,5,3,2,19
E33037058,309,179,67,112,5,65,4,61,55,50,3,1,1,5
E33037059,705,540,144,396,8,40,5,35,113,105,1,6,1,4
E33037060,492,316,104,212,3,68,12,56,97,82,5,10,0,8
E33037061,317,152,63,89,1,35,2,33,102,65,28,8,1,27
E33037062,198,116,34,82,2,22,6,16,34,31,0,2,1,24
E33037063,617,365,80,285,3,102,22,80,134,121,7,5,1,13
E33037064,487,371,77,294,6,32,7,25,72,67,2,1,2,6
E33037065,292,188,45,143,3,42,3,39,57,47,1,6,3,2
E33037066,578,395,124,271,4,44,10,34,130,119,6,5,0,5
E33037067,4273,3138,532,2606,50,167,27,140,889,824,21,27,17,29
E33037068,723,511,115,396,12,27,0,27,164,140,8,8,8,9
E33037069,441,308,95,213,7,72,9,63,48,38,5,5,0,6
E33037070,205,152,51,101,0,24,4,20,25,24,1,0,0,4
E33037071,288,172,38,134,2,54,9,45,55,51,0,2,2,5
E33037072,311,246,46,200,7,16,3,13,40,40,0,0,0,2
E33037073,450,350,57,293,9,32,5,27,58,56,1,1,0,1
E33037074,524,355,87,268,11,69,8,61,86,75,0,10,1,3
E33037075,669,414,99,315,14,118,18,100,118,111,1,6,0,5
E33037076,589,379,100,279,7,66,32,34,136,125,1,9,1,1
E33037077,2164,1644,303,1341,26,69,22,47,421,392,5,18,6,4
E33037078,683,461,92,369,8,44,13,31,165,155,3,5,2,5
E33037079,423,311,65,246,1,37,11,26,74,70,2,1,1,0
E33037080,332,256,79,177,8,29,16,13,37,32,0,4,1,2
E33037081,785,565,178,387,13,70,30,40,131,127,0,4,0,6
E33037082,908,606,155,451,14,100,46,54,186,168,2,11,5,2
E33037083,209,151,44,107,4,20,1,19,33,30,2,1,0,1
E33037084,535,387,79,308,5,29,5,24,109,106,0,2,1,5
E33037085,336,249,56,193,5,27,2,25,54,49,1,4,0,1
E33037086,704,452,146,306,15,108,5,103,125,115,2,8,0,4
E33037087,234,156,45,111,4,16,0,16,58,52,3,2,1,0
E33037088,393,258,67,191,12,61,5,56,58,53,2,2,1,4
E33037089,833,537,164,373,9,109,13,96,168,155,4,7,2,10
E33037090,366,236,41,195,8,46,5,41,73,64,5,4,0,3
E33037091,241,162,39,123,2,26,4,22,51,46,3,2,0,0
E33037092,247,155,39,116,8,29,3,26,53,50,0,3,0,2
E33037093,246,176,48,128,4,45,4,41,20,20,0,0,0,1
E33037094,281,191,48,143,2,26,3,23,57,53,2,2,0,5
E33037095,331,269,80,189,4,22,0,22,34,28,0,6,0,2
E33037096,394,244,77,167,10,65,4,61,72,66,2,4,0,3
E33037097,364,270,86,184,6,42,4,38,46,42,1,3,0,0
E33037098,446,271,78,193,11,68,12,56,93,88,1,2,2,3
E33037099,891,624,147,477,18,102,13,89,146,136,3,6,1,1
E33037100,253,188,61,127,7,21,1,20,36,33,0,3,0,1
E33037101,1384,1004,233,771,23,128,14,114,226,209,1,13,3,3
E33037102,3689,3016,751,2265,39,220,26,194,399,378,4,15,2,15
E33037103,581,415,92,323,10,53,5,48,99,88,7,2,2,4
E33037104,206,151,46,105,3,17,4,13,34,32,0,2,0,1
E33037105,565,385,108,277,13,90,10,80,74,70,0,4,0,3
E33037106,225,165,42,123,4,20,12,8,35,30,0,4,1,1
E33037107,202,146,47,99,2,31,18,13,22,19,0,3,0,1
E33037108,430,328,93,235,12,26,13,13,62,60,1,1,0,2
E33037109,611,398,96,302,8,48,25,23,157,146,1,9,1,0
E33037110,255,168,45,123,5,35,13,22,42,38,0,4,0,5
E33037111,1343,1002,225,777,32,73,23,50,229,209,2,15,3,7
E33037112,1774,1191,209,982,23,87,27,60,470,444,5,19,2,3
E33037113,221,134,37,97,1,15,5,10,71,66,1,4,0,0
E33037114,267,189,53,136,7,16,5,11,53,46,0,4,3,2
E33037115,445,310,83,227,8,26,12,14,96,87,2,6,1,5
E33037116,392,243,64,179,4,31,13,18,106,98,0,7,1,8
E33037117,406,272,72,200,10,42,25,17,79,73,1,4,1,3
E33037118,346,228,72,156,8,56,32,24,50,42,1,6,1,4
E33037119,915,603,178,425,15,146,70,76,147,133,4,10,0,4
E33037120,568,332,96,236,13,119,75,44,103,98,1,3,1,1
E33037121,332,280,93,187,4,11,5,6,37,35,0,2,0,0
E33037122,558,345,94,251,11,98,60,38,102,95,1,4,2,2
E33037123,220,160,47,113,0,22,16,6,37,35,1,1,0,1
E33037124,580,385,85,300,13,68,30,38,110,104,1,5,0,4
E33037125,310,194,65,129,8,43,25,18,61,54,1,4,2,4
E33037126,765,449,123,326,9,126,59,67,177,168,2,6,1,4
E33037127,2010,1370,362,1008,29,240,111,129,355,339,2,12,2,16
E33037128,1816,1259,249,1010,25,115,51,64,413,392,3,15,3,4
E33037129,262,149,38,111,8,43,21,22,62,56,2,4,0,0
E33037130,1400,836,203,633,25,174,86,88,358,339,1,15,3,7
E33037131,357,226,56,170,8,43,22,21,80,74,1,4,1,0
E33037132,247,154,42,112,2,41,14,27,49,43,0,6,0,1
E33037133,262,174,39,135,8,38,20,18,41,41,0,0,0,1
E33037134,481,324,95,229,11,74,26,48,69,64,0,5,0,3
E33037135,522,329,89,240,11,78,42,36,98,92,0,4,2,6
E33037136,1425,895,182,713,29,154,75,79,336,314,0,17,5,11
E33037137,364,205,46,159,3,49,26,23,106,100,1,4,1,1
E33037138,256,172,38,134,6,21,9,12,56,53,0,3,0,1
E33037139,479,381,110,271,3,35,15,20,55,53,1,1,0,5
E33037140,260,191,50,141,6,20,12,8,40,40,0,0,0,3
E33037141,1273,756,184,572,21,186,86,100,302,290,6,6,0,8
E33037142,319,254,58,196,3,20,14,6,41,35,0,6,0,1
E33037143,1503,1097,256,841,19,109,43,66,272,254,4,11,3,6
E33037144,511,317,93,224,8,66,36,30,119,117,0,2,0,1
E33037145,343,200,41,159,6,49,24,25,87,83,1,2,1,1
E33037146,631,446,135,311,9,79,42,37,97,89,4,4,0,0
E33037147,369,265,85,180,4,37,24,13,63,61,0,1,1,0
E33037148,4248,2873,574,2299,43,272,112,160,1035,985,6,37,7,25
E33037149,281,217,49,168,7,21,10,11,36,32,2,1,1,0
E33037150,356,250,57,193,3,24,12,12,76,73,1,2,0,3
E33037151,341,241,45,196,5,11,6,5,82,81,0,1,0,2
E33037152,241,167,49,118,1,25,8,17,45,41,0,2,2,3
E33037153,233,132,35,97,6,42,27,15,51,46,1,4,0,2
E33037154,361,182,39,143,5,54,31,23,120,117,1,0,2,0
E33037155,323,210,46,164,3,48,29,19,57,57,0,0,0,5
E33037156,438,305,92,213,3,51,25,26,76,70,0,6,0,3
E33037157,234,146,49,97,4,38,18,20,44,39,0,5,0,2
E33037158,319,191,49,142,5,42,18,24,79,75,1,3,0,2
E33037159,384,250,66,184,7,60,33,27,64,59,1,3,1,3
E33037160,583,426,112,314,4,63,27,36,88,85,2,1,0,2
E33037161,348,234,75,159,6,59,27,32,46,43,1,1,1,3
E33037162,1266,929,185,744,9,108,39,69,218,203,4,8,3,2
E33037163,718,535,130,405,9,66,41,25,107,102,0,4,1,1
E33037164,333,223,73,150,5,38,23,15,66,64,0,2,0,1
E33037165,821,612,130,482,8,31,14,17,163,156,2,4,1,7
E33037166,702,468,106,362,13,80,38,42,138,128,7,2,1,3
E33037167,371,236,59,177,3,51,26,25,80,77,0,3,0,1
E33037168,309,171,52,119,2,53,27,26,83,79,0,3,1,0
E33037169,354,228,61,167,3,44,15,29,76,73,0,1,2,3
E33037170,367,179,49,130,4,58,28,30,121,111,2,8,0,5
E33037171,778,461,134,327,13,112,49,63,184,170,4,7,3,8
E33037172,390,214,53,161,4,90,49,41,80,73,3,4,0,2
E33037173,307,219,46,173,9,33,12,21,44,39,1,3,1,2
E33037174,277,184,47,137,1,28,15,13,64,59,1,3,1,0
E33037175,465,263,57,206,4,35,18,17,159,156,0,3,0,4
E33037176,280,214,66,148,2,13,5,8,50,44,0,5,1,1
E33037177,256,185,51,134,0,20,3,17,42,40,1,1,0,9
E33037178,223,159,45,114,2,21,4,17,39,36,0,1,2,2
E33037179,246,176,47,129,0,17,2,15,38,34,1,1,2,15
E33037180,365,261,64,197,5,35,15,20,55,50,1,4,0,9
E33037181,424,309,63,246,4,42,17,25,63,59,2,1,1,6
E33037182,301,236,60,176,2,7,2,5,53,48,0,4,1,3
E33037183,467,334,92,242,6,22,5,17,101,98,0,3,0,4
E33037184,256,168,65,103,2,31,8,23,51,42,6,3,0,4
E33037185,785,506,109,397,8,95,29,66,169,156,4,2,7,7
E33037186,273,212,57,155,0,29,12,17,32,30,1,1,0,0
E33037187,280,210,52,158,1,10,2,8,53,45,0,3,5,6
E33037188,257,191,64,127,1,23,11,12,39,32,2,4,1,3
E33037189,337,245,64,181,0,18,6,12,67,62,1,3,1,7
E33037190,224,134,45,89,3,21,6,15,62,57,3,1,1,4
E33037191,413,268,48,220,10,26,6,20,108,102,3,1,2,1
E33037192,1028,644,196,448,18,138,52,86,218,196,10,5,7,10
E33037193,522,278,74,204,2,52,12,40,186,170,6,8,2,4
E33037194,210,109,29,80,3,22,3,19,75,71,1,3,0,1
E33037195,189,109,21,88,3,20,6,14,56,51,1,3,1,1
E33037196,295,187,49,138,5,49,11,38,53,49,1,1,2,1
E33037197,518,386,54,332,8,29,6,23,88,81,4,3,0,7
E33037198,310,204,58,146,1,36,5,31,68,64,1,2,1,1
E33037199,439,303,66,237,2,20,7,13,110,100,3,3,4,4
E33037200,206,126,33,93,2,28,7,21,47,44,1,1,1,3
E33037201,558,380,109,271,8,53,20,33,111,105,0,2,4,6
E33037202,428,301,61,240,4,14,1,13,103,95,1,6,1,6
E33037203,201,121,20,101,0,15,9,6,62,52,5,3,2,3
E33037204,236,165,37,128,4,9,3,6,54,50,3,0,1,4
E33037205,349,232,55,177,4,9,2,7,102,94,2,6,0,2
E33037206,1545,1109,236,873,14,69,28,41,343,327,3,13,0,10
E33037207,978,762,136,626,13,46,23,23,151,142,3,4,2,6
E33037208,425,255,93,162,2,31,9,22,100,72,19,5,4,37
E33037209,237,180,49,131,1,18,7,11,37,29,5,3,0,1
E33037210,315,251,58,193,5,8,1,7,49,45,1,0,3,2
E33037211,384,153,54,99,1,26,10,16,174,50,108,3,13,30
E33037212,879,552,132,420,8,85,24,61,228,220,1,6,1,6
E33037213,217,112,24,88,2,41,4,37,61,59,1,1,0,1
E33037214,224,158,43,115,0,16,3,13,49,45,1,3,0,1
E33037215,537,323,78,245,9,92,16,76,107,97,3,4,3,6
E33037216,1247,857,130,727,16,38,12,26,325,311,0,11,3,11
E33037217,400,287,64,223,5,28,7,21,78,73,0,4,1,2
E33037218,764,464,164,300,7,165,18,147,120,110,1,3,6,8
E33037219,544,371,86,285,9,52,7,45,105,93,6,4,2,7
E33037220,190,122,22,100,4,8,3,5,56,51,0,5,0,0
E33037221,303,177,44,133,5,42,6,36,77,74,1,2,0,2
E33037222,223,154,39,115,4,36,9,27,28,22,0,6,0,1
E33037223,303,211,72,139,5,19,4,15,68,63,0,3,2,0
E33037224,867,644,213,431,14,98,16,82,97,86,0,10,1,14
E33037225,535,398,81,317,2,41,6,35,92,85,1,4,2,2
E33037226,2354,1799,380,1419,32,94,25,69,423,400,4,12,7,6
E33037227,739,514,135,379,8,85,25,60,127,110,12,1,4,5
E33037228,375,254,85,169,2,51,9,42,64,60,0,4,0,4
E33037229,284,193,59,134,1,29,12,17,59,55,1,2,1,2
E33037230,6861,5232,1066,4166,71,253,128,125,1279,1204,8,59,8,26
E33037231,1147,832,210,622,18,79,38,41,210,199,2,7,2,8
E33037232,1028,826,165,661,6,45,15,30,149,138,2,8,1,2
E33037233,559,405,126,279,4,51,34,17,96,88,1,7,0,3
E33037234,393,297,70,227,4,35,19,16,52,47,2,3,0,5
E33037235,364,295,91,204,1,24,14,10,40,35,3,2,0,4
E33037236,1112,886,252,634,10,61,36,25,146,139,2,2,3,9
E33037237,365,271,47,224,7,29,11,18,57,52,0,5,0,1
E33037238,359,229,69,160,7,49,28,21,74,61,4,6,3,0
E33037239,340,221,59,162,6,39,21,18,72,70,0,2,0,2
E33037240,257,188,40,148,2,17,9,8,49,45,2,1,1,1
E33037241,365,268,63,205,9,36,15,21,52,46,0,5,1,0
E33037242,465,347,82,265,3,36,13,23,79,73,2,4,0,0
E33037243,407,309,80,229,9,37,21,16,51,50,0,1,0,1
E33037244,224,170,41,129,2,18,10,8,34,31,0,0,3,0
E33037245,769,576,143,433,15,61,26,35,112,101,2,8,1,5
E33037246,685,497,165,332,11,84,56,28,87,85,0,2,0,6
E33037247,289,221,51,170,5,29,12,17,31,29,0,2,0,3
E33037248,346,244,82,162,2,29,14,15,63,54,4,5,0,8
E33037249,633,443,145,298,12,21,9,12,152,142,3,2,5,5
E33037250,404,302,90,212,6,25,15,10,69,67,1,1,0,2
E33037251,273,211,42,169,2,15,6,9,43,41,0,1,1,2
E33037252,224,161,45,116,3,20,12,8,38,35,0,3,0,2
E33037253,329,250,69,181,2,20,12,8,51,47,1,2,1,6
E33037254,422,257,50,207,9,56,33,23,98,95,1,2,0,2
E33037255,288,217,58,159,6,8,4,4,53,50,0,3,0,4
E33037256,454,337,100,237,5,33,22,11,75,70,1,3,1,4
E33037257,200,149,41,108,5,19,11,8,25,24,0,1,0,2
E33037258,262,174,53,121,5,31,16,15,44,38,0,2,4,8
E33037259,444,338,90,248,1,25,13,12,76,73,2,0,1,4
E33037260,323,251,82,169,7,22,10,12,42,39,1,2,0,1
E33037261,342,266,62,204,5,13,3,10,58,54,0,4,0,0
E33037262,1398,1044,226,818,17,43,18,25,291,279,3,8,1,3
E33037263,755,582,123,459,8,30,11,19,132,125,1,6,0,3
E33037264,359,285,61,224,2,6,4,2,65,63,1,1,0,1
E33037265,350,246,62,184,6,54,18,36,39,37,0,1,1,5
E33037266,220,183,49,134,1,10,6,4,24,21,3,0,0,2
E33037267,235,161,54,107,2,19,10,9,49,32,13,4,0,4
E33037268,327,272,53,219,2,15,5,10,16,10,2,1,3,22
E33037269,320,219,55,164,5,45,29,16,49,46,0,2,1,2
E33037270,548,363,89,274,29,96,59,37,59,59,0,0,0,1
E33037271,210,161,39,122,10,20,9,11,19,18,0,1,0,0
E33037272,275,167,46,121,21,43,27,16,42,41,0,0,1,2
E33037273,460,299,81,218,21,57,35,22,81,78,0,3,0,2
E33037274,331,212,59,153,18,45,28,17,55,49,2,2,2,1
E33037275,307,199,52,147,16,44,33,11,47,44,0,3,0,1
E33037276,329,247,46,201,18,24,15,9,39,34,2,3,0,1
E33037277,417,259,49,210,22,70,48,22,64,56,1,6,1,2
E33037278,1188,659,134,525,56,242,152,90,225,206,2,15,2,6
E33037279,214,165,44,121,8,15,9,6,26,24,2,0,0,0
E33037280,1328,726,144,582,82,207,130,77,307,296,1,4,6,6
E33037281,217,150,44,106,7,27,19,8,32,29,0,3,0,1
E33037282,307,178,70,108,10,59,41,18,56,53,1,2,0,4
E33037283,367,230,57,173,23,56,37,19,58,52,1,5,0,0
E33037284,217,144,35,109,15,15,10,5,39,36,0,1,2,4
E33037285,334,195,40,155,8,36,15,21,91,78,7,1,5,4
E33037286,840,649,132,517,48,45,17,28,94,87,1,4,2,4
E33037287,517,320,88,232,30,85,49,36,78,74,0,3,1,4
E33037288,198,151,37,114,6,17,8,9,23,21,0,2,0,1
E33037289,355,225,60,165,13,29,14,15,88,46,0,42,0,0
E33037290,888,674,175,499,52,58,20,38,102,89,1,10,2,2
E33037291,507,334,71,263,16,28,14,14,125,122,0,2,1,4
E33037292,976,667,181,486,72,87,37,50,145,140,0,5,0,5
E33037293,204,146,32,114,12,14,8,6,31,29,0,2,0,1
E33037294,186,124,33,91,4,22,16,6,36,34,0,2,0,0
E33037295,369,217,38,179,19,52,36,16,78,72,0,5,1,3
E33037296,2729,1691,373,1318,148,330,155,175,546,510,2,32,2,14
E33037297,909,547,131,416,58,135,78,57,165,160,0,3,2,4
E33037298,240,156,32,124,8,27,18,9,48,45,0,3,0,1
E33037299,223,159,64,95,10,24,14,10,29,25,3,1,0,1
E33037300,851,513,129,384,42,87,40,47,202,188,1,9,4,7
E33037301,264,201,60,141,3,15,8,7,42,35,2,4,1,3
E33037302,1601,1307,383,924,37,51,21,30,205,195,1,9,0,1
E33037303,1155,720,148,572,62,118,65,53,251,240,2,9,0,4
E33037304,213,150,35,115,17,15,8,7,30,27,0,3,0,1
E33037305,893,630,115,515,68,78,47,31,113,106,1,6,0,4
E33037306,829,498,101,397,38,75,40,35,216,205,3,7,1,2
E33037307,322,236,51,185,16,13,5,8,57,53,0,4,0,0
E33037308,286,203,52,151,15,14,4,10,54,51,1,2,0,0
E33037309,168,111,29,82,5,13,7,6,39,37,0,1,1,0
E33037310,764,525,95,430,47,63,35,28,127,121,1,5,0,2
E33037311,483,328,71,257,35,49,19,30,68,66,0,2,0,3
E33037312,238,134,18,116,18,47,24,23,39,35,1,3,0,0
E33037313,264,161,27,134,17,25,13,12,60,57,1,2,0,1
E33037314,594,367,59,308,32,48,25,23,139,131,1,7,0,8
E33037315,334,189,45,144,21,53,33,20,70,64,0,6,0,1
E33037316,205,155,34,121,8,11,8,3,27,24,2,1,0,4
E33037317,518,362,91,271,30,41,23,18,84,71,4,6,3,1
E33037318,262,195,48,147,7,22,14,8,37,32,0,4,1,1
E33037319,703,505,98,407,29,49,16,33,119,111,0,7,1,1
E33037320,341,262,45,217,15,20,7,13,43,39,1,1,2,1
E33037321,376,281,54,227,19,9,4,5,66,54,0,9,3,1
E33037322,406,271,41,230,18,31,14,17,86,82,1,3,0,0
E33037323,528,399,83,316,33,34,12,22,61,60,0,1,0,1
E33037324,631,402,99,303,38,76,47,29,112,110,1,1,0,3
E33037325,208,131,40,91,10,16,12,4,49,47,0,2,0,2
E33037326,215,143,45,98,6,29,11,18,37,31,0,5,1,0
E33037327,323,217,62,155,14,37,22,15,52,48,1,3,0,3
E33037328,462,285,54,231,22,50,31,19,105,98,0,6,1,0
E33037329,365,291,64,227,16,16,10,6,41,38,1,2,0,1
E33037330,247,159,47,112,13,35,22,13,40,37,0,2,1,0
E33037331,708,499,79,420,48,55,30,25,105,97,0,7,1,1
E33037332,223,142,27,115,16,19,11,8,46,41,0,5,0,0
E33037333,308,215,52,163,21,34,18,16,38,34,1,2,1,0
E33037334,357,261,77,184,17,24,16,8,50,42,2,6,0,5
E33037335,766,580,86,494,27,24,9,15,132,130,0,2,0,3
E33037336,676,538,87,451,28,18,8,10,91,84,1,6,0,1
E33037337,340,236,66,170,12,28,14,14,62,60,1,1,0,2
E33037338,316,246,52,194,13,11,0,11,46,40,1,4,1,0
E33037339,323,170,43,127,22,44,17,27,85,83,0,1,1,2
E33037340,1408,962,185,777,64,152,67,85,223,211,1,9,2,7
E33037341,318,195,52,143,21,43,19,24,57,55,0,2,0,2
E33037342,1405,698,141,557,76,177,96,81,449,432,1,10,6,5
E33037343,467,330,66,264,17,38,13,25,80,72,0,7,1,2
E33037344,276,209,61,148,19,18,8,10,30,26,0,4,0,0
E33037345,575,356,92,264,19,58,38,20,140,136,0,4,0,2
E33037346,209,133,32,101,7,36,20,16,31,31,0,0,0,2
E33037347,422,287,72,215,27,39,22,17,68,66,0,2,0,1
E33037348,726,347,78,269,41,114,67,47,220,209,0,11,0,4
E33037349,333,213,49,164,1,17,10,7,99,88,2,9,0,3
E33037350,225,102,22,80,1,14,9,5,107,104,0,2,1,1
E33037351,302,163,56,107,2,38,23,15,95,92,0,3,0,4
E33037352,5039,3031,670,2361,84,367,240,127,1532,1441,19,64,8,25
E33037353,893,532,168,364,14,173,120,53,168,158,1,7,2,6
E33037354,305,189,71,118,1,26,19,7,86,81,0,3,2,3
E33037355,899,523,110,413,9,60,30,30,302,289,2,8,3,5
E33037356,567,401,121,280,7,47,25,22,112,103,1,8,0,0
E33037357,935,678,186,492,10,75,50,25,167,152,0,12,3,5
E33037358,737,508,175,333,11,53,30,23,158,149,2,7,0,7
E33037359,901,586,191,395,14,78,45,33,216,207,0,5,4,7
E33037360,1031,746,181,565,13,79,58,21,187,174,2,10,1,6
E33037361,429,271,64,207,7,56,35,21,90,83,0,7,0,5
E33037362,328,257,75,182,2,24,20,4,43,41,0,2,0,2
E33037363,242,164,40,124,4,4,2,2,70,66,0,4,0,0
E33037364,574,277,60,217,4,27,17,10,266,257,0,8,1,0
E33037365,233,141,25,116,1,12,7,5,79,78,0,1,0,0
E33037366,214,137,43,94,4,14,9,5,58,57,0,1,0,1
E33037367,311,184,54,130,4,18,7,11,101,96,0,5,0,4
E33037368,288,200,60,140,0,10,5,5,76,68,2,5,1,2
E33037369,2991,1747,339,1408,46,142,80,62,1049,992,2,53,2,7
E33037370,461,241,69,172,4,32,24,8,179,172,1,4,2,5
E33037371,508,292,68,224,3,22,12,10,181,176,2,3,0,10
E33037372,471,220,51,169,4,17,4,13,223,206,8,8,1,7
E33037373,302,128,38,90,3,19,10,9,150,146,1,3,0,2
E33037374,702,332,74,258,6,30,21,9,327,313,2,11,1,7
E33037375,228,84,15,69,3,20,11,9,113,108,0,5,0,8
E33037376,449,189,46,143,4,59,35,24,194,185,0,7,2,3
E33037377,519,320,85,235,1,18,9,9,176,161,0,15,0,4
E33037378,747,380,132,248,2,88,52,36,273,264,0,8,1,4
E33037379,293,128,41,87,3,27,17,10,134,124,0,7,3,1
E33037380,296,96,25,71,2,34,26,8,162,158,0,4,0,2
E33037381,928,384,92,292,6,88,46,42,443,418,0,20,5,7
E33037382,515,229,64,165,4,47,33,14,229,219,0,8,2,6
E33037383,537,246,50,196,3,30,20,10,255,247,1,6,1,3
E33037384,650,268,64,204,7,68,43,25,305,299,1,4,1,2
E33037385,1210,720,215,505,12,61,34,27,409,384,0,23,2,8
E33037386,195,88,20,68,2,13,7,6,92,88,0,4,0,0
E33037387,235,99,27,72,2,24,12,12,105,99,3,3,0,5
E33037388,264,133,38,95,1,15,8,7,113,106,0,7,0,2
E33037389,282,131,37,94,1,11,6,5,135,131,0,4,0,4
E33037390,885,431,101,330,12,62,36,26,375,359,1,12,3,5
E33037391,376,193,39,154,6,25,16,9,152,141,1,5,5,0
E33037392,549,359,92,267,6,21,13,8,161,146,1,13,1,2
E33037393,738,394,102,292,9,47,31,16,283,267,3,12,1,5
E33037394,202,74,22,52,2,15,10,5,111,104,0,7,0,0
E33037395,430,205,53,152,7,23,16,7,193,186,0,5,2,2
E33037396,239,156,47,109,4,16,12,4,63,56,0,7,0,0
E33037397,318,185,45,140,0,12,8,4,119,111,0,6,2,2
E33037398,1136,465,136,329,5,218,142,76,439,420,0,18,1,9
E33037399,493,265,65,200,1,30,17,13,195,188,0,6,1,2
E33037400,401,193,52,141,1,7,4,3,196,185,0,9,2,4
E33037401,1457,805,184,621,14,79,45,34,555,525,3,26,1,4
E33037402,467,291,81,210,3,51,34,17,119,110,1,8,0,3
E33037403,244,146,24,122,2,6,2,4,90,86,1,3,0,0
E33037404,788,426,107,319,6,48,26,22,297,279,0,17,1,11
E33037405,264,139,31,108,1,36,27,9,86,83,0,2,1,2
E33037406,321,176,38,138,3,37,29,8,101,90,2,8,1,4
E33037407,224,100,22,78,5,38,27,11,79,75,1,3,0,2
E33037408,697,455,134,321,8,46,25,21,182,170,1,10,1,6
E33037409,218,124,27,97,2,6,5,1,84,79,0,5,0,2
E33037410,477,196,44,152,5,17,7,10,254,248,2,4,0,5
E33037411,534,311,100,211,3,43,24,19,171,165,0,6,0,6
E33037412,610,278,58,220,7,28,15,13,294,280,3,10,1,3
E33037413,231,118,31,87,1,13,5,8,90,86,1,3,0,9
E33037414,354,157,34,123,3,25,9,16,164,149,5,7,3,5
E33037415,466,216,65,151,7,57,36,21,176,169,0,7,0,10
E33037416,702,298,72,226,5,42,27,15,352,336,1,14,1,5
E33037417,481,269,80,189,7,23,15,8,179,175,0,4,0,3
E33037418,141,69,18,51,3,9,4,5,60,55,0,5,0,0
E33037419,556,273,69,204,3,28,15,13,249,234,1,12,2,3
E33037420,282,99,26,73,1,13,5,8,162,156,0,6,0,7
E33037421,619,368,94,274,5,42,27,15,199,190,0,9,0,5
E33037422,331,223,64,159,2,33,20,13,73,65,0,8,0,0
E33037423,234,151,49,102,1,20,15,5,61,58,0,3,0,1
E33037424,277,170,50,120,3,49,38,11,51,48,2,1,0,4
E33037425,2362,1567,298,1269,31,105,67,38,646,602,2,41,1,13
E33037426,311,177,36,141,0,33,19,14,98,94,0,4,0,3
E33037427,442,287,99,188,5,40,18,22,107,100,0,5,2,3
E33037428,652,507,147,360,6,20,10,10,116,106,2,8,0,3
E33037429,501,308,84,224,3,59,36,23,128,122,1,4,1,3
E33037430,286,169,44,125,5,29,21,8,81,79,0,2,0,2
E33037431,1189,730,154,576,9,87,59,28,360,341,1,18,0,3
E33037432,483,334,76,258,4,53,28,25,91,77,0,13,1,1
E33037433,374,257,67,190,4,30,20,10,79,72,0,7,0,4
E33037434,388,214,55,159,8,59,33,26,103,97,0,6,0,4
E33037435,923,604,119,485,8,90,55,35,213,139,34,10,30,8
E33037436,296,200,49,151,1,16,8,8,75,52,14,4,5,4
E33037437,493,388,105,283,7,36,17,19,59,51,4,3,1,3
E33037438,3735,2633,549,2084,37,269,152,117,784,480,167,30,107,12
E33037439,675,539,186,353,6,54,31,23,76,51,17,1,7,0
E33037440,474,334,118,216,6,7,1,6,126,118,2,5,1,1
E33037441,224,151,33,118,1,34,23,11,38,37,0,1,0,0
E33037442,250,152,42,110,5,47,30,17,44,42,0,1,1,2
E33037443,281,200,46,154,2,38,23,15,40,38,0,1,1,1
E33037444,207,152,32,120,1,21,17,4,33,27,1,5,0,0
E33037445,280,182,45,137,2,52,30,22,44,37,0,6,1,0
E33037446,342,215,51,164,1,36,22,14,90,83,1,5,1,0
E33037447,225,169,43,126,1,25,14,11,30,26,1,3,0,0
E33037448,220,171,35,136,0,19,9,10,28,25,0,3,0,2
E33037449,1153,821,184,637,19,84,38,46,222,196,1,23,2,7
E33037450,280,213,50,163,8,23,12,11,33,24,0,9,0,3
E33037451,5688,4104,886,3218,58,466,287,179,1031,844,73,69,45,29
E33037452,242,156,35,121,1,41,25,16,44,40,0,3,1,0
E33037453,275,166,47,119,1,40,27,13,67,57,0,10,0,1
E33037454,200,131,29,102,2,15,12,3,50,42,0,8,0,2
E33037455,395,328,70,258,5,14,8,6,47,44,0,2,1,1
E33037456,387,266,57,209,3,31,15,16,87,81,1,4,1,0
E33037457,804,524,113,411,12,108,72,36,157,134,2,17,4,3
E33037458,558,369,75,294,4,37,19,18,146,128,1,15,2,2
E33037459,630,507,154,353,4,53,31,22,66,58,5,2,1,0
E33037460,543,377,79,298,8,76,45,31,80,75,1,4,0,2
E33037461,279,196,60,136,3,36,18,18,43,42,0,1,0,1
E33037462,973,673,157,516,11,85,36,49,197,174,4,17,2,7
E33037463,826,559,129,430,7,91,51,40,164,147,1,13,3,5
E33037464,587,410,111,299,2,74,45,29,98,87,1,9,1,3
E33037465,284,194,52,142,4,32,22,10,52,50,0,2,0,2
E33037466,247,183,52,131,3,29,15,14,32,29,0,2,1,0
E33037467,897,611,139,472,8,130,93,37,146,135,2,9,0,2
E33037468,390,293,96,197,4,44,18,26,49,46,0,3,0,0
E33037469,436,295,69,226,3,56,35,21,80,79,0,1,0,2
E33037470,332,238,73,165,2,35,21,14,55,49,2,4,0,2
E33037471,336,208,50,158,2,56,35,21,69,62,0,6,1,1
E33037472,563,435,113,322,8,41,18,23,78,72,0,5,1,1
E33037473,537,287,86,201,3,80,55,25,163,139,0,22,2,4
E33037474,465,355,86,269,8,21,10,11,78,52,12,6,8,3
E33037475,648,498,80,418,8,39,13,26,101,91,2,2,6,2
E33037476,957,665,142,523,11,98,64,34,179,157,3,17,2,4
E33037477,1675,1208,248,960,9,100,60,40,356,163,131,18,44,2
E33037478,492,322,75,247,5,59,33,26,105,99,2,4,0,1
E33037479,427,278,75,203,4,44,21,23,101,94,2,5,0,0
E33037480,476,320,85,235,2,45,27,18,107,95,2,9,1,2
E33037481,341,182,49,133,2,18,14,4,138,125,4,8,1,1
E33037482,586,336,87,249,2,67,44,23,176,161,1,14,0,5
E33037483,386,253,74,179,1,21,10,11,105,93,3,7,2,6
E33037484,293,202,50,152,0,31,18,13,59,46,3,5,5,1
E33037485,287,163,37,126,2,23,9,14,98,89,0,9,0,1
E33037486,208,90,24,66,2,24,16,8,91,91,0,0,0,1
E33037487,599,302,58,244,5,77,38,39,214,202,2,9,1,1
E33037488,847,455,106,349,14,115,68,47,262,253,0,9,0,1
E33037489,808,468,128,340,11,91,64,27,233,221,1,10,1,5
E33037490,1191,731,201,530,11,103,68,35,337,318,2,16,1,9
E33037491,1649,1168,240,928,28,82,40,42,363,327,3,33,0,8
E33037492,1649,857,188,669,16,215,139,76,557,525,2,25,5,4
E33037493,436,215,57,158,1,71,46,25,148,137,0,11,0,1
E33037494,218,139,32,107,2,25,16,9,49,45,2,2,0,3
E33037495,263,192,31,161,4,8,5,3,59,55,0,4,0,0
E33037496,312,238,52,186,2,7,4,3,63,57,0,5,1,2
E33037497,230,95,22,73,3,37,30,7,95,90,1,4,0,0
E33037498,526,344,100,244,4,55,34,21,121,116,2,2,1,2
E33037499,300,191,47,144,0,33,17,16,76,73,0,3,0,0
E33037500,530,329,70,259,5,47,24,23,144,125,3,15,1,5
E33037501,1519,1070,293,777,18,228,154,74,199,185,0,12,2,4
E33037502,229,144,42,102,2,19,13,6,64,60,1,3,0,0
E33037503,1739,1218,222,996,23,73,43,30,419,386,2,25,6,6
E33037504,1021,783,204,579,8,60,38,22,169,157,1,10,1,1
E33037505,278,156,35,121,5,24,13,11,90,81,2,5,2,3
E33037506,1938,1347,320,1027,27,113,69,44,445,411,7,23,4,6
E33037507,976,439,126,313,6,221,147,74,307,290,3,14,0,3
E33037508,697,374,86,288,6,75,47,28,236,228,1,4,3,6
E33037509,668,404,133,271,15,97,55,42,149,144,1,4,0,3
E33037510,444,314,69,245,3,44,23,21,78,73,2,2,1,5
E33037511,469,341,82,259,4,40,27,13,82,73,0,8,1,2
E33037512,328,185,65,120,2,60,44,16,79,73,0,5,1,2
E33037513,252,183,45,138,5,21,12,9,41,39,0,2,0,2
E33037514,493,305,82,223,7,46,30,16,134,125,1,8,0,1
E33037515,228,127,37,90,0,45,36,9,55,45,1,8,1,1
E33037516,249,114,23,91,2,77,61,16,54,52,0,2,0,2
E33037517,538,340,92,248,6,86,52,34,103,98,0,4,1,3
E33037518,254,171,53,118,5,29,22,7,47,43,0,4,0,2
E33037519,348,270,37,233,3,27,9,18,46,45,0,1,0,2
E33037520,402,305,68,237,7,27,21,6,61,59,0,1,1,2
E33037521,367,255,65,190,4,41,17,24,64,60,1,3,0,3
E33037522,323,203,49,154,1,58,42,16,59,57,0,2,0,2
E33037523,863,661,138,523,7,86,54,32,108,100,2,5,1,1
E33037524,523,379,83,296,4,54,35,19,83,72,1,7,3,3
E33037525,258,161,53,108,1,37,24,13,57,51,3,2,1,2
E33037526,950,658,130,528,14,44,27,17,232,222,2,5,3,2
E33037527,746,472,121,351,8,96,63,33,164,151,4,9,0,6
E33037528,1002,756,248,508,4,29,17,12,205,192,6,2,5,8
E33037529,569,256,73,183,7,82,42,40,218,213,1,3,1,6
E33037530,719,581,164,417,5,52,35,17,75,67,0,7,1,6
E33037531,383,284,88,196,7,41,27,14,50,47,0,2,1,1
E33037532,527,386,98,288,3,59,46,13,76,70,0,4,2,3
E33037533,9715,6638,1559,5079,132,857,495,362,2043,1894,38,84,27,45
E33037534,1092,656,149,507,10,154,96,58,269,258,1,9,1,3
E33037535,233,177,69,108,1,15,6,9,37,32,0,5,0,3
E33037536,379,258,75,183,0,25,3,22,92,87,0,5,0,4
E33037537,239,167,60,107,1,16,1,15,54,48,4,2,0,1
E33037538,1253,1014,258,756,8,37,4,33,187,171,2,14,0,7
E33037539,283,184,74,110,3,35,5,30,60,59,0,0,1,1
E33037540,442,312,132,180,9,35,3,32,84,78,0,6,0,2
E33037541,640,434,125,309,8,84,24,60,112,105,1,6,0,2
E33037542,349,262,78,184,6,19,7,12,61,56,1,4,0,1
E33037543,225,132,40,92,1,24,3,21,68,63,0,5,0,0
E33037544,400,278,91,187,5,37,3,34,80,77,0,3,0,0
E33037545,864,698,172,526,8,29,0,29,127,123,2,2,0,2
E33037546,374,274,69,205,4,17,0,17,76,69,0,6,1,3
E33037547,452,314,73,241,2,32,1,31,99,89,0,8,2,5
E33037548,447,295,83,212,4,51,5,46,92,78,3,11,0,5
E33037549,626,443,134,309,9,51,7,44,117,101,0,15,1,6
E33037550,259,181,39,142,0,20,3,17,54,43,2,9,0,4
E33037551,398,269,85,184,4,24,2,22,98,87,0,11,0,3
E33037552,240,178,49,129,2,21,1,20,38,34,0,4,0,1
E33037553,216,160,59,101,2,8,1,7,45,41,1,3,0,1
E33037554,205,134,34,100,3,18,2,16,50,46,1,2,1,0
E33037555,242,177,52,125,2,19,1,18,42,37,1,4,0,2
E33037556,554,475,139,336,4,16,0,16,56,52,0,4,0,3
E33037557,374,262,85,177,1,36,1,35,72,62,1,9,0,3
E33037558,388,279,83,196,2,30,4,26,76,72,0,4,0,1
E33037559,289,228,59,169,2,17,2,15,41,32,1,8,0,1
E33037560,570,436,85,351,3,18,4,14,106,95,0,11,0,7
E33037561,391,272,83,189,4,36,5,31,77,67,1,8,1,2
E33037562,466,325,94,231,6,26,6,20,105,97,1,5,2,4
E33037563,315,196,73,123,3,26,2,24,88,81,2,5,0,2
E33037564,474,304,104,200,3,40,8,32,127,117,0,10,0,0
E33037565,455,269,93,176,1,49,3,46,133,122,4,4,3,3
E33037566,393,260,69,191,3,26,2,24,98,92,0,5,1,6
E33037567,346,251,94,157,2,15,0,15,71,67,0,2,2,7
E33037568,217,137,34,103,2,25,2,23,52,49,0,3,0,1
E33037569,428,292,81,211,3,25,2,23,105,97,0,5,3,3
E33037570,1081,749,222,527,11,78,5,73,237,209,3,21,4,6
E33037571,228,161,47,114,7,13,1,12,46,44,1,1,0,1
E33037572,354,241,79,162,2,17,0,17,90,82,0,8,0,4
E33037573,422,298,80,218,5,30,10,20,85,77,3,2,3,4
E33037574,221,177,48,129,0,18,8,10,25,25,0,0,0,1
E33037575,235,168,42,126,5,14,4,10,46,39,0,7,0,2
E33037576,229,130,34,96,1,50,12,38,47,43,1,2,1,1
E33037577,416,281,78,203,6,60,21,39,66,61,0,5,0,3
E33037578,151,102,17,85,1,16,7,9,30,27,2,1,0,2
E33037579,467,324,97,227,2,63,14,49,76,70,2,4,0,2
E33037580,208,137,38,99,1,25,6,19,45,39,1,3,2,0
E33037581,528,340,99,241,7,85,23,62,94,86,1,6,1,2
E33037582,472,300,88,212,5,75,19,56,84,77,3,4,0,8
E33037583,434,301,78,223,9,54,13,41,67,64,2,1,0,3
E33037584,698,531,121,410,14,45,9,36,107,100,0,6,1,1
E33037585,401,313,57,256,9,14,3,11,63,53,4,5,1,2
E33037586,306,236,53,183,4,19,4,15,46,46,0,0,0,1
E33037587,377,299,78,221,3,29,10,19,46,41,5,0,0,0
E33037588,253,173,50,123,4,30,7,23,45,41,1,3,0,1
E33037589,242,178,40,138,4,26,11,15,33,32,0,1,0,1
E33037590,260,201,62,139,0,22,5,17,34,31,0,3,0,3
E33037591,218,151,39,112,5,20,5,15,40,36,0,3,1,2
E33037592,522,372,106,266,6,68,27,41,75,75,0,0,0,1
E33037593,391,300,78,222,8,36,6,30,41,37,0,3,1,6
E33037594,445,301,66,235,3,54,16,38,85,81,0,1,3,2
E33037595,219,152,30,122,5,32,16,16,30,25,0,5,0,0
E33037596,395,282,89,193,3,44,13,31,65,59,1,4,1,1
E33037597,1135,753,206,547,20,117,39,78,234,217,1,15,1,11
E33037598,216,164,43,121,3,12,3,9,37,35,0,2,0,0
E33037599,486,324,100,224,5,63,23,40,92,83,2,6,1,2
E33037600,254,113,40,73,2,29,8,21,108,101,3,2,2,2
E33037601,645,460,128,332,10,65,16,49,104,98,1,2,3,6
E33037602,228,154,39,115,1,33,12,21,37,35,0,0,2,3
E33037603,218,137,50,87,3,42,13,29,35,33,0,2,0,1
E33037604,441,366,102,264,10,24,7,17,37,32,0,4,1,4
E33037605,268,183,47,136,3,42,12,30,38,33,1,0,4,2
E33037606,568,391,107,284,6,65,21,44,101,94,0,4,3,5
E33037607,900,567,131,436,4,176,56,120,146,133,4,9,0,7
E33037608,515,376,97,279,6,65,18,47,67,61,1,5,0,1
E33037609,426,312,100,212,7,38,9,29,67,64,0,3,0,2
E33037610,611,405,117,288,6,107,29,78,90,83,0,6,1,3
E33037611,488,354,91,263,10,40,17,23,83,81,0,1,1,1
E33037612,684,478,136,342,10,102,29,73,92,88,0,4,0,2
E33037613,1471,805,219,586,13,146,51,95,504,169,209,8,118,3
E33037614,302,210,66,144,3,40,14,26,47,43,1,2,1,2
E33037615,444,331,67,264,11,42,15,27,60,57,1,2,0,0
E33037616,970,737,176,561,7,56,15,41,164,156,1,6,1,6
E33037617,290,215,75,140,5,27,8,19,43,43,0,0,0,0
E33037618,508,351,110,241,5,70,14,56,78,68,3,7,0,4
E33037619,318,248,71,177,2,11,2,9,53,51,0,2,0,4
E33037620,822,648,209,439,14,50,13,37,98,89,4,5,0,12
E33037621,276,205,64,141,6,13,5,8,47,41,0,1,5,5
E33037622,506,319,99,220,7,99,14,85,80,75,0,4,1,1
E33037623,226,163,46,117,5,2,1,1,53,51,0,2,0,3
E33037624,224,178,60,118,4,8,0,8,23,18,1,2,2,11
E33037625,288,209,54,155,3,26,4,22,47,38,0,7,2,3
E33037626,520,412,163,249,3,33,8,25,63,56,0,3,4,9
E33037627,327,249,81,168,2,28,2,26,46,43,1,1,1,2
E33037628,373,232,61,171,2,31,6,25,106,102,1,3,0,2
E33037629,205,147,51,96,2,20,5,15,32,28,1,2,1,4
E33037630,301,219,78,141,2,41,10,31,38,36,1,1,0,1
E33037631,207,140,47,93,3,27,5,22,36,34,0,2,0,1
E33037632,510,333,102,231,11,105,19,86,58,55,1,2,0,3
E33037633,230,174,50,124,1,21,3,18,30,29,0,1,0,4
E33037634,583,390,135,255,5,96,34,62,86,78,3,4,1,6
E33037635,449,300,94,206,7,54,18,36,83,81,0,2,0,5
E33037636,665,448,141,307,4,85,42,43,121,109,1,7,4,7
E33037637,225,163,47,116,5,23,6,17,32,28,4,0,0,2
E33037638,264,190,47,143,4,24,10,14,43,39,2,1,1,3
E33037639,384,297,94,203,7,39,17,22,32,22,2,5,3,9
E33037640,608,421,132,289,10,77,25,52,95,83,5,2,5,5
E33037641,279,192,67,125,9,25,9,16,52,46,1,5,0,1
E33037642,239,171,51,120,1,25,4,21,41,37,1,3,0,1
E33037643,206,133,36,97,1,17,4,13,51,42,7,2,0,4
E33037644,531,384,103,281,6,25,7,18,108,100,1,5,2,8
E33037645,201,103,40,63,2,15,7,8,69,49,12,2,6,12
E33037646,778,566,143,423,5,48,19,29,156,148,1,7,0,3
E33037647,308,186,75,111,5,46,20,26,54,45,5,2,2,17
E33037648,244,167,57,110,7,15,8,7,51,42,5,3,1,4
E33037649,425,298,97,201,5,29,9,20,83,79,0,4,0,10
E33037650,206,134,51,83,0,18,2,16,49,38,2,2,7,5
E33037651,518,393,140,253,10,36,7,29,69,58,2,4,5,10
E33037652,1793,1220,321,899,26,118,46,72,417,394,0,21,2,12
E33037653,258,157,54,103,5,44,25,19,50,47,0,3,0,2
E33037654,845,534,149,385,13,115,52,63,182,171,0,6,5,1
E33037655,370,228,59,169,5,50,24,26,83,74,3,4,2,4
E33037656,372,254,79,175,2,38,14,24,74,61,10,1,2,4
E33037657,377,303,92,211,4,17,7,10,50,46,2,1,1,3
E33037658,414,267,89,178,3,61,21,40,81,69,4,6,2,2
E33037659,481,329,69,260,10,29,19,10,106,97,3,5,1,7
E33037660,951,630,205,425,12,75,33,42,226,208,6,3,9,8
E33037661,223,178,55,123,1,12,5,7,31,30,1,0,0,1
E33037662,487,331,102,229,3,57,29,28,95,91,1,2,1,1
E33037663,574,425,126,299,8,51,23,28,87,82,0,4,1,3
E33037664,115,74,36,38,3,17,11,6,21,20,0,1,0,0
E33037665,311,230,47,183,5,26,11,15,50,48,1,1,0,0
E33037666,598,437,121,316,7,58,34,24,95,91,0,4,0,1
E33037667,334,246,69,177,5,41,21,20,41,37,2,2,0,1
E33037668,465,324,100,224,9,46,22,24,84,76,0,5,3,2
E33037669,529,351,97,254,7,53,22,31,116,100,6,10,0,2
E33037670,736,557,168,389,12,59,36,23,104,96,1,6,1,4
E33037671,424,299,81,218,7,49,30,19,66,61,0,3,2,3
E33037672,403,286,63,223,10,37,21,16,68,63,0,4,1,2
E33037673,399,252,53,199,0,41,22,19,105,104,0,1,0,1
E33037674,648,492,115,377,3,23,11,12,128,126,0,2,0,2
E33037675,1307,950,286,664,13,153,98,55,183,168,5,7,3,8
E33037676,982,731,201,530,9,57,32,25,179,172,1,6,0,6
E33037677,220,141,50,91,3,21,10,11,44,38,2,1,3,11
E33037678,362,257,104,153,4,48,27,21,53,48,3,1,1,0
E33037679,231,147,59,88,1,14,2,12,63,56,4,3,0,6
E33037680,602,412,96,316,4,35,17,18,145,132,2,6,5,6
E33037681,1151,864,166,698,12,40,22,18,228,219,2,6,1,7
E33037682,294,175,53,122,7,33,21,12,77,69,0,6,2,2
E33037683,738,559,128,431,13,32,14,18,131,122,2,7,0,3
E33037684,911,613,135,478,13,76,34,42,206,188,3,14,1,3
E33037685,785,600,128,472,11,22,9,13,146,134,2,9,1,6
E33037686,360,264,72,192,3,26,16,10,66,58,3,4,1,1
E33037687,203,149,35,114,1,6,2,4,44,39,2,1,2,3
E33037688,374,275,75,200,4,40,27,13,54,48,1,4,1,1
E33037689,491,366,119,247,6,27,13,14,90,84,0,2,4,2
E33037690,567,416,151,265,11,67,44,23,70,64,1,3,2,3
E33037691,395,271,71,200,5,27,10,17,89,80,2,5,2,3
E33037692,301,169,38,131,7,55,24,31,67,59,1,6,1,3
E33037693,600,447,100,347,14,57,28,29,78,71,1,6,0,4
E33037694,306,196,58,138,4,41,23,18,64,60,0,4,0,1
E33037695,1008,684,182,502,12,111,57,54,198,180,3,14,1,3
E33037696,274,211,66,145,2,16,9,7,44,41,0,3,0,1
E33037697,689,534,125,409,11,23,11,12,109,103,3,2,1,12
E33037698,535,400,121,279,7,47,24,23,75,67,3,2,3,6
E33037699,713,555,156,399,7,51,26,25,96,87,6,1,2,4
E33037700,510,321,95,226,12,77,41,36,98,94,1,3,0,2
E33037701,279,192,48,144,3,41,19,22,41,37,1,2,1,2
E33037702,293,183,56,127,2,38,21,17,66,59,1,6,0,4
E33037703,321,182,44,138,0,29,17,12,107,101,0,5,1,3
E33037704,1565,901,275,626,8,170,94,76,477,458,3,15,1,9
E33037705,262,147,35,112,0,37,21,16,78,76,0,2,0,0
E33037706,945,502,171,331,11,84,51,33,342,327,1,13,1,6
E33037707,352,261,75,186,5,27,15,12,59,53,0,6,0,0
E33037708,369,267,59,208,1,44,26,18,56,50,0,6,0,1
E33037709,550,359,88,271,4,74,31,43,108,96,0,11,1,5
E33037710,353,251,78,173,3,16,11,5,81,77,0,4,0,2
E33037711,452,279,59,220,3,33,16,17,136,128,0,8,0,1
E33037712,221,152,37,115,1,11,8,3,56,54,0,2,0,1
E33037713,221,162,49,113,0,13,10,3,43,39,0,4,0,3
E33037714,211,162,44,118,1,11,6,5,36,33,1,1,1,1
E33037715,207,153,52,101,2,10,6,4,42,36,2,4,0,0
E33037716,285,182,51,131,1,19,11,8,81,79,0,2,0,2
E33037717,239,159,37,122,0,19,15,4,59,57,1,1,0,2
E33037718,370,228,59,169,3,38,21,17,99,89,3,7,0,2
E33037719,305,204,46,158,3,25,10,15,72,70,1,1,0,1
E33037720,167,102,33,69,0,14,8,6,51,46,2,2,1,0
E33037721,286,192,47,145,2,17,11,6,75,69,0,6,0,0
E33037722,169,122,29,93,0,11,6,5,34,33,0,1,0,2
E33037723,4037,2836,804,2032,37,307,191,116,847,720,70,25,32,10
E33037724,697,478,102,376,5,46,19,27,168,156,3,8,1,0
E33037725,573,344,83,261,6,67,40,27,154,147,2,5,0,2
E33037726,642,335,83,252,10,79,44,35,215,196,3,14,2,3
E33037727,125,84,18,66,4,4,0,4,32,30,0,2,0,1
E33037728,771,462,112,350,7,110,78,32,189,176,0,10,3,3
E33037729,352,241,58,183,2,47,34,13,58,54,0,4,0,4
E33037730,408,290,57,233,2,16,7,9,95,86,2,5,2,5
E33037731,681,511,130,381,7,23,12,11,137,123,1,12,1,3
E33037732,276,166,47,119,0,20,13,7,87,80,1,3,3,3
E33037733,456,307,69,238,4,38,21,17,105,96,1,8,0,2
E33037734,355,269,86,183,5,19,9,10,62,57,0,5,0,0
E33037735,361,230,61,169,4,28,20,8,97,85,3,9,0,2
E33037736,771,601,138,463,9,24,13,11,130,124,1,4,1,7
E33037737,227,167,54,113,1,7,4,3,51,50,0,1,0,1
E33037738,615,422,133,289,4,70,44,26,118,111,2,4,1,1
E33037739,608,450,130,320,4,31,19,12,121,113,0,6,2,2
E33037740,705,462,153,309,1,73,18,55,166,157,1,7,1,3
E33037741,1274,921,252,669,5,91,11,80,247,233,2,11,1,10
E33037742,309,196,54,142,3,35,4,31,71,66,1,3,1,4
E33037743,409,257,53,204,6,31,4,27,112,102,1,9,0,3
E33037744,210,127,24,103,1,15,2,13,67,65,1,1,0,0
E33037745,339,202,61,141,1,27,5,22,106,103,2,1,0,3
E33037746,227,143,41,102,0,11,1,10,70,65,0,5,0,3
E33037747,306,223,70,153,3,19,2,17,60,53,1,5,1,1
E33037748,948,544,134,410,5,91,12,79,302,275,3,24,0,6
E33037749,348,203,50,153,2,27,3,24,115,105,3,7,0,1
E33037750,459,274,84,190,2,38,7,31,143,133,0,9,1,2
E33037751,208,137,46,91,2,10,3,7,57,53,0,3,1,2
E33037752,405,258,81,177,2,21,3,18,122,116,0,6,0,2
E33037753,223,135,46,89,2,18,3,15,67,64,0,3,0,1
E33037754,269,164,58,106,2,23,4,19,79,68,3,3,5,1
E33037755,2752,1965,563,1402,16,172,28,144,588,544,8,27,9,11
E33037756,428,274,72,202,1,30,7,23,123,113,3,7,0,0
E33037757,582,462,114,348,2,21,5,16,91,84,0,6,1,6
E33037758,433,293,89,204,1,32,2,30,107,101,1,5,0,0
E33037759,514,351,84,267,1,35,6,29,124,119,0,4,1,3
E33037760,539,332,102,230,1,83,16,67,122,112,0,10,0,1
E33037761,142,106,44,62,1,9,1,8,26,25,0,1,0,0
E33037762,511,318,124,194,1,56,3,53,130,119,3,7,1,6
E33037763,652,424,144,280,7,91,29,62,116,116,0,0,0,14
E33037764,420,258,79,179,4,6,3,3,149,136,0,9,4,3
E33037765,219,147,41,106,0,20,14,6,48,40,4,3,1,4
E33037766,712,518,123,395,6,62,48,14,121,111,0,9,1,5
E33037767,1670,1355,195,1160,30,49,35,14,220,199,1,19,1,16
E33037768,353,259,93,166,6,37,28,9,50,48,0,2,0,1
E33037769,283,221,58,163,1,11,6,5,47,42,0,5,0,3
E33037770,284,200,64,136,1,17,11,6,64,61,1,2,0,2
E33037771,231,150,36,114,1,28,22,6,51,47,0,3,1,1
E33037772,606,469,84,385,9,23,10,13,101,94,0,7,0,4
E33037773,348,210,64,146,9,51,40,11,72,66,0,6,0,6
E33037774,541,342,125,217,8,39,31,8,146,129,6,9,2,6
E33037775,565,392,103,289,9,51,34,17,112,103,0,9,0,1
E33037776,250,182,65,117,2,15,11,4,49,43,0,4,2,2
E33037777,313,246,84,162,0,23,19,4,44,41,0,2,1,0
E33037778,343,240,83,157,4,23,19,4,74,70,0,3,1,2
E33037779,925,710,215,495,9,50,42,8,154,140,1,11,2,2
E33037780,1141,918,273,645,5,30,17,13,183,168,0,15,0,5
E33037781,976,657,185,472,7,114,77,37,193,176,1,15,1,5
E33037782,492,337,93,244,0,53,35,18,99,85,2,11,1,3
E33037783,334,256,78,178,0,33,26,7,42,38,2,2,0,3
E33037784,388,236,63,173,1,48,35,13,101,97,0,4,0,2
E33037785,396,282,75,207,3,34,19,15,76,69,0,7,0,1
E33037786,424,305,75,230,2,53,32,21,63,58,2,2,1,1
E33037787,474,310,98,212,3,66,42,24,91,86,0,4,1,4
E33037788,660,509,145,364,8,36,24,12,96,92,0,3,1,11
E33037789,492,355,96,259,2,40,27,13,88,82,0,6,0,7
E33037790,285,198,50,148,3,21,15,6,63,59,0,3,1,0
E33037791,230,161,46,115,0,19,13,6,49,47,0,2,0,1
E33037792,214,161,52,109,3,11,7,4,37,37,0,0,0,2
E33037793,209,157,50,107,2,12,8,4,37,35,1,1,0,1
E33037794,274,212,76,136,1,22,17,5,38,35,0,2,1,1
E33037795,311,238,87,151,3,13,4,9,56,55,1,0,0,1
E33037796,357,246,95,151,4,31,12,19,68,60,2,5,1,8
E33037797,476,345,97,248,2,26,10,16,102,91,1,9,1,1
E33037798,213,158,38,120,1,6,3,3,48,44,1,3,0,0
E33037799,414,264,85,179,1,29,3,26,118,108,3,5,2,2
E33037800,311,222,70,152,2,18,7,11,68,66,0,2,0,1
E33037801,301,215,63,152,3,14,1,13,64,61,0,3,0,5
E33037802,395,263,81,182,3,26,11,15,100,95,0,4,1,3
E33037803,617,410,167,243,3,65,23,42,129,114,3,12,0,10
E33037804,360,260,86,174,5,41,9,32,48,41,3,4,0,6
E33037805,310,247,88,159,2,17,12,5,43,42,0,1,0,1
E33037806,951,668,193,475,18,96,48,48,151,139,0,11,1,18
E33037807,346,243,81,162,1,23,10,13,72,66,1,2,3,7
E33037808,601,450,101,349,7,38,18,20,97,88,6,2,1,9
E33037809,386,267,64,203,2,27,14,13,78,71,3,1,3,12
E33037810,581,475,106,369,7,27,14,13,70,62,1,6,1,2
E33037811,517,385,134,251,6,56,32,24,65,59,0,5,1,5
E33037812,217,163,48,115,3,20,9,11,30,27,0,3,0,1
E33037813,281,176,41,135,5,44,25,19,54,49,0,4,1,2
E33037814,258,184,36,148,2,17,9,8,54,45,1,8,0,1
E33037815,335,208,57,151,4,52,27,25,68,60,1,5,2,3
E33037816,966,698,185,513,13,94,39,55,156,147,1,8,0,5
E33037817,459,352,122,230,1,39,21,18,59,51,1,5,2,8
E33037818,295,226,72,154,3,18,12,6,48,42,1,4,1,0
E33037819,458,349,121,228,4,13,8,5,67,56,5,6,0,25
E33037820,259,204,66,138,3,13,6,7,37,30,2,3,2,2
E33037821,361,262,60,202,4,23,12,11,70,59,8,3,0,2
E33037822,1180,852,208,644,23,94,47,47,204,181,1,20,2,7
E33037823,256,187,60,127,1,21,12,9,45,41,1,2,1,2
E33037824,166,126,34,92,2,8,4,4,29,27,0,2,0,1
E33037825,212,162,44,118,1,18,9,9,31,27,1,3,0,0
E33037826,319,235,56,179,5,30,13,17,46,41,2,3,0,3
E33037827,252,168,42,126,0,34,23,11,48,47,0,1,0,2
E33037828,269,220,69,151,0,23,7,16,25,22,0,2,1,1
E33037829,241,182,51,131,1,25,3,22,28,24,1,3,0,5
E33037830,678,509,106,403,7,33,2,31,126,117,4,4,1,3
E33037831,610,512,111,401,4,22,5,17,69,66,1,2,0,3
E33037832,280,190,45,145,1,43,5,38,42,35,1,4,2,4
E33037833,407,333,87,246,6,21,1,20,46,43,0,3,0,1
E33037834,211,161,38,123,6,23,1,22,19,14,2,3,0,2
E33037835,231,147,41,106,1,30,4,26,53,48,1,4,0,0
E33037836,246,160,32,128,2,37,2,35,46,42,1,3,0,1
E33037837,998,636,149,487,30,175,8,167,152,142,1,9,0,5
E33037838,371,265,55,210,15,17,1,16,74,66,4,4,0,0
E33037839,291,210,66,144,8,34,3,31,37,31,0,4,2,2
E33037840,981,727,179,548,17,118,3,115,117,103,4,8,2,2
E33037841,278,156,37,119,7,53,5,48,55,50,3,1,1,7
E33037842,371,252,45,207,5,62,3,59,51,46,2,2,1,1
E33037843,304,189,36,153,3,54,3,51,57,52,0,4,1,1
E33037844,376,273,55,218,10,30,4,26,62,57,0,5,0,1
E33037845,1993,1559,312,1247,23,146,48,98,263,253,4,5,1,2
E33037846,416,295,57,238,11,33,0,33,76,73,0,3,0,1
E33037847,567,441,73,368,5,39,2,37,82,79,1,2,0,0
E33037848,285,202,54,148,7,22,4,18,51,49,1,0,1,3
E33037849,252,181,44,137,6,32,9,23,33,31,1,1,0,0
E33037850,379,230,47,183,4,87,3,84,56,55,0,1,0,2
E33037851,476,320,76,244,7,77,5,72,70,69,1,0,0,2
E33037852,503,367,121,246,8,54,5,49,53,45,3,5,0,21
E33037853,1178,645,125,520,28,183,19,164,315,301,1,11,2,7
E33037854,428,227,42,185,4,85,7,78,110,105,1,4,0,2
E33037855,450,353,78,275,10,37,5,32,47,44,0,2,1,3
E33037856,353,271,79,192,1,44,8,36,36,33,1,0,2,1
E33037857,390,296,65,231,13,45,5,40,36,33,1,2,0,0
E33037858,708,504,100,404,14,108,13,95,81,74,2,4,1,1
E33037859,726,448,72,376,9,125,9,116,141,134,1,6,0,3
E33037860,478,307,86,221,7,87,10,77,76,67,2,5,2,1
E33037861,302,216,43,173,8,40,6,34,36,32,1,3,0,2
E33037862,298,187,41,146,4,47,6,41,58,55,0,3,0,2
E33037863,353,223,40,183,12,46,12,34,69,63,0,6,0,3
E33037864,891,605,118,487,20,92,6,86,172,162,1,9,0,2
E33037865,176,128,30,98,1,21,1,20,24,24,0,0,0,2
E33037866,1248,858,164,694,17,129,29,100,242,228,3,11,0,2
E33037867,582,440,93,347,4,70,7,63,67,58,2,6,1,1
E33037868,293,191,40,151,7,45,3,42,48,42,0,5,1,2
E33037869,269,160,32,128,7,37,7,30,65,62,2,1,0,0
E33037870,423,269,59,210,7,94,8,86,52,49,0,3,0,1
E33037871,527,387,98,289,6,47,3,44,79,74,1,4,0,8
E33037872,609,439,111,328,10,92,12,80,58,51,2,5,0,10
E33037873,738,586,110,476,7,32,3,29,112,101,0,8,3,1
E33037874,278,188,39,149,7,29,1,28,52,49,0,2,1,2
E33037875,305,230,53,177,5,24,6,18,44,42,2,0,0,2
E33037876,428,320,55,265,8,32,7,25,66,56,1,8,1,2
E33037877,451,310,56,254,11,43,5,38,87,83,1,3,0,0
E33037878,414,302,78,224,11,36,2,34,64,61,0,3,0,1
E33037879,288,230,46,184,3,13,4,9,41,36,0,5,0,1
E33037880,325,206,42,164,2,59,4,55,58,55,2,1,0,0
E33037881,479,288,53,235,9,78,7,71,101,92,2,5,2,3
E33037882,285,160,37,123,8,81,4,77,36,29,0,7,0,0
E33037883,410,300,85,215,3,55,6,49,49,48,0,0,1,3
E33037884,485,349,113,236,4,68,5,63,62,56,4,2,0,2
E33037885,249,179,56,123,7,28,10,18,34,31,0,3,0,1
E33037886,485,300,82,218,6,77,18,59,97,85,0,10,2,5
E33037887,291,220,65,155,2,23,3,20,44,39,2,2,1,2
E33037888,226,146,52,94,4,31,5,26,44,37,2,3,2,1
E33037889,380,256,83,173,6,40,11,29,55,47,5,2,1,23
E33037890,263,191,50,141,4,30,4,26,35,29,3,3,0,3
E33037891,776,534,139,395,20,86,17,69,125,106,3,15,1,11
E33037892,492,369,121,248,6,39,12,27,77,58,11,4,4,1
E33037893,235,167,44,123,4,20,9,11,43,36,4,3,0,1
E33037894,541,374,123,251,10,77,16,61,77,72,1,3,1,3
E33037895,218,151,55,96,0,25,8,17,39,39,0,0,0,3
E33037896,209,151,49,102,2,16,6,10,37,34,0,3,0,3
E33037897,626,421,140,281,6,94,25,69,96,74,17,2,3,9
E33037898,471,352,128,224,8,51,9,42,58,54,1,2,1,2
E33037899,656,502,122,380,2,70,30,40,78,74,0,4,0,4
E33037900,220,140,33,107,2,37,14,23,41,37,0,3,1,0
E33037901,604,438,125,313,5,48,5,43,112,96,4,10,2,1
E33037902,569,393,134,259,7,66,21,45,97,87,6,3,1,6
E33037903,318,232,66,166,1,22,2,20,56,51,2,3,0,7
E33037904,261,168,48,120,2,23,3,20,68,56,5,5,2,0
E33037905,324,238,73,165,1,22,3,19,56,44,6,2,4,7
E33037906,233,158,71,87,5,20,5,15,42,32,2,5,3,8
E33037907,1457,891,252,639,21,188,44,144,349,176,102,15,56,8
E33037908,1379,729,200,529,20,281,119,162,340,318,8,7,7,9
E33037909,463,332,56,276,6,20,7,13,105,98,1,6,0,0
E33037910,2363,1816,261,1555,29,88,41,47,417,394,2,18,3,13
E33037911,805,621,181,440,17,63,24,39,104,94,1,8,1,0
E33037912,343,211,46,165,8,53,29,24,65,56,1,5,3,6
E33037913,289,227,69,158,1,22,5,17,37,34,0,3,0,2
E33037914,492,325,90,235,7,65,32,33,94,86,0,7,1,1
E33037915,470,367,103,264,7,32,15,17,62,57,1,3,1,2
E33037916,404,307,81,226,2,29,10,19,64,63,0,1,0,2
E33037917,274,200,49,151,1,29,9,20,44,42,0,2,0,0
E33037918,555,381,97,284,6,66,18,48,100,93,1,6,0,2
E33037919,1105,815,220,595,9,118,43,75,160,153,1,6,0,3
E33037920,564,423,104,319,16,54,20,34,70,66,0,3,1,1
E33037921,699,452,135,317,5,136,79,57,96,86,0,9,1,10
E33037922,586,407,95,312,6,78,41,37,93,81,0,10,2,2
E33037923,837,657,148,509,17,55,16,39,106,96,0,9,1,2
E33037924,439,310,92,218,5,48,15,33,74,64,3,7,0,2
E33037925,230,143,34,109,6,24,3,21,50,46,1,3,0,7
E33037926,239,151,43,108,4,34,10,24,50,46,0,4,0,0
E33037927,571,349,76,273,6,108,30,78,100,89,1,7,3,8
E33037928,791,539,133,406,10,65,20,45,173,159,5,8,1,4
E33037929,315,201,41,160,4,31,6,25,57,52,2,2,1,22
E33037930,370,246,70,176,1,53,19,34,56,50,2,2,2,14
E33037931,661,531,123,408,5,50,12,38,73,68,0,5,0,2
E33037932,831,564,168,396,14,122,54,68,129,122,0,7,0,2
E33037933,615,429,103,326,13,80,29,51,92,85,1,6,0,1
E33037934,488,322,77,245,7,67,28,39,91,80,1,9,1,1
E33037935,321,217,62,155,11,43,8,35,49,45,0,4,0,1
E33037936,686,549,153,396,10,45,18,27,79,73,1,3,2,3
E33037937,850,612,144,468,6,63,31,32,167,159,1,6,1,2
E33037938,592,431,94,337,8,68,29,39,81,78,0,3,0,4
E33037939,2089,1517,409,1108,29,255,136,119,281,260,5,15,1,7
E33037940,676,508,124,384,11,63,22,41,88,84,2,2,0,6
E33037941,241,180,53,127,3,31,11,20,26,23,1,2,0,1
E33037942,454,342,73,269,4,35,18,17,71,65,0,6,0,2
E33037943,447,329,71,258,8,49,26,23,60,51,1,8,0,1
E33037944,229,178,50,128,0,26,12,14,25,22,0,3,0,0
E33037945,835,605,144,461,7,71,32,39,151,146,0,5,0,1
E33037946,242,174,38,136,1,29,15,14,37,33,0,4,0,1
E33037947,207,139,56,83,1,21,12,9,46,36,1,5,4,0
E33037948,369,281,73,208,3,27,13,14,55,48,2,4,1,3
E33037949,384,285,65,220,5,20,10,10,73,66,1,6,0,1
E33037950,830,619,167,452,16,71,37,34,120,111,1,7,1,4
E33037951,303,231,64,167,1,39,23,16,28,28,0,0,0,4
E33037952,405,304,64,240,5,36,21,15,59,49,4,6,0,1
E33037953,278,221,56,165,0,12,6,6,43,40,0,3,0,2
E33037954,310,239,68,171,0,20,8,12,48,38,5,4,1,3
E33037955,663,540,132,408,5,44,28,16,72,64,4,1,3,2
E33037956,244,164,31,133,3,20,8,12,54,49,3,2,0,3
E33037957,422,291,85,206,3,37,22,15,84,75,2,7,0,7
E33037958,349,264,59,205,4,36,15,21,44,36,1,7,0,1
E33037959,218,153,44,109,1,24,12,12,38,32,1,3,2,2
E33037960,255,185,39,146,3,18,5,13,47,36,3,7,1,2
E33037961,227,160,41,119,2,27,11,16,38,35,0,2,1,0
E33037962,219,163,28,135,2,17,8,9,36,28,3,4,1,1
E33037963,428,261,51,210,1,75,38,37,90,74,0,16,0,1
E33037964,188,125,37,88,0,15,9,6,46,41,1,3,1,2
E33037965,203,143,38,105,0,22,14,8,32,32,0,0,0,6
E33037966,506,363,69,294,1,73,36,37,66,54,2,7,3,3
E33037967,374,285,77,208,4,33,19,14,51,44,2,5,0,1
E33037968,698,523,143,380,13,73,46,27,88,82,0,4,2,1
E33037969,314,239,72,167,3,28,10,18,43,39,1,2,1,1
E33037970,360,282,83,199,2,33,16,17,36,31,0,4,1,7
E33037971,318,242,50,192,6,19,9,10,50,43,0,5,2,1
E33037972,250,182,30,152,2,10,6,4,56,54,0,2,0,0
E33037973,911,616,162,454,5,126,69,57,160,139,3,17,1,4
E33037974,317,207,37,170,3,27,14,13,77,68,1,8,0,3
E33037975,296,231,50,181,4,7,6,1,52,50,0,2,0,2
E33037976,325,259,58,201,4,9,5,4,53,50,1,1,1,0
E33037977,1939,1520,232,1288,11,62,23,39,333,272,28,14,19,13
E33037978,325,260,64,196,3,22,15,7,38,32,1,3,2,2
E33037979,2769,1939,430,1509,23,243,139,104,550,301,142,22,85,14
E33037980,697,395,91,304,9,101,50,51,186,169,5,9,3,6
E33037981,493,361,85,276,5,52,21,31,74,68,1,3,2,1
E33037982,1604,1153,273,880,26,149,84,65,267,240,4,20,3,9
E33037983,210,160,39,121,2,20,9,11,28,24,2,2,0,0
E33037984,2063,1674,451,1223,25,81,47,34,276,254,7,15,0,7
E33037985,1194,965,273,692,11,75,37,38,140,127,4,8,1,3
E33037986,494,366,92,274,5,36,14,22,86,75,4,5,2,1
E33037987,903,706,159,547,9,68,38,30,120,103,7,8,2,0
E33037988,478,340,94,246,4,45,27,18,85,71,2,12,0,4
E33037989,1806,1230,318,912,10,147,85,62,412,221,121,18,52,7
E33037990,750,564,131,433,6,69,42,27,111,91,3,15,2,0
E33037991,461,325,81,244,2,36,24,12,94,80,3,9,2,4
E33037992,455,315,69,246,2,52,26,26,85,68,4,10,3,1
E33037993,318,207,35,172,5,39,22,17,64,53,5,5,1,3
E33037994,630,480,125,355,7,65,33,32,78,66,5,4,3,0
E33037995,238,167,33,134,8,29,13,16,32,29,1,1,1,2
E33037996,713,513,107,406,14,56,18,38,130,113,7,4,6,0
E33037997,368,261,105,156,2,38,12,26,61,52,4,4,1,6
E33037998,316,242,70,172,3,36,13,23,33,28,0,4,1,2
E33037999,210,140,44,96,3,13,2,11,42,36,0,5,1,12
E33038000,229,151,36,115,10,20,3,17,45,43,2,0,0,3
E33038001,204,140,32,108,1,32,17,15,31,28,0,3,0,0
E33038002,363,307,67,240,4,13,1,12,35,31,0,3,1,4
E33038003,216,173,48,125,3,11,1,10,27,27,0,0,0,2
E33038004,1120,815,209,606,14,119,14,105,167,143,10,12,2,5
E33038005,564,387,81,306,10,39,6,33,126,115,1,9,1,2
E33038006,321,272,69,203,2,11,4,7,36,29,1,5,1,0
E33038007,240,176,39,137,6,22,3,19,32,23,0,5,4,4
E33038008,613,477,100,377,3,19,5,14,111,103,1,7,0,3
E33038009,200,167,32,135,1,5,1,4,26,23,0,3,0,1
E33038010,579,418,82,336,12,24,2,22,122,110,0,10,2,3
E33038011,221,141,45,96,3,35,8,27,36,30,4,2,0,6
E33038012,515,313,73,240,6,50,10,40,142,106,9,14,13,4
E33038013,1393,1034,161,873,22,75,25,50,257,243,2,8,4,5
E33038014,224,181,37,144,1,6,1,5,34,31,0,2,1,2
E33038015,2362,1876,384,1492,44,76,18,58,361,325,6,26,4,5
E33038016,617,429,117,312,17,84,9,75,82,73,6,3,0,5
E33038017,588,442,102,340,7,48,6,42,89,79,4,4,2,2
E33038018,428,246,72,174,9,17,7,10,147,137,4,2,4,9
E33038019,566,307,93,214,9,47,12,35,190,180,4,3,3,13
E33038020,1066,691,197,494,7,232,139,93,131,117,3,10,1,5
E33038021,1162,830,245,585,7,188,108,80,130,117,2,11,0,7
E33038022,720,545,121,424,11,85,51,34,77,71,1,4,1,2
E33038023,336,231,55,176,2,48,30,18,51,47,0,4,0,4
E33038024,488,361,124,237,1,38,11,27,87,75,3,7,2,1
E33038025,369,311,94,217,0,21,8,13,35,30,2,3,0,2
E33038026,2327,1590,323,1267,28,165,86,79,532,482,4,42,4,12
E33038027,532,402,80,322,3,26,14,12,100,92,0,7,1,1
E33038028,2007,1540,355,1185,10,129,72,57,318,283,0,31,4,10
E33038029,511,328,76,252,6,85,41,44,91,82,0,6,3,1
E33038030,761,561,137,424,4,100,47,53,95,82,5,8,0,1
E33038031,473,355,92,263,4,50,31,19,64,53,1,6,4,0
E33038032,456,313,57,256,7,28,10,18,106,99,0,7,0,2
E33038033,686,548,151,397,8,52,20,32,77,65,1,9,2,1
E33038034,307,209,43,166,7,49,23,26,42,37,1,4,0,0
E33038035,414,253,43,210,4,97,47,50,57,52,1,3,1,3
E33038036,311,179,45,134,4,72,37,35,54,48,0,4,2,2
E33038037,352,227,42,185,3,64,34,30,57,53,0,4,0,1
E33038038,566,430,101,329,4,61,32,29,69,57,2,10,0,2
E33038039,247,185,55,130,3,31,14,17,28,21,2,5,0,0
E33038040,260,175,38,137,1,38,22,16,43,39,0,4,0,3
E33038041,244,162,34,128,2,39,18,21,40,31,3,6,0,1
E33038042,234,174,49,125,1,18,5,13,38,34,0,4,0,3
E33038043,367,259,81,178,4,40,20,20,62,57,0,4,1,2
E33038044,874,601,162,439,9,136,63,73,123,107,2,13,1,5
E33038045,885,697,186,511,7,71,37,34,108,103,1,4,0,2
E33038046,531,373,74,299,9,48,18,30,98,93,0,5,0,3
E33038047,415,312,70,242,1,42,23,19,59,46,0,11,2,1
E33038048,214,157,45,112,3,21,5,16,32,27,1,3,1,1
E33038049,475,351,91,260,3,64,23,41,52,40,2,8,2,5
E33038050,214,157,43,114,2,26,18,8,29,25,1,3,0,0
E33038051,233,191,26,165,0,17,4,13,23,21,0,2,0,2
E33038052,618,423,119,304,3,127,58,69,65,60,2,3,0,0
E33038053,344,266,60,206,0,32,12,20,42,41,1,0,0,4
E33038054,679,463,116,347,5,97,34,63,108,92,2,13,1,6
E33038055,744,515,125,390,4,119,54,65,103,91,2,9,1,3
E33038056,419,301,67,234,8,55,20,35,53,48,0,5,0,2
E33038057,429,329,98,231,2,19,11,8,76,72,1,3,0,3
E33038058,1099,812,202,610,15,86,34,52,184,164,6,11,3,2
E33038059,286,193,61,132,1,20,13,7,72,66,1,4,1,0
E33038060,331,227,77,150,5,26,16,10,59,46,11,0,2,14
E33038061,475,333,100,233,2,49,25,24,86,83,1,2,0,5
E33038062,807,609,211,398,10,48,30,18,136,122,6,8,0,4
E33038063,237,166,71,95,2,16,8,8,50,46,4,0,0,3
E33038064,387,247,79,168,2,37,25,12,92,82,9,1,0,9
E33038065,661,454,153,301,6,66,45,21,131,116,1,14,0,4
E33038066,206,163,45,118,2,8,4,4,33,27,1,5,0,0
E33038067,542,398,143,255,5,70,44,26,66,59,3,3,1,3
E33038068,383,306,95,211,2,30,14,16,45,41,2,2,0,0
E33038069,1042,723,186,537,4,106,58,48,187,171,2,13,1,22
E33038070,268,182,53,129,2,23,16,7,57,55,1,1,0,4
E33038071,827,614,176,438,8,46,17,29,155,142,0,12,1,4
E33038072,256,181,65,116,3,29,17,12,43,43,0,0,0,0
E33038073,224,162,61,101,2,13,8,5,45,45,0,0,0,2
E33038074,230,167,62,105,3,24,13,11,35,32,0,3,0,1
E33038075,465,370,136,234,4,31,26,5,51,48,0,3,0,9
E33038076,324,224,97,127,2,28,18,10,66,63,1,2,0,4
E33038077,334,219,68,151,2,33,18,15,74,63,7,4,0,6
E33038078,276,186,63,123,3,15,9,6,63,60,0,2,1,9
E33038079,523,340,123,217,6,63,42,21,109,102,3,3,1,5
E33038080,228,173,61,112,3,22,17,5,28,25,0,2,1,2
E33038081,603,436,143,293,12,31,19,12,118,93,11,6,8,6
E33038082,253,157,49,108,7,32,18,14,55,44,4,2,5,2
E33038083,987,498,118,380,9,104,53,51,371,177,127,3,64,5
E33038084,535,347,110,237,2,32,27,5,145,141,0,4,0,9
E33038085,285,190,69,121,9,32,19,13,50,47,0,2,1,4
E33038086,298,207,80,127,5,29,19,10,56,52,2,1,1,1
E33038087,298,222,74,148,2,23,11,12,51,47,1,3,0,0
E33038088,553,413,128,285,6,28,9,19,102,86,1,13,2,4
E33038089,290,207,52,155,0,44,24,20,39,31,2,4,2,0
E33038090,302,231,51,180,1,13,7,6,56,48,0,5,3,1
E33038091,219,149,35,114,1,18,11,7,48,40,1,5,2,3
E33038092,213,170,61,109,2,12,10,2,29,27,0,1,1,0
E33038093,571,431,150,281,3,46,29,17,89,83,1,5,0,2
E33038094,249,169,54,115,0,24,9,15,52,47,2,3,0,4
E33038095,333,234,63,171,1,26,12,14,72,71,0,1,0,0
E33038096,286,192,53,139,2,24,11,13,67,63,1,2,1,1
E33038097,286,230,54,176,3,17,9,8,34,32,0,2,0,2
E33038098,341,230,59,171,5,35,15,20,69,63,1,5,0,2
E33038099,258,217,53,164,1,19,9,10,21,16,1,3,1,0
E33038100,604,416,135,281,11,65,37,28,111,98,2,8,3,1
E33038101,883,630,204,426,11,130,81,49,106,94,1,7,4,6
E33038102,701,501,122,379,8,68,35,33,123,105,2,15,1,1
E33038103,235,156,37,119,2,38,27,11,37,36,1,0,0,2
E33038104,993,708,198,510,13,102,57,45,164,145,4,14,1,6
E33038105,242,160,44,116,2,42,25,17,38,37,0,1,0,0
E33038106,798,562,148,414,7,74,45,29,151,143,1,4,3,4
E33038107,1212,837,203,634,26,145,35,110,204,192,4,6,2,0
E33038108,213,147,42,105,2,29,7,22,34,30,0,3,1,1
E33038109,707,552,107,445,3,32,4,28,118,110,0,7,1,2
E33038110,747,628,155,473,6,20,4,16,90,81,2,6,1,3
E33038111,281,217,67,150,3,35,4,31,26,26,0,0,0,0
E33038112,597,440,73,367,11,50,7,43,96,84,3,7,2,0
E33038113,721,454,84,370,13,110,15,95,140,108,17,9,6,4
E33038114,291,172,45,127,8,51,8,43,59,51,3,2,3,1
E33038115,475,376,76,300,14,29,1,28,53,48,3,0,2,3
E33038116,477,303,62,241,5,68,14,54,94,83,4,5,2,7
E33038117,572,434,119,315,10,54,6,48,73,67,0,4,2,1
E33038118,866,626,134,492,18,83,14,69,135,125,1,8,1,4
E33038119,1342,947,208,739,24,54,12,42,317,299,5,6,7,0
E33038120,632,506,151,355,13,36,9,27,74,63,4,3,4,3
E33038121,251,171,47,124,6,10,2,8,56,53,0,3,0,8
E33038122,216,117,24,93,3,28,10,18,65,39,4,15,7,3
E33038123,218,150,43,107,3,34,14,20,31,30,0,0,1,0
E33038124,540,374,103,271,9,72,16,56,84,76,1,4,3,1
E33038125,389,192,43,149,4,57,13,44,132,32,62,1,37,4
E33038126,674,539,114,425,3,20,4,16,110,92,11,3,4,2
E33038127,3037,2415,554,1861,47,99,32,67,463,422,10,21,10,13
E33038128,239,108,21,87,3,25,6,19,100,33,33,2,32,3
E33038129,296,225,49,176,6,17,6,11,45,35,5,3,2,3
E33038130,609,478,129,349,15,28,4,24,86,71,6,6,3,2
E33038131,772,379,110,269,11,85,19,66,297,64,136,5,92,0
E33038132,372,243,63,180,9,39,14,25,81,69,4,3,5,0
E33038133,381,269,75,194,3,37,7,30,72,39,18,3,12,0
E33038134,217,171,56,115,2,23,4,19,17,15,0,2,0,4
E33038135,363,257,80,177,3,41,11,30,57,53,0,3,1,5
E33038136,367,264,105,159,3,31,15,16,66,61,2,3,0,3
E33038137,219,165,58,107,5,23,11,12,25,18,4,1,2,1
E33038138,242,153,49,104,0,24,9,15,63,54,6,2,1,2
E33038139,295,195,59,136,2,40,18,22,58,52,2,4,0,0
E33038140,697,485,141,344,13,88,46,42,106,95,2,6,3,5
E33038141,237,177,54,123,2,6,0,6,47,34,7,5,1,5
E33038142,241,153,63,90,1,23,3,20,52,42,7,0,3,12
E33038143,270,168,44,124,4,24,11,13,74,66,1,6,1,0
E33038144,993,742,152,590,3,25,14,11,222,205,1,12,4,1
E33038145,764,615,176,439,3,41,33,8,104,100,0,4,0,1
E33038146,346,224,47,177,3,43,28,15,74,67,0,4,3,2
E33038147,356,242,56,186,6,49,27,22,58,54,0,4,0,1
E33038148,2557,1669,432,1237,24,370,250,120,482,455,1,24,2,12
E33038149,232,160,39,121,3,17,14,3,51,45,0,6,0,1
E33038150,399,256,61,195,7,64,15,49,71,64,2,4,1,1
E33038151,567,397,94,303,14,77,31,46,78,62,5,8,3,1
E33038152,440,272,49,223,1,65,22,43,101,94,1,4,2,1
E33038153,290,204,44,160,3,30,9,21,53,45,1,5,2,0
E33038154,587,404,112,292,11,85,22,63,86,67,6,10,3,1
E33038155,250,150,37,113,5,47,16,31,47,38,4,4,1,1
E33038156,1675,1107,290,817,16,126,50,76,415,155,171,10,79,11
E33038157,213,125,32,93,4,37,16,21,44,41,2,0,1,3
E33038158,248,176,65,111,4,32,13,19,33,31,1,1,0,3
E33038159,417,300,85,215,5,43,19,24,64,57,1,5,1,5
E33038160,525,371,122,249,7,39,16,23,92,81,6,5,0,16
E33038161,365,286,80,206,3,18,7,11,57,47,6,3,1,1
E33038162,537,395,99,296,9,44,17,27,88,81,0,6,1,1
E33038163,354,259,79,180,1,43,10,33,48,45,0,2,1,3
E33038164,212,137,48,89,2,30,7,23,43,30,11,1,1,0
E33038165,204,146,38,108,0,28,12,16,29,24,0,3,2,1
E33038166,712,458,92,366,8,88,25,63,154,147,2,4,1,4
E33038167,302,169,35,134,5,77,26,51,50,43,2,4,1,1
E33038168,601,418,97,321,7,72,29,43,99,83,7,8,1,5
E33038169,585,382,91,291,9,93,36,57,92,70,5,13,4,9
E33038170,231,157,29,128,3,21,5,16,50,35,8,1,6,0
E33038171,288,175,47,128,5,44,13,31,63,49,5,6,3,1
E33038172,375,245,42,203,0,47,15,32,79,68,8,3,0,4
E33038173,234,172,46,126,4,18,6,12,40,35,3,1,1,0
E33038174,202,117,33,84,3,42,12,30,39,30,6,1,2,1
E33038175,698,471,92,379,8,73,19,54,140,129,7,2,2,6
E33038176,350,237,72,165,7,42,13,29,61,45,8,5,3,3
E33038177,1082,698,170,528,25,156,58,98,198,173,12,9,4,5
E33038178,812,448,96,352,12,200,65,135,144,120,7,10,7,8
E33038179,1380,946,240,706,21,165,54,111,240,194,19,22,5,8
E33038180,264,179,32,147,6,32,16,16,45,37,3,3,2,2
E33038181,407,305,67,238,4,29,9,20,65,55,4,5,1,4
E33038182,504,317,80,237,4,76,17,59,107,97,5,4,1,0
E33038183,559,320,76,244,4,111,39,72,123,105,11,2,5,1
E33038184,658,484,142,342,9,70,49,21,92,80,4,6,2,3
E33038185,1258,917,222,695,13,41,18,23,276,249,17,7,3,11
E33038186,995,741,189,552,10,38,14,24,190,169,11,9,1,16
E33038187,640,488,116,372,5,43,18,25,103,90,4,5,4,1
E33038188,572,426,143,283,7,56,32,24,78,72,4,2,0,5
E33038189,594,293,75,218,2,87,43,44,201,84,72,5,40,11
E33038190,339,252,77,175,4,27,13,14,55,50,1,1,3,1
E33038191,433,323,90,233,2,61,37,24,46,43,0,2,1,1
E33038192,897,578,145,433,17,58,28,30,236,211,9,12,4,8
E33038193,324,229,71,158,8,33,15,18,47,45,0,2,0,7
E33038194,537,386,94,292,9,42,14,28,94,84,3,6,1,6
E33038195,331,197,52,145,3,31,18,13,98,86,4,6,2,2
E33038196,368,249,74,175,4,27,15,12,86,76,1,7,2,2
E33038197,224,111,34,77,0,51,39,12,57,50,5,1,1,5
E33038198,482,264,91,173,3,87,60,27,125,116,2,3,4,3
E33038199,386,212,53,159,7,88,53,35,77,69,5,3,0,2
E33038200,731,387,110,277,17,179,118,61,137,121,0,14,2,11
E33038201,140,95,30,65,2,27,18,9,16,13,0,3,0,0
E33038202,954,617,160,457,10,153,85,68,170,155,3,10,2,4
E33038203,239,131,56,75,3,18,10,8,64,49,14,0,1,23
E33038204,449,252,82,170,4,49,26,23,141,126,4,8,3,3
E33038205,736,539,149,390,7,82,46,36,104,85,10,6,3,4
E33038206,196,100,31,69,1,34,21,13,56,52,3,1,0,5
E33038207,356,193,51,142,3,48,27,21,106,102,1,2,1,6
E33038208,2818,2222,646,1576,39,211,105,106,332,294,8,26,4,14
E33038209,2178,1454,416,1038,31,269,145,124,410,371,15,17,7,14
E33038210,428,250,77,173,7,57,26,31,113,97,4,6,6,1
E33038211,608,486,132,354,13,20,15,5,83,75,2,5,1,6
E33038212,231,158,33,125,0,15,6,9,53,51,0,2,0,5
E33038213,280,213,59,154,4,9,5,4,53,49,0,3,1,1
E33038214,417,330,102,228,6,20,12,8,59,52,7,0,0,2
E33038215,586,401,86,315,11,72,39,33,101,95,0,4,2,1
E33038216,295,210,63,147,2,20,13,7,61,60,0,0,1,2
E33038217,2433,1940,402,1538,36,175,66,109,272,235,10,15,12,10
E33038218,306,204,84,120,5,35,27,8,50,44,0,4,2,12
E33038219,2440,2009,314,1695,47,67,39,28,301,280,5,15,1,16
E33038220,237,127,38,89,4,25,11,14,66,57,7,2,0,15
E33038221,734,541,108,433,12,30,18,12,148,134,1,11,2,3
E33038222,573,437,86,351,5,47,26,21,82,77,0,5,0,2
E33038223,745,558,109,449,5,27,11,16,152,141,3,8,0,3
E33038224,329,242,52,190,4,20,13,7,62,60,1,1,0,1
E33038225,1341,945,214,731,15,109,63,46,264,245,4,12,3,8
E33038226,2323,1880,313,1567,14,65,36,29,356,330,4,19,3,8
E33038227,289,201,38,163,6,18,5,13,61,52,2,3,4,3
E33038228,1234,965,158,807,13,39,20,19,214,189,3,19,3,3
E33038229,221,159,17,142,2,16,8,8,44,38,0,6,0,0
E33038230,523,401,52,349,5,13,4,9,100,91,3,6,0,4
E33038231,218,149,44,105,1,25,6,19,35,29,1,5,0,8
E33038232,247,164,45,119,8,34,14,20,40,37,1,2,0,1
E33038233,621,425,108,317,8,75,32,43,110,106,0,3,1,3
E33038234,248,173,32,141,5,19,11,8,49,40,0,8,1,2
E33038235,259,162,48,114,9,39,24,15,49,44,0,3,2,0
E33038236,641,460,125,335,9,54,34,20,113,105,0,8,0,5
E33038237,602,446,104,342,11,34,17,17,107,93,2,10,2,4
E33038238,423,294,62,232,10,49,28,21,68,61,2,4,1,2
E33038239,433,287,56,231,8,38,19,19,98,88,2,8,0,2
E33038240,558,400,96,304,7,55,36,19,96,85,0,11,0,0
E33038241,365,247,70,177,4,52,34,18,61,60,0,1,0,1
E33038242,1099,731,132,599,18,142,82,60,200,182,3,14,1,8
E33038243,809,617,134,483,6,54,37,17,129,120,2,6,1,3
E33038244,3502,2512,648,1864,42,257,155,102,679,574,37,50,18,12
E33038245,533,419,105,314,8,29,17,12,72,63,1,8,0,5
E33038246,282,195,62,133,5,30,20,10,49,48,1,0,0,3
E33038247,504,369,119,250,12,48,27,21,68,65,0,3,0,7
E33038248,1398,1102,300,802,25,66,35,31,201,182,3,15,1,4
E33038249,279,205,45,160,10,26,16,10,38,34,0,4,0,0
E33038250,206,148,41,107,2,13,5,8,41,37,2,2,0,2
E33038251,232,169,43,126,4,15,7,8,43,39,0,4,0,1
E33038252,203,125,28,97,2,24,11,13,49,44,0,5,0,3
E33038253,261,176,49,127,3,32,19,13,50,45,0,5,0,0
E33038254,227,144,34,110,0,22,13,9,58,47,2,6,3,3
E33038255,334,253,40,213,8,14,7,7,55,43,5,7,0,4
E33038256,353,224,60,164,7,42,29,13,80,77,0,3,0,0
E33038257,496,354,94,260,5,59,33,26,73,65,0,8,0,5
E33038258,257,204,48,156,3,10,9,1,38,36,0,2,0,2
E33038259,601,393,86,307,11,69,49,20,124,114,4,4,2,4
E33038260,454,339,70,269,3,40,19,21,70,63,0,6,1,2
E33038261,279,206,42,164,4,22,14,8,41,40,0,1,0,6
E33038262,234,125,29,96,3,37,22,15,67,60,1,6,0,2
E33038263,226,141,36,105,4,31,15,16,49,43,0,5,1,1
E33038264,279,200,66,134,1,22,11,11,47,42,0,4,1,9
E33038265,1529,1152,372,780,16,72,52,20,275,253,5,15,2,14
E33038266,556,386,112,274,6,26,16,10,134,128,1,5,0,4
E33038267,911,685,208,477,11,53,36,17,157,144,2,10,1,5
E33038268,626,459,107,352,9,26,15,11,125,116,4,5,0,7
E33038269,3332,2434,711,1723,41,239,149,90,606,534,28,24,20,12
E33038270,553,412,119,293,3,47,37,10,85,71,2,12,0,6
E33038271,616,463,144,319,3,39,21,18,110,102,0,8,0,1
E33038272,483,378,106,272,4,13,8,5,86,81,0,4,1,2
E33038273,818,665,177,488,6,31,7,24,110,99,4,5,2,6
E33038274,221,125,42,83,4,17,11,6,71,68,1,2,0,4
E33038275,204,149,54,95,3,7,6,1,43,41,1,1,0,2
E33038276,213,165,41,124,2,8,6,2,35,31,0,3,1,3
E33038277,223,147,44,103,0,17,10,7,57,51,0,6,0,2
E33038278,757,546,175,371,7,61,42,19,137,132,0,4,1,6
E33038279,291,225,83,142,2,20,11,9,42,36,0,3,3,2
E33038280,485,346,74,272,4,46,29,17,88,80,0,6,2,1
E33038281,1370,1033,304,729,10,128,80,48,194,181,0,10,3,5
E33038282,266,172,50,122,2,19,12,7,71,69,0,0,2,2
E33038283,521,331,66,265,7,61,40,21,121,114,0,6,1,1
E33038284,1054,580,170,410,15,101,64,37,351,328,5,13,5,7
E33038285,236,177,39,138,2,12,6,6,42,38,1,3,0,3
E33038286,449,259,78,181,5,49,28,21,130,122,1,5,2,6
E33038287,219,159,31,128,6,11,5,6,41,40,0,0,1,2
E33038288,368,172,47,125,6,23,16,7,165,151,6,5,3,2
E33038289,204,127,40,87,1,12,9,3,61,52,1,8,0,3
E33038290,300,178,37,141,5,27,21,6,88,84,0,4,0,2
E33038291,205,118,42,76,1,27,22,5,58,54,1,2,1,1
E33038292,306,234,61,173,1,8,6,2,61,60,0,1,0,2
E33038293,216,125,31,94,2,11,3,8,77,72,1,4,0,1
E33038294,612,338,113,225,9,39,22,17,209,194,10,4,1,17
E33038295,212,145,45,100,0,17,9,8,47,44,0,2,1,3
E33038296,239,129,32,97,1,22,13,9,75,66,2,4,3,12
E33038297,227,120,25,95,1,11,6,5,91,85,1,5,0,4
E33038298,335,166,43,123,1,24,7,17,139,125,3,7,4,5
E33038299,307,217,67,150,4,15,12,3,69,65,0,4,0,2
E33038300,391,249,79,170,1,23,10,13,115,107,1,6,1,3
E33038301,627,371,102,269,9,94,59,35,144,131,2,10,1,9
E33038302,799,577,141,436,4,73,44,29,138,126,0,11,1,7
E33038303,1102,753,213,540,11,149,78,71,188,179,1,7,1,1
E33038304,1096,808,173,635,24,132,63,69,130,119,0,10,1,2
E33038305,991,647,164,483,13,109,59,50,215,202,1,12,0,7
E33038306,663,515,155,360,10,55,28,27,83,78,0,5,0,0
E33038307,345,261,65,196,2,36,20,16,46,46,0,0,0,0
E33038308,667,465,146,319,12,104,46,58,83,80,0,2,1,3
E33038309,4249,2916,612,2304,41,454,228,226,817,759,7,44,7,21
E33038310,929,649,162,487,15,117,59,58,144,137,2,5,0,4
E33038311,1081,719,158,561,10,115,66,49,227,216,1,9,1,10
E33038312,1204,875,207,668,15,85,41,44,219,204,2,8,5,10
E33038313,1242,873,193,680,19,134,63,71,209,191,1,14,3,7
E33038314,759,502,122,380,14,133,77,56,105,100,1,4,0,5
E33038315,913,621,139,482,18,104,46,58,170,163,0,7,0,0
E33038316,485,311,68,243,8,41,19,22,123,119,1,3,0,2
E33038317,862,632,126,506,9,66,33,33,154,151,0,3,0,1
E33038318,412,299,65,234,4,46,22,24,61,54,1,6,0,2
E33038319,1635,1127,248,879,14,154,71,83,336,324,0,10,2,4
E33038320,2102,1645,340,1305,24,138,85,53,290,270,5,11,4,5
E33038321,514,314,87,227,5,74,48,26,118,110,0,7,1,3
E33038322,581,376,120,256,6,91,49,42,107,101,1,5,0,1
E33038323,293,170,47,123,2,43,23,20,75,70,0,4,1,3
E33038324,271,178,53,125,1,37,21,16,54,53,0,0,1,1
E33038325,483,284,89,195,7,103,73,30,88,74,0,2,12,1
E33038326,257,208,37,171,2,19,14,5,28,23,0,4,1,0
E33038327,986,655,182,473,11,154,74,80,162,149,3,8,2,4
E33038328,215,150,28,122,1,30,14,16,32,32,0,0,0,2
E33038329,1275,975,264,711,24,108,51,57,160,153,0,7,0,8
E33038330,240,141,39,102,6,46,19,27,45,39,0,5,1,2
E33038331,409,288,66,222,3,49,30,19,67,64,2,1,0,2
E33038332,258,178,46,132,4,33,17,16,41,36,2,3,0,2
E33038333,313,243,51,192,4,26,13,13,39,36,0,3,0,1
E33038334,338,237,47,190,6,41,27,14,51,47,0,3,1,3
E33038335,811,562,166,396,15,125,59,66,108,100,0,8,0,1
E33038336,688,486,140,346,5,81,62,19,111,103,0,8,0,5
E33038337,255,186,70,116,0,19,11,8,50,47,1,1,1,0
E33038338,1354,1020,247,773,17,78,48,30,232,209,1,21,1,7
E33038339,215,155,45,110,0,13,8,5,45,38,0,6,1,2
E33038340,252,171,34,137,3,21,9,12,57,48,1,6,2,0
E33038341,264,166,44,122,2,25,14,11,71,65,0,6,0,0
E33038342,400,276,86,190,1,34,22,12,88,74,8,4,2,1
E33038343,332,243,87,156,3,20,16,4,62,55,3,4,0,4
E33038344,808,349,94,255,4,80,51,29,369,354,4,11,0,6
E33038345,627,395,109,286,6,87,51,36,136,127,2,6,1,3
E33038346,260,189,59,130,2,18,11,7,50,45,3,2,0,1
E33038347,202,131,49,82,0,18,12,6,52,47,1,4,0,1
E33038348,209,155,60,95,1,6,4,2,46,43,0,3,0,1
E33038349,433,284,90,194,7,49,33,16,83,77,2,4,0,10
E33038350,776,496,154,342,4,117,74,43,156,136,2,17,1,3
E33038351,2887,2252,500,1752,16,75,38,37,530,494,6,28,2,14
E33038352,269,171,51,120,2,27,14,13,67,65,0,2,0,2
E33038353,479,262,75,187,2,84,59,25,127,113,0,13,1,4
E33038354,436,289,105,184,2,69,52,17,75,72,1,2,0,1
E33038355,212,157,48,109,0,20,12,8,30,30,0,0,0,5
E33038356,325,209,58,151,6,51,32,19,58,55,1,2,0,1
E33038357,244,163,55,108,8,20,11,9,51,48,0,3,0,2
E33038358,357,252,71,181,2,40,24,16,62,57,0,0,5,1
E33038359,233,184,46,138,3,13,8,5,31,29,0,2,0,2
E33038360,218,164,60,104,0,19,7,12,35,34,0,1,0,0
E33038361,551,353,99,254,5,75,42,33,118,110,0,6,2,0
E33038362,306,243,73,170,2,23,16,7,38,37,0,1,0,0
E33038363,580,432,146,286,1,70,52,18,75,71,1,1,2,2
E33038364,1000,620,182,438,6,179,124,55,189,168,5,16,0,6
E33038365,1001,663,185,478,10,169,131,38,154,145,0,3,6,5
E33038366,300,205,60,145,1,29,16,13,62,58,0,4,0,3
E33038367,473,367,102,265,4,47,33,14,51,49,0,2,0,4
E33038368,259,176,48,128,2,16,8,8,62,56,2,4,0,3
E33038369,318,205,74,131,2,51,36,15,58,51,1,5,1,2
E33038370,858,640,190,450,12,72,35,37,129,115,0,11,3,5
E33038371,221,156,48,108,3,17,8,9,45,42,1,2,0,0
E33038372,325,246,86,160,4,30,20,10,44,40,3,1,0,1
E33038373,340,229,76,153,4,51,37,14,54,51,0,2,1,2
E33038374,582,421,134,287,3,75,45,30,80,76,0,4,0,3
E33038375,454,367,90,277,7,18,12,6,62,59,0,3,0,0
E33038376,274,192,52,140,0,38,26,12,43,40,0,2,1,1
E33038377,437,342,88,254,4,25,15,10,57,49,0,6,2,9
E33038378,513,414,87,327,9,21,4,17,66,62,0,3,1,3
E33038379,808,541,119,422,8,68,20,48,185,176,3,6,0,6
E33038380,222,178,49,129,7,15,3,12,21,19,0,1,1,1
E33038381,1012,714,170,544,13,117,25,92,160,147,1,12,0,8
E33038382,205,128,28,100,2,25,7,18,45,36,2,5,2,5
E33038383,605,405,85,320,10,53,10,43,134,124,3,5,2,3
E33038384,727,572,150,422,9,44,2,42,99,94,1,2,2,3
E33038385,279,178,51,127,2,16,4,12,81,73,0,6,2,2
E33038386,376,270,80,190,6,39,13,26,54,45,4,3,2,7
E33038387,271,168,38,130,2,49,23,26,51,47,3,1,0,1
E33038388,286,170,52,118,5,47,14,33,62,58,0,4,0,2
E33038389,662,529,115,414,10,24,8,16,95,91,2,2,0,4
E33038390,656,471,127,344,12,69,30,39,102,99,0,3,0,2
E33038391,329,222,85,137,4,12,4,8,87,76,6,3,2,4
E33038392,380,295,101,194,4,25,5,20,54,49,0,3,2,2
E33038393,500,414,132,282,5,19,6,13,61,57,2,2,0,1
E33038394,1150,749,173,576,12,191,36,155,192,170,1,18,3,6
E33038395,234,199,65,134,4,10,3,7,20,20,0,0,0,1
E33038396,683,502,158,344,5,71,19,52,103,92,3,7,1,2
E33038397,359,235,51,184,3,58,13,45,62,57,2,3,0,1
E33038398,224,170,32,138,2,13,5,8,39,34,3,2,0,0
E33038399,296,233,73,160,10,16,4,12,36,35,0,0,1,1
E33038400,202,146,31,115,2,12,5,7,42,37,0,5,0,0
E33038401,428,327,82,245,10,28,5,23,62,58,2,2,0,1
E33038402,903,659,168,491,13,47,9,38,181,169,3,9,0,3
E33038403,568,439,102,337,6,39,9,30,81,75,1,4,1,3
E33038404,305,204,57,147,4,38,9,29,58,53,0,4,1,1
E33038405,480,392,111,281,9,28,7,21,48,44,0,3,1,3
E33038406,782,578,161,417,10,60,14,46,129,115,3,11,0,5
E33038407,291,205,79,126,1,25,7,18,53,42,5,6,0,7
E33038408,252,199,65,134,3,20,9,11,29,28,1,0,0,1
E33038409,1582,1271,362,909,31,89,22,67,188,167,7,12,2,3
E33038410,392,250,80,170,7,74,15,59,59,53,1,2,3,2
E33038411,651,468,105,363,8,56,10,46,116,100,3,12,1,3
E33038412,398,294,119,175,4,40,4,36,57,52,4,0,1,3
E33038413,292,231,92,139,3,19,3,16,38,37,1,0,0,1
E33038414,247,184,60,124,3,27,6,21,32,25,2,5,0,1
E33038415,537,358,101,257,5,64,30,34,103,95,1,7,0,7
E33038416,246,193,59,134,1,18,10,8,33,31,2,0,0,1
E33038417,837,541,163,378,28,149,23,126,117,103,6,8,0,2
E33038418,363,220,63,157,5,38,3,35,93,86,1,4,2,7
E33038419,205,151,37,114,3,16,1,15,33,31,0,2,0,2
E33038420,532,407,127,280,13,45,5,40,62,59,0,2,1,5
E33038421,513,389,136,253,9,45,7,38,66,54,5,5,2,4
E33038422,272,186,55,131,6,23,4,19,52,45,2,4,1,5
E33038423,367,244,68,176,6,53,9,44,63,57,0,6,0,1
E33038424,329,239,93,146,7,20,2,18,59,59,0,0,0,4
E33038425,293,202,65,137,11,31,1,30,46,40,1,5,0,3
E33038426,399,268,72,196,5,52,19,33,67,59,2,6,0,7
E33038427,306,214,67,147,8,52,13,39,30,27,0,3,0,2
E33038428,270,181,41,140,8,40,7,33,40,39,1,0,0,1
E33038429,415,272,59,213,4,69,26,43,69,65,0,4,0,1
E33038430,209,144,71,73,2,14,5,9,33,28,4,1,0,16
E33038431,386,239,54,185,1,27,21,6,118,116,0,1,1,1
E33038432,703,449,134,315,5,57,33,24,186,176,2,6,2,6
E33038433,296,205,66,139,0,21,9,12,70,60,3,7,0,0
E33038434,726,555,152,403,5,28,20,8,134,127,0,5,2,4
E33038435,654,531,106,425,3,19,12,7,98,86,2,8,2,3
E33038436,1103,807,187,620,6,62,36,26,224,205,1,15,3,4
E33038437,218,145,34,111,2,17,10,7,54,52,0,2,0,0
E33038438,575,390,85,305,4,46,22,24,130,120,3,7,0,5
E33038439,629,196,62,134,7,111,35,76,295,42,99,4,150,20
E33038440,689,443,131,312,3,70,40,30,169,156,2,6,5,4
E33038441,1352,971,234,737,8,48,22,26,318,293,2,22,1,7
E33038442,279,204,74,130,2,30,24,6,41,41,0,0,0,2
E33038443,227,174,70,104,0,16,12,4,36,33,0,3,0,1
E33038444,241,176,54,122,1,23,16,7,38,34,1,2,1,3
E33038445,201,150,47,103,0,14,12,2,35,32,1,2,0,2
E33038446,1363,1127,328,799,6,33,22,11,192,172,0,19,1,5
E33038447,1447,1119,277,842,6,80,49,31,233,211,0,20,2,9
E33038448,224,154,45,109,1,22,0,22,46,41,1,4,0,1
E33038449,233,146,46,100,3,32,5,27,50,44,1,4,1,2
E33038450,433,294,100,194,7,59,5,54,67,63,0,4,0,6
E33038451,626,451,133,318,10,50,16,34,111,98,0,11,2,4
E33038452,421,318,102,216,3,27,5,22,65,61,0,3,1,8
E33038453,260,191,51,140,4,24,2,22,41,38,0,2,1,0
E33038454,744,472,96,376,9,88,15,73,169,157,4,8,0,6
E33038455,879,621,206,415,7,100,31,69,148,137,1,9,1,3
E33038456,393,272,63,209,9,35,9,26,76,73,0,0,3,1
E33038457,219,140,24,116,4,16,1,15,58,57,0,1,0,1
E33038458,448,319,101,218,7,52,7,45,68,65,0,3,0,2
E33038459,201,133,40,93,2,28,3,25,35,29,1,5,0,3
E33038460,1702,1100,254,846,22,160,41,119,414,394,3,14,3,6
E33038461,244,194,50,144,3,18,3,15,29,29,0,0,0,0
E33038462,469,342,78,264,4,49,19,30,74,60,0,12,2,0
E33038463,215,150,40,110,2,26,7,19,37,33,0,4,0,0
E33038464,199,150,39,111,2,15,5,10,32,27,1,2,2,0
E33038465,550,441,105,336,3,14,1,13,89,77,3,9,0,3
E33038466,318,218,58,160,4,28,5,23,64,61,0,2,1,4
E33038467,326,234,46,188,5,32,2,30,53,52,0,1,0,2
E33038468,462,371,107,264,2,23,6,17,63,60,0,2,1,3
E33038469,427,270,58,212,9,52,8,44,93,82,1,8,2,3
E33038470,816,581,164,417,8,74,11,63,150,139,1,8,2,3
E33038471,1258,854,239,615,5,95,19,76,297,275,2,15,5,7
E33038472,252,186,55,131,1,23,1,22,40,39,0,1,0,2
E33038473,437,283,94,189,4,64,12,52,85,73,0,11,1,1
E33038474,620,449,126,323,6,42,7,35,122,118,0,4,0,1
E33038475,939,758,162,596,22,33,8,25,120,103,3,12,2,6
E33038476,230,197,59,138,2,8,3,5,22,19,0,3,0,1
E33038477,243,187,44,143,3,13,4,9,37,35,0,2,0,3
E33038478,588,447,109,338,8,31,2,29,100,93,0,7,0,2
E33038479,416,279,62,217,0,17,11,6,114,102,0,10,2,6
E33038480,216,159,32,127,0,8,3,5,48,42,1,3,2,1
E33038481,270,143,42,101,0,42,20,22,82,72,1,6,3,3
E33038482,275,201,51,150,1,14,7,7,58,50,1,5,2,1
E33038483,314,187,42,145,2,36,9,27,85,80,1,3,1,4
E33038484,306,194,65,129,1,20,4,16,89,87,1,1,0,2
E33038485,777,606,150,456,4,46,23,23,116,111,1,4,0,5
E33038486,360,223,51,172,0,28,14,14,106,99,1,6,0,3
E33038487,390,269,72,197,0,23,9,14,94,87,1,4,2,4
E33038488,589,366,90,276,1,41,23,18,179,163,7,7,2,2
E33038489,818,561,146,415,9,86,51,35,158,138,3,15,2,4
E33038490,338,203,41,162,0,31,21,10,104,95,1,8,0,0
E33038491,1635,1011,207,804,9,135,80,55,474,449,2,20,3,6
E33038492,424,280,81,199,2,27,16,11,112,104,0,6,2,3
E33038493,294,230,71,159,0,15,11,4,45,40,0,5,0,4
E33038494,524,401,104,297,0,34,14,20,89,83,1,5,0,0
E33038495,275,181,52,129,1,28,10,18,64,60,0,3,1,1
E33038496,390,292,75,217,1,15,12,3,79,75,1,3,0,3
E33038497,936,598,169,429,3,108,44,64,222,205,0,15,2,5
E33038498,498,312,86,226,3,51,25,26,129,117,2,8,2,3
E33038499,760,493,127,366,4,74,41,33,187,170,2,12,3,2
E33038500,2254,1512,366,1146,17,141,59,82,569,454,72,26,17,15
E33038501,744,503,122,381,4,45,27,18,190,179,1,10,0,2
E33038502,376,249,66,183,3,19,9,10,104,78,9,3,14,1
E33038503,733,571,178,393,8,64,8,56,88,71,6,8,3,2
E33038504,1014,765,167,598,17,85,18,67,142,130,1,9,2,5
E33038505,210,168,41,127,2,13,1,12,26,22,1,3,0,1
E33038506,371,301,62,239,9,24,2,22,32,26,2,4,0,5
E33038507,479,337,83,254,8,59,13,46,75,66,1,8,0,0
E33038508,212,138,36,102,3,37,8,29,33,31,0,2,0,1
E33038509,979,686,146,540,9,117,30,87,161,152,0,3,6,6
E33038510,631,475,112,363,12,61,4,57,80,75,1,3,1,3
E33038511,471,344,104,240,7,45,8,37,72,66,1,4,1,3
E33038512,255,180,56,124,3,23,3,20,48,44,0,2,2,1
E33038513,222,124,39,85,5,32,3,29,57,51,2,4,0,4
E33038514,406,254,67,187,6,54,8,46,87,75,5,6,1,5
E33038515,1057,787,180,607,12,94,22,72,159,150,0,6,3,5
E33038516,352,236,60,176,5,44,8,36,66,59,3,4,0,1
E33038517,293,224,71,153,7,22,5,17,35,31,0,4,0,5
E33038518,704,508,159,349,16,62,10,52,112,104,2,5,1,6
E33038519,1055,808,150,658,19,64,7,57,159,146,0,11,2,5
E33038520,522,427,123,304,8,32,6,26,51,46,1,4,0,4
E33038521,1055,712,175,537,26,124,35,89,185,172,1,11,1,8
E33038522,277,212,53,159,7,24,4,20,33,27,1,1,4,1
E33038523,227,160,30,130,2,27,4,23,36,28,0,6,2,2
E33038524,411,288,86,202,9,74,19,55,36,32,0,1,3,4
E33038525,521,362,96,266,9,42,5,37,100,88,4,8,0,8
E33038526,714,407,123,284,16,130,13,117,151,134,9,8,0,10
E33038527,417,285,87,198,7,66,12,54,56,52,1,3,0,3
E33038528,702,523,127,396,19,60,12,48,99,92,3,4,0,1
E33038529,788,540,125,415,8,107,20,87,129,118,4,4,3,4
E33038530,402,275,67,208,7,48,8,40,66,50,7,7,2,6
E33038531,289,234,69,165,3,14,4,10,35,33,1,1,0,3
E33038532,580,431,111,320,10,61,13,48,68,59,1,7,1,10
E33038533,768,555,200,355,9,56,20,36,125,102,15,6,2,23
E33038534,405,307,82,225,4,25,7,18,65,53,10,2,0,4
E33038535,382,288,82,206,5,24,2,22,65,60,1,4,0,0
E33038536,227,175,45,130,2,8,2,6,41,38,0,3,0,1
E33038537,332,236,56,180,4,14,5,9,76,72,1,3,0,2
E33038538,475,359,74,285,6,13,1,12,91,85,1,5,0,6
E33038539,230,141,41,100,4,14,0,14,64,63,0,1,0,7
E33038540,324,235,67,168,3,23,2,21,62,59,0,2,1,1
E33038541,414,276,77,199,9,37,6,31,91,85,0,6,0,1
E33038542,280,224,81,143,0,20,0,20,28,21,5,2,0,8
E33038543,228,158,48,110,2,30,8,22,34,18,9,6,1,4
E33038544,363,262,87,175,8,37,10,27,55,50,0,5,0,1
E33038545,972,583,168,415,16,91,15,76,276,261,0,9,6,6
E33038546,302,205,46,159,7,13,2,11,74,69,0,2,3,3
E33038547,486,373,86,287,4,20,2,18,85,80,0,3,2,4
E33038548,212,140,40,100,2,10,4,6,59,56,0,2,1,1
E33038549,210,152,40,112,1,7,0,7,48,47,1,0,0,2
E33038550,213,143,36,107,1,8,1,7,60,58,0,2,0,1
E33038551,1146,776,205,571,15,103,14,89,242,222,3,16,1,10
E33038552,479,317,80,237,7,29,2,27,121,115,1,4,1,5
E33038553,1445,924,243,681,17,189,13,176,310,290,1,18,1,5
E33038554,1468,903,199,704,31,106,12,94,419,389,17,12,1,9
E33038555,246,141,42,99,3,41,6,35,59,54,2,3,0,2
E33038556,678,486,127,359,15,57,11,46,115,105,0,10,0,5
E33038557,261,164,37,127,1,22,5,17,74,68,0,4,2,0
E33038558,372,262,81,181,4,33,2,31,69,61,3,5,0,4
E33038559,230,139,34,105,2,23,3,20,65,63,0,2,0,1
E33038560,251,183,47,136,2,10,2,8,55,50,1,4,0,1
E33038561,961,667,199,468,22,113,21,92,156,152,2,2,0,3
E33038562,206,58,13,45,1,24,3,21,121,117,2,2,0,2
E33038563,271,183,49,134,7,31,4,27,50,45,0,5,0,0
E33038564,232,150,36,114,2,25,6,19,50,50,0,0,0,5
E33038565,594,447,161,286,4,36,8,28,84,77,7,0,0,23
E33038566,627,425,100,325,8,40,4,36,147,134,2,10,1,7
E33038567,416,312,91,221,1,27,6,21,71,60,3,7,1,5
E33038568,532,426,88,338,7,24,5,19,71,66,1,4,0,4
E33038569,573,428,113,315,8,23,3,20,108,104,2,2,0,6
E33038570,207,160,26,134,1,8,4,4,38,35,0,3,0,0
E33038571,443,316,59,257,7,48,12,36,70,65,1,2,2,2
E33038572,655,464,115,349,10,49,15,34,131,122,1,8,0,1
E33038573,238,167,25,142,2,19,4,15,49,46,1,2,0,1
E33038574,441,340,58,282,6,17,7,10,78,74,0,2,2,0
E33038575,1051,652,127,525,14,92,30,62,290,281,0,7,2,3
E33038576,870,544,124,420,11,73,25,48,234,222,0,10,2,8
E33038577,353,244,56,188,8,29,8,21,70,65,2,3,0,2
E33038578,521,368,81,287,3,30,6,24,115,108,1,5,1,5
E33038579,328,229,65,164,1,22,6,16,74,67,2,5,0,2
E33038580,224,145,35,110,2,33,12,21,42,39,1,2,0,2
E33038581,952,610,156,454,6,141,28,113,190,174,0,13,3,5
E33038582,365,225,65,160,7,43,6,37,90,85,0,5,0,0
E33038583,638,366,84,282,11,118,50,68,140,132,0,7,1,3
E33038584,215,155,40,115,2,19,3,16,35,34,1,0,0,4
E33038585,278,195,58,137,0,43,7,36,38,34,0,4,0,2
E33038586,333,226,59,167,5,39,6,33,61,57,0,4,0,2
E33038587,269,186,53,133,1,29,7,22,52,50,2,0,0,1
E33038588,266,192,47,145,2,21,8,13,50,43,0,7,0,1
E33038589,230,176,70,106,2,13,4,9,35,34,0,0,1,4
E33038590,220,138,35,103,2,23,3,20,45,38,4,1,2,12
E33038591,209,142,53,89,3,23,7,16,40,37,0,3,0,1
E33038592,209,139,43,96,3,25,8,17,41,40,0,1,0,1
E33038593,986,608,152,456,9,143,23,120,223,212,5,5,1,3
E33038594,557,309,66,243,1,64,14,50,182,167,1,11,3,1
E33038595,267,191,50,141,3,16,4,12,57,50,0,6,1,0
E33038596,400,295,75,220,4,44,13,31,55,51,0,4,0,2
E33038597,437,287,70,217,2,51,11,40,95,89,1,5,0,2
E33038598,317,231,61,170,3,26,10,16,55,51,0,3,1,2
E33038599,635,462,113,349,2,75,24,51,94,83,1,10,0,2
E33038600,209,154,42,112,1,17,4,13,37,34,0,3,0,0
E33038601,278,196,39,157,2,19,8,11,60,57,0,3,0,1
E33038602,1260,832,192,640,21,105,22,83,293,279,1,9,4,9
E33038603,845,633,144,489,12,68,13,55,130,120,2,7,1,2
E33038604,445,241,61,180,4,55,17,38,142,133,1,5,3,3
E33038605,368,245,57,188,2,24,6,18,87,82,2,1,2,10
E33038606,314,212,50,162,3,35,6,29,58,48,2,6,2,6
E33038607,296,204,47,157,3,33,8,25,55,51,0,4,0,1
E33038608,314,198,58,140,2,53,10,43,57,51,3,3,0,4
E33038609,260,188,46,142,2,25,3,22,44,36,1,7,0,1
E33038610,281,200,46,154,2,33,8,25,45,42,2,1,0,1
E33038611,2067,1365,273,1092,23,150,51,99,515,488,9,14,4,14
E33038612,535,414,109,305,7,41,7,34,70,63,0,7,0,3
E33038613,317,246,86,160,4,16,1,15,47,46,0,1,0,4
E33038614,286,224,62,162,4,19,5,14,38,35,0,2,1,1
E33038615,550,394,87,307,9,51,19,32,92,81,3,8,0,4
E33038616,508,377,94,283,11,54,29,25,63,60,0,3,0,3
E33038617,318,242,66,176,8,29,12,17,39,36,0,2,1,0
E33038618,792,554,94,460,10,38,9,29,187,177,2,6,2,3
E33038619,471,346,67,279,3,22,4,18,95,84,3,8,0,5
E33038620,552,409,135,274,4,29,14,15,107,99,0,3,5,3
E33038621,277,228,79,149,4,22,11,11,21,17,1,3,0,2
E33038622,321,235,79,156,6,25,10,15,51,47,0,3,1,4
E33038623,274,215,87,128,2,14,5,9,35,31,0,3,1,8
E33038624,616,364,92,272,12,154,69,85,81,76,0,5,0,5
E33038625,622,308,105,203,17,164,109,55,132,120,3,6,3,1
E33038626,380,225,102,123,12,39,27,12,84,62,18,1,3,20
E33038627,183,105,39,66,0,9,8,1,54,52,1,0,1,15
E33038628,399,243,95,148,4,17,7,10,130,121,4,2,3,5
E33038629,376,205,68,137,7,23,9,14,137,122,4,6,5,4
E33038630,188,107,34,73,3,11,4,7,64,56,4,1,3,3
E33038631,355,232,74,158,7,30,18,12,82,74,2,3,3,4
E33038632,245,109,34,75,2,29,21,8,94,89,0,4,1,11
E33038633,754,515,157,358,13,21,9,12,196,179,5,8,4,9
E33038634,341,193,67,126,8,32,14,18,99,95,0,2,2,9
E33038635,193,112,36,76,3,18,6,12,57,54,1,2,0,3
E33038636,509,267,68,199,6,95,50,45,134,126,4,2,2,7
E33038637,582,336,143,193,4,57,37,20,159,135,15,6,3,26
E33038638,201,73,33,40,2,19,8,11,103,100,0,2,1,4
E33038639,651,330,100,230,11,95,58,37,206,192,2,11,1,9
E33038640,468,292,117,175,3,22,12,10,150,129,1,13,7,1
E33038641,202,108,29,79,3,13,7,6,70,58,7,2,3,8
E33038642,343,162,47,115,5,18,11,7,154,144,2,7,1,4
E33038643,291,148,39,109,2,21,7,14,114,107,1,5,1,6
E33038644,394,225,72,153,5,74,38,36,85,76,2,3,4,5
E33038645,451,239,53,186,9,40,23,17,155,147,2,2,4,8
E33038646,734,465,133,332,10,124,69,55,126,109,7,6,4,9
E33038647,190,115,37,78,3,21,14,7,46,43,0,2,1,5
E33038648,336,171,57,114,7,34,21,13,116,104,4,8,0,8
E33038649,297,167,61,106,3,38,25,13,81,68,6,4,3,8
E33038650,593,292,97,195,7,109,61,48,176,168,5,3,0,9
E33038651,225,155,42,113,0,8,3,5,60,54,1,3,2,2
E33038652,265,128,33,95,4,21,11,10,109,106,0,3,0,3
E33038653,236,150,43,107,1,27,17,10,57,50,5,1,1,1
E33038654,326,227,87,140,4,22,9,13,69,62,0,3,4,4
E33038655,266,181,63,118,3,22,15,7,53,48,5,0,0,7
E33038656,761,496,155,341,14,67,24,43,179,171,2,4,2,5
E33038657,860,529,156,373,15,68,37,31,244,228,6,7,3,4
E33038658,1535,955,265,690,12,52,24,28,506,487,4,11,4,10
E33038659,346,273,64,209,11,14,10,4,47,46,1,0,0,1
E33038660,1855,1192,299,893,47,83,34,49,521,482,3,32,4,12
E33038661,725,556,128,428,8,35,13,22,122,115,2,3,2,4
E33038662,365,250,63,187,10,28,15,13,71,70,0,1,0,6
E33038663,779,521,153,368,14,75,38,37,164,153,4,5,2,5
E33038664,1301,838,219,619,23,162,62,100,269,249,6,10,4,9
E33038665,7065,4418,1077,3341,114,641,242,399,1848,1698,53,52,45,44
E33038666,896,628,171,457,9,75,28,47,177,162,4,9,2,7
E33038667,605,354,127,227,9,63,44,19,135,112,13,3,7,44
E33038668,962,660,144,516,19,92,44,48,183,165,5,10,3,8
E33038669,389,271,80,191,9,32,12,20,75,69,1,3,2,2
E33038670,264,144,61,83,5,21,12,9,70,57,10,3,0,24
E33038671,1016,621,156,465,18,100,51,49,269,258,2,8,1,8
E33038672,1772,1120,267,853,26,42,20,22,574,549,4,19,2,10
E33038673,399,275,71,204,10,38,20,18,75,66,2,6,1,1
E33038674,403,256,94,162,7,30,9,21,107,98,1,8,0,3
E33038675,742,484,143,341,18,30,13,17,203,192,1,3,7,7
E33038676,714,444,128,316,16,93,42,51,154,140,2,10,2,7
E33038677,663,439,98,341,13,32,18,14,175,171,2,1,1,4
E33038678,1324,889,171,718,21,135,74,61,270,256,2,9,3,9
E33038679,293,177,56,121,6,55,34,21,55,52,0,2,1,0
E33038680,603,359,107,252,12,122,62,60,107,94,2,7,4,3
E33038681,421,279,66,213,12,51,28,23,78,71,1,6,0,1
E33038682,203,130,31,99,4,33,15,18,36,31,0,5,0,0
E33038683,692,486,117,369,7,100,48,52,94,85,3,6,0,5
E33038684,3603,2375,565,1810,76,479,252,227,661,616,5,30,10,12
E33038685,314,189,45,144,9,44,25,19,70,62,4,3,1,2
E33038686,2179,1457,385,1072,31,234,123,111,453,419,5,23,6,4
E33038687,1077,716,170,546,18,64,37,27,276,260,2,11,3,3
E33038688,229,150,65,85,1,15,11,4,61,54,2,2,3,2
E33038689,314,179,55,124,3,14,10,4,116,106,3,5,2,2
E33038690,645,379,124,255,4,18,7,11,234,214,6,6,8,10
E33038691,653,385,71,314,9,21,9,12,232,230,0,2,0,6
E33038692,437,259,66,193,10,41,24,17,124,114,1,8,1,3
E33038693,425,304,98,206,4,28,15,13,86,75,5,4,2,3
E33038694,356,201,74,127,6,49,24,25,95,83,3,5,4,5
E33038695,456,267,110,157,9,41,25,16,120,113,2,4,1,19
E33038696,371,188,59,129,10,44,25,19,119,112,1,6,0,10
E33038697,222,129,33,96,1,18,9,9,70,67,1,2,0,4
E33038698,530,346,92,254,6,24,12,12,151,140,2,9,0,3
E33038699,312,208,52,156,1,14,7,7,86,80,3,3,0,3
E33038700,310,165,58,107,2,26,13,13,91,69,17,2,3,26
E33038701,267,165,49,116,6,24,10,14,71,67,1,3,0,1
E33038702,818,604,165,439,11,64,18,46,132,127,0,2,3,7
E33038703,979,718,221,497,9,49,11,38,196,171,6,11,8,7
E33038704,261,185,57,128,1,36,9,27,37,32,2,2,1,2
E33038705,733,448,104,344,11,145,24,121,120,101,11,4,4,9
E33038706,313,205,53,152,6,46,13,33,56,50,2,3,1,0
E33038707,219,142,47,95,3,36,7,29,36,35,0,1,0,2
E33038708,201,140,35,105,1,27,4,23,33,31,0,2,0,0
E33038709,446,309,88,221,3,58,6,52,72,58,4,8,2,4
E33038710,314,213,64,149,6,27,4,23,67,64,1,2,0,1
E33038711,249,183,32,151,5,20,7,13,40,35,1,3,1,1
E33038712,207,130,44,86,4,44,9,35,28,26,0,2,0,1
E33038713,731,441,112,329,7,117,25,92,164,145,6,11,2,2
E33038714,326,210,84,126,2,40,10,30,66,61,3,1,1,8
E33038715,465,315,111,204,6,25,4,21,111,105,1,3,2,8
E33038716,292,202,70,132,3,10,3,7,66,59,4,3,0,11
E33038717,594,403,119,284,3,81,16,65,100,88,7,4,1,7
E33038718,254,176,61,115,1,25,2,23,46,40,1,3,2,6
E33038719,388,247,85,162,2,38,8,30,99,93,0,6,0,2
E33038720,343,259,66,193,3,7,3,4,70,61,5,4,0,4
E33038721,769,555,153,402,12,48,17,31,148,140,0,6,2,6
E33038722,379,224,75,149,3,71,19,52,75,69,2,3,1,6
E33038723,527,359,121,238,4,56,18,38,103,96,3,4,0,5
E33038724,1672,1272,403,869,26,78,15,63,289,278,2,7,2,7
E33038725,408,259,88,171,6,63,18,45,76,65,5,5,1,4
E33038726,413,276,76,200,1,48,23,25,79,63,7,6,3,9
E33038727,910,676,161,515,9,65,22,43,156,146,0,10,0,4
E33038728,669,550,126,424,9,27,6,21,79,65,6,5,3,4
E33038729,204,160,55,105,0,19,4,15,20,17,1,2,0,5
E33038730,228,181,71,110,1,14,4,10,31,29,1,1,0,1
E33038731,297,200,53,147,4,25,6,19,67,63,1,3,0,1
E33038732,260,192,59,133,2,22,3,19,43,40,1,0,2,1
E33038733,325,272,67,205,1,8,2,6,44,39,1,3,1,0
E33038734,405,310,88,222,6,39,14,25,48,47,0,1,0,2
E33038735,206,151,45,106,4,25,9,16,26,23,0,2,1,0
E33038736,212,153,46,107,2,19,5,14,33,30,0,3,0,5
E33038737,523,384,113,271,8,48,17,31,82,78,0,4,0,1
E33038738,332,262,76,186,5,21,6,15,42,35,2,5,0,2
E33038739,210,132,46,86,1,33,5,28,41,30,5,6,0,3
E33038740,265,181,74,107,6,24,9,15,52,40,2,5,5,2
E33038741,242,167,75,92,0,32,3,29,42,33,3,4,2,1
E33038742,319,219,74,145,4,43,5,38,52,45,2,1,4,1
E33038743,653,399,107,292,9,71,19,52,170,156,4,8,2,4
E33038744,255,171,47,124,8,31,5,26,43,38,2,2,1,2
E33038745,224,149,39,110,3,29,10,19,43,38,0,2,3,0
E33038746,426,249,81,168,2,96,22,74,75,64,7,1,3,4
E33038747,246,167,44,123,0,36,10,26,41,35,1,4,1,2
E33038748,199,141,39,102,0,22,2,20,36,34,0,2,0,0
E33038749,1158,824,190,634,15,62,15,47,253,236,3,13,1,4
E33038750,238,191,61,130,4,19,3,16,24,22,1,0,1,0
E33038751,1204,818,216,602,13,107,38,69,263,245,5,8,5,3
E33038752,454,344,79,265,6,35,14,21,67,62,2,2,1,2
E33038753,758,554,157,397,13,69,18,51,116,98,6,7,5,6
E33038754,211,121,34,87,3,44,9,35,42,39,1,1,1,1
E33038755,216,152,40,112,2,13,1,12,46,44,0,2,0,3
E33038756,229,148,47,101,3,40,12,28,36,26,4,2,4,2
E33038757,392,260,56,204,2,12,1,11,117,115,1,1,0,1
E33038758,1037,781,179,602,16,93,19,74,138,113,9,11,5,9
E33038759,231,154,38,116,6,40,14,26,30,27,0,3,0,1
E33038760,403,262,87,175,5,46,12,34,73,68,2,3,0,17
E33038761,376,256,74,182,7,41,10,31,65,59,2,4,0,7
E33038762,647,512,153,359,10,38,7,31,73,66,3,2,2,14
E33038763,509,344,118,226,17,79,17,62,63,56,5,2,0,6
E33038764,635,475,85,390,7,34,6,28,115,104,4,4,3,4
E33038765,469,347,88,259,7,45,8,37,66,57,1,7,1,4
E33038766,502,401,122,279,1,25,3,22,74,71,0,1,2,1
E33038767,407,333,88,245,3,11,0,11,59,50,3,6,0,1
E33038768,1686,1158,257,901,20,105,25,80,394,375,2,13,4,9
E33038769,233,167,43,124,6,34,5,29,26,23,2,1,0,0
E33038770,2139,1405,302,1103,28,81,24,57,616,585,4,25,2,9
E33038771,458,328,97,231,6,25,3,22,98,95,1,2,0,1
E33038772,250,172,49,123,4,26,12,14,45,40,3,2,0,3
E33038773,205,129,37,92,6,29,6,23,40,36,1,3,0,1
E33038774,240,161,36,125,5,16,7,9,57,53,1,1,2,1
E33038775,480,365,78,287,5,21,10,11,88,77,1,9,1,1
E33038776,515,381,110,271,7,32,6,26,93,89,1,2,1,2
E33038777,1600,1002,274,728,14,111,49,62,461,198,184,7,72,12
E33038778,642,362,74,288,5,36,9,27,232,93,92,9,38,7
E33038779,637,469,137,332,6,22,12,10,136,104,19,7,6,4
E33038780,657,454,118,336,9,82,19,63,111,106,0,5,0,1
E33038781,326,239,75,164,0,32,4,28,50,45,1,1,3,5
E33038782,276,203,61,142,5,21,6,15,37,32,3,2,0,10
E33038783,230,155,48,107,3,18,3,15,48,44,3,0,1,6
E33038784,208,141,66,75,3,15,2,13,46,28,17,1,0,3
E33038785,622,366,131,235,3,96,21,75,151,139,4,8,0,6
E33038786,594,384,122,262,13,98,18,80,91,83,5,2,1,8
E33038787,326,198,66,132,8,35,6,29,73,63,6,3,1,12
E33038788,963,715,196,519,11,96,18,78,138,124,1,7,6,3
E33038789,208,141,34,107,1,17,3,14,48,44,1,2,1,1
E33038790,213,156,64,92,0,21,1,20,35,34,0,1,0,1
E33038791,351,240,52,188,4,21,4,17,80,70,3,6,1,6
E33038792,287,220,52,168,2,21,6,15,43,39,2,2,0,1
E33038793,110,74,25,49,2,16,1,15,18,17,0,1,0,0
E33038794,237,160,45,115,0,23,4,19,42,38,0,3,1,12
E33038795,652,473,95,378,8,15,2,13,148,135,4,6,3,8
E33038796,353,254,75,179,5,32,11,21,56,51,2,3,0,6
E33038797,861,539,154,385,12,100,21,79,205,182,9,13,1,5
E33038798,243,158,36,122,4,32,4,28,43,39,3,1,0,6
E33038799,412,272,70,202,10,50,6,44,73,60,8,2,3,7
E33038800,268,193,46,147,8,27,4,23,39,31,5,0,3,1
E33038801,629,402,111,291,14,80,12,68,124,112,5,5,2,9
E33038802,227,168,48,120,4,24,5,19,29,24,3,1,1,2
E33038803,227,170,42,128,5,22,4,18,27,25,1,0,1,3
E33038804,201,152,47,105,4,14,3,11,29,26,3,0,0,2
E33038805,281,193,61,132,5,37,7,30,45,41,1,3,0,1
E33038806,271,153,51,102,7,35,8,27,73,71,0,2,0,3
E33038807,272,175,48,127,9,31,8,23,54,44,1,8,1,3
E33038808,388,273,64,209,9,30,2,28,73,67,1,5,0,3
E33038809,197,136,48,88,4,19,3,16,37,34,0,2,1,1
E33038810,327,214,50,164,5,52,9,43,56,50,1,5,0,0
E33038811,233,140,39,101,9,44,6,38,36,32,2,2,0,4
E33038812,873,666,154,512,15,79,16,63,106,90,4,9,3,7
E33038813,317,222,78,144,3,30,4,26,58,55,1,2,0,4
E33038814,493,354,81,273,5,20,11,9,111,103,2,5,1,3
E33038815,296,213,64,149,3,13,2,11,61,42,13,6,0,6
E33038816,449,299,102,197,3,52,23,29,93,84,2,6,1,2
E33038817,311,222,49,173,5,27,11,16,56,51,1,4,0,1
E33038818,782,547,140,407,12,42,18,24,178,170,2,6,0,3
E33038819,277,199,53,146,2,17,10,7,57,52,0,4,1,2
E33038820,379,261,85,176,3,34,9,25,76,68,4,2,2,5
E33038821,569,469,167,302,6,31,10,21,59,54,0,5,0,4
E33038822,410,279,80,199,7,44,21,23,78,66,1,7,4,2
E33038823,327,244,67,177,1,21,4,17,61,55,4,1,1,0
E33038824,299,209,47,162,2,18,4,14,66,63,1,2,0,4
E33038825,217,167,34,133,1,7,0,7,39,35,3,1,0,3
E33038826,804,608,147,461,7,39,17,22,146,140,2,4,0,4
E33038827,233,160,45,115,2,26,8,18,45,45,0,0,0,0
E33038828,237,182,52,130,2,18,10,8,34,32,1,1,0,1
E33038829,452,316,90,226,6,43,22,21,85,82,0,3,0,2
E33038830,903,612,165,447,17,113,55,58,161,145,1,8,7,0
E33038831,2145,1436,247,1189,24,54,26,28,622,607,1,11,3,9
E33038832,271,196,53,143,2,14,8,6,57,32,0,2,23,2
E33038833,212,145,41,104,5,36,15,21,26,23,0,2,1,0
E33038834,1128,773,183,590,20,31,12,19,297,280,2,13,2,7
E33038835,793,518,139,379,8,135,68,67,127,113,3,8,3,5
E33038836,1059,679,176,503,21,132,70,62,222,206,0,16,0,5
E33038837,882,555,162,393,14,110,50,60,201,164,19,10,8,2
E33038838,368,223,67,156,2,46,11,35,96,85,5,3,3,1
E33038839,218,133,32,101,5,26,5,21,54,44,3,6,1,0
E33038840,392,268,85,183,6,44,14,30,70,67,1,2,0,4
E33038841,627,423,101,322,17,67,18,49,112,99,7,4,2,8
E33038842,291,237,59,178,5,17,8,9,29,29,0,0,0,3
E33038843,455,370,135,235,6,29,8,21,48,46,0,2,0,2
E33038844,620,426,98,328,4,34,12,22,146,139,2,5,0,10
E33038845,341,224,61,163,2,32,8,24,79,74,1,4,0,4
E33038846,254,181,47,134,2,20,7,13,49,44,2,3,0,2
E33038847,342,251,57,194,3,17,6,11,69,63,1,5,0,2
E33038848,438,291,88,203,5,73,21,52,66,59,3,4,0,3
E33038849,338,241,67,174,2,24,7,17,68,64,0,4,0,3
E33038850,284,207,63,144,5,15,7,8,50,45,0,5,0,7
E33038851,719,552,183,369,7,56,29,27,104,102,1,0,1,0
E33038852,897,598,215,383,12,97,21,76,183,172,0,6,5,7
E33038853,362,257,70,187,0,23,4,19,81,77,0,4,0,1
E33038854,496,410,91,319,3,9,5,4,72,67,0,5,0,2
E33038855,262,178,48,130,5,19,9,10,60,55,0,5,0,0
E33038856,689,492,107,385,10,53,23,30,134,126,1,6,1,0
E33038857,230,165,48,117,3,23,4,19,38,37,0,1,0,1
E33038858,1803,1313,352,961,20,89,31,58,366,345,5,15,1,15
E33038859,467,348,103,245,9,33,17,16,73,62,0,10,1,4
E33038860,731,557,202,355,8,62,41,21,97,84,6,6,1,7
E33038861,283,173,36,137,5,29,15,14,76,72,3,1,0,0
E33038862,492,361,85,276,7,35,22,13,88,76,6,3,3,1
E33038863,386,296,93,203,7,22,13,9,60,55,0,5,0,1
E33038864,280,171,34,137,9,22,17,5,78,72,0,5,1,0
E33038865,304,191,56,135,7,35,24,11,70,63,4,3,0,1
E33038866,296,171,55,116,7,59,38,21,56,53,1,1,1,3
E33038867,318,248,83,165,7,16,12,4,43,37,1,5,0,4
E33038868,573,331,99,232,25,121,82,39,95,83,2,7,3,1
E33038869,1264,852,153,699,29,65,36,29,308,287,12,7,2,10
E33038870,372,282,84,198,11,18,11,7,58,53,0,5,0,3
E33038871,320,178,46,132,3,29,14,15,106,99,1,3,3,4
E33038872,336,236,57,179,6,8,7,1,85,77,4,4,0,1
E33038873,407,229,58,171,6,63,35,28,107,97,3,6,1,2
E33038874,228,176,45,131,1,12,4,8,39,36,0,3,0,0
E33038875,490,254,68,186,12,62,42,20,157,145,6,6,0,5
E33038876,335,224,63,161,9,38,25,13,60,52,2,5,1,4
E33038877,540,386,81,305,8,22,16,6,120,114,2,1,3,4
E33038878,287,168,46,122,6,27,15,12,81,74,2,3,2,5
E33038879,1229,881,266,615,38,126,81,45,178,164,6,4,4,6
E33038880,509,281,67,214,8,69,47,22,149,135,1,12,1,2
E33038881,396,250,74,176,2,42,31,11,95,89,1,4,1,7
E33038882,607,428,117,311,10,54,40,14,113,104,3,4,2,2
E33038883,214,167,55,112,0,14,12,2,33,32,0,0,1,0
E33038884,916,582,146,436,12,85,45,40,232,210,4,13,5,5
E33038885,239,165,59,106,6,23,16,7,44,38,3,0,3,1
E33038886,428,300,75,225,0,38,27,11,87,82,0,4,1,3
E33038887,696,421,139,282,14,86,57,29,170,153,7,6,4,5
E33038888,376,247,50,197,11,31,17,14,86,82,2,2,0,1
E33038889,447,323,97,226,5,25,14,11,91,82,3,4,2,3
E33038890,433,219,61,158,12,71,49,22,127,117,0,5,5,4
E33038891,202,157,38,119,0,11,9,2,34,28,1,4,1,0
E33038892,478,289,76,213,5,36,18,18,144,136,3,4,1,4
E33038893,199,145,49,96,1,19,7,12,30,24,3,3,0,4
E33038894,374,259,77,182,4,34,18,16,70,57,5,7,1,7
E33038895,524,341,121,220,7,20,7,13,149,61,81,4,3,7
E33038896,724,497,147,350,17,82,46,36,125,113,1,10,1,3
E33038897,224,179,50,129,0,9,5,4,35,28,1,4,2,1
E33038898,214,145,42,103,0,21,16,5,34,30,0,3,1,14
E33038899,823,584,154,430,12,67,32,35,153,140,7,4,2,7
E33038900,1909,1465,305,1160,54,88,47,41,266,218,30,16,2,36
E33038901,264,194,57,137,7,19,11,8,41,36,3,2,0,3
E33038902,292,218,68,150,4,43,35,8,25,23,2,0,0,2
E33038903,618,433,135,298,12,68,43,25,99,94,3,1,1,6
E33038904,225,145,39,106,7,29,19,10,41,39,0,2,0,3
E33038905,408,285,71,214,8,52,33,19,61,56,2,2,1,2
E33038906,501,329,99,230,8,94,61,33,69,66,0,1,2,1
E33038907,920,583,149,434,27,133,81,52,171,156,6,7,2,6
E33038908,335,201,34,167,4,8,4,4,119,115,1,3,0,3
E33038909,466,359,93,266,5,16,13,3,82,80,0,2,0,4
E33038910,408,286,97,189,1,48,7,41,72,60,2,4,6,1
E33038911,199,146,50,96,3,25,6,19,24,15,9,0,0,1
E33038912,871,589,187,402,11,116,55,61,149,141,3,5,0,6
E33038913,240,146,38,108,6,30,3,27,55,49,1,4,1,3
E33038914,285,181,66,115,3,42,6,36,59,52,0,6,1,0
E33038915,257,187,49,138,2,16,2,14,48,44,1,2,1,4
E33038916,792,589,145,444,18,54,14,40,124,114,1,9,0,7
E33038917,364,269,82,187,4,22,4,18,68,59,0,4,5,1
E33038918,389,252,69,183,7,73,14,59,50,45,1,3,1,7
E33038919,229,157,33,124,2,35,12,23,35,28,1,5,1,0
E33038920,289,217,61,156,3,10,6,4,54,49,1,4,0,5
E33038921,586,476,166,310,11,39,5,34,56,49,0,6,1,4
E33038922,343,250,75,175,4,25,3,22,59,54,0,4,1,5
E33038923,199,145,57,88,2,11,1,10,38,35,2,1,0,3
E33038924,242,170,52,118,3,19,5,14,47,46,0,1,0,3
E33038925,1004,742,165,577,9,98,11,87,146,130,3,8,5,9
E33038926,1882,1292,264,1028,13,69,39,30,495,467,3,21,4,13
E33038927,545,368,97,271,7,73,16,57,95,89,2,4,0,2
E33038928,327,230,64,166,3,36,9,27,56,50,3,3,0,2
E33038929,1195,860,259,601,25,132,19,113,173,161,1,7,4,5
E33038930,265,189,60,129,7,35,9,26,33,27,0,4,2,1
E33038931,576,395,94,301,3,56,12,44,112,104,2,4,2,10
E33038932,405,224,71,153,3,80,12,68,93,84,1,8,0,5
E33038933,261,196,68,128,1,25,7,18,36,30,5,1,0,3
E33038934,224,152,47,105,3,16,2,14,51,49,0,2,0,2
E33038935,472,381,97,284,5,25,5,20,59,57,1,0,1,2
E33038936,445,352,101,251,2,19,8,11,72,65,3,4,0,0
E33038937,202,107,25,82,2,28,8,20,64,55,5,3,1,1
E33038938,202,152,44,108,1,13,6,7,36,33,2,1,0,0
E33038939,967,743,173,570,9,40,11,29,169,153,4,11,1,6
E33038940,961,677,182,495,25,102,43,59,155,141,1,11,2,2
E33038941,225,183,54,129,1,10,2,8,26,19,5,2,0,5
E33038942,450,321,88,233,3,40,19,21,85,82,1,2,0,1
E33038943,334,243,69,174,6,27,10,17,56,52,4,0,0,2
E33038944,3457,2388,586,1802,75,383,144,239,585,556,3,19,7,26
E33038945,653,461,133,328,13,66,26,40,110,103,2,5,0,3
E33038946,490,333,101,232,7,78,35,43,68,62,0,4,2,4
E33038947,378,297,89,208,3,20,9,11,57,54,0,3,0,1
E33038948,290,199,53,146,4,30,10,20,55,51,3,1,0,2
E33038949,251,206,56,150,3,16,4,12,25,23,0,2,0,1
E33038950,453,326,95,231,2,45,23,22,76,72,0,4,0,4
E33038951,687,493,111,382,8,66,26,40,115,110,0,4,1,5
E33038952,1053,815,165,650,9,43,17,26,182,164,2,14,2,4
E33038953,231,171,71,100,3,22,12,10,33,33,0,0,0,2
E33038954,591,426,122,304,9,61,23,38,92,89,0,3,0,3
E33038955,246,188,47,141,3,22,11,11,30,26,1,3,0,3
E33038956,530,369,80,289,10,49,21,28,99,85,3,11,0,3
E33038957,271,182,59,123,0,40,11,29,46,41,1,2,2,3
E33038958,245,166,48,118,2,39,13,26,37,36,0,1,0,1
E33038959,1376,1000,258,742,21,140,49,91,204,193,0,11,0,11
E33038960,221,109,22,87,3,36,18,18,65,64,0,1,0,8
E33038961,485,370,112,258,1,24,10,14,88,79,4,4,1,2
E33038962,533,398,100,298,2,28,9,19,103,98,2,3,0,2
E33038963,734,535,114,421,12,59,19,40,125,121,1,2,1,3
E33038964,423,344,106,238,6,18,10,8,53,48,2,3,0,2
E33038965,205,120,26,94,4,45,14,31,35,33,0,2,0,1
E33038966,597,468,114,354,5,35,12,23,89,82,0,6,1,0
E33038967,468,336,64,272,10,24,5,19,97,87,3,5,2,1
E33038968,568,366,98,268,10,54,24,30,134,123,2,9,0,4
E33038969,282,182,48,134,2,57,18,39,35,34,0,1,0,6
E33038970,209,132,34,98,2,33,14,19,42,38,1,3,0,0
E33038971,217,144,47,97,2,29,9,20,41,40,0,1,0,1
E33038972,417,302,84,218,5,24,11,13,83,79,0,3,1,3
E33038973,342,229,69,160,2,46,11,35,62,59,0,3,0,3
E33038974,368,287,65,222,2,17,8,9,61,55,0,3,3,1
E33038975,564,422,123,299,9,54,10,44,72,70,0,2,0,7
E33038976,235,158,30,128,0,22,7,15,54,48,1,4,1,1
E33038977,312,201,55,146,4,46,15,31,56,52,1,2,1,5
E33038978,352,290,59,231,2,12,3,9,48,44,0,4,0,0
E33038979,325,222,64,158,6,38,9,29,58,54,0,4,0,1
E33038980,314,228,42,186,3,15,3,12,66,64,0,2,0,2
E33038981,1525,1140,284,856,20,55,25,30,298,292,1,3,2,12
E33038982,673,506,138,368,15,49,16,33,100,86,4,10,0,3
E33038983,621,419,96,323,8,80,36,44,112,104,3,4,1,2
E33038984,920,659,154,505,16,58,32,26,179,169,3,6,1,8
E33038985,1445,1083,189,894,11,54,17,37,290,279,0,10,1,7
E33038986,209,150,32,118,1,24,9,15,32,31,0,1,0,2
E33038987,397,292,69,223,8,15,5,10,82,77,0,4,1,0
E33038988,537,422,124,298,7,34,18,16,68,63,4,1,0,6
E33038989,269,177,68,109,0,45,29,16,43,36,4,3,0,4
E33038990,435,260,75,185,10,95,66,29,64,59,2,2,1,6
E33038991,892,631,143,488,11,85,40,45,156,148,1,4,3,9
E33038992,697,510,115,395,11,60,31,29,114,110,2,1,1,2
E33038993,239,174,42,132,6,11,6,5,44,43,1,0,0,4
E33038994,201,152,22,130,1,6,4,2,40,34,2,3,1,2
E33038995,443,336,91,245,6,33,17,16,64,61,0,3,0,4
E33038996,517,364,97,267,3,27,13,14,114,109,3,2,0,9
E33038997,862,509,171,338,21,105,49,56,217,200,1,12,4,10
E33038998,505,377,69,308,8,34,12,22,86,85,0,0,1,0
E33038999,217,143,44,99,5,36,16,20,33,28,1,3,1,0
E33039000,1503,1042,205,837,18,69,36,33,366,347,3,9,7,8
E33039001,643,456,82,374,7,28,12,16,151,144,1,4,2,1
E33039002,1915,1304,235,1069,21,49,25,24,530,508,4,8,10,11
E33039003,893,495,140,355,15,96,53,43,281,250,8,8,15,6
E33039004,323,210,51,159,3,50,31,19,59,56,1,0,2,1
E33039005,390,267,56,211,5,39,21,18,78,71,5,2,0,1
E33039006,365,249,53,196,2,35,23,12,75,71,0,4,0,4
E33039007,420,275,82,193,7,23,11,12,109,105,1,3,0,6
E33039008,313,183,64,119,1,13,6,7,96,84,8,2,2,20
E33039009,793,585,165,420,9,85,17,68,107,96,4,6,1,7
E33039010,359,244,75,169,3,28,14,14,76,60,9,3,4,8
E33039011,1170,809,161,648,17,44,19,25,293,280,1,7,5,7
E33039012,555,385,122,263,10,77,28,49,80,77,1,2,0,3
E33039013,3084,2035,539,1496,48,428,118,310,556,495,34,19,8,17
E33039014,1142,891,301,590,20,58,37,21,169,132,24,11,2,4
E33039015,643,477,124,353,10,69,26,43,85,80,0,4,1,2
E33039016,485,347,104,243,6,77,35,42,55,53,0,2,0,0
E33039017,838,501,135,366,7,50,18,32,249,206,29,10,4,31
E33039018,3353,2398,580,1818,25,90,31,59,827,804,7,10,6,13
E33039019,250,182,46,136,3,32,10,22,30,25,1,3,1,3
E33039020,221,147,35,112,4,30,11,19,37,34,2,1,0,3
E33039021,292,208,42,166,3,25,12,13,55,49,0,6,0,1
E33039022,222,138,39,99,4,27,7,20,53,47,0,4,2,0
E33039023,471,299,68,231,0,38,16,22,128,126,0,2,0,6
E33039024,597,354,112,242,16,122,43,79,103,100,0,3,0,2
E33039025,250,166,41,125,2,22,12,10,55,52,2,0,1,5
E33039026,362,279,97,182,6,35,10,25,37,34,0,3,0,5
E33039027,339,239,54,185,5,28,13,15,62,60,0,1,1,5
E33039028,688,437,137,300,7,109,41,68,130,122,3,4,1,5
E33039029,294,195,51,144,3,28,14,14,65,57,0,8,0,3
E33039030,293,182,41,141,4,39,15,24,67,66,0,1,0,1
E33039031,204,121,36,85,5,35,15,20,43,38,0,2,3,0
E33039032,339,149,43,106,2,40,23,17,139,130,2,6,1,9
E33039033,221,130,33,97,1,29,12,17,58,56,1,1,0,3
E33039034,358,243,51,192,2,4,0,4,109,103,1,5,0,0
E33039035,879,602,130,472,10,35,7,28,228,215,5,5,3,4
E33039036,519,340,68,272,7,72,27,45,96,90,1,5,0,4
E33039037,103,77,16,61,0,10,5,5,15,14,0,1,0,1
E33039038,362,239,73,166,5,20,11,9,95,89,3,3,0,3
E33039039,573,426,136,290,8,54,18,36,82,78,1,3,0,3
E33039040,289,212,60,152,7,30,12,18,35,29,2,3,1,5
E33039041,410,279,73,206,6,60,29,31,65,58,2,5,0,0
E33039042,215,169,37,132,4,9,4,5,32,30,0,2,0,1
E33039043,604,448,125,323,4,43,15,28,107,103,1,2,1,2
E33039044,393,250,62,188,2,39,15,24,99,93,0,3,3,3
E33039045,287,206,36,170,6,25,1,24,49,46,1,2,0,1
E33039046,328,226,53,173,2,32,8,24,60,53,3,2,2,8
E33039047,299,213,72,141,6,25,9,16,52,45,2,5,0,3
E33039048,1039,787,151,636,15,54,15,39,181,172,5,3,1,2
E33039049,187,133,34,99,3,20,2,18,31,27,1,2,1,0
E33039050,311,208,51,157,5,31,8,23,66,56,1,8,1,1
E33039051,1368,1068,278,790,12,69,17,52,214,189,16,5,4,5
E33039052,4677,3296,857,2439,73,397,50,347,890,634,135,44,77,21
E33039053,747,480,124,356,21,108,40,68,132,118,2,11,1,6
E33039054,410,294,64,230,1,32,7,25,79,67,6,4,2,4
E33039055,653,430,92,338,7,72,30,42,140,133,0,7,0,4
E33039056,369,229,55,174,7,52,24,28,79,69,3,7,0,2
E33039057,296,239,56,183,8,14,2,12,35,33,1,1,0,0
E33039058,368,260,58,202,13,32,9,23,63,58,1,4,0,0
E33039059,561,408,102,306,10,50,13,37,90,86,1,3,0,3
E33039060,799,542,147,395,11,135,34,101,109,99,1,8,1,2
E33039061,709,529,121,408,16,46,11,35,114,106,2,4,2,4
E33039062,255,169,53,116,2,27,14,13,50,40,1,3,6,7
E33039063,301,219,73,146,2,21,9,12,56,44,9,3,0,3
E33039064,504,376,101,275,6,31,9,22,86,81,2,2,1,5
E33039065,1251,794,252,542,22,132,64,68,289,188,85,11,5,14
E33039066,394,296,91,205,1,42,16,26,55,48,1,6,0,0
E33039067,248,180,61,119,3,21,11,10,41,37,3,1,0,3
E33039068,419,309,84,225,2,44,25,19,59,54,3,1,1,5
E33039069,611,424,121,303,5,89,50,39,90,81,4,5,0,3
E33039070,326,238,71,167,5,33,16,17,48,45,0,3,0,2
E33039071,325,255,76,179,12,27,14,13,29,23,1,4,1,2
E33039072,366,262,85,177,6,43,17,26,55,51,0,4,0,0
E33039073,441,341,110,231,6,34,16,18,52,45,2,5,0,8
E33039074,245,174,31,143,1,23,9,14,45,43,2,0,0,2
E33039075,286,138,43,95,3,44,17,27,92,86,4,1,1,9
E33039076,206,152,46,106,1,18,13,5,35,34,1,0,0,0
E33039077,214,159,29,130,2,16,12,4,33,31,1,1,0,4
E33039078,270,183,60,123,5,33,22,11,48,42,0,5,1,1
E33039079,402,276,109,167,9,32,19,13,57,47,5,5,0,28
E33039080,419,321,83,238,2,31,16,15,65,59,2,4,0,0
E33039081,656,480,157,323,11,45,26,19,115,106,1,5,3,5
E33039082,463,316,84,232,9,41,23,18,92,83,2,3,4,5
E33039083,201,130,47,83,4,37,26,11,30,28,0,1,1,0
E33039084,262,183,39,144,5,20,9,11,53,47,1,3,2,1
E33039085,501,388,110,278,15,21,7,14,74,61,2,9,2,3
E33039086,364,254,77,177,7,31,17,14,69,64,1,3,1,3
E33039087,133,85,22,63,4,29,13,16,15,12,0,3,0,0
E33039088,204,147,43,104,4,7,6,1,46,38,4,2,2,0
E33039089,430,353,110,243,4,23,12,11,49,46,1,1,1,1
E33039090,390,252,78,174,6,36,15,21,90,76,2,7,5,6
E33039091,242,165,38,127,3,24,11,13,46,41,1,4,0,4
E33039092,736,511,155,356,17,84,35,49,119,102,5,8,4,5
E33039093,428,280,86,194,11,62,39,23,72,61,2,9,0,3
E33039094,338,201,53,148,3,41,18,23,88,78,5,3,2,5
E33039095,315,213,56,157,4,31,9,22,59,52,0,5,2,8
E33039096,245,188,42,146,4,23,8,15,27,23,2,2,0,3
E33039097,714,500,177,323,10,98,36,62,104,92,3,9,0,2
E33039098,525,352,90,262,17,56,31,25,97,85,6,5,1,3
E33039099,312,239,69,170,1,14,6,8,34,29,1,1,3,24
E33039100,633,429,131,298,10,46,33,13,141,128,3,8,2,7
E33039101,356,225,80,145,14,61,52,9,49,45,0,4,0,7
E33039102,308,213,49,164,2,24,13,11,67,60,1,4,2,2
E33039103,332,244,70,174,5,31,21,10,50,46,1,2,1,2
E33039104,255,156,58,98,1,54,32,22,40,38,2,0,0,4
E33039105,267,171,45,126,8,33,23,10,50,49,0,1,0,5
E33039106,444,302,93,209,9,60,47,13,67,61,3,2,1,6
E33039107,234,159,50,109,5,30,20,10,38,31,6,1,0,2
E33039108,231,175,65,110,1,16,11,5,36,34,0,2,0,3
E33039109,149,83,28,55,1,27,17,10,37,35,0,2,0,1
E33039110,222,152,48,104,0,22,13,9,47,38,6,3,0,1
E33039111,272,179,48,131,6,39,21,18,45,41,2,1,1,3
E33039112,449,265,74,191,9,54,23,31,118,108,5,5,0,3
E33039113,327,233,80,153,2,31,24,7,56,54,0,2,0,5
E33039114,381,278,72,206,7,36,24,12,55,49,1,4,1,5
E33039115,316,209,62,147,6,28,12,16,68,60,3,2,3,5
E33039116,239,175,28,147,6,20,13,7,38,33,1,2,2,0
E33039117,404,250,79,171,8,42,21,21,99,96,1,2,0,5
E33039118,342,236,62,174,3,43,31,12,59,51,0,8,0,1
E33039119,775,462,128,334,10,122,61,61,172,156,2,12,2,9
E33039120,216,159,41,118,3,14,8,6,39,38,1,0,0,1
E33039121,451,270,92,178,5,86,53,33,90,80,8,1,1,0
E33039122,325,218,59,159,5,36,21,15,64,57,0,6,1,2
E33039123,534,341,52,289,9,36,21,15,148,141,3,4,0,0
E33039124,1008,624,158,466,14,149,90,59,216,198,3,10,5,5
E33039125,624,463,142,321,12,54,30,24,89,82,2,5,0,6
E33039126,1158,816,212,604,16,50,30,20,269,253,5,11,0,7
E33039127,405,273,73,200,7,24,15,9,99,96,0,2,1,2
E33039128,209,139,40,99,5,28,19,9,36,32,2,2,0,1
E33039129,194,123,20,103,3,21,12,9,44,39,1,4,0,3
E33039130,396,271,69,202,8,27,16,11,84,78,3,2,1,6
E33039131,333,211,54,157,1,17,9,8,103,100,0,2,1,1
E33039132,561,383,119,264,7,58,35,23,112,106,1,5,0,1
E33039133,393,257,77,180,2,48,28,20,84,77,1,5,1,2
E33039134,532,381,73,308,6,46,28,18,98,88,2,6,2,1
E33039135,730,527,143,384,8,36,10,26,155,145,2,5,3,4
E33039136,282,185,52,133,1,15,11,4,79,71,0,8,0,2
E33039137,429,305,66,239,7,25,12,13,87,81,0,2,4,5
E33039138,1375,1040,190,850,8,28,10,18,294,281,1,11,1,5
E33039139,200,128,51,77,3,25,19,6,41,39,1,1,0,3
E33039140,262,180,50,130,5,35,22,13,42,42,0,0,0,0
E33039141,1355,836,192,644,10,232,118,114,267,236,6,18,7,10
E33039142,279,194,28,166,6,32,17,15,47,46,1,0,0,0
E33039143,907,589,145,444,17,110,65,45,184,158,4,15,7,7
E33039144,357,268,57,211,5,13,7,6,71,64,2,5,0,0
E33039145,285,208,69,139,4,12,5,7,59,58,0,1,0,2
E33039146,218,133,30,103,2,26,15,11,50,42,3,3,2,7
E33039147,371,269,78,191,7,36,27,9,55,50,1,4,0,4
E33039148,327,223,59,164,4,24,15,9,58,56,0,2,0,18
E33039149,210,143,42,101,1,25,14,11,39,35,0,4,0,2
E33039150,359,255,61,194,1,24,14,10,78,68,1,8,1,1
E33039151,298,218,61,157,1,34,24,10,44,42,0,2,0,1
E33039152,273,178,46,132,3,29,21,8,62,58,1,3,0,1
E33039153,334,185,49,136,2,47,25,22,95,91,0,3,1,5
E33039154,211,152,42,110,0,33,25,8,25,25,0,0,0,1
E33039155,1209,883,218,665,10,64,33,31,246,238,0,8,0,6
E33039156,737,569,171,398,1,58,23,35,106,95,3,8,0,3
E33039157,301,204,51,153,2,32,22,10,60,58,0,1,1,3
E33039158,302,204,49,155,2,26,9,17,69,64,0,3,2,1
E33039159,941,658,163,495,7,79,51,28,194,180,2,10,2,3
E33039160,397,301,71,230,2,50,21,29,40,38,0,1,1,4
E33039161,352,239,52,187,1,37,19,18,74,64,0,7,3,1
E33039162,676,505,141,364,5,51,29,22,113,102,1,10,0,2
E33039163,203,138,44,94,0,26,22,4,39,34,0,5,0,0
E33039164,232,177,71,106,3,16,15,1,31,27,0,3,1,5
E33039165,360,248,82,166,1,35,25,10,75,71,0,4,0,1
E33039166,537,359,122,237,7,42,25,17,111,102,3,5,1,18
E33039167,209,137,41,96,2,24,10,14,40,35,4,1,0,6
E33039168,225,141,43,98,1,27,10,17,51,46,0,5,0,5
E33039169,288,205,48,157,3,29,17,12,50,43,0,5,2,1
E33039170,347,245,69,176,4,25,11,14,71,70,0,0,1,2
E33039171,268,186,59,127,4,23,10,13,52,50,0,1,1,3
E33039172,327,239,71,168,2,26,12,14,57,51,1,4,1,3
E33039173,607,401,99,302,8,90,54,36,106,102,0,3,1,2
E33039174,262,169,49,120,3,28,9,19,62,57,0,5,0,0
E33039175,403,259,80,179,3,47,16,31,91,83,2,2,4,3
E33039176,274,139,37,102,4,22,11,11,107,103,0,4,0,2
E33039177,250,133,44,89,3,20,4,16,94,90,0,1,3,0
E33039178,842,607,164,443,8,53,28,25,171,158,1,9,3,3
E33039179,501,176,54,122,7,23,12,11,286,275,7,2,2,9
E33039180,516,343,99,244,9,59,25,34,102,90,3,6,3,3
E33039181,219,155,34,121,1,10,3,7,49,40,1,7,1,4
E33039182,229,155,48,107,3,23,7,16,46,42,2,2,0,2
E33039183,659,480,142,338,8,58,20,38,109,96,0,11,2,4
E33039184,703,499,127,372,12,62,27,35,127,116,3,8,0,3
E33039185,319,155,70,85,4,38,3,35,88,70,11,6,1,34
E33039186,467,270,91,179,3,111,23,88,82,78,0,3,1,1
E33039187,793,491,129,362,7,67,15,52,222,204,2,14,2,6
E33039188,254,160,44,116,1,34,9,25,55,51,0,3,1,4
E33039189,214,152,54,98,4,21,8,13,36,32,2,2,0,1
E33039190,235,155,27,128,4,12,2,10,60,55,0,5,0,4
E33039191,484,365,88,277,10,18,7,11,86,77,1,6,2,5
E33039192,659,451,162,289,2,32,9,23,169,163,1,3,2,5
E33039193,335,264,78,186,2,16,4,12,48,42,0,5,1,5
E33039194,1278,1051,289,762,11,64,17,47,143,127,1,14,1,9
E33039195,316,235,94,141,1,22,3,19,53,46,3,3,1,5
E33039196,1101,787,240,547,21,88,22,66,190,174,8,4,4,15
E33039197,221,133,46,87,1,25,7,18,51,43,3,4,1,11
E33039198,246,197,62,135,4,23,3,20,21,18,1,2,0,1
E33039199,301,249,67,182,3,6,1,5,41,33,1,5,2,2
E33039200,227,181,55,126,5,15,4,11,25,24,0,1,0,1
E33039201,464,273,81,192,4,66,16,50,115,108,2,5,0,6
E33039202,410,273,75,198,4,44,10,34,80,74,1,3,2,9
E33039203,493,317,105,212,14,52,16,36,104,97,1,3,3,6
E33039204,356,203,66,137,1,36,6,30,115,107,5,2,1,1
E33039205,516,324,80,244,15,43,8,35,127,117,1,6,3,7
E33039206,359,192,55,137,4,41,11,30,120,112,0,6,2,2
E33039207,815,596,174,422,10,71,16,55,137,119,6,7,5,1
E33039208,348,247,56,191,2,35,7,28,63,58,0,5,0,1
E33039209,237,172,41,131,1,20,4,16,41,41,0,0,0,3
E33039210,613,476,133,343,4,38,9,29,91,83,2,4,2,4
E33039211,991,645,185,460,15,155,43,112,171,150,5,8,8,5
E33039212,614,438,104,334,6,39,4,35,128,119,0,9,0,3
E33039213,268,160,48,112,2,40,16,24,65,62,0,2,1,1
E33039214,241,176,65,111,2,17,4,13,42,39,2,1,0,4
E33039215,343,185,56,129,1,43,6,37,108,101,1,3,3,6
E33039216,650,417,126,291,9,108,28,80,115,106,5,3,1,1
E33039217,310,221,66,155,1,43,17,26,42,39,0,3,0,3
E33039218,201,145,42,103,1,12,3,9,39,36,0,0,3,4
E33039219,553,350,101,249,5,99,21,78,98,89,1,6,2,1
E33039220,251,184,71,113,2,19,2,17,43,38,2,2,1,3
E33039221,351,228,66,162,2,38,11,27,77,69,5,3,0,6
E33039222,205,152,54,98,1,9,0,9,36,27,6,3,0,7
E33039223,420,292,93,199,10,41,10,31,71,57,0,12,2,6
E33039224,359,242,73,169,2,40,14,26,70,64,3,2,1,5
E33039225,242,181,64,117,1,27,8,19,29,28,0,1,0,4
E33039226,600,380,130,250,9,85,18,67,120,106,1,9,4,6
E33039227,393,183,51,132,4,25,11,14,181,174,3,4,0,0
E33039228,583,404,134,270,5,59,22,37,101,86,4,10,1,14
E33039229,210,110,51,59,6,26,6,20,44,27,8,2,7,24
E33039230,328,225,81,144,1,41,15,26,52,44,2,2,4,9
E33039231,322,215,75,140,2,30,5,25,68,41,26,1,0,7
E33039232,701,345,68,277,6,46,19,27,298,285,7,5,1,6
E33039233,555,327,81,246,7,50,25,25,166,158,1,7,0,5
E33039234,290,218,84,134,2,17,4,13,52,49,0,1,2,1
E33039235,327,251,72,179,0,23,4,19,49,40,2,7,0,4
E33039236,738,550,103,447,4,52,32,20,128,115,2,10,1,4
E33039237,342,200,48,152,3,62,42,20,75,69,2,4,0,2
E33039238,444,278,49,229,5,58,31,27,101,92,0,8,1,2
E33039239,330,219,55,164,5,25,17,8,78,74,2,1,1,3
E33039240,495,331,61,270,11,45,26,19,108,105,1,2,0,0
E33039241,3711,2456,527,1929,46,286,172,114,906,846,5,50,5,17
E33039242,461,330,93,237,5,45,25,20,78,74,0,4,0,3
E33039243,1062,695,168,527,17,112,60,52,233,204,4,23,2,5
E33039244,3294,2354,530,1824,45,223,98,125,662,618,4,37,3,10
E33039245,332,235,62,173,9,39,21,18,49,44,0,4,1,0
E33039246,241,141,34,107,4,26,17,9,63,61,0,1,1,7
E33039247,702,527,97,430,5,32,17,15,135,120,3,11,1,3
E33039248,6796,4615,1010,3605,91,643,327,316,1417,1324,8,76,9,30
E33039249,403,304,62,242,0,37,19,18,62,60,0,2,0,0
E33039250,498,347,65,282,2,58,35,23,88,83,0,5,0,3
E33039251,1679,1107,253,854,29,177,102,75,358,337,3,15,3,8
E33039252,1020,754,211,543,14,133,85,48,117,111,0,6,0,2
E33039253,618,477,85,392,11,25,14,11,102,93,0,9,0,3
E33039254,592,384,82,302,11,87,48,39,108,105,0,3,0,2
E33039255,3995,2913,456,2457,67,225,89,136,767,703,7,48,9,23
E33039256,327,215,46,169,6,49,23,26,55,49,0,4,2,2
E33039257,373,275,46,229,5,38,27,11,55,54,0,1,0,0
E33039258,185,140,32,108,3,13,7,6,29,27,0,2,0,0
E33039259,335,211,44,167,8,41,36,5,74,69,1,3,1,1
E33039260,441,335,68,267,5,35,15,20,65,59,2,3,1,1
E33039261,229,157,33,124,2,25,13,12,45,41,0,4,0,0
E33039262,1952,1592,454,1138,18,67,34,33,270,265,0,4,1,5
E33039263,1203,893,220,673,16,108,66,42,180,161,3,15,1,6
E33039264,636,454,98,356,2,58,38,20,120,113,2,4,1,2
E33039265,381,242,50,192,5,58,39,19,75,71,0,3,1,1
E33039266,851,610,125,485,9,61,26,35,169,163,0,5,1,2
E33039267,262,196,43,153,6,16,10,6,43,39,1,3,0,1
E33039268,246,158,38,120,4,35,19,16,48,47,1,0,0,1
E33039269,1186,835,148,687,18,68,34,34,261,244,4,13,0,4
E33039270,786,573,143,430,6,64,45,19,142,138,0,3,1,1
E33039271,534,331,85,246,4,31,14,17,163,146,14,3,0,5
E33039272,722,570,129,441,4,47,26,21,98,87,0,10,1,3
E33039273,288,165,42,123,7,48,32,16,63,50,4,2,7,5
E33039274,454,283,68,215,9,63,43,20,94,89,0,4,1,5
E33039275,620,398,115,283,13,132,91,41,71,65,1,3,2,6
E33039276,429,304,81,223,4,45,24,21,69,68,0,1,0,7
E33039277,343,194,54,140,6,71,50,21,72,68,1,3,0,0
E33039278,786,611,119,492,13,40,24,16,117,110,0,6,1,5
E33039279,630,374,85,289,9,126,91,35,119,117,0,1,1,2
E33039280,391,284,51,233,3,26,15,11,76,69,3,4,0,2
E33039281,274,154,44,110,8,66,49,17,44,41,0,2,1,2
E33039282,337,211,57,154,5,60,40,20,57,53,0,3,1,4
E33039283,905,544,115,429,18,164,105,59,173,161,2,8,2,6
E33039284,823,548,102,446,18,64,34,30,186,168,1,16,1,7
E33039285,900,681,170,511,9,127,99,28,80,72,1,7,0,3
E33039286,1031,632,158,474,5,66,30,36,325,314,1,9,1,3
E33039287,333,235,64,171,3,39,24,15,54,50,2,2,0,2
E33039288,1714,1244,307,937,27,198,119,79,240,221,2,17,0,5
E33039289,272,190,35,155,5,39,18,21,38,37,0,1,0,0
E33039290,317,219,47,172,6,41,19,22,49,45,0,4,0,2
E33039291,253,181,39,142,4,21,15,6,45,38,1,6,0,2
E33039292,556,352,78,274,9,102,59,43,93,85,1,5,2,0
E33039293,320,231,47,184,9,23,12,11,56,50,0,6,0,1
E33039294,209,150,37,113,3,24,13,11,32,26,0,6,0,0
E33039295,479,349,81,268,3,26,16,10,99,97,1,1,0,2
E33039296,793,481,97,384,12,132,93,39,164,153,2,7,2,4
E33039297,593,332,52,280,10,103,83,20,146,139,0,5,2,2
E33039298,341,260,76,184,2,34,13,21,43,32,8,3,0,2
E33039299,251,189,56,133,0,14,4,10,45,40,0,5,0,3
E33039300,733,479,148,331,11,143,23,120,91,82,1,7,1,9
E33039301,282,171,61,110,1,25,7,18,55,49,3,2,1,30
E33039302,285,175,52,123,3,45,13,32,57,51,2,4,0,5
E33039303,247,172,64,108,4,17,3,14,41,37,2,2,0,13
E33039304,365,256,66,190,5,34,9,25,70,68,0,2,0,0
E33039305,472,313,67,246,6,22,7,15,131,129,0,2,0,0
E33039306,227,182,58,124,0,17,3,14,28,28,0,0,0,0
E33039307,218,137,48,89,2,36,13,23,43,39,0,4,0,0
E33039308,225,172,49,123,2,19,7,12,30,29,0,1,0,2
E33039309,263,181,40,141,2,29,8,21,50,43,4,2,1,1
E33039310,276,194,42,152,5,24,4,20,53,48,0,5,0,0
E33039311,263,214,80,134,0,10,2,8,36,35,1,0,0,3
E33039312,756,486,137,349,9,111,18,93,142,129,2,8,3,8
E33039313,204,153,46,107,1,13,2,11,32,32,0,0,0,5
E33039314,571,410,124,286,7,72,15,57,79,75,0,3,1,3
E33039315,349,244,59,185,3,46,8,38,54,51,0,3,0,2
E33039316,1186,831,203,628,11,101,39,62,233,219,2,9,3,10
E33039317,756,562,152,410,12,83,21,62,92,87,0,4,1,7
E33039318,315,237,66,171,3,21,1,20,53,49,1,3,0,1
E33039319,1191,922,264,658,13,109,29,80,140,126,4,8,2,7
E33039320,1076,858,204,654,6,50,14,36,158,146,6,3,3,4
E33039321,684,542,147,395,8,51,13,38,79,75,2,2,0,4
E33039322,439,306,72,234,2,51,19,32,76,69,2,5,0,4
E33039323,215,170,50,120,3,14,2,12,28,25,3,0,0,0
E33039324,294,226,81,145,3,25,6,19,37,36,0,1,0,3
E33039325,253,208,71,137,1,15,2,13,28,26,1,1,0,1
E33039326,331,217,74,143,0,27,2,25,82,67,9,4,2,5
E33039327,284,204,69,135,2,19,7,12,45,38,2,4,1,14
E33039328,365,223,92,131,3,42,8,34,67,53,9,4,1,30
E33039329,408,265,85,180,2,76,16,60,58,56,0,2,0,7
E33039330,321,235,62,173,1,45,5,40,34,30,0,4,0,6
E33039331,541,372,110,262,6,82,25,57,80,76,0,3,1,1
E33039332,437,296,80,216,10,56,17,39,73,68,1,4,0,2
E33039333,374,289,84,205,4,21,3,18,59,54,0,5,0,1
E33039334,524,346,97,249,8,58,26,32,101,72,20,9,0,11
E33039335,229,127,43,84,1,13,0,13,53,43,9,1,0,35
E33039336,451,308,79,229,3,52,14,38,78,70,2,6,0,10
E33039337,350,264,57,207,13,27,7,20,46,42,0,4,0,0
E33039338,289,207,60,147,1,31,4,27,50,43,2,5,0,0
E33039339,706,489,139,350,11,86,13,73,118,107,4,7,0,2
E33039340,378,275,68,207,5,31,8,23,66,62,1,3,0,1
E33039341,274,210,54,156,1,17,3,14,45,45,0,0,0,1
E33039342,1005,708,177,531,18,96,39,57,178,157,1,18,2,5
E33039343,584,437,120,317,6,49,11,38,92,89,0,1,2,0
E33039344,541,377,113,264,5,83,15,68,73,70,0,3,0,3
E33039345,296,214,68,146,4,26,11,15,46,44,0,2,0,6
E33039346,449,304,53,251,6,27,7,20,108,99,1,8,0,4
E33039347,595,435,142,293,6,48,25,23,99,87,3,8,1,7
E33039348,1227,939,275,664,20,102,18,84,155,139,5,10,1,11
E33039349,575,419,111,308,9,55,17,38,88,78,2,7,1,4
E33039350,192,113,39,74,3,34,13,21,41,37,1,3,0,1
E33039351,698,483,124,359,17,74,18,56,120,109,0,11,0,4
E33039352,211,167,56,111,1,12,2,10,30,28,0,2,0,1
E33039353,323,224,54,170,4,30,5,25,60,55,1,4,0,5
E33039354,859,657,180,477,17,35,6,29,141,135,0,4,2,9
E33039355,268,192,57,135,1,17,9,8,54,44,0,10,0,4
E33039356,113,75,17,58,1,16,7,9,20,19,0,0,1,1
E33039357,328,246,98,148,4,20,4,16,55,46,0,9,0,3
E33039358,247,186,53,133,1,16,3,13,40,39,0,1,0,4
E33039359,222,143,44,99,5,13,4,9,52,46,0,3,3,9
E33039360,1773,1156,350,806,28,185,28,157,393,374,2,15,2,11
E33039361,509,345,115,230,9,55,8,47,94,84,1,9,0,6
E33039362,1006,785,190,595,16,42,9,33,157,146,2,9,0,6
E33039363,321,250,83,167,1,23,3,20,46,44,0,2,0,1
E33039364,211,161,44,117,3,15,4,11,30,27,1,2,0,2
E33039365,655,460,159,301,10,72,12,60,108,101,0,6,1,5
E33039366,499,409,124,285,9,14,2,12,66,63,0,3,0,1
E33039367,270,120,38,82,7,46,11,35,84,78,3,3,0,13
E33039368,216,139,63,76,5,7,2,5,58,47,6,3,2,7
E33039369,206,134,33,101,3,17,11,6,48,47,0,1,0,4
E33039370,818,530,113,417,13,48,18,30,220,207,0,12,1,7
E33039371,405,299,72,227,2,32,17,15,71,68,1,2,0,1
E33039372,617,422,115,307,5,63,31,32,126,115,1,10,0,1
E33039373,606,480,120,360,6,28,16,12,91,85,0,6,0,1
E33039374,230,162,38,124,1,19,2,17,48,45,1,2,0,0
E33039375,707,482,113,369,6,53,25,28,160,147,1,10,2,6
E33039376,371,210,48,162,5,38,11,27,113,106,0,6,1,5
E33039377,254,176,37,139,1,17,9,8,58,55,0,3,0,2
E33039378,199,139,21,118,4,12,7,5,43,41,1,1,0,1
E33039379,245,161,35,126,4,10,4,6,68,58,3,6,1,2
E33039380,241,157,33,124,1,16,5,11,65,58,1,5,1,2
E33039381,294,228,62,166,0,14,5,9,49,47,1,1,0,3
E33039382,461,293,94,199,6,39,8,31,113,105,1,7,0,10
E33039383,341,219,57,162,3,29,4,25,88,78,4,5,1,2
E33039384,308,182,46,136,4,26,12,14,90,79,5,5,1,6
E33039385,656,511,120,391,5,36,14,22,99,93,1,3,2,5
E33039386,391,293,93,200,3,20,9,11,73,68,1,3,1,2
E33039387,315,179,44,135,3,25,11,14,107,100,0,7,0,1
E33039388,287,201,33,168,2,12,6,6,68,62,0,5,1,4
E33039389,424,287,86,201,3,50,17,33,80,78,0,2,0,4
E33039390,361,258,69,189,5,19,4,15,77,70,1,6,0,2
E33039391,763,548,138,410,8,45,16,29,153,141,2,9,1,9
E33039392,3455,2384,594,1790,29,220,94,126,809,725,26,46,12,13
E33039393,205,145,36,109,3,8,6,2,49,46,1,1,1,0
E33039394,622,487,152,335,1,36,12,24,94,82,2,10,0,4
E33039395,687,500,120,380,4,22,11,11,156,148,1,7,0,5
E33039396,291,233,83,150,1,17,9,8,36,33,1,2,0,4
E33039397,274,219,54,165,2,11,2,9,40,36,0,4,0,2
E33039398,698,473,131,342,5,71,28,43,148,136,0,10,2,1
E33039399,1269,1086,321,765,5,48,16,32,125,119,0,4,2,5
E33039400,1025,706,188,518,10,105,40,65,201,186,2,12,1,3
E33039401,1105,870,208,662,21,42,15,27,168,152,1,14,1,4
E33039402,230,175,41,134,2,15,6,9,36,32,0,4,0,2
E33039403,818,648,176,472,8,53,23,30,104,98,0,6,0,5
E33039404,246,189,55,134,1,16,4,12,40,35,0,5,0,0
E33039405,510,375,93,282,7,32,15,17,95,92,0,3,0,1
E33039406,865,602,139,463,7,40,19,21,212,194,1,17,0,4
E33039407,438,330,85,245,3,24,13,11,79,76,2,1,0,2
E33039408,247,178,34,144,3,19,8,11,46,45,0,1,0,1
E33039409,478,368,120,248,8,41,5,36,57,52,2,3,0,4
E33039410,259,170,39,131,3,30,5,25,55,52,1,2,0,1
E33039411,558,363,95,268,4,48,14,34,141,125,2,13,1,2
E33039412,357,218,52,166,4,47,15,32,87,80,0,6,1,1
E33039413,277,171,36,135,3,20,3,17,77,66,9,2,0,6
E33039414,521,370,97,273,1,22,6,16,121,112,1,6,2,7
E33039415,462,315,98,217,4,59,17,42,78,69,5,3,1,6
E33039416,1506,905,189,716,23,93,29,64,471,435,16,14,6,14
E33039417,1838,1472,299,1173,10,59,27,32,290,273,1,14,2,7
E33039418,382,272,74,198,5,49,18,31,56,49,0,6,1,0
E33039419,1149,939,224,715,10,55,18,37,143,133,3,5,2,2
E33039420,2250,1558,512,1046,20,192,48,144,463,210,141,26,86,17
E33039421,588,443,111,332,8,71,30,41,63,50,7,5,1,3
E33039422,920,579,150,429,9,180,57,123,148,135,0,12,1,4
E33039423,747,428,82,346,11,182,73,109,121,99,7,10,5,5
E33039424,514,394,71,323,6,30,10,20,81,76,1,3,1,3
E33039425,312,236,34,202,9,24,6,18,40,33,1,5,1,3
E33039426,330,208,49,159,2,54,21,33,64,55,0,6,3,2
E33039427,353,243,50,193,2,48,17,31,57,54,0,2,1,3
E33039428,791,630,140,490,14,68,21,47,79,74,2,3,0,0
E33039429,613,436,96,340,11,69,24,45,93,84,0,7,2,4
E33039430,115,81,21,60,2,21,7,14,11,11,0,0,0,0
E33039431,423,305,78,227,6,46,19,27,66,63,1,1,1,0
E33039432,740,512,111,401,7,58,20,38,155,149,1,4,1,8
E33039433,313,211,51,160,1,51,19,32,49,48,0,1,0,1
E33039434,239,202,53,149,2,18,6,12,14,13,0,1,0,3
E33039435,296,231,71,160,7,20,6,14,37,35,1,0,1,1
E33039436,841,606,144,462,10,55,19,36,169,158,0,9,2,1
E33039437,281,171,57,114,6,45,22,23,59,56,0,3,0,0
E33039438,442,325,75,250,4,34,14,20,75,68,0,4,3,4
E33039439,3059,1880,461,1419,51,473,146,327,639,583,18,19,19,16
E33039440,367,211,53,158,8,44,20,24,99,96,1,2,0,5
E33039441,264,148,43,105,10,45,19,26,59,58,0,1,0,2
E33039442,200,130,40,90,5,18,8,10,45,41,1,1,2,2
E33039443,864,609,163,446,12,111,38,73,108,94,2,11,1,24
E33039444,438,141,54,87,4,45,14,31,82,43,36,1,2,166
E33039445,286,194,58,136,6,23,5,18,57,52,4,1,0,6
E33039446,1012,797,257,540,13,93,20,73,103,92,2,7,2,6
E33039447,419,283,61,222,4,33,12,21,98,89,2,5,2,1
E33039448,209,148,32,116,4,19,4,15,36,32,1,3,0,2
E33039449,275,202,45,157,2,30,3,27,41,39,0,2,0,0
E33039450,317,189,41,148,6,30,7,23,92,86,0,5,1,0
E33039451,449,258,66,192,2,35,19,16,151,145,0,6,0,3
E33039452,342,263,50,213,4,8,3,5,62,60,0,2,0,5
E33039453,727,470,102,368,8,52,30,22,193,180,1,11,1,4
E33039454,284,166,30,136,4,25,15,10,88,80,0,8,0,1
E33039455,407,183,35,148,9,28,17,11,186,175,1,8,2,1
E33039456,530,355,91,264,13,77,57,20,81,72,2,7,0,4
E33039457,1325,897,284,613,13,71,40,31,337,323,2,10,2,7
E33039458,280,201,55,146,3,14,7,7,61,58,1,2,0,1
E33039459,242,149,35,114,5,18,9,9,65,65,0,0,0,5
E33039460,257,136,26,110,1,22,10,12,97,93,0,4,0,1
E33039461,286,154,47,107,1,32,17,15,98,93,2,3,0,1
E33039462,293,219,50,169,3,14,4,10,57,53,0,4,0,0
E33039463,401,288,84,204,6,15,7,8,91,84,1,6,0,1
E33039464,423,277,68,209,11,50,37,13,83,78,0,3,2,2
E33039465,832,591,112,479,7,31,18,13,202,193,0,7,2,1
E33039466,315,132,32,100,3,63,36,27,117,113,0,4,0,0
E33039467,591,328,103,225,4,74,46,28,183,173,1,7,2,2
E33039468,332,181,44,137,4,41,17,24,102,92,0,10,0,4
E33039469,201,110,25,85,1,32,19,13,57,56,1,0,0,1
E33039470,274,131,31,100,3,50,26,24,85,82,1,2,0,5
E33039471,293,202,54,148,5,22,10,12,60,57,1,2,0,4
E33039472,450,349,86,263,11,37,22,15,50,42,0,7,1,3
E33039473,454,340,99,241,6,52,39,13,55,49,2,3,1,1
E33039474,319,202,39,163,5,35,6,29,76,70,2,4,0,1
E33039475,186,133,45,88,3,12,3,9,38,28,3,7,0,0
E33039476,240,159,35,124,5,17,6,11,58,54,0,3,1,1
E33039477,348,234,75,159,5,39,10,29,69,58,1,7,3,1
E33039478,238,162,44,118,5,27,11,16,38,38,0,0,0,6
E33039479,473,285,77,208,9,63,20,43,108,100,2,5,1,8
E33039480,424,325,86,239,6,23,5,18,70,65,0,1,4,0
E33039481,1047,620,140,480,8,104,30,74,303,146,95,6,56,12
E33039482,317,229,53,176,9,22,6,16,55,53,0,2,0,2
E33039483,220,133,30,103,4,23,8,15,59,57,2,0,0,1
E33039484,282,225,47,178,4,17,3,14,36,32,3,1,0,0
E33039485,343,198,53,145,3,29,9,20,108,81,17,6,4,5
E33039486,1768,1399,353,1046,25,108,19,89,225,202,3,13,7,11
E33039487,772,491,133,358,13,88,28,60,178,161,1,13,3,2
E33039488,731,517,120,397,23,46,6,40,144,133,3,7,1,1
E33039489,415,291,57,234,7,50,28,22,65,59,1,5,0,2
E33039490,254,172,46,126,6,27,19,8,48,44,1,3,0,1
E33039491,334,222,56,166,8,43,29,14,59,55,2,2,0,2
E33039492,360,269,68,201,4,36,26,10,50,47,0,3,0,1
E33039493,770,591,133,458,22,66,37,29,86,77,4,5,0,5
E33039494,459,316,95,221,5,55,40,15,79,77,1,1,0,4
E33039495,308,219,91,128,3,13,7,6,68,63,2,3,0,5
E33039496,291,174,56,118,3,9,5,4,102,100,0,2,0,3
E33039497,293,189,61,128,2,16,8,8,85,80,0,3,2,1
E33039498,198,129,51,78,2,11,6,5,50,46,0,3,1,6
E33039499,1667,1015,288,727,10,43,18,25,581,544,5,28,4,18
E33039500,407,176,45,131,4,11,7,4,215,205,0,10,0,1
E33039501,189,140,40,100,0,6,5,1,41,38,0,3,0,2
E33039502,1385,1002,223,779,24,68,32,36,288,273,0,15,0,3
E33039503,235,173,30,143,3,24,2,22,34,32,0,1,1,1
E33039504,484,381,59,322,10,18,5,13,73,66,0,7,0,2
E33039505,519,426,87,339,4,23,9,14,64,60,0,4,0,2
E33039506,813,618,113,505,9,38,12,26,145,125,1,19,0,3
E33039507,889,682,184,498,11,60,13,47,135,121,1,12,1,1
E33039508,395,324,57,267,4,9,1,8,54,51,2,1,0,4
E33039509,275,232,57,175,5,8,1,7,27,26,0,1,0,3
E33039510,902,597,172,425,25,148,15,133,129,112,4,10,3,3
E33039511,207,125,32,93,5,43,3,40,32,29,1,2,0,2
E33039512,341,260,71,189,4,15,2,13,61,58,0,3,0,1
E33039513,401,226,54,172,8,80,10,70,81,70,6,4,1,6
E33039514,253,167,55,112,7,37,9,28,40,39,0,1,0,2
E33039515,750,430,114,316,16,162,18,144,139,128,1,10,0,3
E33039516,310,194,45,149,10,50,5,45,55,48,3,4,0,1
E33039517,310,215,84,131,5,29,5,24,55,50,0,5,0,6
E33039518,327,239,62,177,6,34,20,14,47,44,1,2,0,1
E33039519,313,216,58,158,2,34,22,12,60,56,1,3,0,1
E33039520,388,238,50,188,6,41,26,15,102,96,2,4,0,1
E33039521,417,236,70,166,5,46,30,16,129,124,1,2,2,1
E33039522,498,344,85,259,10,44,29,15,97,91,1,4,1,3
E33039523,1664,1250,321,929,16,135,83,52,258,242,0,14,2,5
E33039524,221,143,40,103,3,40,20,20,34,31,0,3,0,1
E33039525,761,524,126,398,9,87,51,36,133,132,1,0,0,8
E33039526,304,220,54,166,2,27,5,22,50,43,3,1,3,5
E33039527,665,488,181,307,13,28,18,10,119,113,3,2,1,17
E33039528,1228,577,133,444,11,146,58,88,482,124,184,7,167,12
E33039529,421,316,87,229,2,15,7,8,87,87,0,0,0,1
E33039530,825,570,120,450,13,22,10,12,217,203,2,11,1,3
E33039531,213,139,33,106,1,8,3,5,62,59,0,2,1,3
E33039532,676,526,151,375,13,27,18,9,109,102,3,3,1,1
E33039533,3914,2645,681,1964,93,362,225,137,790,734,18,24,14,24
E33039534,267,166,46,120,2,23,16,7,75,71,1,2,1,1
E33039535,394,262,59,203,4,13,5,8,111,102,0,9,0,4
E33039536,3016,1894,592,1302,41,178,116,62,873,815,11,30,17,30
E33039537,1426,1077,213,864,19,51,30,21,272,260,2,8,2,7
E33039538,224,162,58,104,0,30,19,11,31,29,0,2,0,1
E33039539,626,482,76,406,8,35,22,13,96,90,1,5,0,5
E33039540,403,283,64,219,11,40,19,21,65,47,13,5,0,4
E33039541,496,344,67,277,6,54,7,47,87,75,5,5,2,5
E33039542,336,241,47,194,3,34,8,26,55,46,6,2,1,3
E33039543,617,495,133,362,4,25,8,17,89,77,2,8,2,4
E33039544,591,373,118,255,6,43,10,33,164,78,46,7,33,5
E33039545,491,326,79,247,9,73,14,59,80,75,1,3,1,3
E33039546,514,385,82,303,4,30,12,18,93,86,3,4,0,2
E33039547,241,174,52,122,2,29,4,25,35,27,2,5,1,1
E33039548,336,237,50,187,9,39,8,31,49,44,2,3,0,2
E33039549,843,477,93,384,15,81,20,61,267,82,113,4,68,3
E33039550,516,392,110,282,10,63,4,59,50,46,2,1,1,1
E33039551,2516,1859,463,1396,50,257,17,240,338,293,14,23,8,12
E33039552,554,372,92,280,8,108,12,96,63,56,0,7,0,3
E33039553,334,225,49,176,10,44,8,36,52,46,1,4,1,3
E33039554,179,125,26,99,1,26,2,24,27,24,2,1,0,0
E33039555,1097,656,130,526,26,204,18,186,207,192,2,10,3,4
E33039556,279,180,37,143,4,38,1,37,56,50,2,4,0,1
E33039557,261,160,41,119,4,51,2,49,44,42,1,1,0,2
E33039558,676,433,117,316,10,120,6,114,110,94,3,13,0,3
E33039559,229,142,32,110,5,42,2,40,39,37,0,1,1,1
E33039560,480,277,77,200,7,127,4,123,67,59,2,3,3,2
E33039561,692,486,122,364,15,54,3,51,134,121,4,8,1,3
E33039562,725,615,135,480,6,28,5,23,75,68,3,3,1,1
E33039563,174,126,55,71,1,8,0,8,29,23,1,3,2,10
E33039564,1691,768,145,623,12,120,17,103,779,175,392,8,204,12
E33039565,642,197,65,132,8,97,22,75,333,55,144,3,131,7
E33039566,641,472,74,398,19,49,10,39,98,80,5,11,2,3
E33039567,212,133,27,106,9,28,8,20,40,37,0,0,3,2
E33039568,331,196,49,147,4,45,19,26,84,72,5,4,3,2
E33039569,373,217,68,149,2,56,14,42,89,68,13,2,6,9
E33039570,2319,1369,291,1078,30,289,169,120,621,588,6,25,2,10
E33039571,762,570,121,449,8,31,12,19,148,139,2,7,0,5
E33039572,428,288,51,237,8,35,7,28,96,90,1,4,1,1
E33039573,1968,1474,284,1190,22,126,38,88,341,299,7,33,2,5
E33039574,1073,735,207,528,12,126,65,61,194,175,4,12,3,6
E33039575,1090,767,212,555,15,117,69,48,191,178,0,11,2,0
E33039576,220,146,53,93,7,36,19,17,30,26,0,3,1,1
E33039577,608,382,80,302,10,40,21,19,172,167,0,4,1,4
E33039578,583,420,91,329,2,62,41,21,98,84,2,12,0,1
E33039579,431,312,89,223,7,40,17,23,63,59,0,4,0,9
E33039580,179,117,29,88,4,16,10,6,40,37,0,3,0,2
E33039581,263,179,50,129,2,37,16,21,43,41,0,2,0,2
E33039582,1077,717,138,579,9,120,53,67,222,201,1,18,2,9
E33039583,453,304,59,245,5,51,30,21,90,78,7,5,0,3
E33039584,253,177,47,130,1,31,15,16,43,35,0,4,4,1
E33039585,489,350,106,244,5,45,9,36,86,78,3,4,1,3
E33039586,288,199,50,149,4,26,8,18,57,53,2,2,0,2
E33039587,345,237,49,188,5,20,5,15,81,76,1,3,1,2
E33039588,631,378,72,306,7,74,22,52,167,158,0,8,1,5
E33039589,428,339,85,254,7,19,5,14,60,54,2,3,1,3
E33039590,370,263,56,207,5,33,7,26,65,60,0,5,0,4
E33039591,246,178,51,127,6,11,1,10,50,47,0,2,1,1
E33039592,296,196,56,140,3,41,12,29,54,50,0,3,1,2
E33039593,671,424,113,311,18,92,9,83,133,105,18,3,7,4
E33039594,583,407,100,307,11,56,11,45,104,87,3,10,4,5
E33039595,1047,808,199,609,11,92,57,35,134,129,1,4,0,2
E33039596,2182,1752,511,1241,33,131,31,100,257,234,4,16,3,9
E33039597,234,146,46,100,2,22,10,12,64,58,1,5,0,0
E33039598,3589,2615,696,1919,54,293,43,250,612,541,31,33,7,15
E33039599,260,184,45,139,9,24,5,19,41,39,1,1,0,2
E33039600,274,185,48,137,7,30,6,24,51,47,1,3,0,1
E33039601,238,179,45,134,3,19,3,16,36,29,3,3,1,1
E33039602,378,292,79,213,6,19,2,17,57,52,1,3,1,4
E33039603,242,168,23,145,4,31,8,23,39,33,1,5,0,0
E33039604,258,188,34,154,9,15,2,13,43,40,0,3,0,3
E33039605,738,576,112,464,9,49,14,35,94,86,1,6,1,10
E33039606,341,218,67,151,6,47,6,41,66,63,1,0,2,4
E33039607,307,208,39,169,6,22,6,16,70,66,0,3,1,1
E33039608,230,133,22,111,2,41,5,36,52,45,2,2,3,2
E33039609,429,309,84,225,3,34,9,25,81,76,0,5,0,2
E33039610,698,574,127,447,11,25,6,19,79,70,1,7,1,9
E33039611,236,177,44,133,6,11,1,10,41,39,0,2,0,1
E33039612,208,161,58,103,2,10,1,9,34,33,0,1,0,1
E33039613,259,171,40,131,7,26,5,21,53,52,0,1,0,2
E33039614,835,587,132,455,10,76,14,62,156,141,3,11,1,6
E33039615,374,207,59,148,9,25,7,18,130,123,3,3,1,3
E33039616,458,315,98,217,10,53,11,42,73,72,0,1,0,7
E33039617,342,263,78,185,5,33,5,28,41,40,1,0,0,0
E33039618,103,86,23,63,0,6,2,4,9,8,0,1,0,2
E33039619,442,338,96,242,5,42,9,33,55,48,0,7,0,2
E33039620,230,152,45,107,5,40,16,24,32,30,0,2,0,1
E33039621,278,199,58,141,5,28,11,17,46,41,0,5,0,0
E33039622,602,465,134,331,5,25,10,15,102,94,1,7,0,5
E33039623,422,317,97,220,9,15,0,15,79,72,2,2,3,2
E33039624,726,578,139,439,10,35,11,24,97,90,1,5,1,6
E33039625,456,341,68,273,10,24,8,16,80,70,0,9,1,1
E33039626,202,116,26,90,6,29,14,15,50,45,0,3,2,1
E33039627,480,351,104,247,7,62,25,37,58,53,1,2,2,2
E33039628,1004,727,174,553,32,113,53,60,127,113,2,11,1,5
E33039629,689,444,99,345,15,73,50,23,155,147,1,7,0,2
E33039630,819,616,193,423,3,82,58,24,117,105,0,12,0,1
E33039631,229,161,37,124,1,23,15,8,40,37,0,2,1,4
E33039632,614,418,119,299,4,92,47,45,100,87,1,12,0,0
E33039633,1295,684,141,543,7,97,55,42,498,465,4,23,6,9
E33039634,219,133,27,106,1,24,16,8,57,56,0,1,0,4
E33039635,355,219,70,149,4,24,18,6,106,95,0,8,3,2
E33039636,958,511,124,387,7,124,70,54,313,280,3,22,8,3
E33039637,272,172,52,120,1,21,14,7,77,75,1,1,0,1
E33039638,374,221,53,168,2,37,21,16,114,105,4,4,1,0
E33039639,212,137,39,98,7,30,7,23,38,38,0,0,0,0
E33039640,232,167,62,105,7,25,4,21,31,26,0,5,0,2
E33039641,330,240,78,162,13,36,13,23,39,37,0,2,0,2
E33039642,282,166,44,122,4,32,3,29,79,73,1,4,1,1
E33039643,1455,895,282,613,16,135,16,119,393,384,3,6,0,16
E33039644,988,567,167,400,7,102,44,58,306,281,5,14,6,6
E33039645,318,165,61,104,8,13,5,8,123,108,5,5,5,9
E33039646,217,103,37,66,0,12,6,6,97,82,9,6,0,5
E33039647,532,281,88,193,5,19,14,5,216,207,4,2,3,11
E33039648,479,293,111,182,6,21,14,7,150,144,3,2,1,9
E33039649,400,236,86,150,1,27,16,11,127,115,3,5,4,9
E33039650,213,120,42,78,0,8,5,3,81,76,1,1,3,4
E33039651,348,209,79,130,2,30,15,15,97,90,2,2,3,10
E33039652,213,140,54,86,3,5,2,3,64,57,1,3,3,1
E33039653,444,258,112,146,4,58,43,15,107,88,13,4,2,17
E33039654,560,294,94,200,3,16,6,10,242,229,6,4,3,5
E33039655,259,103,39,64,4,7,2,5,139,132,1,4,2,6
E33039656,229,128,36,92,2,17,5,12,77,73,0,4,0,5
E33039657,195,115,54,61,1,9,6,3,64,60,2,1,1,6
E33039658,282,167,83,84,4,35,24,11,69,62,4,3,0,7
E33039659,303,193,81,112,2,21,13,8,78,67,4,1,6,9
E33039660,217,134,38,96,5,13,6,7,62,56,0,4,2,3
E33039661,331,211,80,131,8,6,3,3,104,98,0,2,4,2
E33039662,211,122,54,68,7,23,15,8,59,52,1,2,4,0
E33039663,297,175,72,103,4,23,11,12,92,85,1,2,4,3
E33039664,232,103,30,73,6,23,12,11,99,98,1,0,0,1
E33039665,394,247,107,140,3,29,13,16,104,99,2,1,2,11
E33039666,450,260,71,189,13,59,28,31,114,108,3,2,1,4
E33039667,236,119,34,85,0,58,35,23,59,56,1,2,0,0
E33039668,193,132,54,78,8,19,11,8,29,28,0,1,0,5
E33039669,223,104,23,81,2,14,6,8,103,95,2,4,2,0
E33039670,885,606,169,437,14,43,12,31,215,203,0,10,2,7
E33039671,245,125,53,72,7,14,6,8,96,81,7,4,4,3
E33039672,677,366,76,290,8,45,23,22,250,230,2,11,7,8
E33039673,256,194,66,128,4,13,8,5,43,40,0,3,0,2
E33039674,313,190,41,149,5,43,19,24,72,64,1,5,2,3
E33039675,950,518,125,393,13,132,73,59,284,255,9,11,9,3
E33039676,549,335,110,225,4,82,46,36,121,113,2,3,3,7
E33039677,234,169,48,121,1,27,14,13,36,33,1,2,0,1
E33039678,218,165,43,122,4,25,16,9,24,24,0,0,0,0
E33039679,212,141,46,95,1,29,18,11,37,36,0,1,0,4
E33039680,315,221,66,155,6,42,19,23,44,41,1,1,1,2
E33039681,518,279,89,190,5,74,38,36,157,151,2,3,1,3
E33039682,446,334,79,255,7,25,9,16,77,70,3,2,2,3
E33039683,228,168,51,117,1,20,10,10,37,32,2,3,0,2
E33039684,214,124,39,85,3,31,19,12,52,45,2,2,3,4
E33039685,251,144,29,115,4,41,26,15,59,55,3,1,0,3
E33039686,257,143,43,100,3,32,17,15,77,66,3,3,5,2
E33039687,259,183,43,140,2,14,8,6,60,51,4,4,1,0
E33039688,243,166,36,130,2,24,14,10,51,48,1,1,1,0
E33039689,349,241,59,182,7,31,20,11,69,65,1,2,1,1
E33039690,732,528,153,375,10,42,19,23,149,139,2,5,3,3
E33039691,238,196,76,120,2,11,6,5,28,27,0,0,1,1
E33039692,264,134,46,88,2,28,16,12,98,91,3,1,3,2
E33039693,313,197,42,155,7,20,10,10,87,81,2,3,1,2
E33039694,531,390,122,268,10,54,33,21,72,68,1,2,1,5
E33039695,1988,1357,458,899,35,202,83,119,360,317,12,13,18,34
E33039696,310,200,53,147,3,36,16,20,68,58,4,3,3,3
E33039697,330,186,45,141,5,29,13,16,106,105,1,0,0,4
E33039698,372,272,70,202,6,19,6,13,69,60,3,2,4,6
E33039699,489,312,63,249,16,59,8,51,99,93,1,5,0,3
E33039700,331,190,37,153,1,9,8,1,128,128,0,0,0,3
E33039701,775,544,161,383,11,37,25,12,174,163,2,9,0,9
E33039702,1197,744,248,496,9,49,27,22,392,378,0,12,2,3
E33039703,361,202,60,142,3,11,6,5,144,139,2,2,1,1
E33039704,293,172,37,135,1,13,4,9,105,101,1,3,0,2
E33039705,239,173,47,126,3,5,2,3,58,55,0,3,0,0
E33039706,176,89,23,66,2,7,4,3,76,71,0,5,0,2
E33039707,248,140,43,97,2,23,15,8,82,76,0,3,3,1
E33039708,264,187,51,136,6,17,4,13,52,47,1,4,0,2
E33039709,479,319,112,207,7,52,8,44,96,89,1,4,2,5
E33039710,523,351,78,273,7,60,19,41,100,96,0,3,1,5
E33039711,327,250,82,168,7,19,3,16,43,41,0,1,1,8
E33039712,410,289,79,210,12,51,11,40,50,36,4,8,2,8
E33039713,390,261,86,175,7,69,13,56,52,48,0,3,1,1
E33039714,424,320,73,247,4,36,22,14,63,57,2,3,1,1
E33039715,612,396,110,286,2,119,71,48,89,72,6,7,4,6
E33039716,328,217,57,160,1,42,21,21,65,57,7,1,0,3
E33039717,2967,2203,625,1578,30,259,166,93,460,408,4,41,7,15
E33039718,468,231,45,186,2,29,16,13,203,192,0,7,4,3
E33039719,579,441,111,330,6,43,26,17,87,83,2,0,2,2
E33039720,311,232,39,193,3,20,13,7,55,45,2,5,3,1
E33039721,342,235,93,142,2,15,12,3,88,79,0,8,1,2
E33039722,347,263,74,189,3,15,8,7,64,61,0,3,0,2
E33039723,1123,529,110,419,11,166,107,59,412,370,11,24,7,5
E33039724,782,380,79,301,6,92,54,38,300,271,3,24,2,4
E33039725,414,187,41,146,3,29,20,9,193,186,0,5,2,2
E33039726,1086,462,88,374,8,81,44,37,514,483,2,27,2,21
E33039727,602,338,80,258,5,83,48,35,174,160,3,11,0,2
E33039728,707,397,93,304,9,98,60,38,202,186,2,10,4,1
E33039729,504,318,78,240,6,57,31,26,122,111,1,10,0,1
E33039730,330,181,33,148,5,37,20,17,102,89,3,8,2,5
E33039731,863,604,173,431,9,108,72,36,139,132,2,5,0,3
E33039732,544,310,63,247,5,77,44,33,151,141,3,6,1,1
E33039733,253,178,42,136,4,18,7,11,52,51,0,1,0,1
E33039734,236,162,36,126,5,10,5,5,58,57,1,0,0,1
E33039735,725,529,93,436,16,35,14,21,144,133,3,4,4,1
E33039736,316,199,56,143,5,21,7,14,91,87,0,4,0,0
E33039737,368,213,59,154,10,55,24,31,88,83,1,4,0,2
E33039738,447,271,81,190,3,21,13,8,148,138,2,6,2,4
E33039739,605,395,122,273,13,67,21,46,125,115,1,8,1,5
E33039740,906,632,192,440,17,79,40,39,173,160,2,10,1,5
E33039741,530,377,85,292,9,30,12,18,114,104,1,8,1,0
E33039742,495,351,58,293,5,10,5,5,128,119,1,6,2,1
E33039743,215,115,23,92,2,20,8,12,75,75,0,0,0,3
E33039744,543,298,71,227,6,83,44,39,150,136,4,9,1,6
E33039745,1503,1148,264,884,32,117,48,69,205,188,6,7,4,1
E33039746,614,339,72,267,11,75,32,43,186,170,0,13,3,3
E33039747,587,377,68,309,9,23,8,15,176,168,0,7,1,2
E33039748,287,160,39,121,5,43,25,18,77,72,0,5,0,2
E33039749,242,161,30,131,3,20,7,13,56,51,2,2,1,2
E33039750,654,371,92,279,11,70,35,35,195,181,1,8,5,7
E33039751,244,173,52,121,6,18,7,11,46,42,1,3,0,1
E33039752,567,363,86,277,15,54,23,31,134,120,2,10,2,1
E33039753,1431,1006,218,788,27,47,17,30,341,312,7,20,2,10
E33039754,587,415,70,345,17,24,12,12,129,119,2,8,0,2
E33039755,288,183,54,129,8,27,13,14,69,65,1,3,0,1
E33039756,845,585,119,466,13,32,16,16,209,200,0,4,5,6
E33039757,463,354,112,242,9,34,18,16,65,58,0,7,0,1
E33039758,402,327,92,235,3,11,3,8,61,56,1,2,2,0
E33039759,427,320,62,258,8,20,6,14,77,68,0,8,1,2
E33039760,1429,1138,202,936,34,55,32,23,200,191,1,8,0,2
E33039761,761,555,110,445,10,23,10,13,170,163,1,4,2,3
E33039762,399,228,57,171,6,30,9,21,133,127,0,5,1,2
E33039763,457,316,87,229,4,24,14,10,112,100,4,4,4,1
E33039764,244,176,61,115,1,12,3,9,52,48,1,3,0,3
E33039765,370,312,107,205,6,22,12,10,28,27,1,0,0,2
E33039766,276,148,53,95,2,43,25,18,80,76,1,3,0,3
E33039767,1684,1094,281,813,33,222,119,103,328,305,2,12,9,7
E33039768,225,159,48,111,1,17,10,7,47,45,1,1,0,1
E33039769,298,183,51,132,4,13,3,10,98,89,6,2,1,0
E33039770,1920,1002,261,741,41,200,96,104,667,625,6,31,5,10
E33039771,502,316,55,261,14,12,1,11,160,153,1,3,3,0
E33039772,318,237,41,196,6,16,5,11,58,55,0,3,0,1
E33039773,529,386,81,305,5,55,31,24,80,79,0,1,0,3
E33039774,446,293,67,226,15,52,29,23,84,77,2,2,3,2
E33039775,1213,882,151,731,23,42,23,19,262,256,2,4,0,4
E33039776,1043,772,169,603,11,33,12,21,223,211,4,6,2,4
E33039777,733,509,89,420,14,35,16,19,172,165,0,7,0,3
E33039778,541,333,76,257,6,43,21,22,156,141,3,7,5,3
E33039779,487,352,71,281,18,32,21,11,84,79,0,5,0,1
E33039780,468,274,75,199,26,95,67,28,70,64,0,5,1,3
E33039781,496,342,81,261,30,66,39,27,56,49,1,6,0,2
E33039782,427,289,63,226,16,38,20,18,84,75,0,7,2,0
E33039783,436,314,74,240,21,43,30,13,54,51,0,3,0,4
E33039784,268,175,50,125,21,41,25,16,29,29,0,0,0,2
E33039785,370,267,63,204,20,29,20,9,52,48,0,4,0,2
E33039786,448,300,69,231,28,45,26,19,74,73,0,1,0,1
E33039787,1619,1114,248,866,74,104,57,47,326,303,0,18,5,1
E33039788,610,292,43,249,22,36,13,23,251,241,1,6,3,9
E33039789,1055,782,137,645,50,33,15,18,188,178,2,5,3,2
E33039790,261,143,21,122,6,26,16,10,83,79,1,1,2,3
E33039791,2614,1912,305,1607,110,124,64,60,457,435,2,16,4,11
E33039792,480,310,67,243,19,31,19,12,116,107,1,6,2,4
E33039793,1084,760,157,603,39,46,17,29,237,228,1,7,1,2
E33039794,520,353,88,265,19,41,21,20,107,101,2,3,1,0
E33039795,234,164,35,129,8,22,8,14,39,35,0,3,1,1
E33039796,484,324,75,249,21,30,21,9,108,105,0,3,0,1
E33039797,237,165,34,131,21,20,14,6,31,29,0,2,0,0
E33039798,342,236,48,188,14,25,14,11,65,59,0,5,1,2
E33039799,332,267,69,198,16,25,8,17,24,21,0,1,2,0
E33039800,457,302,80,222,34,33,17,16,86,83,0,2,1,2
E33039801,327,225,31,194,11,23,13,10,67,50,0,17,0,1
E33039802,214,165,36,129,9,10,5,5,28,25,0,3,0,2
E33039803,548,395,73,322,23,38,12,26,89,84,0,5,0,3
E33039804,1035,696,94,602,94,73,24,49,170,154,1,14,1,2
E33039805,2464,1826,286,1540,97,110,51,59,424,396,3,24,1,7
E33039806,1477,1011,186,825,54,112,37,75,293,274,0,18,1,7
E33039807,508,281,46,235,34,41,20,21,150,139,1,6,4,2
E33039808,224,154,42,112,8,27,12,15,35,32,0,3,0,0
E33039809,1532,1057,183,874,109,129,45,84,231,212,3,12,4,6
E33039810,753,479,89,390,30,65,37,28,176,168,1,4,3,3
E33039811,572,348,76,272,29,56,25,31,138,125,2,11,0,1
E33039812,553,306,73,233,25,97,40,57,117,109,1,5,2,8
E33039813,220,157,48,109,16,20,7,13,26,26,0,0,0,1
E33039814,922,567,124,443,68,145,39,106,139,133,1,5,0,3
E33039815,430,336,86,250,1,19,4,15,63,41,13,2,7,11
E33039816,274,223,83,140,1,18,3,15,27,22,1,3,1,5
E33039817,409,322,104,218,3,19,3,16,62,57,1,1,3,3
E33039818,1066,798,227,571,12,97,28,69,156,136,3,15,2,3
E33039819,566,433,95,338,7,41,10,31,80,70,0,9,1,5
E33039820,386,316,83,233,2,19,5,14,47,46,0,1,0,2
E33039821,394,305,146,159,13,23,6,17,49,46,0,2,1,4
E33039822,575,471,124,347,2,30,8,22,66,63,0,3,0,6
E33039823,504,428,122,306,3,20,7,13,49,41,2,4,2,4
E33039824,556,442,118,324,6,50,11,39,53,50,1,2,0,5
E33039825,331,254,78,176,3,20,4,16,52,47,2,1,2,2
E33039826,450,387,118,269,5,16,5,11,38,31,2,4,1,4
E33039827,243,177,74,103,3,30,4,26,31,31,0,0,0,2
E33039828,364,283,75,208,2,29,5,24,47,43,1,3,0,3
E33039829,307,196,52,144,9,33,3,30,68,32,18,3,15,1
E33039830,414,307,82,225,8,35,3,32,57,50,1,1,5,7
E33039831,671,542,149,393,10,38,6,32,77,68,0,6,3,4
E33039832,375,306,94,212,5,12,3,9,51,45,3,0,3,1
E33039833,410,349,93,256,2,19,3,16,38,33,0,5,0,2
E33039834,313,188,54,134,5,37,5,32,79,64,5,7,3,4
E33039835,603,432,114,318,13,63,12,51,89,80,2,5,2,6
E33039836,297,212,48,164,4,33,10,23,44,39,0,5,0,4
E33039837,379,264,64,200,2,14,3,11,91,87,0,3,1,8
E33039838,244,182,50,132,6,23,10,13,31,29,0,2,0,2
E33039839,376,289,44,245,4,10,2,8,73,68,3,2,0,0
E33039840,390,249,77,172,4,42,19,23,94,76,10,2,6,1
E33039841,395,239,47,192,1,41,13,28,107,86,12,2,7,7
E33039842,441,347,90,257,1,46,7,39,46,44,0,2,0,1
E33039843,625,482,112,370,5,78,12,66,59,58,1,0,0,1
E33039844,341,222,60,162,5,20,2,18,90,78,0,10,2,4
E33039845,611,376,120,256,6,79,35,44,148,141,0,6,1,2
E33039846,424,278,53,225,6,44,33,11,92,87,1,4,0,4
E33039847,374,254,67,187,17,24,8,16,79,70,1,8,0,0
E33039848,332,231,57,174,1,28,16,12,70,65,0,4,1,2
E33039849,444,288,83,205,5,89,31,58,60,54,0,4,2,2
E33039850,961,681,153,528,19,100,22,78,159,152,1,6,0,2
E33039851,408,321,51,270,10,34,4,30,42,33,1,7,1,1
E33039852,948,596,167,429,7,78,38,40,253,235,5,12,1,14
E33039853,434,321,90,231,3,18,6,12,84,77,0,5,2,8
E33039854,787,443,98,345,11,94,46,48,232,216,2,12,2,7
E33039855,617,413,133,280,6,44,24,20,143,126,3,11,3,11
E33039856,375,293,81,212,3,21,6,15,55,47,1,6,1,3
E33039857,369,269,63,206,8,28,10,18,61,59,0,2,0,3
E33039858,331,243,49,194,4,31,10,21,53,51,0,0,2,0
E33039859,462,348,82,266,4,33,16,17,73,70,2,1,0,4
E33039860,382,284,65,219,7,25,9,16,64,62,0,2,0,2
E33039861,528,336,111,225,9,45,7,38,121,110,5,3,3,17
E33039862,294,179,53,126,3,33,6,27,76,67,4,1,4,3
E33039863,359,253,72,181,2,23,5,18,67,57,2,6,2,14
E33039864,634,430,137,293,7,48,11,37,123,113,3,3,4,26
E33039865,578,389,90,299,12,69,16,53,106,96,1,7,2,2
E33039866,270,173,34,139,6,34,6,28,55,37,11,1,6,2
E33039867,369,232,78,154,4,32,14,18,94,84,1,5,4,7
E33039868,338,208,55,153,5,33,8,25,86,77,0,8,1,6
E33039869,718,491,130,361,9,85,20,65,130,113,1,12,4,3
E33039870,429,270,57,213,5,43,16,27,109,98,1,4,6,2
E33039871,295,206,56,150,0,7,2,5,81,79,0,2,0,1
E33039872,4564,3410,809,2601,60,281,95,186,798,713,28,46,11,15
E33039873,444,269,80,189,5,52,17,35,113,105,1,4,3,5
E33039874,376,278,80,198,5,14,7,7,77,72,1,2,2,2
E33039875,441,316,93,223,5,30,4,26,83,72,0,9,2,7
E33039876,434,315,75,240,16,44,6,38,54,52,1,1,0,5
E33039877,352,229,58,171,2,37,6,31,79,73,2,3,1,5
E33039878,436,350,91,259,2,34,15,19,45,39,0,4,2,5
E33039879,424,309,84,225,2,74,62,12,36,31,0,3,2,3
E33039880,687,484,123,361,9,86,50,36,105,99,3,2,1,3
E33039881,349,290,80,210,0,22,15,7,35,32,1,2,0,2
E33039882,898,718,158,560,6,64,34,30,104,86,7,8,3,6
E33039883,666,509,130,379,9,40,16,24,105,98,0,5,2,3
E33039884,291,188,48,140,3,26,10,16,69,59,1,3,6,5
E33039885,307,132,34,98,2,27,7,20,143,137,0,4,2,3
E33039886,313,241,57,184,1,11,1,10,57,53,0,1,3,3
E33039887,395,290,77,213,9,30,10,20,63,59,0,4,0,3
E33039888,527,350,115,235,3,38,9,29,130,123,0,6,1,6
E33039889,356,214,71,143,3,31,4,27,105,95,1,8,1,3
E33039890,373,270,68,202,10,7,0,7,84,76,0,7,1,2
E33039891,534,358,72,286,4,64,7,57,107,92,3,10,2,1
E33039892,827,706,199,507,1,35,12,23,79,71,0,3,5,6
E33039893,444,379,109,270,7,18,13,5,38,35,0,1,2,2
E33039894,328,259,77,182,1,21,4,17,43,41,0,2,0,4
E33039895,418,331,93,238,6,35,2,33,39,31,2,6,0,7
E33039896,581,368,86,282,9,66,18,48,135,122,3,8,2,3
E33039897,466,343,95,248,5,23,4,19,93,89,0,4,0,2
E33039898,331,270,86,184,2,16,14,2,41,37,0,3,1,2
E33039899,638,460,125,335,8,49,16,33,113,103,2,5,3,8
E33039900,455,322,91,231,2,58,36,22,70,65,2,3,0,3
E33039901,511,388,103,285,8,44,21,23,66,57,0,9,0,5
E33039902,366,261,61,200,6,38,4,34,60,54,0,6,0,1
E33039903,436,345,100,245,3,34,5,29,53,51,1,1,0,1
E33039904,408,338,106,232,5,24,5,19,39,36,0,1,2,2
E33039905,397,318,75,243,2,34,5,29,38,33,0,5,0,5
E33039906,463,309,100,209,3,52,21,31,98,88,3,7,0,1
E33039907,398,267,53,214,3,79,11,68,46,42,0,3,1,3
E33039908,537,436,117,319,6,33,5,28,57,49,1,7,0,5
E33039909,505,415,127,288,6,30,4,26,50,43,0,3,4,4
E33039910,483,394,88,306,7,28,3,25,50,41,5,4,0,4
E33039911,368,329,101,228,1,6,2,4,31,24,0,4,3,1
E33039912,334,267,63,204,2,15,4,11,50,44,1,4,1,0
E33039913,457,368,94,274,8,28,18,10,52,45,3,4,0,1
E33039914,371,288,68,220,3,24,11,13,50,49,1,0,0,6
E33039915,1262,962,290,672,12,67,23,44,215,206,0,6,3,6
E33039916,290,239,90,149,2,6,5,1,41,35,0,6,0,2
E33039917,295,253,69,184,0,11,4,7,25,19,0,3,3,6
E33039918,498,364,90,274,4,24,12,12,102,92,5,3,2,4
E33039919,588,460,96,364,6,60,8,52,55,54,0,1,0,7
E33039920,320,225,57,168,0,45,9,36,49,43,1,5,0,1
E33039921,904,759,192,567,3,16,3,13,120,106,0,14,0,6
E33039922,328,261,77,184,4,26,2,24,36,31,0,4,1,1
E33039923,293,253,78,175,0,1,1,0,38,34,3,1,0,1
E33039924,303,236,55,181,5,6,1,5,56,51,0,4,1,0
E33039925,318,240,65,175,2,36,7,29,39,32,2,4,1,1
E33039926,427,352,65,287,7,15,3,12,50,46,2,2,0,3
E33039927,524,434,67,367,4,21,2,19,62,54,1,4,3,3
E33039928,481,406,109,297,3,13,4,9,54,50,2,1,1,5
E33039929,360,328,95,233,2,3,1,2,25,21,0,4,0,2
E33039930,451,380,124,256,1,9,5,4,57,48,1,7,1,4
E33039931,298,262,67,195,1,7,2,5,26,22,1,3,0,2
E33039932,558,486,149,337,4,18,5,13,46,43,0,2,1,4
E33039933,430,356,80,276,1,19,9,10,50,43,0,7,0,4
E33039934,439,360,88,272,3,31,8,23,42,41,0,1,0,3
E33039935,552,439,104,335,3,42,11,31,63,55,3,5,0,5
E33039936,264,222,47,175,4,11,3,8,26,22,1,3,0,1
E33039937,709,590,113,477,11,30,4,26,76,65,2,8,1,2
E33039938,519,426,100,326,3,29,4,25,56,49,2,5,0,5
E33039939,383,286,90,196,2,27,10,17,55,38,11,4,2,13
E33039940,528,445,144,301,4,18,8,10,60,51,6,3,0,1
E33039941,355,245,77,168,4,41,19,22,57,43,5,4,5,8
E33039942,613,440,127,313,4,36,16,20,123,115,1,3,4,10
E33039943,391,290,66,224,2,17,4,13,73,50,15,0,8,9
E33039944,299,216,38,178,3,27,6,21,49,45,2,1,1,4
E33039945,581,447,122,325,15,41,16,25,75,67,4,4,0,3
E33039946,316,219,65,154,6,26,11,15,59,49,7,2,1,6
E33039947,353,291,102,189,3,12,5,7,42,38,2,2,0,5
E33039948,981,694,123,571,5,114,40,74,164,141,13,8,2,4
E33039949,2694,2111,364,1747,29,99,28,71,451,427,9,12,3,4
E33039950,248,166,47,119,12,30,7,23,30,25,4,0,1,10
E33039951,359,282,57,225,4,22,6,16,51,42,5,3,1,0
E33039952,558,416,92,324,3,53,14,39,81,77,0,2,2,5
E33039953,766,541,101,440,13,76,35,41,133,122,0,8,3,3
E33039954,441,366,70,296,1,23,4,19,48,42,0,6,0,3
E33039955,528,390,105,285,8,58,26,32,71,65,1,4,1,1
E33039956,535,345,57,288,5,129,55,74,52,47,0,5,0,4
E33039957,509,352,73,279,7,62,13,49,88,80,1,6,1,0
E33039958,688,465,93,372,21,79,31,48,121,110,2,9,0,2
E33039959,277,216,53,163,0,16,7,9,42,38,0,2,2,3
E33039960,466,324,89,235,3,44,16,28,75,65,5,5,0,20
E33039961,691,505,133,372,5,39,13,26,134,109,12,8,5,8
E33039962,327,257,71,186,4,22,8,14,41,37,2,2,0,3
E33039963,605,423,92,331,2,69,27,42,101,95,1,5,0,10
E33039964,549,396,69,327,8,39,15,24,104,99,0,5,0,2
E33039965,489,307,71,236,4,96,39,57,70,61,5,3,1,12
E33039966,469,282,75,207,5,101,36,65,75,66,2,7,0,6
E33039967,661,520,177,343,9,69,24,45,59,52,2,5,0,4
E33039968,346,217,54,163,1,79,31,48,47,37,2,6,2,2
E33039969,319,219,49,170,2,50,12,38,47,38,0,9,0,1
E33039970,374,216,44,172,9,77,32,45,71,61,4,6,0,1
E33039971,544,352,80,272,14,85,29,56,92,82,2,7,1,1
E33039972,321,228,42,186,5,54,17,37,33,30,1,1,1,1
E33039973,381,271,51,220,9,50,28,22,48,42,2,4,0,3
E33039974,520,345,64,281,6,67,26,41,99,94,0,4,1,3
E33039975,609,435,80,355,4,111,49,62,54,47,1,5,1,5
E33039976,373,303,59,244,7,28,12,16,33,24,3,5,1,2
E33039977,532,384,73,311,10,80,28,52,57,51,3,2,1,1
E33039978,460,277,49,228,7,101,33,68,75,71,0,4,0,0
E33039979,343,231,44,187,2,65,26,39,45,42,0,3,0,0
E33039980,459,315,72,243,9,77,23,54,52,47,0,4,1,6
E33039981,337,240,26,214,2,39,17,22,53,50,1,2,0,3
E33039982,472,345,81,264,6,67,25,42,51,46,1,4,0,3
E33039983,397,303,66,237,1,48,14,34,43,31,0,12,0,2
E33039984,716,429,142,287,6,48,21,27,111,63,39,5,4,122
E33039985,370,302,83,219,2,12,3,9,49,40,3,5,1,5
E33039986,389,310,87,223,3,21,9,12,52,44,5,3,0,3
E33039987,555,454,107,347,3,26,7,19,70,61,3,5,1,2
E33039988,515,386,115,271,9,41,10,31,74,56,11,3,4,5
E33039989,353,314,79,235,2,14,4,10,22,21,1,0,0,1
E33039990,602,479,103,376,5,49,15,34,63,50,5,6,2,6
E33039991,355,260,71,189,2,42,7,35,48,41,3,0,4,3
E33039992,361,286,72,214,2,24,3,21,42,37,4,0,1,7
E33039993,277,243,65,178,0,4,1,3,27,24,0,3,0,3
E33039994,349,246,66,180,1,43,16,27,56,46,1,6,3,3
E33039995,291,233,62,171,3,13,5,8,37,30,1,5,1,5
E33039996,677,531,149,382,10,50,12,38,84,72,3,5,4,2
E33039997,299,205,55,150,1,29,6,23,62,50,4,1,7,2
E33039998,283,165,32,133,6,23,3,20,85,17,37,3,28,4
E33039999,377,316,81,235,0,18,4,14,40,32,5,0,3,3
E33040000,342,268,52,216,0,23,11,12,50,38,6,2,4,1
E33040001,462,290,101,189,6,44,1,43,86,70,10,6,0,36
E33040002,451,308,84,224,5,62,3,59,71,62,3,4,2,5
E33040003,263,158,59,99,4,21,0,21,48,38,5,1,4,32
E33040004,324,224,86,138,4,38,1,37,46,34,6,4,2,12
E33040005,262,198,70,128,2,31,5,26,24,19,3,0,2,7
E33040006,445,285,95,190,3,88,6,82,54,45,4,1,4,15
E33040007,328,223,67,156,2,39,3,36,57,47,2,6,2,7
E33040008,315,219,67,152,1,35,2,33,48,44,3,1,0,12
E33040009,257,167,73,94,3,23,4,19,56,43,9,2,2,8
E33040010,313,223,51,172,2,29,1,28,54,48,1,4,1,5
E33040011,443,351,105,246,17,12,1,11,61,53,2,5,1,2
E33040012,441,339,110,229,2,21,4,17,58,49,5,2,2,21
E33040013,321,197,48,149,2,31,7,24,60,39,15,5,1,31
E33040014,348,251,88,163,6,16,3,13,66,48,13,2,3,9
E33040015,321,268,65,203,0,15,4,11,36,33,1,2,0,2
E33040016,337,300,76,224,5,13,6,7,18,17,0,1,0,1
E33040017,348,270,75,195,4,29,16,13,43,39,0,4,0,2
E33040018,282,224,89,135,4,19,1,18,25,22,0,1,2,10
E33040019,462,423,89,334,1,11,4,7,22,17,0,5,0,5
E33040020,325,289,100,189,2,8,2,6,26,18,2,6,0,0
E33040021,498,395,103,292,12,21,11,10,66,57,6,2,1,4
E33040022,394,301,72,229,1,65,10,55,26,24,1,1,0,1
E33040023,435,374,121,253,4,17,7,10,38,33,0,2,3,2
E33040024,528,453,117,336,1,24,2,22,42,38,1,3,0,8
E33040025,346,240,68,172,11,26,2,24,53,43,6,3,1,16
E33040026,413,309,127,182,4,23,2,21,51,42,4,1,4,26
E33040027,618,349,125,224,5,60,4,56,163,146,11,2,4,41
E33040028,330,249,93,156,2,20,0,20,58,46,8,0,4,1
E33040029,492,382,115,267,8,30,4,26,66,54,8,4,0,6
E33040030,370,299,50,249,1,18,0,18,51,47,0,4,0,1
E33040031,555,411,111,300,3,59,10,49,80,65,6,7,2,2
E33040032,896,607,160,447,19,58,12,46,188,174,4,7,3,24
E33040033,411,307,77,230,11,38,9,29,43,35,4,3,1,12
E33040034,572,441,106,335,8,44,10,34,76,66,3,7,0,3
E33040035,587,418,122,296,7,73,12,61,83,72,3,6,2,6
E33040036,482,352,120,232,6,42,7,35,76,66,3,4,3,6
E33040037,256,190,53,137,1,25,2,23,36,34,1,1,0,4
E33040038,415,293,86,207,3,65,9,56,53,47,2,1,3,1
E33040039,385,260,79,181,1,45,2,43,75,63,3,7,2,4
E33040040,3332,2630,610,2020,41,193,34,159,454,415,10,20,9,14
E33040041,293,207,59,148,1,27,1,26,51,43,0,4,4,7
E33040042,645,374,140,234,5,47,11,36,173,90,73,2,8,46
E33040043,321,218,78,140,1,19,3,16,56,43,6,4,3,27
E33040044,446,318,86,232,10,48,4,44,67,62,2,3,0,3
E33040045,336,242,69,173,1,32,4,28,51,44,2,4,1,10
E33040046,632,411,104,307,9,90,15,75,120,109,1,9,1,2
E33040047,320,233,97,136,0,24,4,20,55,44,6,4,1,8
E33040048,261,205,77,128,3,20,2,18,27,18,3,3,3,6
E33040049,246,196,57,139,0,22,1,21,26,26,0,0,0,2
E33040050,703,525,145,380,10,34,3,31,129,117,2,9,1,5
E33040051,336,247,64,183,4,37,4,33,43,37,3,3,0,5
E33040052,318,227,75,152,2,33,1,32,51,47,1,3,0,5
E33040053,327,206,53,153,1,79,4,75,40,31,5,4,0,1
E33040054,247,149,48,101,6,33,4,29,54,34,16,1,3,5
E33040055,581,375,128,247,15,97,9,88,89,83,2,3,1,5
E33040056,279,191,42,149,3,24,2,22,60,55,1,4,0,1
E33040057,509,340,87,253,11,69,9,60,87,80,1,2,4,2
E33040058,327,204,49,155,3,39,4,35,79,76,0,3,0,2
E33040059,373,242,59,183,13,41,3,38,69,62,2,5,0,8
E33040060,483,376,86,290,11,40,5,35,56,51,0,4,1,0
E33040061,576,438,124,314,7,69,4,65,58,53,0,5,0,4
E33040062,326,204,48,156,4,71,4,67,45,44,0,0,1,2
E33040063,295,230,70,160,4,15,2,13,43,37,2,3,1,3
E33040064,517,358,88,270,5,75,8,67,75,62,7,4,2,4
E33040065,286,204,52,152,2,18,4,14,56,38,14,1,3,6
E33040066,691,446,114,332,11,59,25,34,170,160,2,4,4,5
E33040067,501,320,80,240,3,102,6,96,72,67,2,3,0,4
E33040068,428,304,93,211,4,61,3,58,54,48,1,4,1,5
E33040069,438,320,91,229,8,48,3,45,60,54,1,4,1,2
E33040070,310,220,47,173,6,32,3,29,50,44,1,5,0,2
E33040071,390,286,65,221,6,39,8,31,53,49,0,4,0,6
E33040072,620,471,102,369,10,50,3,47,80,72,1,7,0,9
E33040073,290,241,72,169,0,15,4,11,33,30,1,2,0,1
E33040074,284,190,82,108,5,22,2,20,54,49,1,2,2,13
E33040075,329,203,81,122,2,31,9,22,62,55,4,3,0,31
E33040076,281,191,76,115,2,23,1,22,46,41,4,1,0,19
E33040077,549,332,109,223,4,64,10,54,118,97,8,4,9,31
E33040078,326,231,77,154,3,46,0,46,42,38,2,2,0,4
E33040079,404,202,60,142,15,60,3,57,119,109,5,4,1,8
E33040080,472,264,74,190,13,86,5,81,101,92,3,5,1,8
E33040081,263,168,41,127,7,32,3,29,54,49,1,4,0,2
E33040082,590,350,98,252,7,112,7,105,115,104,4,7,0,6
E33040083,392,261,91,170,10,54,4,50,64,60,1,3,0,3
E33040084,527,325,82,243,16,97,5,92,89,78,2,7,2,0
E33040085,330,224,75,149,5,47,3,44,53,47,0,3,3,1
E33040086,339,245,66,179,3,40,1,39,50,45,1,4,0,1
E33040087,1140,709,175,534,14,251,17,234,158,148,4,4,2,8
E33040088,301,200,74,126,2,39,3,36,57,55,0,2,0,3
E33040089,301,210,68,142,6,32,2,30,47,46,0,1,0,6
E33040090,300,217,74,143,4,46,4,42,33,32,0,1,0,0
E33040091,270,213,84,129,0,14,0,14,41,38,0,1,2,2
E33040092,509,393,129,264,6,38,5,33,64,52,3,9,0,8
E33040093,605,486,136,350,8,31,4,27,78,71,3,3,1,2
E33040094,309,213,79,134,6,26,9,17,51,44,4,1,2,13
E33040095,446,321,119,202,8,49,3,46,59,53,1,3,2,9
E33040096,424,302,92,210,6,36,12,24,77,73,2,2,0,3
E33040097,335,248,68,180,6,38,6,32,40,38,1,1,0,3
E33040098,502,370,88,282,10,46,7,39,71,65,1,3,2,5
E33040099,319,268,66,202,4,11,6,5,36,29,1,6,0,0
E33040100,260,196,60,136,1,17,10,7,41,40,0,1,0,5
E33040101,853,662,197,465,8,34,15,19,148,139,1,8,0,1
E33040102,341,296,91,205,1,12,5,7,26,20,1,4,1,6
E33040103,312,287,118,169,0,4,1,3,21,18,0,3,0,0
E33040104,365,322,82,240,3,8,3,5,31,24,0,6,1,1
E33040105,386,325,119,206,3,12,5,7,42,39,0,3,0,4
E33040106,275,230,70,160,3,12,10,2,29,28,0,1,0,1
E33040107,276,196,56,140,4,17,11,6,53,44,2,3,4,6
E33040108,258,205,70,135,1,17,7,10,30,29,0,1,0,5
E33040109,280,203,53,150,2,19,12,7,53,45,2,6,0,3
E33040110,429,333,113,220,4,16,6,10,62,55,3,3,1,14
E33040111,303,216,68,148,6,29,18,11,50,44,1,5,0,2
E33040112,336,214,57,157,2,21,9,12,97,93,0,2,2,2
E33040113,568,406,120,286,6,39,22,17,113,105,1,6,1,4
E33040114,384,206,60,146,17,83,34,49,77,76,1,0,0,1
E33040115,316,218,78,140,8,37,12,25,48,48,0,0,0,5
E33040116,315,222,74,148,8,29,10,19,52,46,0,3,3,4
E33040117,475,405,138,267,2,25,17,8,42,34,0,7,1,1
E33040118,599,471,102,369,7,40,14,26,77,68,1,4,4,4
E33040119,328,255,73,182,3,21,12,9,45,40,3,2,0,4
E33040120,263,225,51,174,2,8,4,4,26,24,1,1,0,2
E33040121,339,241,43,198,2,39,32,7,56,53,0,3,0,1
E33040122,677,484,125,359,10,97,63,34,82,76,2,4,0,4
E33040123,587,359,121,238,10,86,46,40,127,118,0,7,2,5
E33040124,354,242,64,178,6,63,48,15,43,36,0,6,1,0
E33040125,505,363,72,291,18,61,41,20,60,54,0,4,2,3
E33040126,242,153,26,127,6,22,12,10,57,51,0,3,3,4
E33040127,299,156,42,114,5,24,11,13,114,109,1,2,2,0
E33040128,492,281,77,204,6,33,14,19,169,158,2,6,3,3
E33040129,591,328,71,257,5,54,20,34,197,187,0,9,1,7
E33040130,494,305,71,234,4,37,14,23,146,135,6,5,0,2
E33040131,370,261,78,183,5,32,12,20,70,58,5,5,2,2
E33040132,275,168,33,135,10,19,8,11,78,72,2,3,1,0
E33040133,379,268,71,197,6,35,14,21,67,56,7,4,0,3
E33040134,383,246,64,182,10,17,10,7,109,104,1,4,0,1
E33040135,307,183,31,152,6,36,10,26,82,74,3,5,0,0
E33040136,305,244,57,187,4,24,18,6,33,32,1,0,0,0
E33040137,467,340,91,249,6,48,29,19,69,62,2,3,2,4
E33040138,307,240,73,167,3,30,21,9,28,25,2,0,1,6
E33040139,327,266,68,198,2,24,10,14,35,32,0,2,1,0
E33040140,300,206,33,173,0,52,46,6,41,32,1,6,2,1
E33040141,419,256,77,179,6,22,11,11,134,122,0,9,3,1
E33040142,822,560,158,402,13,86,35,51,157,149,2,6,0,6
E33040143,288,180,48,132,7,14,2,12,86,81,3,0,2,1
E33040144,406,206,63,143,5,26,15,11,167,158,0,8,1,2
E33040145,823,416,92,324,11,81,38,43,313,306,0,4,3,2
E33040146,330,207,48,159,0,32,15,17,89,85,0,1,3,2
E33040147,337,165,45,120,5,44,15,29,119,112,1,5,1,4
E33040148,1785,1170,274,896,39,126,65,61,440,415,2,18,5,10
E33040149,320,203,57,146,8,21,7,14,84,77,0,4,3,4
E33040150,588,418,109,309,13,29,12,17,123,115,2,5,1,5
E33040151,368,213,54,159,9,46,33,13,98,86,3,5,4,2
E33040152,210,102,32,70,1,18,11,7,88,86,0,1,1,1
E33040153,419,249,71,178,11,35,18,17,121,115,0,5,1,3
E33040154,438,289,58,231,11,47,14,33,90,85,0,5,0,1
E33040155,429,243,71,172,7,32,14,18,143,138,0,4,1,4
E33040156,1172,737,190,547,20,118,53,65,295,280,2,10,3,2
E33040157,404,247,56,191,5,31,17,14,119,116,0,3,0,2
E33040158,297,185,43,142,5,23,14,9,84,77,1,3,3,0
E33040159,634,404,118,286,26,109,55,54,91,87,1,2,1,4
E33040160,487,301,81,220,2,27,12,15,155,148,0,6,1,2
E33040161,474,302,101,201,1,14,7,7,152,145,3,1,3,5
E33040162,390,234,92,142,2,24,12,12,123,113,1,7,2,7
E33040163,420,265,67,198,6,27,8,19,118,110,2,5,1,4
E33040164,327,230,65,165,7,18,7,11,70,63,4,2,1,2
E33040165,321,141,29,112,2,10,3,7,167,165,0,2,0,1
E33040166,509,406,144,262,3,11,4,7,80,74,3,1,2,9
E33040167,871,566,119,447,8,144,86,58,145,131,2,10,2,8
E33040168,511,389,107,282,4,46,33,13,66,64,0,2,0,6
E33040169,396,273,95,178,4,34,17,17,85,78,2,5,0,0
E33040170,309,147,41,106,3,39,12,27,116,108,1,7,0,4
E33040171,374,224,60,164,5,38,20,18,102,94,3,3,2,5
E33040172,234,139,43,96,4,23,16,7,66,61,0,1,4,2
E33040173,278,191,60,131,6,12,4,8,68,64,1,3,0,1
E33040174,1096,756,188,568,22,110,56,54,203,177,11,8,7,5
E33040175,349,241,71,170,13,27,14,13,68,61,0,4,3,0
E33040176,298,157,40,117,2,24,11,13,115,112,0,3,0,0
E33040177,4254,2853,749,2104,87,365,122,243,937,876,30,23,8,12
E33040178,447,317,108,209,5,24,9,15,94,80,9,5,0,7
E33040179,531,329,90,239,11,120,100,20,66,63,2,1,0,5
E33040180,257,174,48,126,1,28,14,14,49,46,1,2,0,5
E33040181,628,426,121,305,12,57,23,34,128,118,3,5,2,5
E33040182,386,312,80,232,3,26,23,3,41,39,0,2,0,4
E33040183,368,192,56,136,7,83,70,13,81,75,0,1,5,5
E33040184,273,172,40,132,2,33,23,10,62,54,3,3,2,4
E33040185,257,185,74,111,2,34,22,12,31,27,2,1,1,5
E33040186,428,253,64,189,10,76,43,33,81,75,2,1,3,8
E33040187,338,212,40,172,5,61,33,28,57,48,1,8,0,3
E33040188,503,332,99,233,10,78,37,41,80,71,0,6,3,3
E33040189,382,233,54,179,7,83,65,18,56,47,2,6,1,3
E33040190,292,175,37,138,9,75,45,30,32,29,1,2,0,1
E33040191,718,507,120,387,11,80,47,33,113,107,0,6,0,7
E33040192,1094,676,142,534,29,140,72,68,241,222,4,14,1,8
E33040193,479,241,71,170,8,120,76,44,105,92,3,5,5,5
E33040194,381,225,67,158,2,109,71,38,39,33,1,4,1,6
E33040195,1086,744,192,552,22,120,60,60,192,182,3,7,0,8
E33040196,1142,815,128,687,23,75,36,39,223,210,2,10,1,6
E33040197,382,273,64,209,5,44,32,12,58,54,1,3,0,2
E33040198,327,230,61,169,7,43,29,14,46,44,0,2,0,1
E33040199,856,640,138,502,16,49,34,15,145,137,0,6,2,6
E33040200,867,532,104,428,16,179,137,42,134,125,2,5,2,6
E33040201,437,228,49,179,6,147,118,29,51,42,0,9,0,5
E33040202,448,290,85,205,1,24,6,18,129,117,1,6,5,4
E33040203,374,230,79,151,3,34,23,11,103,99,1,1,2,4
E33040204,330,188,69,119,2,29,19,10,110,90,2,15,3,1
E33040205,576,419,139,280,6,75,41,34,73,71,0,0,2,3
E33040206,307,216,54,162,4,49,38,11,38,37,0,1,0,0
E33040207,375,216,36,180,4,70,50,20,84,73,2,9,0,1
E33040208,468,303,74,229,6,40,18,22,119,112,1,3,3,0
E33040209,451,293,79,214,5,70,48,22,80,77,1,1,1,3
E33040210,604,411,97,314,8,45,17,28,138,133,0,5,0,2
E33040211,495,250,72,178,3,43,20,23,196,185,1,8,2,3
E33040212,907,591,193,398,8,88,41,47,218,203,3,10,2,2
E33040213,534,357,89,268,7,55,31,24,113,100,4,7,2,2
E33040214,408,236,57,179,1,73,55,18,94,88,0,5,1,4
E33040215,512,295,75,220,5,105,69,36,105,95,0,7,3,2
E33040216,548,315,67,248,1,50,34,16,178,170,0,8,0,4
E33040217,486,293,80,213,7,93,49,44,92,89,1,2,0,1
E33040218,350,264,68,196,3,34,13,21,45,42,1,2,0,4
E33040219,359,264,54,210,4,30,22,8,56,50,0,2,4,5
E33040220,386,258,64,194,7,46,22,24,73,69,0,3,1,2
E33040221,918,646,149,497,12,44,22,22,213,209,1,3,0,3
E33040222,321,199,46,153,2,37,24,13,81,76,2,3,0,2
E33040223,324,216,75,141,2,33,18,15,70,68,1,1,0,3
E33040224,437,232,76,156,15,37,18,19,150,138,1,11,0,3
E33040225,320,224,63,161,4,21,9,12,68,64,0,4,0,3
E33040226,337,165,40,125,7,62,23,39,98,88,0,10,0,5
E33040227,651,420,110,310,2,63,36,27,162,149,1,8,4,4
E33040228,412,245,85,160,6,34,14,20,121,117,0,4,0,6
E33040229,408,247,66,181,5,35,21,14,119,115,1,2,1,2
E33040230,330,200,34,166,3,56,15,41,71,69,1,1,0,0
E33040231,432,232,58,174,7,57,40,17,130,120,1,7,2,6
E33040232,831,594,118,476,13,55,25,30,164,159,2,3,0,5
E33040233,663,418,129,289,17,106,55,51,118,112,1,4,1,4
E33040234,598,346,71,275,2,41,13,28,206,204,0,2,0,3
E33040235,681,409,87,322,16,63,24,39,190,178,2,8,2,3
E33040236,484,237,54,183,4,91,51,40,144,125,2,5,12,8
E33040237,864,521,116,405,12,94,55,39,232,219,4,8,1,5
E33040238,468,332,79,253,8,33,13,20,85,82,2,1,0,10
E33040239,676,454,101,353,18,44,17,27,150,140,1,6,3,10
E33040240,2174,1454,300,1154,36,91,39,52,584,550,3,20,11,9
E33040241,426,219,60,159,9,37,13,24,161,155,1,3,2,0
E33040242,522,286,88,198,7,38,12,26,186,177,1,7,1,5
E33040243,419,285,75,210,4,28,17,11,102,96,0,6,0,0
E33040244,878,628,172,456,12,59,32,27,177,165,4,8,0,2
E33040245,459,370,109,261,5,14,12,2,67,63,4,0,0,3
E33040246,636,461,155,306,10,70,27,43,92,90,1,1,0,3
E33040247,328,225,76,149,5,17,8,9,77,72,4,1,0,4
E33040248,356,239,78,161,3,19,14,5,92,90,1,1,0,3
E33040249,539,296,93,203,7,78,48,30,152,148,1,1,2,6
E33040250,1092,659,136,523,10,57,25,32,360,347,3,8,2,6
E33040251,699,461,128,333,12,75,33,42,145,139,2,4,0,6
E33040252,366,244,53,191,6,49,44,5,66,64,0,0,2,1
E33040253,282,182,52,130,2,48,39,9,48,46,0,2,0,2
E33040254,451,267,55,212,4,72,54,18,102,93,3,4,2,6
E33040255,482,334,87,247,7,52,34,18,85,78,2,4,1,4
E33040256,307,222,64,158,3,24,14,10,53,46,0,6,1,5
E33040257,3029,2110,501,1609,40,328,141,187,537,511,4,20,2,14
E33040258,335,184,48,136,5,67,33,34,78,69,1,8,0,1
E33040259,283,181,60,121,2,37,21,16,59,54,2,3,0,4
E33040260,390,198,57,141,9,62,27,35,118,109,0,9,0,3
E33040261,423,282,55,227,7,47,16,31,85,78,4,2,1,2
E33040262,723,498,92,406,10,38,13,25,172,164,0,7,1,5
E33040263,322,174,33,141,13,40,11,29,93,90,1,2,0,2
E33040264,353,237,65,172,7,33,15,18,73,71,0,2,0,3
E33040265,322,228,84,144,7,35,8,27,44,34,2,4,4,8
E33040266,454,319,110,209,3,60,8,52,66,63,1,1,1,6
E33040267,451,366,105,261,2,18,2,16,59,52,2,5,0,6
E33040268,368,235,89,146,2,30,4,26,78,69,4,3,2,23
E33040269,856,615,124,491,12,46,14,32,179,161,6,11,1,4
E33040270,697,498,146,352,5,62,16,46,120,104,2,12,2,12
E33040271,224,186,74,112,0,7,3,4,26,24,1,1,0,5
E33040272,379,280,110,170,0,20,6,14,65,49,7,5,4,14
E33040273,576,424,175,249,3,31,9,22,102,84,12,5,1,16
E33040274,679,450,162,288,5,31,11,20,178,158,8,10,2,15
E33040275,276,193,67,126,2,40,7,33,37,33,4,0,0,4
E33040276,257,165,61,104,2,53,16,37,37,34,1,1,1,0
E33040277,495,314,115,199,6,39,12,27,108,77,28,2,1,28
E33040278,411,333,107,226,1,12,2,10,58,47,6,5,0,7
E33040279,231,182,76,106,1,20,1,19,24,19,1,3,1,4
E33040280,410,305,107,198,2,42,4,38,57,51,2,3,1,4
E33040281,354,247,77,170,3,70,8,62,32,28,3,1,0,2
E33040282,805,530,155,375,9,111,16,95,153,137,6,8,2,2
E33040283,341,219,60,159,1,65,14,51,55,48,2,5,0,1
E33040284,315,217,50,167,1,27,9,18,68,65,2,1,0,2
E33040285,297,219,68,151,2,20,4,16,54,49,0,5,0,2
E33040286,253,206,68,138,2,5,1,4,37,32,2,2,1,3
E33040287,499,364,98,266,6,20,11,9,107,105,0,2,0,2
E33040288,276,218,71,147,1,13,3,10,36,33,0,2,1,8
E33040289,398,268,98,170,1,40,11,29,83,82,0,1,0,6
E33040290,520,407,112,295,3,37,5,32,72,66,2,3,1,1
E33040291,402,278,82,196,4,40,11,29,77,74,0,2,1,3
E33040292,227,137,43,94,2,24,6,18,62,58,0,3,1,2
E33040293,248,173,61,112,3,18,1,17,52,51,0,1,0,2
E33040294,304,198,67,131,2,36,6,30,55,50,2,1,2,13
E33040295,446,306,70,236,12,47,8,39,76,71,2,3,0,5
E33040296,379,292,97,195,3,31,2,29,44,39,2,2,1,9
E33040297,390,268,82,186,1,46,7,39,70,63,2,4,1,5
E33040298,681,499,151,348,11,90,18,72,80,77,0,2,1,1
E33040299,368,254,59,195,2,34,6,28,75,62,4,9,0,3
E33040300,285,183,44,139,2,30,5,25,68,62,0,2,4,2
E33040301,259,206,56,150,2,14,5,9,36,33,0,1,2,1
E33040302,620,451,108,343,6,64,12,52,96,88,3,3,2,3
E33040303,376,276,76,200,5,34,9,25,58,52,2,4,0,3
E33040304,402,336,97,239,4,14,0,14,43,38,3,2,0,5
E33040305,282,229,66,163,3,27,1,26,21,19,0,2,0,2
E33040306,285,238,78,160,0,25,2,23,20,17,2,1,0,2
E33040307,371,270,66,204,1,27,3,24,70,60,2,3,5,3
E33040308,511,415,153,262,3,34,9,25,58,49,6,1,2,1
E33040309,684,455,146,309,10,94,17,77,117,108,2,2,5,8
E33040310,349,220,57,163,2,77,8,69,48,46,0,2,0,2
E33040311,327,225,79,146,2,30,1,29,57,49,0,8,0,13
E33040312,340,242,78,164,1,23,4,19,71,63,3,3,2,3
E33040313,279,201,58,143,3,40,4,36,35,33,1,1,0,0
E33040314,339,279,82,197,6,13,1,12,38,33,2,3,0,3
E33040315,523,417,112,305,2,31,5,26,69,65,1,3,0,4
E33040316,406,288,79,209,4,78,10,68,36,35,0,1,0,0
E33040317,882,598,142,456,7,46,8,38,228,217,1,9,1,3
E33040318,431,316,85,231,4,82,10,72,24,22,0,1,1,5
E33040319,274,212,72,140,5,27,2,25,25,21,1,3,0,5
E33040320,224,166,42,124,3,15,6,9,35,31,2,0,2,5
E33040321,246,165,69,96,1,26,6,20,45,38,4,2,1,9
E33040322,324,254,78,176,0,12,1,11,51,43,2,6,0,7
E33040323,230,140,46,94,0,10,5,5,77,72,1,2,2,3
E33040324,464,352,113,239,10,33,10,23,65,60,0,4,1,4
E33040325,307,230,75,155,0,22,9,13,51,46,1,4,0,4
E33040326,792,377,99,278,13,102,43,59,293,158,69,10,56,7
E33040327,235,138,49,89,1,29,5,24,47,28,15,2,2,20
E33040328,553,352,113,239,8,49,9,40,118,105,6,3,4,26
E33040329,714,367,78,289,8,51,16,35,274,255,9,7,3,14
E33040330,256,121,43,78,1,37,16,21,70,48,11,3,8,27
E33040331,586,419,97,322,4,21,6,15,139,127,7,1,4,3
E33040332,450,313,111,202,6,52,6,46,75,68,3,3,1,4
E33040333,285,205,60,145,0,35,5,30,33,25,5,2,1,12
E33040334,290,172,49,123,1,31,11,20,84,78,1,4,1,2
E33040335,383,260,74,186,5,42,15,27,73,61,5,7,0,3
E33040336,316,229,55,174,1,39,10,29,44,43,0,1,0,3
E33040337,286,212,51,161,1,20,7,13,51,47,2,0,2,2
E33040338,445,326,81,245,1,37,10,27,74,68,1,5,0,7
E33040339,708,326,87,239,2,67,16,51,307,119,111,2,75,6
E33040340,337,256,87,169,1,18,3,15,59,49,0,6,4,3
E33040341,328,227,55,172,6,32,10,22,62,56,2,2,2,1
E33040342,371,256,71,185,5,26,4,22,79,76,1,0,2,5
E33040343,395,274,81,193,3,41,7,34,74,64,2,6,2,3
E33040344,353,275,102,173,2,21,6,15,48,37,3,2,6,7
E33040345,434,254,74,180,8,73,10,63,97,44,27,3,23,2
E33040346,244,183,74,109,3,31,5,26,25,20,5,0,0,2
E33040347,442,279,98,181,0,86,10,76,76,64,5,0,7,1
E33040348,548,382,101,281,4,59,11,48,99,81,5,5,8,4
E33040349,433,253,60,193,6,80,24,56,94,82,5,5,2,0
E33040350,434,298,111,187,6,53,3,50,70,58,7,1,4,7
E33040351,318,198,60,138,3,79,12,67,34,28,1,4,1,4
E33040352,344,225,61,164,3,61,7,54,50,37,8,3,2,5
E33040353,343,248,85,163,1,28,6,22,59,50,3,0,6,7
E33040354,263,202,66,136,1,10,2,8,32,26,2,0,4,18
E33040355,406,280,73,207,7,18,3,15,97,91,2,4,0,4
E33040356,261,198,51,147,2,28,4,24,31,24,6,1,0,2
E33040357,561,410,149,261,5,41,8,33,100,91,4,4,1,5
E33040358,647,472,149,323,6,69,18,51,97,83,7,5,2,3
E33040359,313,210,60,150,0,39,14,25,60,49,6,2,3,4
E33040360,397,286,93,193,3,25,11,14,78,67,2,6,3,5
E33040361,320,230,65,165,1,26,6,20,54,43,5,3,3,9
E33040362,267,205,60,145,0,23,2,21,34,31,1,0,2,5
E33040363,310,263,106,157,2,12,6,6,31,27,0,4,0,2
E33040364,396,214,60,154,8,29,8,21,137,130,1,4,2,8
E33040365,329,250,80,170,2,17,2,15,50,49,0,1,0,10
E33040366,507,393,119,274,2,39,9,30,47,43,2,2,0,26
E33040367,627,450,107,343,6,33,10,23,130,116,7,7,0,8
E33040368,707,489,108,381,3,104,17,87,106,95,4,6,1,5
E33040369,284,182,61,121,1,19,2,17,74,69,3,1,1,8
E33040370,497,353,111,242,1,36,14,22,63,53,7,1,2,44
E33040371,291,229,56,173,0,24,4,20,38,35,1,1,1,0
E33040372,471,337,125,212,3,24,7,17,88,80,2,4,2,19
E33040373,402,282,83,199,5,23,10,13,80,75,1,3,1,12
E33040374,253,212,63,149,1,8,0,8,31,28,0,3,0,1
E33040375,586,414,118,296,9,73,19,54,85,63,14,6,2,5
E33040376,469,350,108,242,1,43,13,30,65,59,3,2,1,10
E33040377,244,157,52,105,3,19,4,15,53,46,2,3,2,12
E33040378,567,441,143,298,3,40,16,24,67,63,1,3,0,16
E33040379,757,535,144,391,7,74,47,27,137,131,3,2,1,4
E33040380,448,337,108,229,4,24,15,9,75,65,5,3,2,8
E33040381,339,201,86,115,7,41,15,26,63,53,6,2,2,27
E33040382,309,237,91,146,0,26,21,5,44,42,1,1,0,2
E33040383,421,316,92,224,3,37,25,12,57,49,4,3,1,8
E33040384,417,296,95,201,8,34,14,20,72,61,2,4,5,7
E33040385,428,349,92,257,1,18,15,3,58,53,0,2,3,2
E33040386,267,220,67,153,4,11,7,4,32,30,0,0,2,0
E33040387,286,232,79,153,4,12,10,2,36,34,0,2,0,2
E33040388,262,201,58,143,2,23,12,11,32,30,0,2,0,4
E33040389,271,187,43,144,3,15,8,7,64,59,0,4,1,2
E33040390,294,220,59,161,4,14,9,5,54,53,0,1,0,2
E33040391,1066,741,141,600,13,28,17,11,277,263,0,11,3,7
E33040392,357,287,103,184,3,15,8,7,52,47,0,3,2,0
E33040393,574,400,118,282,6,44,21,23,111,96,7,6,2,13
E33040394,333,296,92,204,2,8,6,2,27,23,1,2,1,0
E33040395,362,284,87,197,5,27,17,10,43,38,0,4,1,3
E33040396,447,365,102,263,2,24,11,13,54,51,0,2,1,2
E33040397,338,306,75,231,2,2,1,1,27,25,0,2,0,1
E33040398,400,332,89,243,8,12,5,7,43,39,0,4,0,5
E33040399,290,250,72,178,2,13,7,6,23,23,0,0,0,2
E33040400,360,287,67,220,3,20,13,7,48,48,0,0,0,2
E33040401,290,188,56,132,3,58,52,6,41,36,1,2,2,0
E33040402,481,369,116,253,11,30,21,9,69,65,1,3,0,2
E33040403,759,594,179,415,6,62,41,21,93,88,1,4,0,4
E33040404,368,307,105,202,1,11,7,4,48,46,2,0,0,1
E33040405,581,494,133,361,6,20,7,13,61,49,4,2,6,0
E33040406,404,283,69,214,3,19,9,10,95,87,2,6,0,4
E33040407,438,350,90,260,6,9,4,5,69,67,0,2,0,4
E33040408,416,359,82,277,4,14,8,6,39,38,0,1,0,0
E33040409,321,275,101,174,2,9,5,4,33,30,0,3,0,2
E33040410,611,524,156,368,1,12,7,5,70,59,2,9,0,4
E33040411,313,281,97,184,0,3,2,1,27,25,1,1,0,2
E33040412,428,370,98,272,7,7,4,3,41,41,0,0,0,3
E33040413,890,639,194,445,18,21,15,6,205,190,4,7,4,7
E33040414,446,374,124,250,3,12,5,7,56,51,1,3,1,1
E33040415,336,214,50,164,14,54,24,30,53,46,0,6,1,1
E33040416,413,318,71,247,9,19,9,10,65,64,0,1,0,2
E33040417,484,311,79,232,12,66,25,41,91,88,2,0,1,4
E33040418,523,379,80,299,8,41,21,20,87,75,4,8,0,8
E33040419,433,352,90,262,11,18,7,11,47,43,1,3,0,5
E33040420,533,403,85,318,8,39,18,21,81,76,2,2,1,2
E33040421,669,489,132,357,7,81,38,43,87,83,2,2,0,5
E33040422,442,320,106,214,4,20,11,9,82,63,9,9,1,16
E33040423,511,438,138,300,7,16,6,10,47,38,3,6,0,3
E33040424,355,261,55,206,2,38,25,13,53,50,1,2,0,1
E33040425,854,687,177,510,6,35,20,15,120,113,2,5,0,6
E33040426,392,337,74,263,2,13,4,9,40,37,0,3,0,0
E33040427,525,428,82,346,4,19,8,11,72,64,0,7,1,2
E33040428,350,289,73,216,4,15,8,7,40,38,0,2,0,2
E33040429,518,371,50,321,5,23,13,10,117,105,3,8,1,2
E33040430,462,344,81,263,6,33,24,9,77,72,1,3,1,2
E33040431,298,233,58,175,5,20,14,6,36,32,3,0,1,4
E33040432,1964,1385,397,988,17,92,48,44,466,450,1,14,1,4
E33040433,338,244,53,191,7,27,10,17,57,51,4,2,0,3
E33040434,328,256,75,181,3,24,20,4,44,42,1,1,0,1
E33040435,447,336,75,261,14,36,11,25,58,48,4,3,3,3
E33040436,675,495,140,355,8,57,29,28,106,92,4,9,1,9
E33040437,450,317,75,242,8,51,23,28,67,59,3,4,1,7
E33040438,803,554,130,424,15,62,22,40,167,160,2,4,1,5
E33040439,208,164,55,109,3,14,6,8,23,21,0,0,2,4
E33040440,294,227,66,161,4,25,18,7,37,34,2,0,1,1
E33040441,280,188,55,133,5,31,22,9,50,41,1,8,0,6
E33040442,532,384,113,271,5,86,68,18,57,51,2,4,0,0
E33040443,314,252,78,174,1,25,18,7,33,28,2,3,0,3
E33040444,373,275,91,184,1,27,18,9,70,58,5,4,3,0
E33040445,273,209,46,163,14,21,16,5,28,27,0,1,0,1
E33040446,300,244,62,182,2,10,2,8,42,30,8,4,0,2
E33040447,248,211,67,144,2,11,6,5,24,23,0,1,0,0
E33040448,254,230,78,152,0,3,1,2,20,17,1,2,0,1
E33040449,244,201,66,135,1,19,13,6,19,17,0,2,0,4
E33040450,278,261,81,180,1,1,1,0,14,14,0,0,0,1
E33040451,903,708,221,487,20,76,32,44,93,86,0,7,0,6
E33040452,396,328,99,229,2,21,11,10,44,40,0,4,0,1
E33040453,255,210,60,150,2,11,6,5,29,26,2,1,0,3
E33040454,257,202,67,135,5,11,4,7,36,36,0,0,0,3
E33040455,579,425,143,282,1,76,51,25,72,60,3,2,7,5
E33040456,243,167,51,116,2,14,7,7,45,42,2,1,0,15
E33040457,590,450,120,330,11,22,18,4,103,91,5,1,6,4
E33040458,334,245,64,181,17,28,19,9,40,35,0,4,1,4
E33040459,286,206,63,143,5,35,17,18,39,38,0,0,1,1
E33040460,291,222,72,150,5,19,16,3,40,37,0,3,0,5
E33040461,321,247,68,179,10,11,8,3,49,44,0,5,0,4
E33040462,240,180,43,137,14,12,5,7,33,29,0,2,2,1
E33040463,281,197,60,137,8,40,32,8,35,31,2,2,0,1
E33040464,322,241,51,190,7,14,8,6,56,35,11,1,9,4
E33040465,290,240,84,156,1,14,4,10,33,28,3,2,0,2
E33040466,295,235,66,169,3,21,11,10,27,16,6,2,3,9
E33040467,1016,644,180,464,8,67,35,32,297,75,135,13,74,0
E33040468,380,254,72,182,6,21,8,13,81,44,27,4,6,18
E33040469,333,244,60,184,2,50,36,14,37,32,1,2,2,0
E33040470,288,259,57,202,2,6,5,1,21,20,0,1,0,0
E33040471,328,275,75,200,1,7,7,0,42,37,1,4,0,3
E33040472,437,399,140,259,1,5,4,1,28,23,3,1,1,4
E33040473,299,252,71,181,0,18,15,3,25,24,0,1,0,4
E33040474,446,369,115,254,0,22,15,7,51,44,2,2,3,4
E33040475,450,389,140,249,3,21,15,6,32,29,0,3,0,5
E33040476,650,419,107,312,9,61,27,34,157,145,2,6,4,4
E33040477,408,352,116,236,0,12,4,8,43,42,0,1,0,1
E33040478,565,419,89,330,5,21,13,8,119,113,0,4,2,1
E33040479,636,453,126,327,4,41,28,13,130,119,1,9,1,8
E33040480,269,222,64,158,3,15,13,2,28,27,0,1,0,1
E33040481,654,518,145,373,10,39,18,21,85,76,2,3,4,2
E33040482,300,221,52,169,2,25,15,10,45,43,0,2,0,7
E33040483,259,193,59,134,2,10,3,7,51,46,4,1,0,3
E33040484,556,454,146,308,8,25,17,8,68,66,1,1,0,1
E33040485,432,327,91,236,3,19,14,5,79,74,1,2,2,4
E33040486,324,252,76,176,6,26,17,9,34,31,0,3,0,6
E33040487,282,185,63,122,8,28,18,10,54,49,1,4,0,7
E33040488,311,229,64,165,4,24,17,7,39,33,3,3,0,15
E33040489,328,235,64,171,4,25,10,15,60,50,4,2,4,4
E33040490,440,291,69,222,16,42,17,25,82,73,0,4,5,9
E33040491,318,220,68,152,12,27,19,8,54,48,3,3,0,5
E33040492,335,258,75,183,16,25,7,18,35,31,0,4,0,1
E33040493,546,397,110,287,16,54,37,17,76,70,2,4,0,3
E33040494,272,228,70,158,8,4,3,1,31,26,0,3,2,1
E33040495,384,320,72,248,7,10,5,5,44,41,0,3,0,3
E33040496,263,231,64,167,4,4,2,2,22,20,0,2,0,2
E33040497,487,372,88,284,11,27,21,6,74,61,2,10,1,3
E33040498,275,206,57,149,6,9,4,5,49,39,6,4,0,5
E33040499,270,221,40,181,10,10,5,5,27,25,0,2,0,2
E33040500,649,468,113,355,32,48,26,22,98,91,0,6,1,3
E33040501,234,190,35,155,4,13,10,3,27,22,0,3,2,0
E33040502,744,526,121,405,29,63,36,27,123,110,1,10,2,3
E33040503,337,255,86,169,13,31,19,12,36,34,0,2,0,2
E33040504,456,321,85,236,20,43,23,20,68,61,2,4,1,4
E33040505,362,243,77,166,32,35,12,23,45,41,1,3,0,7
E33040506,730,440,112,328,31,127,100,27,128,119,1,8,0,4
E33040507,244,149,59,90,13,35,17,18,47,40,0,7,0,0
E33040508,1605,1227,241,986,95,77,40,37,198,181,1,16,0,8
E33040509,1145,906,164,742,43,36,15,21,155,147,1,6,1,5
E33040510,498,372,89,283,27,24,15,9,71,67,1,2,1,4
E33040511,282,176,37,139,30,39,11,28,35,29,0,6,0,2
E33040512,444,344,88,256,34,24,9,15,40,37,0,3,0,2
E33040513,628,370,94,276,26,105,68,37,125,114,2,8,1,2
E33040514,562,353,98,255,26,63,37,26,118,103,4,6,5,2
E33040515,303,198,51,147,4,25,20,5,73,67,0,5,1,3
E33040516,311,203,64,139,6,35,20,15,63,59,0,3,1,4
E33040517,307,214,43,171,4,27,14,13,60,53,3,4,0,2
E33040518,330,222,60,162,8,29,16,13,70,65,0,5,0,1
E33040519,766,452,110,342,34,107,59,48,169,147,0,20,2,4
E33040520,872,601,127,474,52,91,58,33,120,109,2,7,2,8
E33040521,402,266,47,219,16,29,12,17,90,89,0,0,1,1
E33040522,351,195,45,150,9,65,40,25,80,76,2,1,1,2
E33040523,460,274,37,237,23,47,26,21,110,105,0,5,0,6
E33040524,588,422,138,284,22,59,39,20,83,79,0,4,0,2
E33040525,318,241,57,184,15,16,10,6,44,37,2,5,0,2
E33040526,418,258,48,210,19,45,24,21,90,88,0,2,0,6
E33040527,664,478,104,374,23,23,16,7,138,127,1,7,3,2
E33040528,411,309,82,227,9,27,15,12,63,58,1,4,0,3
E33040529,1024,733,178,555,50,97,56,41,139,134,1,4,0,5
E33040530,305,252,67,185,6,16,14,2,26,23,0,2,1,5
E33040531,364,264,74,190,8,32,19,13,58,58,0,0,0,2
E33040532,307,233,63,170,9,15,10,5,47,46,0,1,0,3
E33040533,503,379,107,272,26,28,22,6,68,57,0,9,2,2
E33040534,520,305,67,238,22,94,58,36,94,84,0,10,0,5
E33040535,479,278,61,217,13,132,111,21,51,49,0,2,0,5
E33040536,290,173,39,134,10,42,27,15,64,48,1,15,0,1
E33040537,498,289,72,217,21,72,43,29,110,102,1,6,1,6
E33040538,448,253,68,185,37,64,37,27,94,87,0,4,3,0
E33040539,992,521,112,409,53,128,64,64,280,262,3,14,1,10
E33040540,491,315,65,250,22,33,20,13,119,115,0,4,0,2
E33040541,660,407,75,332,39,30,11,19,182,173,0,9,0,2
E33040542,916,568,129,439,56,101,56,45,175,162,3,10,0,16
E33040543,366,216,45,171,9,50,27,23,87,78,0,8,1,4
E33040544,270,152,31,121,9,32,13,19,73,63,0,5,5,4
E33040545,315,144,30,114,9,62,40,22,98,94,4,0,0,2
E33040546,537,331,87,244,32,44,26,18,127,113,6,7,1,3
E33040547,643,462,107,355,65,25,18,7,87,77,0,10,0,4
E33040548,368,214,24,190,28,38,6,32,87,86,0,1,0,1
E33040549,290,201,63,138,12,35,13,22,39,36,0,2,1,3
E33040550,394,285,89,196,10,26,10,16,67,65,1,1,0,6
E33040551,347,251,76,175,15,26,21,5,51,49,0,2,0,4
E33040552,286,182,56,126,17,27,5,22,59,59,0,0,0,1
E33040553,904,589,88,501,30,74,28,46,207,194,3,6,4,4
E33040554,1107,690,144,546,77,149,53,96,185,168,1,12,4,6
E33040555,300,189,54,135,24,25,13,12,59,58,0,1,0,3
E33040556,611,431,71,360,20,38,14,24,120,110,2,7,1,2
E33040557,305,181,23,158,24,27,3,24,73,64,1,7,1,0
E33040558,348,188,40,148,37,32,10,22,90,83,1,4,2,1
E33040559,902,549,100,449,74,107,41,66,170,159,1,7,3,2
E33040560,294,219,36,183,14,23,3,20,37,33,1,1,2,1
E33040561,265,181,18,163,18,16,6,10,50,49,0,1,0,0
E33040562,3906,3060,834,2226,153,141,61,80,537,512,2,22,1,15
E33040563,479,289,41,248,24,55,21,34,108,100,2,6,0,3
E33040564,986,608,104,504,64,65,22,43,242,225,1,15,1,7
E33040565,302,216,51,165,17,16,9,7,53,47,3,2,1,0
E33040566,1049,704,184,520,62,134,63,71,143,132,1,7,3,6
E33040567,3906,2505,606,1899,258,534,250,284,599,551,18,24,6,10
E33040568,459,253,62,191,17,80,49,31,109,105,0,4,0,0
E33040569,393,195,39,156,17,76,42,34,103,99,0,4,0,2
E33040570,336,216,38,178,28,36,15,21,55,52,0,3,0,1
E33040571,574,370,63,307,42,54,14,40,106,101,2,3,0,2
E33040572,267,207,72,135,3,23,19,4,32,27,0,5,0,2
E33040573,254,170,15,155,22,22,5,17,40,37,0,3,0,0
E33040574,361,254,46,208,28,24,4,20,54,53,0,1,0,1
E33040575,454,290,53,237,26,64,32,32,72,69,0,3,0,2
E33040576,1004,666,142,524,32,39,22,17,265,254,2,4,5,2
E33040577,362,247,61,186,35,33,12,21,46,42,0,2,2,1
E33040578,552,364,94,270,43,47,14,33,94,88,0,6,0,4
E33040579,720,526,112,414,39,41,16,25,110,105,1,4,0,4
E33040580,291,225,74,151,7,12,5,7,45,43,0,2,0,2
E33040581,635,451,102,349,35,38,17,21,109,105,0,4,0,2
E33040582,709,495,119,376,35,51,19,32,123,111,1,10,1,5
E33040583,317,182,38,144,11,56,15,41,64,59,5,0,0,4
E33040584,824,544,97,447,34,79,39,40,165,151,1,12,1,2
E33040585,619,365,67,298,25,76,34,42,149,144,0,4,1,4
E33040586,991,644,152,492,64,140,51,89,137,129,2,5,1,6
E33040587,498,341,96,245,25,55,11,44,76,70,2,4,0,1
E33040588,421,285,50,235,36,32,13,19,66,63,0,2,1,2
E33040589,374,217,43,174,58,41,4,37,57,52,1,4,0,1
E33040590,586,363,92,271,16,97,62,35,106,93,5,6,2,4
E33040591,378,238,58,180,7,64,45,19,69,63,4,2,0,0
E33040592,356,164,36,128,17,107,79,28,66,59,2,5,0,2
E33040593,317,225,74,151,13,35,18,17,42,32,2,4,4,2
E33040594,699,506,141,365,23,76,32,44,91,80,2,8,1,3
E33040595,750,618,141,477,15,34,16,18,80,67,8,4,1,3
E33040596,385,300,89,211,9,28,11,17,44,40,0,4,0,4
E33040597,461,318,54,264,22,51,1,50,68,63,0,4,1,2
E33040598,294,233,25,208,6,6,0,6,47,45,0,2,0,2
E33040599,282,197,33,164,13,40,4,36,29,27,0,1,1,3
E33040600,328,204,40,164,17,38,10,28,65,60,0,5,0,4
E33040601,842,577,141,436,47,90,33,57,120,113,0,5,2,8
E33040602,447,254,40,214,47,67,11,56,77,73,0,2,2,2
E33040603,692,483,150,333,35,75,55,20,96,87,0,7,2,3
E33040604,720,516,126,390,28,62,45,17,112,103,0,9,0,2
E33040605,307,207,63,144,13,32,21,11,50,48,0,2,0,5
E33040606,276,185,38,147,19,27,15,12,43,40,0,2,1,2
E33040607,321,233,31,202,16,27,5,22,45,40,0,5,0,0
E33040608,875,480,86,394,53,86,27,59,253,244,0,8,1,3
E33040609,402,297,71,226,15,26,10,16,64,60,0,4,0,0
E33040610,398,285,79,206,7,52,41,11,52,47,0,5,0,2
E33040611,449,368,106,262,14,29,19,10,37,34,0,3,0,1
E33040612,282,202,53,149,7,31,26,5,41,38,2,1,0,1
E33040613,270,160,45,115,11,43,30,13,53,52,0,1,0,3
E33040614,277,207,56,151,14,22,17,5,34,33,0,1,0,0
E33040615,444,325,97,228,19,47,31,16,46,39,2,5,0,7
E33040616,469,325,79,246,18,55,28,27,70,63,2,5,0,1
E33040617,289,230,62,168,5,15,6,9,36,36,0,0,0,3
E33040618,383,259,60,199,23,37,25,12,60,54,1,5,0,4
E33040619,443,300,88,212,15,39,29,10,83,82,0,1,0,6
E33040620,661,458,100,358,27,62,33,29,111,102,1,6,2,3
E33040621,534,330,84,246,13,117,97,20,73,69,0,4,0,1
E33040622,284,196,50,146,17,36,24,12,33,29,0,4,0,2
E33040623,267,176,39,137,8,51,37,14,30,26,0,3,1,2
E33040624,307,258,69,189,1,14,10,4,29,24,0,5,0,5
E33040625,310,242,64,178,2,16,10,6,45,42,0,3,0,5
E33040626,449,355,85,270,4,28,24,4,62,59,0,3,0,0
E33040627,762,440,138,302,3,170,129,41,147,139,0,6,2,2
E33040628,426,290,77,213,2,65,49,16,66,54,1,7,4,3
E33040629,535,293,84,209,6,126,116,10,106,100,1,3,2,4
E33040630,277,214,54,160,5,13,10,3,44,37,2,4,1,1
E33040631,346,286,88,198,2,6,4,2,44,40,0,4,0,8
E33040632,309,216,62,154,1,16,8,8,68,58,1,9,0,8
E33040633,239,166,53,113,1,19,15,4,43,40,0,3,0,10
E33040634,334,257,90,167,0,23,11,12,48,46,0,2,0,6
E33040635,354,277,81,196,1,22,17,5,50,48,0,2,0,4
E33040636,430,352,102,250,5,25,22,3,45,43,0,1,1,3
E33040637,503,398,104,294,3,27,18,9,72,67,0,4,1,3
E33040638,957,724,199,525,11,48,30,18,169,157,3,8,1,5
E33040639,420,320,102,218,5,51,20,31,40,36,0,4,0,4
E33040640,675,496,128,368,7,71,36,35,96,91,0,5,0,5
E33040641,484,358,92,266,6,60,52,8,57,52,0,5,0,3
E33040642,354,237,67,170,1,57,49,8,51,43,0,5,3,8
E33040643,349,225,76,149,0,48,40,8,74,66,3,5,0,2
E33040644,318,237,91,146,1,18,11,7,60,60,0,0,0,2
E33040645,304,253,89,164,1,8,4,4,42,40,0,2,0,0
E33040646,826,580,161,419,4,74,43,31,159,149,1,9,0,9
E33040647,346,277,75,202,1,17,14,3,46,45,0,1,0,5
E33040648,318,171,69,102,3,58,31,27,83,73,0,8,2,3
E33040649,451,278,73,205,5,81,52,29,84,77,1,5,1,3
E33040650,370,238,63,175,7,72,55,17,50,42,1,6,1,3
E33040651,373,230,71,159,7,58,44,14,74,71,0,2,1,4
E33040652,362,187,46,141,1,83,58,25,88,82,0,6,0,3
E33040653,396,188,47,141,4,112,44,68,89,83,2,3,1,3
E33040654,525,268,60,208,9,138,83,55,109,101,1,7,0,1
E33040655,509,265,75,190,5,138,118,20,100,95,0,4,1,1
E33040656,292,212,61,151,3,30,21,9,44,42,0,2,0,3
E33040657,298,224,63,161,2,17,11,6,53,48,1,2,2,2
E33040658,294,243,50,193,2,6,4,2,43,41,1,1,0,0
E33040659,577,324,95,229,3,85,61,24,158,153,2,2,1,7
E33040660,284,187,50,137,3,10,5,5,83,78,1,4,0,1
E33040661,312,246,78,168,3,16,12,4,47,45,0,2,0,0
E33040662,536,339,93,246,3,28,15,13,154,148,3,3,0,12
E33040663,323,239,74,165,3,9,7,2,68,67,0,1,0,4
E33040664,441,307,96,211,0,30,21,9,102,96,0,6,0,2
E33040665,346,254,75,179,4,9,7,2,77,75,0,2,0,2
E33040666,573,392,95,297,4,16,3,13,154,146,2,6,0,7
E33040667,436,325,84,241,5,50,36,14,50,46,0,4,0,6
E33040668,260,186,57,129,3,21,12,9,49,44,0,5,0,1
E33040669,295,211,49,162,4,23,18,5,56,50,1,4,1,1
E33040670,288,225,70,155,0,30,21,9,33,27,5,1,0,0
E33040671,476,303,71,232,6,78,64,14,87,77,1,9,0,2
E33040672,285,230,70,160,1,22,17,5,29,25,0,4,0,3
E33040673,645,404,121,283,3,112,75,37,123,115,0,6,2,3
E33040674,416,260,66,194,7,54,40,14,91,89,0,2,0,4
E33040675,331,261,48,213,2,10,5,5,57,50,0,7,0,1
E33040676,673,450,133,317,9,79,32,47,129,117,2,9,1,6
E33040677,588,386,94,292,4,80,56,24,113,108,0,5,0,5
E33040678,717,430,130,300,13,42,27,15,230,214,1,12,3,2
E33040679,326,168,56,112,5,37,23,14,115,106,0,6,3,1
E33040680,269,186,55,131,6,6,5,1,69,63,2,3,1,2
E33040681,243,164,55,109,0,16,9,7,60,58,0,2,0,3
E33040682,302,193,37,156,2,22,13,9,81,78,0,3,0,4
E33040683,363,274,74,200,4,11,6,5,71,69,0,2,0,3
E33040684,323,162,30,132,19,28,11,17,112,104,0,7,1,2
E33040685,302,226,52,174,0,14,10,4,59,58,1,0,0,3
E33040686,700,335,96,239,10,109,77,32,240,231,0,8,1,6
E33040687,348,167,51,116,3,46,29,17,129,123,0,3,3,3
E33040688,259,164,55,109,0,7,4,3,84,77,0,7,0,4
E33040689,268,132,39,93,0,16,9,7,113,106,1,6,0,7
E33040690,455,215,39,176,5,54,37,17,178,165,0,8,5,3
E33040691,694,442,116,326,5,41,23,18,200,183,0,15,2,6
E33040692,354,223,46,177,4,29,15,14,98,92,1,4,1,0
E33040693,303,198,44,154,1,29,18,11,73,70,0,3,0,2
E33040694,322,205,54,151,2,17,9,8,92,83,4,5,0,6
E33040695,346,226,50,176,7,23,10,13,86,78,1,7,0,4
E33040696,315,224,63,161,4,29,20,9,55,51,0,4,0,3
E33040697,299,226,58,168,3,34,28,6,36,28,2,6,0,0
E33040698,309,239,49,190,3,34,22,12,33,30,0,3,0,0
E33040699,583,392,98,294,8,71,42,29,109,100,0,9,0,3
E33040700,730,466,124,342,6,121,90,31,135,127,0,6,2,2
E33040701,462,374,109,265,4,23,13,10,54,51,0,2,1,7
E33040702,318,203,67,136,2,2,2,0,107,98,0,7,2,4
E33040703,467,271,86,185,6,50,27,23,137,131,0,6,0,3
E33040704,321,214,54,160,4,35,28,7,68,67,0,1,0,0
E33040705,283,187,49,138,3,19,14,5,73,67,0,3,3,1
E33040706,307,176,44,132,5,27,16,11,96,90,3,2,1,3
E33040707,515,318,73,245,2,22,13,9,171,163,0,8,0,2
E33040708,281,147,49,98,3,30,18,12,97,93,0,2,2,4
E33040709,297,121,42,79,1,12,11,1,156,150,0,6,0,7
E33040710,293,155,33,122,3,27,17,10,104,100,0,4,0,4
E33040711,485,245,69,176,3,63,45,18,167,160,0,7,0,7
E33040712,336,199,53,146,3,40,31,9,93,92,0,1,0,1
E33040713,410,259,75,184,4,22,12,10,122,109,2,11,0,3
E33040714,580,399,118,281,2,31,17,14,147,145,0,0,2,1
E33040715,352,199,64,135,0,25,15,10,116,108,0,8,0,12
E33040716,334,202,58,144,0,15,8,7,116,114,0,2,0,1
E33040717,278,194,57,137,0,14,8,6,70,62,0,8,0,0
E33040718,258,167,33,134,0,9,6,3,78,72,2,4,0,4
E33040719,291,178,49,129,10,13,8,5,86,78,2,4,2,4
E33040720,358,171,44,127,7,27,16,11,146,136,3,7,0,7
E33040721,298,234,56,178,0,13,11,2,51,49,0,1,1,0
E33040722,374,255,65,190,5,33,23,10,78,71,1,6,0,3
E33040723,453,311,86,225,3,38,28,10,98,89,0,9,0,3
E33040724,246,163,44,119,4,36,28,8,42,39,0,3,0,1
E33040725,469,318,112,206,3,39,26,13,101,93,2,6,0,8
E33040726,624,433,118,315,12,55,37,18,120,111,0,8,1,4
E33040727,249,168,33,135,3,14,10,4,61,52,0,5,4,3
E33040728,361,260,81,179,2,27,23,4,69,69,0,0,0,3
E33040729,295,160,38,122,2,18,14,4,112,105,1,4,2,3
E33040730,392,244,69,175,2,15,12,3,126,118,1,7,0,5
E33040731,400,238,78,160,6,28,7,21,127,116,2,8,1,1
E33040732,545,329,71,258,0,54,34,20,159,153,0,6,0,3
E33040733,277,183,52,131,2,25,20,5,63,57,0,6,0,4
E33040734,259,191,53,138,1,22,15,7,45,43,0,2,0,0
E33040735,539,313,79,234,1,74,49,25,144,135,0,9,0,7
E33040736,392,242,68,174,3,16,13,3,127,121,0,6,0,4
E33040737,381,250,66,184,4,48,32,16,79,71,0,8,0,0
E33040738,322,138,24,114,1,18,11,7,161,151,2,8,0,4
E33040739,253,147,32,115,2,10,8,2,92,88,1,2,1,2
E33040740,400,235,40,195,1,38,22,16,123,120,0,3,0,3
E33040741,299,156,45,111,2,28,13,15,112,108,0,4,0,1
E33040742,490,273,91,182,7,28,16,12,172,163,0,9,0,10
E33040743,255,118,27,91,2,8,3,5,126,118,1,7,0,1
E33040744,295,171,49,122,3,6,2,4,110,107,0,1,2,5
E33040745,522,275,71,204,3,38,22,16,200,183,0,17,0,6
E33040746,548,285,72,213,5,143,120,23,107,101,0,5,1,8
E33040747,338,130,43,87,8,125,103,22,74,71,1,2,0,1
E33040748,423,174,47,127,9,181,114,67,51,48,0,3,0,8
E33040749,295,163,51,112,3,19,8,11,108,105,0,3,0,2
E33040750,310,128,37,91,2,26,14,12,150,141,1,4,4,4
E33040751,258,141,39,102,1,6,4,2,109,104,0,5,0,1
E33040752,697,419,108,311,6,32,22,10,235,227,0,8,0,5
E33040753,412,228,56,172,4,14,9,5,165,156,1,8,0,1
E33040754,541,315,70,245,3,17,13,4,198,194,0,3,1,8
E33040755,521,353,100,253,5,27,14,13,133,127,1,5,0,3
E33040756,463,228,61,167,5,25,13,12,203,190,1,10,2,2
E33040757,474,234,77,157,3,54,22,32,176,169,0,7,0,7
E33040758,316,166,47,119,3,6,2,4,138,134,0,4,0,3
E33040759,902,571,124,447,10,36,28,8,282,270,2,7,3,3
E33040760,955,607,127,480,13,31,14,17,297,279,1,15,2,7
E33040761,336,224,58,166,3,12,7,5,92,88,0,4,0,5
E33040762,802,477,102,375,4,64,27,37,249,233,7,7,2,8
E33040763,279,142,33,109,1,25,15,10,100,92,5,3,0,11
E33040764,282,149,41,108,1,8,6,2,120,110,0,5,5,4
E33040765,634,384,58,326,9,56,37,19,185,180,1,3,1,0
E33040766,521,270,81,189,7,47,35,12,190,178,0,8,4,7
E33040767,440,249,66,183,7,19,9,10,158,150,0,8,0,7
E33040768,548,339,82,257,10,22,17,5,176,169,0,6,1,1
E33040769,897,489,163,326,25,69,47,22,310,296,1,10,3,4
E33040770,1174,824,220,604,16,70,43,27,256,245,0,9,2,8
E33040771,255,128,35,93,1,13,10,3,109,99,0,9,1,4
E33040772,248,142,41,101,8,9,4,5,89,83,0,6,0,0
E33040773,425,260,78,182,1,31,19,12,128,118,1,9,0,5
E33040774,331,165,48,117,0,20,16,4,138,127,1,6,4,8
E33040775,389,226,62,164,1,41,29,12,121,120,0,1,0,0
E33040776,523,241,74,167,3,68,48,20,204,195,0,7,2,7
E33040777,337,208,42,166,0,13,9,4,113,106,1,5,1,3
E33040778,263,148,55,93,1,3,1,2,104,101,0,3,0,7
E33040779,512,223,75,148,4,35,29,6,246,240,0,3,3,4
E33040780,346,185,48,137,0,17,7,10,136,126,0,9,1,8
E33040781,370,194,62,132,1,10,5,5,164,153,0,11,0,1
E33040782,298,104,32,72,2,25,11,14,163,159,1,0,3,4
E33040783,284,143,34,109,4,9,2,7,125,114,4,7,0,3
E33040784,297,128,39,89,2,15,6,9,150,147,0,3,0,2
E33040785,266,126,42,84,0,5,3,2,134,127,0,7,0,1
E33040786,444,196,32,164,5,40,17,23,202,193,0,8,1,1
E33040787,474,223,43,180,5,14,8,6,218,200,1,8,9,14
E33040788,249,115,39,76,0,36,30,6,97,94,0,3,0,1
E33040789,248,113,39,74,4,42,36,6,87,84,0,3,0,2
E33040790,363,143,36,107,0,50,36,14,165,160,0,4,1,5
E33040791,359,247,66,181,4,35,28,7,71,65,1,5,0,2
E33040792,279,138,35,103,5,32,20,12,101,96,0,4,1,3
E33040793,276,164,61,103,1,38,26,12,71,66,0,4,1,2
E33040794,278,119,32,87,0,15,11,4,135,125,3,7,0,9
E33040795,489,283,71,212,12,55,42,13,135,130,0,5,0,4
E33040796,623,388,99,289,8,57,39,18,167,159,0,6,2,3
E33040797,346,197,59,138,4,25,18,7,116,111,0,5,0,4
E33040798,333,178,44,134,5,21,11,10,125,119,0,6,0,4
E33040799,389,150,42,108,4,35,27,8,196,188,0,8,0,4
E33040800,318,145,42,103,1,68,49,19,97,87,0,10,0,7
E33040801,401,249,64,185,7,24,12,12,115,112,1,2,0,6
E33040802,250,156,43,113,1,6,3,3,84,77,0,7,0,3
E33040803,637,380,96,284,7,63,40,23,172,160,2,6,4,15
E33040804,280,151,45,106,3,42,35,7,76,70,3,3,0,8
E33040805,382,211,69,142,5,19,14,5,143,135,0,8,0,4
E33040806,296,158,44,114,1,29,21,8,106,100,1,4,1,2
E33040807,415,252,72,180,3,83,60,23,76,68,1,6,1,1
E33040808,788,545,158,387,8,48,28,20,181,174,0,7,0,6
E33040809,364,203,60,143,2,39,27,12,118,115,0,3,0,2
E33040810,576,423,146,277,4,49,31,18,91,87,1,2,1,9
E33040811,424,322,93,229,6,20,11,9,73,71,0,2,0,3
E33040812,391,332,90,242,5,8,5,3,42,38,0,4,0,4
E33040813,381,283,78,205,12,19,10,9,64,60,1,2,1,3
E33040814,269,220,70,150,1,16,13,3,30,30,0,0,0,2
E33040815,243,151,55,96,2,21,15,6,69,60,0,8,1,0
E33040816,295,251,93,158,3,5,2,3,35,32,1,1,1,1
E33040817,553,429,125,304,1,62,44,18,60,44,4,5,7,1
E33040818,336,208,46,162,0,86,72,14,39,32,0,6,1,3
E33040819,491,350,63,287,8,71,56,15,59,54,1,4,0,3
E33040820,386,258,39,219,6,69,58,11,51,42,1,5,3,2
E33040821,907,610,121,489,6,180,135,45,106,83,5,15,3,5
E33040822,716,554,188,366,4,66,28,38,91,81,2,7,1,1
E33040823,693,532,149,383,6,62,41,21,88,75,4,7,2,5
E33040824,278,208,63,145,4,24,16,8,37,18,18,1,0,5
E33040825,392,300,84,216,0,31,14,17,59,51,1,4,3,2
E33040826,344,300,100,200,2,17,5,12,23,23,0,0,0,2
E33040827,633,466,109,357,1,48,38,10,114,96,1,13,4,4
E33040828,420,294,58,236,1,58,34,24,61,38,13,5,5,6
E33040829,305,221,52,169,2,9,4,5,72,64,3,5,0,1
E33040830,821,590,126,464,16,57,31,26,151,139,3,8,1,7
E33040831,423,310,67,243,6,25,8,17,81,48,21,7,5,1
E33040832,394,332,90,242,0,29,15,14,31,24,2,4,1,2
E33040833,413,315,98,217,2,36,13,23,59,54,0,3,2,1
E33040834,383,302,81,221,2,40,36,4,36,29,1,4,2,3
E33040835,371,324,74,250,1,15,10,5,30,26,0,2,2,1
E33040836,610,423,114,309,10,88,43,45,88,75,4,6,3,1
E33040837,467,369,116,253,1,37,22,15,58,46,2,7,3,2
E33040838,300,172,48,124,4,46,15,31,77,32,28,0,17,1
E33040839,358,248,62,186,0,30,14,16,78,72,1,3,2,2
E33040840,314,205,52,153,2,50,33,17,51,47,3,1,0,6
E33040841,240,170,39,131,6,18,7,11,44,39,1,4,0,2
E33040842,307,215,54,161,2,28,14,14,61,56,0,3,2,1
E33040843,2617,2141,604,1537,18,107,59,48,340,315,4,17,4,11
E33040844,190,138,22,116,1,18,14,4,33,27,0,2,4,0
E33040845,552,380,96,284,4,53,29,24,113,97,6,8,2,2
E33040846,427,298,75,223,3,41,24,17,82,73,2,3,4,3
E33040847,1454,1097,334,763,15,132,79,53,207,185,5,15,2,3
E33040848,566,435,121,314,1,46,28,18,80,68,3,6,3,4
E33040849,314,223,48,175,2,28,17,11,58,51,0,7,0,3
E33040850,315,227,41,186,1,26,15,11,56,53,0,3,0,5
E33040851,393,305,62,243,1,28,11,17,59,43,0,16,0,0
E33040852,338,248,63,185,2,32,16,16,55,51,1,2,1,1
E33040853,349,244,53,191,1,29,14,15,73,63,1,5,4,2
E33040854,385,276,64,212,0,18,14,4,87,78,4,5,0,4
E33040855,281,194,56,138,2,21,9,12,63,58,1,4,0,1
E33040856,264,190,55,135,3,10,6,4,59,54,0,5,0,2
E33040857,312,241,61,180,1,14,5,9,52,50,1,1,0,4
E33040858,318,234,61,173,2,35,23,12,44,36,1,5,2,3
E33040859,362,242,63,179,2,38,22,16,79,72,1,2,4,1
E33040860,753,449,97,352,11,67,35,32,220,190,3,21,6,6
E33040861,362,248,51,197,1,22,7,15,91,86,1,4,0,0
E33040862,283,209,49,160,2,16,9,7,51,47,0,4,0,5
E33040863,386,239,43,196,5,39,23,16,101,88,1,12,0,2
E33040864,343,289,78,211,2,6,3,3,43,39,0,4,0,3
E33040865,368,308,83,225,2,12,9,3,43,35,1,7,0,3
E33040866,335,257,47,210,5,16,7,9,57,52,1,3,1,0
E33040867,313,216,36,180,4,22,6,16,70,55,0,8,7,1
E33040868,556,422,94,328,5,48,30,18,78,67,2,7,2,3
E33040869,409,261,61,200,4,40,22,18,102,89,2,9,2,2
E33040870,1783,1271,278,993,9,221,157,64,272,230,24,8,10,10
E33040871,475,295,84,211,4,60,31,29,113,105,0,6,2,3
E33040872,240,146,37,109,2,41,31,10,50,43,0,7,0,1
E33040873,546,313,81,232,3,92,74,18,136,122,1,10,3,2
E33040874,346,198,47,151,9,83,64,19,49,41,1,7,0,7
E33040875,372,264,51,213,7,34,11,23,65,52,5,5,3,2
E33040876,462,312,76,236,3,45,26,19,99,84,0,12,3,3
E33040877,548,436,132,304,4,24,19,5,79,70,1,8,0,5
E33040878,345,278,61,217,2,21,10,11,42,36,0,6,0,2
E33040879,499,386,87,299,12,37,19,18,61,52,1,5,3,3
E33040880,392,256,65,191,5,30,12,18,99,87,1,10,1,2
E33040881,407,259,59,200,7,42,25,17,97,85,2,7,3,2
E33040882,336,238,62,176,6,33,15,18,57,49,3,5,0,2
E33040883,270,146,41,105,4,50,23,27,69,61,2,6,0,1
E33040884,244,129,27,102,4,31,17,14,78,70,1,7,0,2
E33040885,399,278,50,228,0,37,20,17,83,75,0,6,2,1
E33040886,231,113,25,88,1,59,34,25,57,52,1,3,1,1
E33040887,516,336,98,238,2,71,49,22,96,77,10,2,7,11
E33040888,375,230,63,167,3,95,72,23,47,39,1,7,0,0
E33040889,469,318,94,224,2,44,34,10,102,98,1,3,0,3
E33040890,407,213,53,160,2,57,33,24,131,114,2,12,3,4
E33040891,381,241,72,169,7,65,46,19,64,59,1,4,0,4
E33040892,839,410,113,297,13,172,94,78,236,217,3,11,5,8
E33040893,329,182,50,132,5,88,72,16,52,45,3,2,2,2
E33040894,1743,1312,351,961,14,109,78,31,300,259,10,20,11,8
E33040895,620,320,92,228,8,145,104,41,144,133,2,9,0,3
E33040896,1778,1134,238,896,28,203,123,80,405,195,133,10,67,8
E33040897,456,341,78,263,2,34,16,18,75,68,1,6,0,4
E33040898,406,313,66,247,2,11,6,5,74,59,1,10,4,6
E33040899,1858,1395,367,1028,14,123,60,63,315,283,3,26,3,11
E33040900,347,251,86,165,4,24,13,11,66,58,1,7,0,2
E33040901,291,174,60,114,3,55,47,8,54,47,1,4,2,5
E33040902,1203,772,221,551,19,107,90,17,298,276,5,14,3,7
E33040903,325,141,33,108,4,41,23,18,136,128,5,3,0,3
E33040904,471,285,67,218,8,70,40,30,105,92,0,12,1,3
E33040905,296,163,47,116,0,71,61,10,61,52,1,2,6,1
E33040906,410,164,36,128,3,126,104,22,114,107,3,3,1,3
E33040907,250,170,46,124,0,17,13,4,61,54,3,3,1,2
E33040908,284,182,45,137,3,16,6,10,82,73,2,6,1,1
E33040909,524,334,88,246,1,27,9,18,155,148,0,7,0,7
E33040910,281,164,53,111,2,21,9,12,93,83,0,9,1,1
E33040911,430,255,58,197,3,37,21,16,131,117,6,8,0,4
E33040912,300,163,46,117,3,15,7,8,112,109,1,2,0,7
E33040913,524,260,73,187,6,67,37,30,188,168,3,17,0,3
E33040914,358,230,65,165,6,18,9,9,104,99,1,3,1,0
E33040915,313,218,48,170,1,22,8,14,70,58,4,6,2,2
E33040916,314,211,53,158,1,26,14,12,73,65,1,7,0,3
E33040917,267,183,62,121,1,25,12,13,52,45,0,4,3,6
E33040918,407,295,75,220,2,22,7,15,86,79,0,6,1,2
E33040919,284,193,64,129,1,23,9,14,62,54,1,7,0,5
E33040920,371,204,54,150,2,41,27,14,122,110,1,5,6,2
E33040921,651,450,140,310,3,37,18,19,159,141,4,11,3,2
E33040922,395,239,57,182,5,41,22,19,106,101,3,2,0,4
E33040923,300,147,53,94,3,32,15,17,115,104,5,4,2,3
E33040924,374,235,62,173,0,6,6,0,132,116,2,12,2,1
E33040925,434,299,78,221,2,21,10,11,100,93,1,4,2,12
E33040926,556,329,121,208,3,41,23,18,179,133,25,4,17,4
E33040927,340,156,38,118,5,40,20,20,135,119,2,9,5,4
E33040928,784,475,130,345,4,58,26,32,240,219,4,13,4,7
E33040929,792,531,150,381,7,56,30,26,184,147,20,9,8,14
E33040930,422,226,64,162,4,28,15,13,160,149,0,8,3,4
E33040931,285,148,39,109,10,24,17,7,100,93,0,7,0,3
E33040932,248,164,50,114,6,12,7,5,59,48,6,4,1,7
E33040933,473,266,70,196,2,37,27,10,163,144,2,13,4,5
E33040934,471,286,107,179,4,43,24,19,133,120,1,8,4,5
E33040935,396,256,66,190,8,30,17,13,97,89,4,4,0,5
E33040936,269,162,58,104,2,30,20,10,74,71,1,1,1,1
E33040937,511,279,82,197,7,47,20,27,168,150,4,10,4,10
E33040938,464,267,75,192,6,94,81,13,95,90,1,4,0,2
E33040939,287,187,71,116,1,18,9,9,78,65,1,5,7,3
E33040940,386,298,74,224,1,18,10,8,67,63,2,2,0,2
E33040941,581,437,106,331,7,69,56,13,63,56,0,7,0,5
E33040942,1200,887,213,674,13,108,76,32,181,167,4,7,3,11
E33040943,264,184,43,141,1,27,20,7,51,44,0,5,2,1
E33040944,290,169,37,132,5,74,13,61,38,31,0,4,3,4
E33040945,284,178,58,120,3,36,14,22,66,56,6,3,1,1
E33040946,1197,733,204,529,12,286,212,74,156,146,1,9,0,10
E33040947,366,154,43,111,4,62,49,13,141,131,4,5,1,5
E33040948,383,185,51,134,3,72,67,5,122,116,0,4,2,1
E33040949,276,141,42,99,2,44,33,11,87,84,1,2,0,2
E33040950,301,204,67,137,0,52,37,15,44,40,0,4,0,1
E33040951,474,310,76,234,4,67,39,28,90,81,4,5,0,3
E33040952,300,172,59,113,2,39,24,15,84,79,3,2,0,3
E33040953,324,235,83,152,5,37,30,7,44,41,1,2,0,3
E33040954,261,173,55,118,1,16,11,5,69,65,1,3,0,2
E33040955,321,202,58,144,3,66,53,13,49,44,1,4,0,1
E33040956,507,383,105,278,3,62,48,14,58,54,0,4,0,1
E33040957,333,240,66,174,3,53,34,19,36,32,0,4,0,1
E33040958,351,222,52,170,4,54,44,10,70,64,0,5,1,1
E33040959,704,565,152,413,8,46,35,11,84,74,3,7,0,1
E33040960,4567,2890,860,2030,32,172,97,75,1444,1362,9,62,11,29
E33040961,312,190,62,128,2,38,22,16,75,71,1,3,0,7
E33040962,309,201,73,128,1,27,14,13,78,76,0,2,0,2
E33040963,394,202,45,157,6,79,50,29,106,96,0,4,6,1
E33040964,316,165,39,126,3,69,43,26,77,73,1,3,0,2
E33040965,619,385,110,275,5,116,86,30,109,95,0,10,4,4
E33040966,563,310,94,216,5,141,117,24,103,93,2,8,0,4
E33040967,322,218,65,153,1,43,28,15,58,50,3,2,3,2
E33040968,279,207,60,147,2,20,11,9,47,44,1,2,0,3
E33040969,223,148,42,106,1,17,12,5,56,51,0,3,2,1
E33040970,435,241,66,175,5,43,27,16,143,135,1,5,2,3
E33040971,362,283,72,211,1,19,10,9,57,55,0,2,0,2
E33040972,372,292,95,197,3,8,4,4,62,54,4,4,0,7
E33040973,832,603,167,436,5,91,64,27,127,116,2,9,0,6
E33040974,454,290,78,212,2,120,96,24,36,30,0,6,0,6
E33040975,467,241,60,181,3,164,148,16,52,47,0,5,0,7
E33040976,418,222,72,150,1,40,21,19,152,147,0,3,2,3
E33040977,330,168,41,127,5,55,19,36,101,97,0,3,1,1
E33040978,280,140,46,94,1,44,28,16,92,88,2,2,0,3
E33040979,405,305,76,229,3,18,13,5,71,70,0,0,1,8
E33040980,638,385,96,289,2,91,51,40,157,151,2,3,1,3
E33040981,327,248,75,173,4,26,12,14,49,46,1,2,0,0
E33040982,522,312,84,228,5,51,27,24,150,141,4,4,1,4
E33040983,270,175,39,136,5,27,19,8,60,56,0,2,2,3
E33040984,784,438,139,299,8,211,158,53,123,118,1,4,0,4
E33040985,415,307,98,209,3,34,26,8,69,62,0,7,0,2
E33040986,420,246,62,184,3,65,38,27,102,98,0,4,0,4
E33040987,821,584,148,436,10,122,82,40,102,94,1,6,1,3
E33040988,361,179,52,127,5,80,59,21,96,92,0,3,1,1
E33040989,307,184,46,138,3,32,19,13,87,82,0,3,2,1
E33040990,460,299,73,226,8,88,73,15,62,56,0,6,0,3
E33040991,545,381,100,281,5,69,55,14,82,70,1,8,3,8
E33040992,333,238,55,183,1,40,33,7,52,50,1,1,0,2
E33040993,263,131,31,100,2,28,10,18,99,89,0,9,1,3
E33040994,357,199,53,146,5,44,27,17,105,97,2,3,3,4
E33040995,477,321,82,239,10,45,26,19,96,89,1,5,1,5
E33040996,425,183,59,124,4,47,34,13,187,183,1,3,0,4
E33040997,689,394,101,293,8,95,46,49,187,181,0,6,0,5
E33040998,903,627,157,470,20,138,105,33,116,107,0,9,0,2
E33040999,310,165,37,128,2,97,85,12,41,34,0,7,0,5
E33041000,227,135,42,93,2,36,29,7,53,49,0,4,0,1
E33041001,738,448,113,335,12,115,86,29,161,144,7,6,4,2
E33041002,381,226,60,166,4,87,70,17,63,57,0,4,2,1
E33041003,309,175,53,122,4,26,19,7,101,94,3,4,0,3
E33041004,268,169,42,127,3,12,3,9,82,73,0,9,0,2
E33041005,327,160,37,123,2,29,11,18,134,130,0,2,2,2
E33041006,438,239,55,184,0,27,13,14,164,155,1,7,1,8
E33041007,394,280,69,211,8,23,10,13,82,71,2,8,1,1
E33041008,402,218,59,159,4,70,51,19,107,100,2,5,0,3
E33041009,304,192,66,126,1,30,21,9,80,76,1,2,1,1
E33041010,267,177,64,113,3,21,11,10,63,54,3,4,2,3
E33041011,340,225,56,169,2,31,11,20,80,74,0,5,1,2
E33041012,749,522,153,369,15,69,47,22,138,124,4,9,1,5
E33041013,458,290,73,217,5,49,30,19,111,106,0,5,0,3
E33041014,580,341,69,272,5,96,65,31,133,125,0,8,0,5
E33041015,1116,676,192,484,12,129,64,65,297,275,5,15,2,2
E33041016,391,227,53,174,4,71,37,34,85,79,0,6,0,4
E33041017,265,137,38,99,1,41,26,15,86,82,2,0,2,0
E33041018,732,431,73,358,8,76,41,35,213,201,4,5,3,4
E33041019,340,162,52,110,1,70,35,35,101,98,0,3,0,6
E33041020,441,223,50,173,7,37,13,24,173,166,0,5,2,1
E33041021,366,251,68,183,1,24,11,13,82,76,0,5,1,8
E33041022,269,111,36,75,4,41,29,12,110,108,0,0,2,3
E33041023,354,189,45,144,6,29,15,14,129,123,1,3,2,1
E33041024,372,286,79,207,1,23,15,8,61,57,0,4,0,1
E33041025,392,254,50,204,3,49,32,17,84,82,0,2,0,2
E33041026,332,254,69,185,6,30,20,10,42,38,1,2,1,0
E33041027,397,269,74,195,7,88,75,13,29,25,1,3,0,4
E33041028,438,218,53,165,4,182,158,24,32,25,0,5,2,2
E33041029,345,224,63,161,2,69,61,8,48,43,0,3,2,2
E33041030,548,451,101,350,5,32,15,17,59,50,1,7,1,1
E33041031,471,330,80,250,5,68,42,26,66,56,0,10,0,2
E33041032,440,350,98,252,14,16,11,5,57,54,0,3,0,3
E33041033,292,139,34,105,5,121,103,18,23,18,2,3,0,4
E33041034,387,246,43,203,12,78,66,12,50,42,1,3,4,1
E33041035,329,217,40,177,2,68,56,12,40,36,0,3,1,2
E33041036,907,609,148,461,8,111,76,35,176,162,2,10,2,3
E33041037,501,353,72,281,6,62,40,22,75,69,0,4,2,5
E33041038,365,280,55,225,1,23,15,8,60,56,0,3,1,1
E33041039,590,356,119,237,17,58,35,23,151,140,4,7,0,8
E33041040,861,604,183,421,0,35,17,18,217,203,0,13,1,5
E33041041,415,232,50,182,10,85,61,24,85,75,0,10,0,3
E33041042,960,632,194,438,13,160,109,51,150,141,1,7,1,5
E33041043,996,678,144,534,13,56,33,23,227,210,2,14,1,22
E33041044,251,104,25,79,1,31,19,12,111,110,0,0,1,4
E33041045,495,322,78,244,5,36,19,17,128,119,2,6,1,4
E33041046,567,402,81,321,5,45,33,12,109,101,0,6,2,6
E33041047,470,247,56,191,5,55,35,20,159,155,1,3,0,4
E33041048,405,210,52,158,1,99,75,24,94,91,0,3,0,1
E33041049,300,181,43,138,3,22,13,9,93,88,0,5,0,1
E33041050,587,413,105,308,3,52,31,21,116,114,0,2,0,3
E33041051,392,201,60,141,7,48,31,17,133,129,1,3,0,3
E33041052,314,200,55,145,1,26,21,5,84,78,0,5,1,3
E33041053,640,386,95,291,8,61,30,31,184,169,2,9,4,1
E33041054,287,192,52,140,1,46,27,19,48,44,0,3,1,0
E33041055,376,279,59,220,1,32,26,6,62,45,4,12,1,2
E33041056,286,226,56,170,2,30,18,12,26,23,0,3,0,2
E33041057,519,378,83,295,7,59,29,30,74,68,0,6,0,1
E33041058,330,238,54,184,3,23,15,8,64,57,0,7,0,2
E33041059,354,256,72,184,3,31,13,18,59,58,0,1,0,5
E33041060,425,266,87,179,0,76,48,28,78,75,0,1,2,5
E33041061,336,232,70,162,4,42,25,17,55,47,2,5,1,3
E33041062,452,273,90,183,0,85,41,44,89,82,2,4,1,5
E33041063,462,244,44,200,3,162,138,24,47,43,1,3,0,6
E33041064,291,167,42,125,5,78,68,10,39,37,0,2,0,2
E33041065,375,272,91,181,4,14,0,14,83,75,3,4,1,2
E33041066,275,190,68,122,1,18,3,15,64,58,1,4,1,2
E33041067,502,364,108,256,1,34,3,31,98,89,1,8,0,5
E33041068,273,196,60,136,2,16,1,15,55,49,0,3,3,4
E33041069,296,209,82,127,0,12,0,12,65,57,4,4,0,10
E33041070,355,247,65,182,1,18,0,18,84,78,0,6,0,5
E33041071,281,226,86,140,1,16,3,13,36,30,0,6,0,2
E33041072,283,203,59,144,0,24,4,20,53,51,1,1,0,3
E33041073,313,240,56,184,0,6,0,6,64,58,0,6,0,3
E33041074,519,430,168,262,4,7,0,7,70,59,0,11,0,8
E33041075,530,379,98,281,2,36,2,34,110,98,0,10,2,3
E33041076,274,192,72,120,2,43,6,37,35,32,2,1,0,2
E33041077,468,312,101,211,6,67,8,59,81,76,0,5,0,2
E33041078,259,195,73,122,0,12,1,11,49,44,1,3,1,3
E33041079,318,237,82,155,3,18,1,17,54,46,3,3,2,6
E33041080,234,163,63,100,1,8,1,7,55,49,0,6,0,7
E33041081,342,256,76,180,1,15,0,15,65,60,0,5,0,5
E33041082,225,160,41,119,3,8,3,5,48,42,2,4,0,6
E33041083,464,296,70,226,3,26,5,21,136,131,1,4,0,3
E33041084,304,211,63,148,2,26,2,24,64,56,1,5,2,1
E33041085,245,191,78,113,0,10,0,10,42,36,4,2,0,2
E33041086,293,233,77,156,0,14,0,14,46,41,0,3,2,0
E33041087,239,176,84,92,2,8,1,7,49,43,2,3,1,4
E33041088,543,362,130,232,15,39,3,36,118,104,5,9,0,9
E33041089,331,255,68,187,3,19,0,19,51,48,0,3,0,3
E33041090,363,240,98,142,4,37,4,33,78,69,1,7,1,4
E33041091,279,191,62,129,3,21,1,20,63,55,0,8,0,1
E33041092,281,200,69,131,1,13,4,9,64,51,3,5,5,3
E33041093,308,228,68,160,1,20,1,19,57,49,0,6,2,2
E33041094,311,243,62,181,4,12,0,12,52,47,0,5,0,0
E33041095,268,198,57,141,0,19,2,17,50,40,0,10,0,1
E33041096,550,369,140,229,6,40,4,36,130,118,0,10,2,5
E33041097,407,270,101,169,4,59,7,52,69,67,0,2,0,5
E33041098,359,271,87,184,1,31,4,27,55,49,1,5,0,1
E33041099,724,516,181,335,6,52,4,48,144,126,0,16,2,6
E33041100,337,223,63,160,3,52,4,48,57,52,2,3,0,2
E33041101,404,248,63,185,2,59,12,47,94,87,0,7,0,1
E33041102,419,312,69,243,0,15,3,12,85,77,0,3,5,7
E33041103,364,301,120,181,2,14,0,14,46,41,0,4,1,1
E33041104,3270,2554,697,1857,40,143,19,124,519,479,6,31,3,14
E33041105,814,623,162,461,14,38,3,35,137,117,1,16,3,2
E33041106,294,220,64,156,0,17,0,17,57,51,0,6,0,0
E33041107,453,315,90,225,4,36,4,32,97,87,3,7,0,1
E33041108,395,269,85,184,1,23,4,19,101,88,1,11,1,1
E33041109,343,264,109,155,0,13,2,11,62,55,4,3,0,4
E33041110,340,243,104,139,2,20,1,19,70,62,1,5,2,5
E33041111,247,207,89,118,0,5,0,5,33,27,2,4,0,2
E33041112,485,370,180,190,5,19,4,15,80,77,1,2,0,11
E33041113,271,204,73,131,1,9,3,6,55,52,1,2,0,2
E33041114,272,212,71,141,3,9,0,9,45,41,0,3,1,3
E33041115,242,156,62,94,1,10,0,10,68,62,3,3,0,7
E33041116,300,226,69,157,2,22,1,21,47,44,0,3,0,3
E33041117,446,334,118,216,3,26,1,25,80,74,0,3,3,3
E33041118,619,476,139,337,5,27,2,25,105,89,1,15,0,6
E33041119,555,429,129,300,2,33,8,25,88,79,0,9,0,3
E33041120,280,206,50,156,0,29,5,24,45,39,0,6,0,0
E33041121,418,286,88,198,1,50,5,45,74,66,1,7,0,7
E33041122,503,331,125,206,5,44,5,39,114,95,9,9,1,9
E33041123,452,281,135,146,6,54,3,51,105,98,0,3,4,6
E33041124,371,260,105,155,3,31,2,29,74,64,0,9,1,3
E33041125,472,347,150,197,2,43,4,39,72,64,1,7,0,8
E33041126,321,245,112,133,1,29,2,27,39,34,1,3,1,7
E33041127,245,170,73,97,1,33,2,31,38,31,1,3,3,3
E33041128,283,180,74,106,3,21,0,21,74,58,2,10,4,5
E33041129,550,372,163,209,5,51,2,49,114,105,1,6,2,8
E33041130,301,247,105,142,1,19,0,19,25,19,1,1,4,9
E33041131,269,202,98,104,4,14,2,12,44,31,4,6,3,5
E33041132,441,306,103,203,2,49,24,25,80,74,0,3,3,4
E33041133,391,294,134,160,4,19,2,17,61,49,4,5,3,13
E33041134,337,276,99,177,3,10,1,9,47,39,2,6,0,1
E33041135,517,398,144,254,1,38,1,37,79,71,1,7,0,1
E33041136,493,317,108,209,7,43,1,42,123,111,2,9,1,3
E33041137,585,384,140,244,3,46,4,42,148,134,0,13,1,4
E33041138,605,424,150,274,15,61,5,56,99,86,3,7,3,6
E33041139,382,300,100,200,5,24,0,24,48,44,1,3,0,5
E33041140,460,317,90,227,7,30,3,27,101,96,0,5,0,5
E33041141,298,242,96,146,1,13,3,10,38,32,0,6,0,4
E33041142,641,454,167,287,7,48,1,47,129,122,0,7,0,3
E33041143,551,458,147,311,1,22,4,18,68,61,1,6,0,2
E33041144,278,212,72,140,1,15,2,13,49,47,0,2,0,1
E33041145,312,261,99,162,1,12,0,12,36,29,2,5,0,2
E33041146,319,242,74,168,2,30,2,28,43,33,1,8,1,2
E33041147,364,235,85,150,1,26,3,23,93,87,0,6,0,9
E33041148,254,170,57,113,2,29,0,29,51,42,0,9,0,2
E33041149,307,235,81,154,1,21,3,18,47,44,0,3,0,3
E33041150,330,219,83,136,1,19,2,17,90,86,1,3,0,1
E33041151,316,220,84,136,2,21,4,17,70,62,0,8,0,3
E33041152,353,221,91,130,3,25,2,23,100,96,0,4,0,4
E33041153,605,450,206,244,2,46,8,38,95,87,3,2,3,12
E33041154,418,327,141,186,5,11,0,11,66,56,2,8,0,9
E33041155,397,304,136,168,1,25,1,24,62,53,2,6,1,5
E33041156,275,201,70,131,1,22,1,21,38,35,0,2,1,13
E33041157,530,351,131,220,4,38,3,35,130,113,0,11,6,7
E33041158,222,157,64,93,0,13,1,12,48,39,1,8,0,4
E33041159,300,230,101,129,1,32,5,27,36,29,0,6,1,1
E33041160,325,249,127,122,2,19,2,17,50,44,0,4,2,5
E33041161,363,252,99,153,4,32,2,30,73,60,7,6,0,2
E33041162,248,194,71,123,5,15,8,7,31,30,1,0,0,3
E33041163,355,247,58,189,4,29,10,19,72,68,2,2,0,3
E33041164,582,386,106,280,9,57,22,35,129,121,2,6,0,1
E33041165,684,494,152,342,8,50,8,42,107,89,12,5,1,25
E33041166,565,433,98,335,7,39,11,28,79,73,1,5,0,7
E33041167,262,201,69,132,5,12,5,7,36,33,0,2,1,8
E33041168,335,253,87,166,3,22,5,17,51,48,0,2,1,6
E33041169,419,333,86,247,8,18,8,10,59,56,1,2,0,1
E33041170,521,421,121,300,6,25,7,18,66,59,0,7,0,3
E33041171,639,474,168,306,7,41,14,27,112,97,5,10,0,5
E33041172,295,200,58,142,2,53,15,38,33,28,2,3,0,7
E33041173,266,210,62,148,6,24,9,15,21,18,0,3,0,5
E33041174,635,511,138,373,10,38,18,20,66,55,2,9,0,10
E33041175,285,241,78,163,0,14,8,6,25,22,1,2,0,5
E33041176,443,327,93,234,8,32,7,25,71,66,2,3,0,5
E33041177,551,432,122,310,15,36,11,25,66,56,0,7,3,2
E33041178,385,294,95,199,5,37,10,27,43,37,1,1,4,6
E33041179,358,276,75,201,1,23,6,17,44,38,4,2,0,14
E33041180,289,210,69,141,0,27,5,22,40,38,0,0,2,12
E33041181,611,479,92,387,3,59,14,45,68,57,2,6,3,2
E33041182,374,282,87,195,5,20,5,15,63,47,10,4,2,4
E33041183,396,317,82,235,1,35,9,26,37,33,0,4,0,6
E33041184,380,286,99,187,2,29,13,16,49,43,0,5,1,14
E33041185,261,200,97,103,1,18,7,11,33,29,0,4,0,9
E33041186,293,204,61,143,6,25,6,19,56,48,1,5,2,2
E33041187,352,270,95,175,5,43,18,25,33,30,1,2,0,1
E33041188,326,250,80,170,1,34,13,21,36,33,1,2,0,5
E33041189,280,211,66,145,0,10,1,9,36,29,3,2,2,23
E33041190,262,204,59,145,7,24,11,13,25,22,0,3,0,2
E33041191,392,298,93,205,8,43,18,25,40,37,2,1,0,3
E33041192,396,234,73,161,16,60,33,27,79,72,0,6,1,7
E33041193,366,295,98,197,1,21,10,11,45,36,1,7,1,4
E33041194,550,399,139,260,3,33,11,22,93,70,13,5,5,22
E33041195,505,355,108,247,6,47,16,31,96,84,1,7,4,1
E33041196,248,179,40,139,1,30,16,14,32,27,0,5,0,6
E33041197,630,460,122,338,11,62,14,48,88,72,1,13,2,9
E33041198,241,178,45,133,1,16,7,9,36,33,1,1,1,10
E33041199,461,354,125,229,3,41,17,24,56,52,0,2,2,7
E33041200,273,199,68,131,0,28,10,18,43,33,3,4,3,3
E33041201,303,216,56,160,7,26,7,19,50,44,1,4,1,4
E33041202,304,200,43,157,6,51,5,46,37,33,0,3,1,10
E33041203,467,297,103,194,5,33,3,30,112,82,20,8,2,20
E33041204,415,285,77,208,1,48,15,33,75,65,2,5,3,6
E33041205,328,227,74,153,2,28,6,22,55,48,6,1,0,16
E33041206,344,241,86,155,2,28,10,18,62,55,4,1,2,11
E33041207,366,293,116,177,3,30,9,21,30,27,0,3,0,10
E33041208,357,287,101,186,0,24,10,14,39,31,2,4,2,7
E33041209,367,273,90,183,4,45,16,29,43,34,3,2,4,2
E33041210,487,383,130,253,9,47,17,30,47,43,1,3,0,1
E33041211,410,330,89,241,1,34,9,25,39,36,1,1,1,6
E33041212,261,198,69,129,2,16,7,9,42,33,5,3,1,3
E33041213,295,264,91,173,2,3,2,1,24,22,0,1,1,2
E33041214,318,257,93,164,1,17,5,12,38,34,1,2,1,5
E33041215,379,260,93,167,3,28,8,20,78,66,7,3,2,10
E33041216,257,185,56,129,0,17,4,13,49,38,10,0,1,6
E33041217,712,533,147,386,9,59,18,41,105,93,2,8,2,6
E33041218,428,331,120,211,4,31,11,20,57,50,2,2,3,5
E33041219,561,454,103,351,11,35,7,28,56,48,4,2,2,5
E33041220,349,238,41,197,5,39,7,32,67,62,0,4,1,0
E33041221,548,373,102,271,5,62,12,50,105,97,5,3,0,3
E33041222,630,412,84,328,4,130,43,87,82,69,2,8,3,2
E33041223,416,295,69,226,5,60,27,33,54,50,1,3,0,2
E33041224,704,495,135,360,12,62,14,48,130,116,0,11,3,5
E33041225,625,448,109,339,6,87,27,60,82,70,4,7,1,2
E33041226,668,472,119,353,6,78,22,56,107,94,0,12,1,5
E33041227,720,496,145,351,8,86,26,60,129,116,2,9,2,1
E33041228,471,379,110,269,3,24,9,15,64,56,1,6,1,1
E33041229,556,373,89,284,9,67,19,48,104,101,1,2,0,3
E33041230,506,325,96,229,5,80,18,62,90,82,2,4,2,6
E33041231,393,291,70,221,9,43,10,33,49,44,0,5,0,1
E33041232,250,193,45,148,4,19,5,14,32,27,1,2,2,2
E33041233,913,705,176,529,22,54,15,39,127,117,0,10,0,5
E33041234,565,390,96,294,5,49,14,35,117,111,0,3,3,4
E33041235,349,244,86,158,7,29,5,24,66,59,3,4,0,3
E33041236,605,437,83,354,6,34,6,28,124,117,0,5,2,4
E33041237,822,606,138,468,12,87,23,64,113,104,6,2,1,4
E33041238,313,220,29,191,3,21,4,17,68,63,0,4,1,1
E33041239,290,198,40,158,3,37,15,22,50,41,0,9,0,2
E33041240,269,211,70,141,2,18,6,12,33,24,7,0,2,5
E33041241,439,375,121,254,2,15,3,12,43,40,0,3,0,4
E33041242,311,268,62,206,1,4,2,2,38,35,2,1,0,0
E33041243,419,370,96,274,0,9,4,5,38,34,2,2,0,2
E33041244,356,222,51,171,2,88,32,56,41,38,0,3,0,3
E33041245,723,505,133,372,12,95,42,53,105,96,3,6,0,6
E33041246,337,216,52,164,6,60,20,40,55,50,1,4,0,0
E33041247,400,360,99,261,2,10,5,5,26,22,0,3,1,2
E33041248,371,266,68,198,3,23,5,18,76,71,0,5,0,3
E33041249,3526,2519,648,1871,58,377,106,271,553,496,12,28,17,19
E33041250,296,207,59,148,5,47,9,38,36,28,0,7,1,1
E33041251,242,188,43,145,1,18,4,14,33,33,0,0,0,2
E33041252,606,401,83,318,6,92,29,63,98,92,3,3,0,9
E33041253,430,337,108,229,4,35,6,29,51,35,10,5,1,3
E33041254,265,185,70,115,1,25,10,15,53,45,3,5,0,1
E33041255,351,274,90,184,4,29,8,21,42,35,1,2,4,2
E33041256,707,550,155,395,2,47,14,33,106,91,2,11,2,2
E33041257,289,227,49,178,6,17,6,11,36,32,2,1,1,3
E33041258,617,443,144,299,7,65,25,40,101,95,1,3,2,1
E33041259,253,188,59,129,0,27,10,17,36,27,3,4,2,2
E33041260,289,237,66,171,3,9,2,7,36,25,6,2,3,4
E33041261,236,195,51,144,1,6,2,4,32,29,2,1,0,2
E33041262,249,181,44,137,3,34,13,21,27,19,4,3,1,4
E33041263,1053,796,193,603,18,73,20,53,165,153,1,9,2,1
E33041264,343,267,94,173,2,14,0,14,50,46,2,2,0,10
E33041265,673,509,143,366,9,45,16,29,106,96,0,10,0,4
E33041266,364,273,87,186,1,49,12,37,39,35,3,1,0,2
E33041267,260,190,79,111,0,16,4,12,40,35,3,2,0,14
E33041268,387,303,109,194,1,25,11,14,45,37,3,5,0,13
E33041269,578,445,154,291,4,46,13,33,75,66,1,4,4,8
E33041270,275,216,65,151,2,22,11,11,33,25,2,2,4,2
E33041271,249,177,53,124,0,22,4,18,49,42,4,3,0,1
E33041272,325,239,70,169,9,24,8,16,47,41,0,6,0,6
E33041273,246,187,62,125,0,25,9,16,31,27,4,0,0,3
E33041274,373,286,84,202,1,32,10,22,45,42,2,1,0,9
E33041275,286,231,50,181,2,16,2,14,36,27,6,1,2,1
E33041276,282,218,63,155,3,27,8,19,32,30,1,0,1,2
E33041277,545,375,119,256,4,93,25,68,70,56,8,2,4,3
E33041278,611,427,121,306,4,78,23,55,87,61,17,4,5,15
E33041279,435,322,88,234,4,44,11,33,64,40,11,5,8,1
E33041280,413,337,137,200,0,24,1,23,44,38,2,4,0,8
E33041281,307,242,103,139,3,26,6,20,33,24,5,1,3,3
E33041282,336,254,98,156,4,34,13,21,41,29,3,7,2,3
E33041283,355,265,101,164,3,39,14,25,39,35,3,1,0,9
E33041284,310,251,135,116,3,31,6,25,17,16,0,1,0,8
E33041285,356,270,123,147,2,36,6,30,44,37,3,4,0,4
E33041286,518,361,125,236,5,67,28,39,82,78,3,1,0,3
E33041287,299,204,66,138,1,52,13,39,41,34,0,7,0,1
E33041288,397,265,81,184,6,60,15,45,61,57,0,3,1,5
E33041289,413,289,88,201,1,91,10,81,32,27,0,4,1,0
E33041290,301,249,79,170,4,25,6,19,23,20,0,2,1,0
E33041291,671,448,152,296,14,139,29,110,64,56,0,7,1,6
E33041292,289,227,60,167,5,24,4,20,32,27,0,4,1,1
E33041293,282,244,74,170,4,16,7,9,15,13,0,1,1,3
E33041294,437,365,122,243,2,20,3,17,47,41,2,3,1,3
E33041295,254,183,69,114,1,33,8,25,36,33,0,3,0,1
E33041296,241,173,55,118,1,33,13,20,31,28,0,3,0,3
E33041297,456,308,114,194,5,79,26,53,61,57,0,3,1,3
E33041298,455,304,80,224,6,66,17,49,77,73,1,3,0,2
E33041299,319,193,63,130,7,77,9,68,39,35,0,3,1,3
E33041300,308,212,76,136,5,41,9,32,44,39,2,3,0,6
E33041301,292,201,67,134,2,56,10,46,29,27,0,2,0,4
E33041302,431,350,100,250,3,27,6,21,49,40,0,4,5,2
E33041303,355,287,112,175,1,26,4,22,38,32,6,0,0,3
E33041304,386,295,97,198,3,60,10,50,22,17,3,1,1,6
E33041305,391,294,96,198,4,36,13,23,54,49,3,2,0,3
E33041306,331,251,92,159,3,23,12,11,46,34,12,0,0,8
E33041307,283,242,90,152,1,17,9,8,21,20,1,0,0,2
E33041308,287,241,90,151,1,14,6,8,22,15,5,1,1,9
E33041309,420,295,108,187,5,45,8,37,72,71,0,1,0,3
E33041310,257,221,108,113,2,20,4,16,11,11,0,0,0,3
E33041311,370,219,76,143,2,81,14,67,68,60,5,1,2,0
E33041312,335,212,81,131,2,65,10,55,52,49,0,2,1,4
E33041313,272,231,75,156,2,11,1,10,24,20,4,0,0,4
E33041314,265,206,67,139,3,26,6,20,28,20,2,6,0,2
E33041315,222,186,72,114,1,9,1,8,18,14,0,4,0,8
E33041316,249,197,80,117,2,12,4,8,33,29,0,4,0,5
E33041317,256,188,68,120,4,18,5,13,39,34,1,4,0,7
E33041318,296,229,76,153,1,17,2,15,49,49,0,0,0,0
E33041319,491,391,128,263,13,27,5,22,58,50,2,4,2,2
E33041320,1096,814,289,525,14,105,19,86,158,147,5,5,1,5
E33041321,428,278,92,186,9,69,17,52,63,57,2,4,0,9
E33041322,610,481,164,317,5,17,7,10,93,88,2,3,0,14
E33041323,314,259,99,160,16,12,1,11,26,26,0,0,0,1
E33041324,325,235,76,159,5,59,9,50,25,24,0,0,1,1
E33041325,523,371,93,278,11,49,12,37,90,85,2,3,0,2
E33041326,365,311,104,207,6,10,4,6,35,33,1,1,0,3
E33041327,256,216,81,135,1,14,4,10,19,15,1,3,0,6
E33041328,334,285,110,175,1,6,1,5,39,38,0,1,0,3
E33041329,327,240,100,140,2,32,5,27,42,35,1,1,5,11
E33041330,596,443,114,329,7,32,12,20,102,94,4,4,0,12
E33041331,514,420,158,262,11,41,11,30,38,34,1,1,2,4
E33041332,458,338,111,227,9,39,10,29,69,61,4,3,1,3
E33041333,570,423,132,291,8,45,9,36,89,76,5,7,1,5
E33041334,494,345,126,219,7,18,6,12,122,117,1,3,1,2
E33041335,273,159,61,98,1,22,9,13,85,81,1,3,0,6
E33041336,300,258,91,167,4,12,1,11,26,22,2,2,0,0
E33041337,562,353,119,234,6,54,18,36,145,106,35,0,4,4
E33041338,299,238,75,163,2,11,4,7,43,35,6,2,0,5
E33041339,263,185,68,117,6,37,10,27,33,29,2,1,1,2
E33041340,316,244,70,174,2,31,6,25,37,30,0,6,1,2
E33041341,465,348,115,233,4,57,8,49,52,45,4,2,1,4
E33041342,633,496,129,367,8,19,6,13,102,98,3,1,0,8
E33041343,238,209,75,134,2,10,1,9,15,12,1,1,1,2
E33041344,622,418,136,282,8,79,25,54,106,99,2,4,1,11
E33041345,278,235,97,138,0,14,2,12,26,26,0,0,0,3
E33041346,504,380,104,276,5,38,10,28,77,73,0,3,1,4
E33041347,486,401,138,263,4,22,8,14,57,51,2,3,1,2
E33041348,263,204,81,123,3,34,2,32,20,19,0,1,0,2
E33041349,348,219,66,153,2,57,23,34,66,64,0,2,0,4
E33041350,496,273,82,191,1,57,18,39,150,77,48,0,25,15
E33041351,211,151,69,82,1,20,4,16,38,33,0,3,2,1
E33041352,314,239,76,163,2,34,1,33,27,20,2,5,0,12
E33041353,424,329,85,244,8,23,13,10,58,54,1,3,0,6
E33041354,311,231,72,159,2,21,5,16,36,34,0,2,0,21
E33041355,423,359,109,250,2,6,2,4,54,33,14,5,2,2
E33041356,206,126,60,66,3,15,3,12,55,51,2,1,1,7
E33041357,527,350,118,232,13,51,13,38,107,91,12,4,0,6
E33041358,511,422,157,265,4,19,6,13,57,55,2,0,0,9
E33041359,649,427,121,306,9,72,26,46,132,126,2,4,0,9
E33041360,286,210,59,151,5,34,10,24,35,30,3,1,1,2
E33041361,782,625,196,429,6,68,26,42,81,78,2,1,0,2
E33041362,332,242,82,160,11,23,13,10,52,46,1,3,2,4
E33041363,1447,961,212,749,17,92,41,51,373,341,10,21,1,4
E33041364,360,239,57,182,1,40,18,22,70,65,0,3,2,10
E33041365,465,287,96,191,12,64,19,45,79,69,5,4,1,23
E33041366,250,198,68,130,1,12,1,11,32,30,1,1,0,7
E33041367,331,247,74,173,6,38,17,21,35,25,8,2,0,5
E33041368,224,159,53,106,3,13,5,8,46,33,12,0,1,3
E33041369,403,285,96,189,8,40,13,27,68,50,10,8,0,2
E33041370,490,329,119,210,3,44,17,27,102,94,4,3,1,12
E33041371,253,179,65,114,4,23,6,17,41,34,3,2,2,6
E33041372,331,269,92,177,3,21,4,17,33,26,5,2,0,5
E33041373,506,353,114,239,6,75,29,46,67,62,3,1,1,5
E33041374,408,249,78,171,2,27,16,11,126,108,14,4,0,4
E33041375,580,438,115,323,6,36,7,29,97,95,0,2,0,3
E33041376,512,357,116,241,16,50,20,30,83,79,2,1,1,6
E33041377,269,237,96,141,4,9,3,6,17,16,0,0,1,2
E33041378,516,370,100,270,9,26,4,22,97,92,0,5,0,14
E33041379,261,200,69,131,2,18,4,14,33,25,5,1,2,8
E33041380,688,424,131,293,6,78,27,51,176,161,6,8,1,4
E33041381,329,230,78,152,2,37,15,22,56,46,7,2,1,4
E33041382,455,303,135,168,4,50,13,37,91,77,5,7,2,7
E33041383,459,307,89,218,6,74,26,48,68,64,3,0,1,4
E33041384,660,477,121,356,9,64,18,46,103,89,4,5,5,7
E33041385,581,429,120,309,10,55,15,40,74,64,1,5,4,13
E33041386,419,309,79,230,9,44,13,31,53,47,1,2,3,4
E33041387,340,197,60,137,5,93,15,78,42,42,0,0,0,3
E33041388,303,232,63,169,8,32,3,29,27,21,1,4,1,4
E33041389,354,253,70,183,26,42,7,35,31,27,0,1,3,2
E33041390,278,211,66,145,2,29,9,20,35,34,0,1,0,1
E33041391,333,249,57,192,6,31,13,18,44,39,1,3,1,3
E33041392,448,329,109,220,10,55,13,42,51,43,1,4,3,3
E33041393,317,205,64,141,2,52,12,40,55,45,4,4,2,3
E33041394,429,341,84,257,2,30,14,16,54,53,0,0,1,2
E33041395,541,433,132,301,8,48,28,20,51,47,0,3,1,1
E33041396,325,235,98,137,1,47,25,22,40,34,1,5,0,2
E33041397,338,245,76,169,1,46,31,15,46,37,2,5,2,0
E33041398,322,252,78,174,2,19,13,6,44,41,2,1,0,5
E33041399,343,242,77,165,2,56,35,21,39,32,1,4,2,4
E33041400,265,208,75,133,2,27,14,13,27,21,0,3,3,1
E33041401,555,419,134,285,1,62,41,21,72,63,3,4,2,1
E33041402,256,200,69,131,2,12,3,9,37,32,1,3,1,5
E33041403,321,260,85,175,2,17,11,6,36,27,3,6,0,6
E33041404,251,199,74,125,2,13,2,11,29,21,5,1,2,8
E33041405,350,296,103,193,2,17,8,9,33,29,4,0,0,2
E33041406,460,353,114,239,6,23,16,7,68,31,23,2,12,10
E33041407,353,223,74,149,5,22,10,12,99,34,37,5,23,4
E33041408,288,245,84,161,1,9,4,5,28,24,0,3,1,5
E33041409,428,385,145,240,2,12,6,6,26,19,3,4,0,3
E33041410,355,311,98,213,5,9,4,5,29,25,3,1,0,1
E33041411,252,208,73,135,1,12,3,9,23,20,2,0,1,8
E33041412,645,489,142,347,2,66,37,29,72,51,14,4,3,16
E33041413,306,238,84,154,2,14,6,8,51,42,4,5,0,1
E33041414,234,193,70,123,1,15,10,5,24,23,0,1,0,1
E33041415,381,271,97,174,2,23,10,13,78,46,19,8,5,7
E33041416,237,162,59,103,0,17,9,8,54,47,4,2,1,4
E33041417,476,352,97,255,10,37,24,13,65,45,7,10,3,12
E33041418,478,298,105,193,4,80,40,40,94,86,4,3,1,2
E33041419,521,400,119,281,4,48,24,24,67,65,1,1,0,2
E33041420,385,319,110,209,2,12,10,2,51,51,0,0,0,1
E33041421,435,328,88,240,0,28,16,12,75,66,3,6,0,4
E33041422,421,288,59,229,7,65,50,15,54,48,2,2,2,7
E33041423,237,178,88,90,5,5,3,2,35,29,2,0,4,14
E33041424,264,199,84,115,1,15,9,6,42,35,2,2,3,7
E33041425,539,332,146,186,4,27,8,19,147,111,22,8,6,29
E33041426,2255,1198,315,883,12,112,39,73,914,277,402,7,228,19
E33041427,463,340,108,232,7,38,15,23,69,59,8,1,1,9
E33041428,230,165,73,92,0,12,7,5,36,30,4,2,0,17
E33041429,282,219,104,115,0,8,3,5,45,34,6,5,0,10
E33041430,351,283,84,199,2,33,18,15,25,24,1,0,0,8
E33041431,421,313,97,216,2,29,17,12,62,59,0,3,0,15
E33041432,417,269,65,204,5,30,7,23,113,108,1,3,1,0
E33041433,475,339,90,249,3,35,13,22,94,91,0,2,1,4
E33041434,501,369,117,252,3,27,17,10,101,77,18,2,4,1
E33041435,471,366,101,265,4,33,21,12,66,65,0,1,0,2
E33041436,381,334,93,241,4,17,13,4,25,25,0,0,0,1
E33041437,520,407,105,302,4,40,22,18,64,57,2,3,2,5
E33041438,313,286,99,187,2,6,2,4,15,13,1,0,1,4
E33041439,454,327,97,230,1,41,26,15,82,77,0,4,1,3
E33041440,310,198,35,163,7,14,6,8,88,80,1,5,2,3
E33041441,641,407,98,309,12,77,37,40,137,132,1,3,1,8
E33041442,355,220,64,156,20,63,31,32,44,32,6,6,0,8
E33041443,633,459,113,346,15,71,41,30,82,76,3,2,1,6
E33041444,303,195,43,152,3,22,8,14,80,80,0,0,0,3
E33041445,389,275,64,211,9,60,41,19,44,38,0,4,2,1
E33041446,755,527,165,362,5,81,43,38,135,121,0,11,3,7
E33041447,341,202,45,157,2,53,32,21,84,83,1,0,0,0
E33041448,519,345,89,256,5,51,19,32,116,105,5,4,2,2
E33041449,312,191,68,123,8,29,15,14,83,76,1,6,0,1
E33041450,376,238,66,172,3,60,53,7,74,67,1,4,2,1
E33041451,370,276,91,185,6,31,15,16,57,54,0,1,2,0
E33041452,780,522,112,410,13,156,92,64,83,66,3,12,2,6
E33041453,267,180,57,123,7,31,9,22,42,40,1,1,0,7
E33041454,518,382,122,260,8,33,15,18,91,83,2,5,1,4
E33041455,449,318,105,213,5,37,21,16,87,80,1,2,4,2
E33041456,397,265,66,199,7,33,18,15,90,81,1,3,5,2
E33041457,285,227,77,150,4,12,6,6,41,27,11,0,3,1
E33041458,446,306,88,218,9,56,27,29,70,59,1,8,2,5
E33041459,493,330,80,250,13,54,23,31,94,83,2,4,5,2
E33041460,554,395,101,294,8,23,9,14,127,114,6,4,3,1
E33041461,309,207,64,143,8,36,22,14,56,51,0,5,0,2
E33041462,602,423,107,316,6,50,23,27,120,109,0,5,6,3
E33041463,248,173,59,114,2,23,12,11,49,46,0,3,0,1
E33041464,281,211,58,153,2,15,9,6,53,50,1,2,0,0
E33041465,328,200,44,156,9,39,18,21,78,69,2,6,1,2
E33041466,326,229,54,175,4,27,12,15,62,58,0,3,1,4
E33041467,336,252,61,191,4,41,30,11,37,33,1,3,0,2
E33041468,337,246,78,168,2,27,20,7,62,58,0,2,2,0
E33041469,282,174,58,116,4,53,38,15,49,46,1,2,0,2
E33041470,260,192,65,127,3,20,13,7,39,35,1,3,0,6
E33041471,584,386,114,272,6,62,47,15,128,116,4,6,2,2
E33041472,307,234,50,184,2,42,33,9,29,24,2,3,0,0
E33041473,258,208,55,153,4,12,7,5,28,19,4,5,0,6
E33041474,412,333,95,238,4,23,19,4,50,49,0,0,1,2
E33041475,308,278,85,193,2,10,7,3,18,12,4,2,0,0
E33041476,295,216,46,170,3,22,11,11,52,45,2,4,1,2
E33041477,293,219,57,162,4,21,16,5,47,44,0,3,0,2
E33041478,331,262,79,183,1,35,26,9,28,23,1,4,0,5
E33041479,609,469,107,362,10,21,10,11,105,96,1,8,0,4
E33041480,629,443,148,295,10,91,46,45,80,74,2,4,0,5
E33041481,723,524,136,388,30,60,26,34,107,100,1,6,0,2
E33041482,291,211,69,142,2,29,18,11,45,41,0,2,2,4
E33041483,299,247,69,178,2,26,16,10,23,20,3,0,0,1
E33041484,627,471,107,364,3,21,13,8,125,79,24,2,20,7
E33041485,307,273,86,187,0,7,5,2,24,21,2,0,1,3
E33041486,362,274,102,172,2,26,15,11,45,40,2,2,1,15
E33041487,412,332,110,222,5,15,11,4,54,44,5,5,0,6
E33041488,261,201,67,134,0,21,9,12,39,32,4,2,1,0
E33041489,322,256,70,186,2,13,8,5,45,42,0,2,1,6
E33041490,719,527,156,371,4,72,48,24,105,97,1,6,1,11
E33041491,270,213,63,150,1,17,9,8,38,37,0,1,0,1
E33041492,308,219,83,136,2,27,16,11,51,45,3,3,0,9
E33041493,421,307,103,204,1,30,17,13,82,76,1,4,1,1
E33041494,353,255,74,181,2,44,35,9,46,37,1,2,6,6
E33041495,521,390,105,285,5,28,24,4,93,87,0,5,1,5
E33041496,282,254,75,179,2,4,4,0,16,14,0,2,0,6
E33041497,539,366,106,260,1,25,9,16,143,137,3,1,2,4
E33041498,267,224,66,158,1,10,5,5,32,25,3,1,3,0
E33041499,303,231,75,156,2,15,4,11,53,50,2,1,0,2
E33041500,353,248,71,177,1,56,42,14,46,33,11,1,1,2
E33041501,691,490,143,347,3,32,19,13,156,143,4,8,1,10
E33041502,422,310,109,201,3,44,33,11,61,54,4,3,0,4
E33041503,579,426,134,292,4,67,40,27,81,69,0,12,0,1
E33041504,380,225,69,156,3,81,52,29,69,61,0,8,0,2
E33041505,295,177,45,132,2,41,26,15,71,64,1,6,0,4
E33041506,385,231,43,188,11,87,55,32,55,49,0,6,0,1
E33041507,565,387,81,306,8,94,71,23,73,66,0,7,0,3
E33041508,752,518,138,380,12,136,68,68,81,76,0,5,0,5
E33041509,363,258,73,185,5,60,40,20,40,36,0,3,1,0
E33041510,510,356,91,265,0,61,40,21,85,80,0,5,0,8
E33041511,604,415,127,288,4,78,43,35,105,104,1,0,0,2
E33041512,503,359,126,233,3,55,36,19,82,73,3,5,1,4
E33041513,358,250,62,188,0,51,39,12,55,50,0,4,1,2
E33041514,453,356,108,248,1,28,15,13,66,60,1,5,0,2
E33041515,325,268,75,193,2,28,22,6,24,20,0,3,1,3
E33041516,443,339,111,228,2,29,21,8,69,59,5,5,0,4
E33041517,380,272,89,183,0,65,53,12,39,39,0,0,0,4
E33041518,445,328,113,215,2,33,24,9,80,70,4,6,0,2
E33041519,307,209,64,145,4,16,11,5,77,67,3,7,0,1
E33041520,246,165,42,123,1,15,12,3,64,56,0,8,0,1
E33041521,356,231,68,163,1,25,19,6,94,89,1,4,0,5
E33041522,389,296,67,229,2,26,18,8,65,60,0,5,0,0
E33041523,443,336,88,248,0,25,13,12,80,73,1,4,2,2
E33041524,310,181,55,126,2,10,5,5,105,102,1,2,0,12
E33041525,470,263,92,171,3,38,18,20,165,153,2,9,1,1
E33041526,310,192,47,145,1,30,18,12,86,82,0,3,1,1
E33041527,322,215,61,154,1,13,7,6,92,86,2,4,0,1
E33041528,301,214,72,142,0,23,11,12,58,52,3,2,1,6
E33041529,293,228,50,178,1,26,21,5,38,35,0,3,0,0
E33041530,259,179,60,119,0,12,4,8,67,63,3,0,1,1
E33041531,349,259,76,183,2,29,16,13,53,50,0,3,0,6
E33041532,271,149,35,114,3,23,11,12,93,86,0,7,0,3
E33041533,391,308,74,234,2,20,13,7,57,54,0,3,0,4
E33041534,341,239,73,166,2,25,14,11,74,68,0,6,0,1
E33041535,367,188,53,135,3,41,22,19,131,122,5,4,0,4
E33041536,410,187,57,130,1,40,21,19,179,170,0,6,3,3
E33041537,285,183,51,132,1,24,16,8,73,66,3,4,0,4
E33041538,228,161,38,123,0,14,7,7,53,45,0,8,0,0
E33041539,473,281,80,201,3,47,28,19,139,129,0,10,0,3
E33041540,240,103,42,61,1,25,10,15,110,103,0,7,0,1
E33041541,242,175,47,128,1,7,3,4,56,50,5,0,1,3
E33041542,287,191,56,135,1,15,10,5,78,75,1,2,0,2
E33041543,656,334,114,220,4,50,33,17,249,216,25,4,4,19
E33041544,478,348,86,262,1,20,11,9,104,99,2,3,0,5
E33041545,434,288,82,206,5,15,9,6,125,114,5,6,0,1
E33041546,335,134,53,81,3,20,12,8,171,163,5,2,1,7
E33041547,402,241,63,178,0,31,21,10,127,122,0,5,0,3
E33041548,406,268,81,187,1,17,9,8,115,106,2,6,1,5
E33041549,397,240,75,165,3,24,12,12,112,91,14,5,2,18
E33041550,532,390,131,259,1,20,13,7,110,97,4,9,0,11
E33041551,274,207,74,133,0,13,8,5,53,50,1,2,0,1
E33041552,306,225,76,149,1,19,12,7,60,56,0,2,2,1
E33041553,219,141,55,86,0,11,7,4,58,54,1,3,0,9
E33041554,267,186,68,118,0,13,8,5,62,60,0,2,0,6
E33041555,341,211,68,143,5,15,7,8,104,97,3,4,0,6
E33041556,327,197,73,124,3,27,15,12,97,90,0,6,1,3
E33041557,363,236,70,166,0,40,6,34,86,80,2,3,1,1
E33041558,298,268,59,209,3,4,3,1,19,16,0,2,1,4
E33041559,645,481,119,362,9,29,4,25,124,118,2,3,1,2
E33041560,381,304,83,221,2,23,4,19,48,43,0,3,2,4
E33041561,474,365,102,263,9,16,2,14,78,68,0,6,4,6
E33041562,462,325,114,211,4,46,5,41,85,74,4,7,0,2
E33041563,265,228,81,147,0,6,0,6,28,28,0,0,0,3
E33041564,292,236,91,145,0,15,2,13,40,37,0,3,0,1
E33041565,592,399,132,267,7,43,12,31,139,126,3,10,0,4
E33041566,269,166,38,128,1,36,1,35,61,42,5,14,0,5
E33041567,304,189,50,139,2,51,3,48,59,57,0,2,0,3
E33041568,634,422,106,316,9,59,10,49,142,130,1,8,3,2
E33041569,264,163,42,121,1,48,13,35,49,47,0,2,0,3
E33041570,331,227,68,159,4,15,2,13,82,76,0,4,2,3
E33041571,314,198,53,145,3,46,8,38,65,59,0,5,1,2
E33041572,767,515,127,388,2,62,11,51,175,159,4,10,2,13
E33041573,316,161,44,117,1,73,5,68,77,69,1,7,0,4
E33041574,500,344,99,245,3,27,4,23,122,112,1,9,0,4
E33041575,1221,769,209,560,7,95,11,84,341,318,2,19,2,9
E33041576,352,245,76,169,1,52,9,43,53,47,0,6,0,1
E33041577,404,279,83,196,3,30,4,26,85,80,1,4,0,7
E33041578,400,229,62,167,3,39,5,34,125,114,4,7,0,4
E33041579,391,308,67,241,1,17,6,11,63,58,0,5,0,2
E33041580,285,189,45,144,1,18,1,17,76,68,0,8,0,1
E33041581,255,161,56,105,2,23,4,19,65,62,0,1,2,4
E33041582,239,136,52,84,2,21,0,21,75,64,2,5,4,5
E33041583,357,220,60,160,2,12,1,11,123,114,3,5,1,0
E33041584,463,340,123,217,0,26,5,21,96,88,0,5,3,1
E33041585,325,245,70,175,2,13,3,10,60,55,1,4,0,5
E33041586,518,324,114,210,3,26,4,22,159,149,0,4,6,6
E33041587,837,591,132,459,5,33,7,26,203,186,1,12,4,5
E33041588,528,366,115,251,7,25,4,21,128,121,0,7,0,2
E33041589,365,259,73,186,0,23,2,21,80,71,1,6,2,3
E33041590,430,276,98,178,0,18,1,17,130,125,0,4,1,6
E33041591,444,292,81,211,0,23,5,18,128,120,1,6,1,1
E33041592,249,140,36,104,3,16,3,13,87,82,1,2,2,3
E33041593,313,190,67,123,1,18,4,14,102,95,1,6,0,2
E33041594,348,226,74,152,2,9,0,9,104,93,3,7,1,7
E33041595,829,562,177,385,9,37,5,32,218,200,2,13,3,3
E33041596,288,155,50,105,1,29,5,24,100,93,2,5,0,3
E33041597,708,371,96,275,5,72,13,59,252,238,0,14,0,8
E33041598,492,335,87,248,4,29,4,25,122,116,0,5,1,2
E33041599,568,430,97,333,3,37,8,29,95,86,2,7,0,3
E33041600,465,309,87,222,1,30,4,26,125,116,4,4,1,0
E33041601,417,308,86,222,1,30,8,22,72,65,4,1,2,6
E33041602,382,240,83,157,4,15,2,13,122,111,4,7,0,1
E33041603,336,186,60,126,1,27,2,25,120,115,4,0,1,2
E33041604,283,185,40,145,3,28,5,23,66,57,2,1,6,1
E33041605,339,241,57,184,2,23,1,22,70,64,1,4,1,3
E33041606,361,235,82,153,3,38,4,34,82,75,1,4,2,3
E33041607,294,146,43,103,1,34,4,30,110,100,0,10,0,3
E33041608,276,131,51,80,1,16,1,15,124,118,0,3,3,4
E33041609,296,190,68,122,1,17,5,12,79,70,3,6,0,9
E33041610,777,488,131,357,1,33,3,30,245,233,5,3,4,10
E33041611,349,186,61,125,2,30,4,26,129,122,0,6,1,2
E33041612,237,108,52,56,1,11,2,9,116,109,2,4,1,1
E33041613,275,134,43,91,3,19,1,18,112,103,3,5,1,7
E33041614,804,595,191,404,4,66,34,32,124,107,3,7,7,15
E33041615,295,205,101,104,1,18,12,6,65,41,10,10,4,6
E33041616,266,191,45,146,3,18,14,4,52,47,3,2,0,2
E33041617,314,257,87,170,8,22,19,3,24,19,0,5,0,3
E33041618,269,180,56,124,3,40,26,14,39,34,3,0,2,7
E33041619,349,274,86,188,3,22,11,11,48,40,2,5,1,2
E33041620,351,272,72,200,6,41,25,16,28,28,0,0,0,4
E33041621,294,210,85,125,3,12,7,5,57,50,2,5,0,12
E33041622,258,181,76,105,5,21,14,7,46,42,1,2,1,5
E33041623,249,199,75,124,4,6,2,4,33,26,1,6,0,7
E33041624,417,293,94,199,3,22,10,12,76,64,10,2,0,23
E33041625,384,288,74,214,4,31,11,20,56,48,3,5,0,5
E33041626,315,242,92,150,2,15,6,9,45,39,3,3,0,11
E33041627,277,203,88,115,0,28,18,10,46,44,0,2,0,0
E33041628,367,287,118,169,4,16,8,8,57,40,2,9,6,3
E33041629,587,377,105,272,2,65,47,18,142,128,1,13,0,1
E33041630,354,242,74,168,4,53,48,5,53,49,0,4,0,2
E33041631,623,428,143,285,3,41,23,18,145,131,1,6,7,6
E33041632,368,239,89,150,4,34,24,10,89,81,2,5,1,2
E33041633,435,270,88,182,5,61,48,13,94,88,1,5,0,5
E33041634,609,416,120,296,5,70,59,11,109,96,3,8,2,9
E33041635,421,317,98,219,3,68,61,7,28,25,0,1,2,5
E33041636,375,245,76,169,1,33,19,14,93,84,2,6,1,3
E33041637,310,241,77,164,1,19,14,5,46,43,0,3,0,3
E33041638,304,202,47,155,1,26,7,19,73,66,1,5,1,2
E33041639,267,193,84,109,3,18,10,8,43,41,1,1,0,10
E33041640,298,225,58,167,4,18,12,6,49,45,1,1,2,2
E33041641,307,207,70,137,2,31,21,10,57,53,2,2,0,10
E33041642,238,159,66,93,6,30,19,11,41,37,1,3,0,2
E33041643,645,342,124,218,6,43,29,14,212,188,2,14,8,42
E33041644,254,182,73,109,3,23,19,4,46,41,0,4,1,0
E33041645,235,198,80,118,3,10,9,1,24,23,0,1,0,0
E33041646,654,461,163,298,5,49,34,15,131,120,2,9,0,8
E33041647,418,349,142,207,4,24,19,5,40,36,0,4,0,1
E33041648,842,672,194,478,5,26,16,10,133,116,0,10,7,6
E33041649,508,412,84,328,3,25,16,9,65,60,0,5,0,3
E33041650,284,222,59,163,2,15,13,2,39,36,0,3,0,6
E33041651,362,294,76,218,4,14,7,7,48,39,1,8,0,2
E33041652,500,392,112,280,6,15,12,3,83,74,0,9,0,4
E33041653,350,258,74,184,3,19,15,4,68,54,1,13,0,2
E33041654,272,217,73,144,1,10,5,5,41,38,0,3,0,3
E33041655,322,222,74,148,3,33,29,4,60,51,1,7,1,4
E33041656,452,339,111,228,1,25,15,10,82,76,1,4,1,5
E33041657,399,275,71,204,5,27,16,11,91,82,0,9,0,1
E33041658,338,229,58,171,3,34,23,11,71,65,2,4,0,1
E33041659,536,367,100,267,0,77,67,10,89,83,1,5,0,3
E33041660,420,315,66,249,7,46,18,28,51,40,0,10,1,1
E33041661,304,212,75,137,4,27,23,4,60,55,2,1,2,1
E33041662,342,255,82,173,2,9,4,5,75,65,5,2,3,1
E33041663,421,335,90,245,5,33,20,13,46,42,1,3,0,2
E33041664,329,233,73,160,0,27,22,5,66,65,0,1,0,3
E33041665,555,412,117,295,3,26,17,9,106,98,1,7,0,8
E33041666,352,294,108,186,3,6,3,3,45,43,0,2,0,4
E33041667,517,404,131,273,5,52,34,18,56,50,1,5,0,0
E33041668,608,490,142,348,2,39,27,12,69,66,0,3,0,8
E33041669,348,283,100,183,1,14,9,5,46,45,0,1,0,4
E33041670,273,229,75,154,1,18,14,4,23,20,1,1,1,2
E33041671,525,385,121,264,1,26,12,14,105,92,3,9,1,8
E33041672,263,158,56,102,0,28,18,10,76,69,0,4,3,1
E33041673,339,215,62,153,3,32,15,17,88,82,2,4,0,1
E33041674,290,208,74,134,5,24,16,8,51,48,1,2,0,2
E33041675,241,162,53,109,1,15,8,7,60,55,0,5,0,3
E33041676,427,335,88,247,4,39,9,30,40,37,0,3,0,9
E33041677,406,277,80,197,3,52,11,41,66,60,0,6,0,8
E33041678,263,209,76,133,0,3,2,1,46,40,1,5,0,5
E33041679,442,358,112,246,0,20,4,16,59,56,2,1,0,5
E33041680,390,312,117,195,0,17,2,15,54,47,2,3,2,7
E33041681,266,180,57,123,7,45,8,37,30,27,1,2,0,4
E33041682,379,303,111,192,0,21,5,16,50,43,2,5,0,5
E33041683,380,260,81,179,9,55,13,42,51,47,2,2,0,5
E33041684,441,305,122,183,5,47,7,40,77,62,9,3,3,7
E33041685,414,318,133,185,2,35,7,28,48,46,0,1,1,11
E33041686,352,227,89,138,2,47,21,26,70,48,14,3,5,6
E33041687,303,210,87,123,2,24,9,15,56,48,4,4,0,11
E33041688,296,214,82,132,0,40,7,33,37,32,3,2,0,5
E33041689,253,181,84,97,2,31,3,28,34,32,1,1,0,5
E33041690,379,307,122,185,0,24,9,15,41,25,3,13,0,7
E33041691,327,241,86,155,3,18,6,12,60,53,0,7,0,5
E33041692,535,385,116,269,5,39,8,31,91,79,8,3,1,15
E33041693,257,183,67,116,0,8,4,4,54,51,1,1,1,12
E33041694,224,186,62,124,0,8,1,7,26,26,0,0,0,4
E33041695,365,284,133,151,1,31,5,26,44,39,3,2,0,5
E33041696,304,227,91,136,6,35,10,25,32,27,1,1,3,4
E33041697,454,354,150,204,0,15,7,8,78,72,3,1,2,7
E33041698,339,249,97,152,3,30,9,21,49,46,0,2,1,8
E33041699,391,263,96,167,2,39,6,33,79,57,11,11,0,8
E33041700,269,196,77,119,0,35,11,24,34,29,0,3,2,4
E33041701,722,507,199,308,6,73,20,53,127,106,7,14,0,9
E33041702,408,257,86,171,2,48,12,36,94,85,3,4,2,7
E33041703,268,158,56,102,4,18,10,8,82,47,28,1,6,6
E33041704,395,283,107,176,1,31,8,23,78,69,4,5,0,2
E33041705,539,407,175,232,3,35,9,26,82,73,2,3,4,12
E33041706,463,349,121,228,4,38,4,34,71,66,0,2,3,1
E33041707,292,233,114,119,0,11,1,10,38,32,1,5,0,10
E33041708,421,303,103,200,1,21,6,15,92,81,3,8,0,4
E33041709,241,179,71,108,0,12,1,11,48,46,0,2,0,2
E33041710,254,204,86,118,1,10,4,6,38,35,0,1,2,1
E33041711,312,228,90,138,1,18,5,13,64,62,0,2,0,1
E33041712,418,275,94,181,3,30,6,24,88,76,1,6,5,22
E33041713,225,166,52,114,1,14,9,5,42,38,3,0,1,2
E33041714,288,213,87,126,3,19,9,10,45,42,1,2,0,8
E33041715,276,203,56,147,2,9,2,7,60,54,1,5,0,2
E33041716,360,261,86,175,3,34,9,25,59,45,5,9,0,3
E33041717,523,383,120,263,7,48,15,33,84,75,1,7,1,1
E33041718,222,166,52,114,1,11,1,10,39,34,3,2,0,5
E33041719,259,210,54,156,3,19,2,17,26,20,0,6,0,1
E33041720,348,244,71,173,2,53,14,39,46,42,0,4,0,3
E33041721,402,303,86,217,0,32,9,23,66,59,1,6,0,1
E33041722,271,171,48,123,4,36,5,31,60,56,1,3,0,0
E33041723,353,243,79,164,5,33,4,29,66,58,1,6,1,6
E33041724,334,214,56,158,2,34,9,25,82,72,3,6,1,2
E33041725,813,623,155,468,6,56,15,41,125,119,0,5,1,3
E33041726,370,271,65,206,2,15,3,12,80,76,1,2,1,2
E33041727,311,187,65,122,1,27,2,25,96,89,2,5,0,0
E33041728,278,202,64,138,1,34,4,30,39,39,0,0,0,2
E33041729,1003,621,171,450,8,89,21,68,278,268,0,10,0,7
E33041730,313,235,64,171,3,24,1,23,50,42,0,8,0,1
E33041731,290,231,97,134,3,10,2,8,42,41,0,1,0,4
E33041732,482,357,127,230,3,28,6,22,89,82,0,5,2,5
E33041733,325,266,87,179,7,8,2,6,42,34,7,1,0,2
E33041734,283,254,87,167,0,5,1,4,24,23,0,1,0,0
E33041735,395,300,94,206,3,27,7,20,60,59,1,0,0,5
E33041736,381,299,89,210,1,19,3,16,61,57,0,4,0,1
E33041737,1185,760,215,545,8,63,12,51,348,328,0,19,1,6
E33041738,281,190,67,123,0,28,5,23,60,49,0,8,3,3
E33041739,488,377,148,229,0,21,6,15,83,76,0,6,1,7
E33041740,369,266,109,157,2,23,2,21,75,72,0,3,0,3
E33041741,290,212,72,140,1,15,1,14,61,55,0,4,2,1
E33041742,380,208,76,132,3,26,6,20,138,126,1,10,1,5
E33041743,323,209,52,157,3,12,2,10,97,96,0,0,1,2
E33041744,431,251,84,167,2,27,10,17,143,138,0,5,0,8
E33041745,274,192,67,125,2,17,3,14,62,58,1,3,0,1
E33041746,268,148,62,86,2,16,7,9,98,94,0,4,0,4
E33041747,265,171,64,107,2,11,1,10,63,60,3,0,0,18
E33041748,744,532,153,379,5,26,5,21,177,170,2,5,0,4
E33041749,224,129,49,80,2,16,3,13,76,71,0,5,0,1
E33041750,395,254,83,171,4,21,7,14,71,66,1,4,0,45
E33041751,276,213,79,134,1,21,20,1,36,35,1,0,0,5
E33041752,238,169,64,105,0,17,4,13,37,34,1,2,0,15
E33041753,322,241,87,154,1,9,3,6,64,56,7,1,0,7
E33041754,381,290,100,190,5,22,18,4,56,43,3,10,0,8
E33041755,637,473,172,301,6,45,21,24,99,92,1,6,0,14
E33041756,354,273,94,179,2,25,4,21,51,45,3,2,1,3
E33041757,239,181,63,118,0,17,7,10,34,27,5,0,2,7
E33041758,390,269,79,190,4,49,20,29,61,59,0,2,0,7
E33041759,251,191,62,129,3,21,9,12,27,25,1,1,0,9
E33041760,297,259,92,167,1,12,10,2,22,19,0,2,1,3
E33041761,454,335,119,216,6,21,7,14,83,75,3,4,1,9
E33041762,456,356,108,248,2,9,4,5,76,69,2,4,1,13
E33041763,424,298,109,189,5,29,9,20,80,66,3,7,4,12
E33041764,455,383,118,265,15,21,13,8,34,33,0,1,0,2
E33041765,356,258,69,189,4,22,6,16,71,68,0,3,0,1
E33041766,292,247,90,157,7,19,7,12,17,16,1,0,0,2
E33041767,291,237,64,173,4,17,5,12,31,25,1,4,1,2
E33041768,470,351,110,241,4,36,19,17,78,72,0,4,2,1
E33041769,242,168,49,119,1,16,7,9,51,46,1,3,1,6
E33041770,282,231,63,168,1,14,5,9,34,30,3,1,0,2
E33041771,394,322,109,213,3,15,5,10,53,48,0,4,1,1
E33041772,300,213,90,123,3,25,9,16,56,53,0,3,0,3
E33041773,664,487,148,339,13,56,21,35,100,90,3,4,3,8
E33041774,241,174,76,98,0,10,6,4,44,39,1,3,1,13
E33041775,523,398,137,261,6,23,11,12,71,65,4,2,0,25
E33041776,558,432,156,276,4,49,16,33,67,60,3,4,0,6
E33041777,425,312,119,193,2,32,12,20,68,59,1,6,2,11
E33041778,326,270,103,167,3,3,0,3,42,35,1,5,1,8
E33041779,373,265,95,170,0,47,23,24,57,48,3,6,0,4
E33041780,374,306,81,225,4,29,13,16,34,30,0,4,0,1
E33041781,793,556,154,402,7,91,51,40,134,121,0,13,0,5
E33041782,828,619,140,479,9,95,61,34,99,93,0,5,1,6
E33041783,384,317,89,228,7,19,12,7,38,33,1,4,0,3
E33041784,235,191,68,123,2,13,5,8,22,22,0,0,0,7
E33041785,350,252,95,157,4,28,8,20,60,55,3,2,0,6
E33041786,369,281,92,189,6,21,6,15,55,46,3,1,5,6
E33041787,308,230,94,136,1,22,16,6,34,26,2,5,1,21
E33041788,385,276,92,184,3,29,14,15,64,54,6,3,1,13
E33041789,293,211,96,115,1,26,16,10,47,42,3,1,1,8
E33041790,293,231,78,153,2,10,4,6,45,39,1,5,0,5
E33041791,257,206,78,128,4,14,6,8,31,25,0,6,0,2
E33041792,356,267,110,157,4,23,12,11,58,50,4,4,0,4
E33041793,344,278,86,192,5,26,11,15,33,30,0,1,2,2
E33041794,238,187,62,125,1,14,5,9,35,31,0,4,0,1
E33041795,393,309,91,218,3,18,6,12,53,46,1,6,0,10
E33041796,308,252,117,135,1,13,9,4,37,33,0,4,0,5
E33041797,337,280,113,167,2,20,17,3,34,31,2,1,0,1
E33041798,408,316,119,197,4,30,18,12,49,41,1,0,7,9
E33041799,1378,1031,297,734,12,115,55,60,208,195,1,11,1,12
E33041800,396,298,80,218,5,36,22,14,54,52,0,2,0,3
E33041801,537,422,112,310,10,28,13,15,75,74,1,0,0,2
E33041802,344,275,72,203,3,14,4,10,50,47,0,3,0,2
E33041803,364,267,88,179,2,22,10,12,72,62,1,9,0,1
E33041804,406,324,101,223,2,23,16,7,53,46,0,5,2,4
E33041805,316,270,68,202,0,5,2,3,38,34,0,3,1,3
E33041806,390,281,86,195,2,23,10,13,82,73,3,4,2,2
E33041807,556,407,115,292,3,51,37,14,92,80,1,9,2,3
E33041808,587,467,124,343,3,29,17,12,78,66,1,7,4,10
E33041809,478,347,127,220,7,31,13,18,82,77,3,2,0,11
E33041810,336,289,121,168,1,9,3,6,32,30,0,2,0,5
E33041811,261,209,79,130,1,15,5,10,35,32,2,1,0,1
E33041812,512,417,142,275,0,28,13,15,61,52,0,5,4,6
E33041813,378,268,91,177,3,16,10,6,81,72,2,4,3,10
E33041814,389,333,79,254,0,10,3,7,43,38,1,2,2,3
E33041815,519,420,136,284,8,40,25,15,48,43,1,3,1,3
E33041816,412,298,83,215,5,35,13,22,69,67,0,2,0,5
E33041817,395,295,68,227,0,21,7,14,68,62,2,3,1,11
E33041818,348,261,92,169,2,17,12,5,63,56,1,3,3,5
E33041819,588,416,137,279,11,64,26,38,85,81,2,1,1,12
E33041820,332,255,92,163,6,29,15,14,37,34,0,0,3,5
E33041821,572,419,154,265,4,30,15,15,106,88,1,16,1,13
E33041822,479,398,130,268,5,27,17,10,47,39,3,4,1,2
E33041823,325,255,119,136,2,6,4,2,48,36,0,12,0,14
E33041824,288,216,83,133,1,25,9,16,41,38,2,0,1,5
E33041825,336,270,109,161,2,13,8,5,47,39,3,3,2,4
E33041826,387,295,124,171,3,14,8,6,70,58,3,5,4,5
E33041827,299,253,117,136,3,10,2,8,31,22,2,7,0,2
E33041828,484,375,108,267,6,38,23,15,63,51,5,3,4,2
E33041829,278,213,46,167,4,22,10,12,35,32,0,3,0,4
E33041830,352,308,83,225,2,8,4,4,34,31,0,3,0,0
E33041831,349,249,76,173,3,23,11,12,68,65,0,3,0,6
E33041832,261,206,69,137,3,15,12,3,36,35,0,1,0,1
E33041833,342,232,57,175,7,30,20,10,71,68,0,1,2,2
E33041834,546,370,98,272,5,40,24,16,126,112,1,12,1,5
E33041835,482,397,108,289,3,33,16,17,44,35,5,4,0,5
E33041836,289,206,59,147,2,44,8,36,35,30,1,2,2,2
E33041837,296,216,63,153,6,27,12,15,42,35,0,7,0,5
E33041838,275,192,58,134,2,35,25,10,36,33,1,2,0,10
E33041839,280,179,42,137,3,64,59,5,30,24,0,6,0,4
E33041840,364,228,74,154,7,67,41,26,59,52,1,5,1,3
E33041841,490,350,107,243,3,12,7,5,114,93,4,15,2,11
E33041842,321,231,87,144,2,12,10,2,68,62,3,3,0,8
E33041843,291,209,85,124,0,13,4,9,65,50,6,8,1,4
E33041844,511,426,122,304,3,21,11,10,58,49,1,6,2,3
E33041845,658,482,142,340,10,29,9,20,133,121,0,10,2,4
E33041846,403,294,117,177,2,17,10,7,68,59,5,4,0,22
E33041847,300,229,96,133,1,10,8,2,52,52,0,0,0,8
E33041848,253,164,54,110,3,23,12,11,59,50,2,5,2,4
E33041849,442,324,94,230,8,24,13,11,85,80,0,5,0,1
E33041850,352,263,72,191,2,20,8,12,63,55,2,6,0,4
E33041851,358,276,98,178,5,22,10,12,53,50,1,2,0,2
E33041852,344,262,100,162,0,31,25,6,40,38,0,2,0,11
E33041853,304,244,61,183,4,10,5,5,46,38,2,4,2,0
E33041854,327,257,92,165,0,15,10,5,51,48,0,3,0,4
E33041855,263,188,59,129,2,10,5,5,61,55,0,6,0,2
E33041856,570,404,111,293,1,40,25,15,118,109,5,4,0,7
E33041857,263,214,70,144,2,6,1,5,40,39,0,1,0,1
E33041858,446,341,120,221,2,15,7,8,67,63,2,2,0,21
E33041859,354,278,58,220,1,25,9,16,50,46,3,1,0,0
E33041860,285,221,39,182,2,20,9,11,42,40,0,2,0,0
E33041861,401,316,111,205,2,18,15,3,59,53,0,5,1,6
E33041862,372,307,100,207,0,8,6,2,55,54,0,1,0,2
E33041863,288,232,73,159,0,15,8,7,34,26,4,4,0,7
E33041864,404,316,78,238,2,13,6,7,72,54,8,10,0,1
E33041865,546,357,86,271,17,78,7,71,92,82,4,3,3,2
E33041866,289,232,67,165,3,30,1,29,24,21,2,1,0,0
E33041867,324,275,79,196,5,22,2,20,20,19,0,1,0,2
E33041868,359,279,71,208,3,33,6,27,40,37,0,3,0,4
E33041869,305,188,54,134,6,71,3,68,33,26,4,3,0,7
E33041870,270,198,48,150,2,21,1,20,45,37,4,0,4,4
E33041871,338,266,58,208,0,26,3,23,40,36,0,3,1,6
E33041872,309,269,98,171,0,18,2,16,21,17,1,1,2,1
E33041873,372,299,87,212,4,30,2,28,33,28,1,3,1,6
E33041874,374,268,105,163,3,41,4,37,57,47,3,4,3,5
E33041875,253,183,66,117,3,23,3,20,32,23,9,0,0,12
E33041876,286,196,64,132,5,28,3,25,41,37,3,1,0,16
E33041877,387,236,88,148,8,50,3,47,69,52,11,4,2,24
E33041878,256,207,83,124,1,18,2,16,24,19,2,2,1,6
E33041879,321,247,90,157,7,20,5,15,40,34,0,2,4,7
E33041880,247,193,58,135,0,26,1,25,25,18,4,1,2,3
E33041881,306,245,96,149,3,11,1,10,38,35,0,3,0,9
E33041882,262,155,63,92,1,21,3,18,54,48,3,1,2,31
E33041883,406,316,111,205,1,18,0,18,53,43,5,3,2,18
E33041884,286,218,82,136,1,33,2,31,30,29,1,0,0,4
E33041885,308,200,68,132,1,44,5,39,35,28,2,3,2,28
E33041886,332,256,75,181,3,23,0,23,46,35,4,7,0,4
E33041887,505,376,141,235,4,47,4,43,61,49,8,3,1,17
E33041888,307,202,56,146,3,36,8,28,58,50,7,1,0,8
E33041889,394,285,69,216,5,37,3,34,60,52,7,1,0,7
E33041890,264,196,72,124,0,4,0,4,56,50,2,1,3,8
E33041891,547,355,83,272,6,68,6,62,101,85,10,5,1,17
E33041892,374,278,51,227,4,49,0,49,41,37,2,2,0,2
E33041893,259,171,51,120,7,40,4,36,39,38,1,0,0,2
E33041894,327,257,77,180,2,39,1,38,24,19,0,3,2,5
E33041895,226,134,31,103,4,21,6,15,41,38,2,1,0,26
E33041896,297,216,55,161,4,38,3,35,38,34,2,2,0,1
E33041897,334,262,53,209,6,24,3,21,41,38,0,3,0,1
E33041898,325,261,67,194,4,7,0,7,52,51,0,1,0,1
E33041899,278,215,50,165,3,17,0,17,42,40,0,2,0,1
E33041900,1069,773,162,611,13,96,8,88,185,168,7,8,2,2
E33041901,980,690,133,557,19,108,21,87,162,148,1,11,2,1
E33041902,277,159,37,122,2,68,4,64,42,35,1,4,2,6
E33041903,298,182,28,154,10,80,4,76,26,24,0,2,0,0
E33041904,292,197,41,156,4,53,2,51,33,31,1,1,0,5
E33041905,345,233,36,197,7,63,4,59,34,32,1,1,0,8
E33041906,396,253,69,184,3,90,7,83,48,44,1,3,0,2
E33041907,325,198,52,146,5,72,6,66,49,41,2,5,1,1
E33041908,1097,714,150,564,21,177,13,164,178,163,4,10,1,7
E33041909,538,399,115,284,11,49,5,44,73,69,0,3,1,6
E33041910,482,371,76,295,8,26,3,23,76,68,2,6,0,1
E33041911,936,694,157,537,19,109,14,95,108,101,0,7,0,6
E33041912,331,198,47,151,7,79,2,77,44,43,0,1,0,3
E33041913,312,176,58,118,8,90,4,86,34,30,1,2,1,4
E33041914,395,279,81,198,4,59,9,50,52,49,0,1,2,1
E33041915,318,233,66,167,8,40,2,38,36,30,2,4,0,1
E33041916,278,185,31,154,5,48,1,47,40,39,0,1,0,0
E33041917,384,281,63,218,4,70,7,63,29,23,2,4,0,0
E33041918,504,386,83,303,8,46,10,36,63,60,0,3,0,1
E33041919,354,280,74,206,8,29,1,28,36,34,0,2,0,1
E33041920,335,237,52,185,1,57,4,53,39,38,0,0,1,1
E33041921,334,209,42,167,5,60,4,56,53,48,0,5,0,7
E33041922,777,497,57,440,24,72,4,68,183,170,3,10,0,1
E33041923,273,175,45,130,6,30,2,28,59,53,1,3,2,3
E33041924,319,220,58,162,3,46,1,45,48,38,1,9,0,2
E33041925,343,245,45,200,9,38,2,36,45,44,0,1,0,6
E33041926,1995,1566,356,1210,29,118,17,101,275,253,5,14,3,7
E33041927,877,616,104,512,24,79,6,73,155,137,1,15,2,3
E33041928,267,190,47,143,3,34,1,33,38,34,0,4,0,2
E33041929,662,444,101,343,6,121,5,116,85,77,1,7,0,6
E33041930,407,311,87,224,6,52,3,49,37,34,1,2,0,1
E33041931,719,563,186,377,11,59,3,56,82,72,3,7,0,4
E33041932,325,222,45,177,7,67,5,62,27,25,0,2,0,2
E33041933,469,333,92,241,9,71,7,64,55,51,0,2,2,1
E33041934,357,205,46,159,4,123,5,118,25,17,4,4,0,0
E33041935,387,269,64,205,7,60,2,58,49,44,1,3,1,2
E33041936,378,253,76,177,4,88,6,82,32,26,3,3,0,1
E33041937,343,182,42,140,1,117,9,108,42,36,3,3,0,1
E33041938,361,243,75,168,4,21,6,15,67,57,4,3,3,26
E33041939,428,359,126,233,1,32,2,30,34,28,0,4,2,2
E33041940,296,253,93,160,0,16,1,15,27,25,1,1,0,0
E33041941,294,229,80,149,3,6,1,5,45,34,10,1,0,11
E33041942,508,396,96,300,4,51,0,51,57,54,0,3,0,0
E33041943,469,362,121,241,7,34,2,32,63,57,2,4,0,3
E33041944,2555,1835,407,1428,27,225,29,196,453,417,12,18,6,15
E33041945,675,482,103,379,5,88,8,80,98,89,5,4,0,2
E33041946,390,297,83,214,11,39,2,37,42,33,1,7,1,1
E33041947,531,372,141,231,7,56,4,52,78,68,6,3,1,18
E33041948,295,215,79,136,2,30,5,25,46,42,0,1,3,2
E33041949,473,386,126,260,5,32,1,31,48,44,3,1,0,2
E33041950,353,210,51,159,5,36,8,28,87,83,1,3,0,15
E33041951,257,190,51,139,6,20,2,18,39,38,1,0,0,2
E33041952,324,213,62,151,9,39,5,34,58,52,2,2,2,5
E33041953,341,180,71,109,4,24,1,23,59,41,12,3,3,74
E33041954,260,198,60,138,1,32,2,30,28,21,2,3,2,1
E33041955,301,264,70,194,2,15,1,14,19,17,0,2,0,1
E33041956,707,612,179,433,3,35,3,32,52,43,0,7,2,5
E33041957,366,240,36,204,7,78,1,77,38,30,4,4,0,3
E33041958,542,350,85,265,2,114,10,104,75,71,0,3,1,1
E33041959,400,275,66,209,7,56,2,54,61,56,0,3,2,1
E33041960,275,213,65,148,7,19,6,13,31,26,1,3,1,5
E33041961,317,212,68,144,1,45,6,39,54,45,5,3,1,5
E33041962,285,184,79,105,5,32,7,25,44,35,7,2,0,20
E33041963,437,323,87,236,3,68,9,59,38,32,1,5,0,5
E33041964,820,511,150,361,8,177,20,157,119,109,2,7,1,5
E33041965,589,312,78,234,7,86,29,57,154,138,14,2,0,30
E33041966,415,311,25,286,5,47,2,45,51,50,0,1,0,1
E33041967,732,524,130,394,10,98,9,89,97,84,2,9,2,3
E33041968,458,394,88,306,6,15,1,14,42,40,0,2,0,1
E33041969,421,345,50,295,6,17,0,17,49,47,0,2,0,4
E33041970,320,231,67,164,8,43,6,37,36,34,1,1,0,2
E33041971,465,312,95,217,6,75,7,68,69,63,3,2,1,3
E33041972,545,337,118,219,4,45,11,34,135,96,23,11,5,24
E33041973,280,200,70,130,1,29,3,26,47,33,12,2,0,3
E33041974,352,272,82,190,3,23,6,17,49,39,4,4,2,5
E33041975,239,164,66,98,4,34,7,27,31,20,5,6,0,6
E33041976,545,378,131,247,6,44,10,34,110,89,11,7,3,7
E33041977,254,188,67,121,1,14,1,13,41,36,3,0,2,10
E33041978,894,656,204,452,8,93,26,67,117,99,8,7,3,20
E33041979,333,223,84,139,3,66,5,61,37,30,4,3,0,4
E33041980,218,140,45,95,2,22,3,19,51,47,1,3,0,3
E33041981,522,370,110,260,7,88,17,71,53,48,2,2,1,4
E33041982,390,254,91,163,3,66,15,51,62,47,0,8,7,5
E33041983,918,574,162,412,14,131,33,98,192,180,3,9,0,7
E33041984,417,319,112,207,7,29,7,22,58,53,3,1,1,4
E33041985,287,216,71,145,8,30,6,24,32,31,0,0,1,1
E33041986,700,528,148,380,11,37,10,27,117,107,1,7,2,7
E33041987,310,217,86,131,6,34,3,31,50,42,1,4,3,3
E33041988,531,346,116,230,5,71,15,56,101,84,5,9,3,8
E33041989,350,260,59,201,6,31,6,25,51,41,1,6,3,2
E33041990,323,278,99,179,2,20,1,19,20,17,0,3,0,3
E33041991,264,218,78,140,1,9,4,5,31,28,0,2,1,5
E33041992,368,244,59,185,3,58,20,38,59,36,12,3,8,4
E33041993,279,181,35,146,9,35,8,27,53,34,10,1,8,1
E33041994,392,265,79,186,0,58,10,48,54,51,1,2,0,15
E33041995,399,280,94,186,2,61,15,46,48,40,4,2,2,8
E33041996,366,202,43,159,15,54,11,43,92,39,25,5,23,3
E33041997,438,347,91,256,3,29,4,25,54,48,2,4,0,5
E33041998,537,411,125,286,9,51,7,44,57,52,3,1,1,9
E33041999,660,508,130,378,7,88,18,70,53,41,5,6,1,4
E33042000,527,415,151,264,5,36,4,32,60,52,1,5,2,11
E33042001,353,227,71,156,7,34,8,26,67,55,7,3,2,18
E33042002,451,353,119,234,4,54,5,49,35,29,3,3,0,5
E33042003,345,227,94,133,5,46,8,38,47,38,5,4,0,20
E33042004,252,195,63,132,4,18,6,12,26,23,2,1,0,9
E33042005,573,473,135,338,10,45,15,30,40,33,0,5,2,5
E33042006,266,220,92,128,1,25,2,23,17,13,1,3,0,3
E33042007,268,187,80,107,3,40,2,38,31,28,2,1,0,7
E33042008,271,196,94,102,2,16,2,14,47,41,3,3,0,10
E33042009,391,282,68,214,8,42,7,35,56,41,4,6,5,3
E33042010,462,339,102,237,2,42,12,30,73,38,18,4,13,6
E33042011,442,301,101,200,11,30,8,22,87,71,11,3,2,13
E33042012,360,252,81,171,4,44,8,36,53,46,4,1,2,7
E33042013,291,186,50,136,4,49,8,41,49,45,3,1,0,3
E33042014,350,234,78,156,1,32,16,16,75,59,6,3,7,8
E33042015,515,376,125,251,4,64,11,53,60,56,1,3,0,11
E33042016,414,289,78,211,12,34,9,25,75,71,4,0,0,4
E33042017,563,431,98,333,5,47,8,39,73,61,5,5,2,7
E33042018,318,251,76,175,0,37,4,33,27,25,0,1,1,3
E33042019,460,347,100,247,5,31,9,22,73,69,0,1,3,4
E33042020,441,320,117,203,1,60,11,49,59,53,2,3,1,1
E33042021,276,212,68,144,3,24,3,21,27,22,1,1,3,10
E33042022,259,165,62,103,1,37,1,36,53,48,3,2,0,3
E33042023,268,170,50,120,1,51,9,42,38,32,0,3,3,8
E33042024,282,202,85,117,3,20,3,17,53,48,0,3,2,4
E33042025,326,238,76,162,3,24,4,20,55,46,5,4,0,6
E33042026,375,275,101,174,0,37,5,32,59,53,3,2,1,4
E33042027,633,412,128,284,8,41,9,32,116,69,40,4,3,56
E33042028,257,182,55,127,3,30,9,21,38,35,0,3,0,4
E33042029,424,263,124,139,3,23,6,17,114,97,12,4,1,21
E33042030,268,172,49,123,6,29,5,24,59,52,5,1,1,2
E33042031,504,383,135,248,5,35,7,28,77,67,2,5,3,4
E33042032,394,233,106,127,2,67,11,56,69,63,4,0,2,23
E33042033,231,183,60,123,0,12,1,11,36,35,0,1,0,0
E33042034,363,266,107,159,1,35,2,33,46,35,4,6,1,15
E33042035,314,228,73,155,8,35,9,26,40,39,0,1,0,3
E33042036,639,517,151,366,9,33,3,30,75,67,1,6,1,5
E33042037,426,278,88,190,3,78,24,54,65,60,0,5,0,2
E33042038,770,538,144,394,11,76,8,68,135,115,12,8,0,10
E33042039,597,441,132,309,5,69,11,58,77,70,3,4,0,5
E33042040,258,174,65,109,0,24,6,18,59,52,1,5,1,1
E33042041,318,206,67,139,3,49,10,39,56,50,2,4,0,4
E33042042,783,564,151,413,8,88,24,64,118,106,1,10,1,5
E33042043,451,319,101,218,8,64,3,61,58,52,2,4,0,2
E33042044,1115,642,154,488,10,229,100,129,229,216,3,9,1,5
E33042045,459,392,88,304,0,19,6,13,47,42,0,4,1,1
E33042046,267,224,83,141,3,17,7,10,19,16,1,1,1,4
E33042047,583,498,160,338,3,22,11,11,50,44,2,4,0,10
E33042048,264,225,84,141,0,7,3,4,27,24,0,1,2,5
E33042049,610,476,124,352,6,58,11,47,67,60,0,5,2,3
E33042050,298,225,59,166,2,28,8,20,41,35,0,5,1,2
E33042051,388,334,105,229,1,21,8,13,30,26,1,1,2,2
E33042052,710,602,176,426,7,28,3,25,68,64,1,2,1,5
E33042053,513,390,106,284,7,33,12,21,81,71,1,9,0,2
E33042054,424,361,103,258,2,10,2,8,51,51,0,0,0,0
E33042055,657,537,174,363,3,36,8,28,80,76,0,4,0,1
E33042056,314,260,82,178,1,18,5,13,32,26,2,4,0,3
E33042057,311,275,95,180,1,4,0,4,28,21,0,7,0,3
E33042058,375,324,103,221,2,12,4,8,37,35,0,2,0,0
E33042059,478,404,119,285,1,29,5,24,42,41,0,1,0,2
E33042060,498,421,125,296,5,23,7,16,43,38,3,2,0,6
E33042061,279,224,65,159,2,23,7,16,28,28,0,0,0,2
E33042062,323,246,86,160,6,19,8,11,49,41,5,3,0,3
E33042063,400,306,90,216,1,14,4,10,71,68,0,3,0,8
E33042064,315,258,77,181,1,19,7,12,36,32,1,3,0,1
E33042065,350,298,71,227,5,11,3,8,33,30,0,2,1,3
E33042066,368,271,68,203,4,53,7,46,38,35,0,3,0,2
E33042067,286,206,62,144,2,34,5,29,43,36,0,5,2,1
E33042068,363,245,61,184,8,34,7,27,76,72,0,3,1,0
E33042069,329,223,67,156,6,43,13,30,55,51,0,4,0,2
E33042070,697,511,143,368,11,90,36,54,84,78,0,6,0,1
E33042071,330,228,65,163,1,60,10,50,39,36,1,1,1,2
E33042072,443,360,91,269,4,34,4,30,42,36,0,6,0,3
E33042073,530,425,108,317,3,50,5,45,50,47,0,2,1,2
E33042074,525,393,103,290,1,68,12,56,61,49,4,7,1,2
E33042075,409,266,64,202,4,76,10,66,61,52,0,7,2,2
E33042076,401,254,53,201,11,58,3,55,72,67,0,3,2,6
E33042077,428,298,74,224,0,79,9,70,44,37,1,6,0,7
E33042078,489,350,90,260,7,41,12,29,88,77,2,8,1,3
E33042079,352,226,66,160,9,45,5,40,70,66,1,2,1,2
E33042080,431,312,89,223,2,52,7,45,63,59,1,2,1,2
E33042081,715,553,160,393,7,54,13,41,96,81,6,8,1,5
E33042082,489,297,73,224,4,78,16,62,105,100,0,4,1,5
E33042083,612,520,129,391,9,24,9,15,57,54,0,3,0,2
E33042084,450,361,110,251,0,39,15,24,44,38,4,2,0,6
E33042085,297,238,74,164,3,17,4,13,36,29,0,7,0,3
E33042086,310,239,65,174,1,20,5,15,45,43,0,2,0,5
E33042087,431,336,88,248,4,41,13,28,48,46,0,2,0,2
E33042088,367,317,74,243,0,19,6,13,31,29,0,2,0,0
E33042089,544,439,140,299,2,43,21,22,56,52,0,3,1,4
E33042090,277,211,57,154,2,26,12,14,35,35,0,0,0,3
E33042091,306,224,66,158,4,26,9,17,44,37,0,6,1,8
E33042092,404,341,97,244,4,24,9,15,32,27,2,3,0,3
E33042093,425,309,80,229,4,35,7,28,75,70,0,5,0,2
E33042094,470,351,103,248,3,25,12,13,88,71,9,8,0,3
E33042095,368,261,45,216,15,39,1,38,51,49,0,2,0,2
E33042096,260,181,51,130,3,16,7,9,57,47,4,5,1,3
E33042097,463,360,95,265,4,41,20,21,50,45,1,4,0,8
E33042098,735,617,125,492,3,31,8,23,82,75,1,6,0,2
E33042099,605,471,93,378,5,37,15,22,89,79,1,9,0,3
E33042100,379,289,93,196,1,39,11,28,47,41,3,3,0,3
E33042101,329,259,69,190,1,26,6,20,42,41,1,0,0,1
E33042102,429,327,98,229,5,41,9,32,55,51,1,2,1,1
E33042103,459,362,90,272,3,29,7,22,59,51,2,6,0,6
E33042104,419,350,92,258,3,17,6,11,49,42,1,6,0,0
E33042105,257,198,58,140,4,26,10,16,26,22,1,3,0,3
E33042106,379,325,68,257,2,11,5,6,40,38,0,2,0,1
E33042107,369,297,84,213,3,17,8,9,47,34,2,10,1,5
E33042108,397,300,83,217,1,31,22,9,62,60,0,2,0,3
E33042109,507,372,135,237,5,42,21,21,81,70,4,3,4,7
E33042110,327,186,51,135,3,115,10,105,20,18,1,0,1,3
E33042111,241,170,45,125,2,24,14,10,39,31,4,3,1,6
E33042112,309,196,58,138,1,59,14,45,49,45,3,0,1,4
E33042113,779,478,129,349,13,165,92,73,118,102,0,16,0,5
E33042114,341,239,58,181,2,37,15,22,63,59,0,4,0,0
E33042115,322,239,56,183,0,39,6,33,42,35,2,3,2,2
E33042116,511,337,99,238,2,68,17,51,90,79,2,5,4,14
E33042117,248,144,60,84,2,50,24,26,46,43,0,3,0,6
E33042118,325,205,45,160,4,38,6,32,77,72,0,2,3,1
E33042119,587,417,123,294,5,47,22,25,112,95,1,13,3,6
E33042120,1005,759,207,552,7,89,35,54,148,138,1,8,1,2
E33042121,500,365,113,252,1,41,17,24,88,84,0,3,1,5
E33042122,978,816,175,641,8,41,24,17,110,94,3,7,6,3
E33042123,351,267,63,204,5,21,5,16,57,52,0,5,0,1
E33042124,255,205,58,147,2,16,9,7,30,23,2,5,0,2
E33042125,519,415,109,306,4,37,14,23,61,54,0,7,0,2
E33042126,295,248,44,204,4,6,0,6,37,28,6,1,2,0
E33042127,294,235,54,181,1,6,2,4,51,30,18,3,0,1
E33042128,379,301,83,218,1,19,10,9,57,43,3,9,2,1
E33042129,342,287,42,245,0,9,6,3,41,37,0,3,1,5
E33042130,303,244,76,168,5,25,13,12,29,27,2,0,0,0
E33042131,342,270,72,198,3,25,11,14,43,41,0,1,1,1
E33042132,248,187,57,130,2,27,14,13,31,26,1,1,3,1
E33042133,631,473,108,365,10,50,18,32,94,76,12,4,2,4
E33042134,299,261,79,182,2,11,4,7,25,23,0,1,1,0
E33042135,350,247,71,176,0,67,33,34,29,25,1,3,0,7
E33042136,346,292,72,220,4,18,7,11,31,27,0,3,1,1
E33042137,665,491,118,373,1,97,68,29,74,66,3,4,1,2
E33042138,393,312,90,222,4,27,11,16,50,36,5,9,0,0
E33042139,381,284,91,193,4,32,22,10,57,52,1,4,0,4
E33042140,464,355,106,249,4,39,25,14,63,56,1,5,1,3
E33042141,596,488,112,376,7,30,11,19,70,64,2,3,1,1
E33042142,437,332,96,236,2,36,23,13,66,56,3,3,4,1
E33042143,344,289,58,231,0,12,6,6,42,40,0,2,0,1
E33042144,340,278,69,209,0,9,5,4,52,47,0,5,0,1
E33042145,393,337,74,263,4,11,6,5,40,36,1,2,1,1
E33042146,637,525,161,364,6,41,25,16,63,56,1,4,2,2
E33042147,321,255,68,187,6,18,11,7,40,36,0,4,0,2
E33042148,359,292,76,216,2,23,18,5,42,38,3,1,0,0
E33042149,573,457,149,308,4,33,22,11,77,63,4,10,0,2
E33042150,439,379,104,275,8,12,6,6,39,36,0,2,1,1
E33042151,432,330,87,243,3,23,16,7,72,68,1,2,1,4
E33042152,554,408,134,274,6,52,37,15,81,57,6,8,10,7
E33042153,347,261,86,175,3,25,17,8,50,45,0,4,1,8
E33042154,317,248,68,180,3,24,15,9,39,33,4,2,0,3
E33042155,578,468,122,346,14,20,11,9,69,60,5,3,1,7
E33042156,688,525,142,383,7,47,20,27,107,89,4,9,5,2
E33042157,702,513,143,370,5,62,31,31,118,106,2,7,3,4
E33042158,271,209,63,146,2,10,5,5,43,37,1,5,0,7
E33042159,477,378,97,281,2,39,19,20,56,48,3,4,1,2
E33042160,283,214,56,158,0,29,20,9,32,26,3,0,3,8
E33042161,425,332,75,257,5,22,13,9,57,46,2,9,0,9
E33042162,290,195,54,141,7,46,24,22,42,36,2,3,1,0
E33042163,312,247,62,185,3,20,15,5,39,30,2,7,0,3
E33042164,609,503,143,360,3,30,13,17,72,45,15,8,4,1
E33042165,275,217,72,145,2,15,9,6,38,30,2,2,4,3
E33042166,362,286,70,216,1,22,12,10,50,38,6,3,3,3
E33042167,351,297,79,218,0,14,13,1,39,32,2,2,3,1
E33042168,311,249,72,177,3,10,5,5,47,44,1,2,0,2
E33042169,496,438,134,304,2,18,15,3,38,31,3,3,1,0
E33042170,372,275,55,220,0,37,29,8,59,52,2,5,0,1
E33042171,533,331,81,250,8,58,26,32,125,114,3,8,0,11
E33042172,555,401,94,307,5,76,59,17,70,59,2,8,1,3
E33042173,265,181,43,138,7,27,13,14,49,38,2,9,0,1
E33042174,468,341,85,256,4,34,19,15,85,72,1,11,1,4
E33042175,631,490,132,358,5,47,27,20,87,77,3,5,2,2
E33042176,453,351,99,252,0,48,36,12,53,45,2,6,0,1
E33042177,388,304,83,221,0,36,32,4,47,33,1,9,4,1
E33042178,335,270,79,191,1,20,17,3,41,37,1,2,1,3
E33042179,361,302,81,221,2,22,14,8,34,31,1,1,1,1
E33042180,272,231,72,159,1,14,8,6,26,23,1,1,1,0
E33042181,530,419,118,301,4,37,23,14,68,63,3,2,0,2
E33042182,551,410,114,296,7,37,18,19,94,79,9,5,1,3
E33042183,452,361,116,245,3,12,7,5,75,42,18,3,12,1
E33042184,379,299,83,216,0,25,16,9,50,40,5,5,0,5
E33042185,314,277,87,190,0,6,3,3,29,21,2,5,1,2
E33042186,344,223,46,177,8,66,46,20,36,27,5,2,2,11
E33042187,439,306,64,242,6,59,34,25,67,55,6,5,1,1
E33042188,451,362,83,279,2,48,34,14,37,31,3,1,2,2
E33042189,481,381,87,294,3,20,7,13,75,71,0,3,1,2
E33042190,1334,1025,252,773,13,68,43,25,223,197,1,21,4,5
E33042191,337,231,43,188,4,58,41,17,40,23,7,4,6,4
E33042192,339,241,57,184,2,51,38,13,43,32,4,3,4,2
E33042193,418,355,77,278,3,19,6,13,40,33,2,4,1,1
E33042194,409,289,59,230,4,42,19,23,73,62,7,3,1,1
E33042195,418,334,97,237,2,30,18,12,50,42,3,3,2,2
E33042196,365,179,42,137,6,109,12,97,71,55,9,3,4,0
E33042197,306,197,41,156,2,33,7,26,69,29,17,2,21,5
E33042198,435,233,56,177,5,54,28,26,141,63,42,6,30,2
E33042199,466,302,63,239,4,74,43,31,79,67,3,6,3,7
E33042200,484,326,77,249,13,45,22,23,98,87,1,9,1,2
E33042201,324,240,39,201,0,21,10,11,62,54,3,5,0,1
E33042202,330,253,72,181,5,16,4,12,54,44,5,5,0,2
E33042203,371,296,74,222,8,17,9,8,47,39,3,5,0,3
E33042204,319,230,68,162,1,24,8,16,61,21,29,3,8,3
E33042205,349,276,66,210,10,19,6,13,42,35,3,4,0,2
E33042206,446,308,94,214,5,45,21,24,83,71,7,2,3,5
E33042207,348,275,71,204,7,14,8,6,48,36,3,4,5,4
E33042208,266,170,44,126,5,50,36,14,40,36,2,2,0,1
E33042209,923,717,147,570,9,49,28,21,142,96,25,7,14,6
E33042210,240,167,35,132,7,20,11,9,44,38,2,4,0,2
E33042211,642,392,115,277,5,137,91,46,106,85,4,12,5,2
E33042212,414,299,76,223,1,50,21,29,59,53,1,5,0,5
E33042213,667,479,120,359,7,70,27,43,109,90,3,12,4,2
E33042214,579,391,88,303,3,41,17,24,106,91,3,7,5,38
E33042215,644,427,126,301,7,76,33,43,130,115,3,11,1,4
E33042216,365,240,63,177,1,31,12,19,85,71,2,10,2,8
E33042217,367,285,69,216,3,33,25,8,44,33,3,7,1,2
E33042218,239,152,34,118,3,14,4,10,68,63,0,5,0,2
E33042219,421,267,55,212,5,51,34,17,98,93,1,4,0,0
E33042220,442,346,87,259,2,35,12,23,57,51,4,2,0,2
E33042221,263,228,52,176,0,8,1,7,26,23,0,2,1,1
E33042222,292,216,63,153,3,16,11,5,53,48,2,2,1,4
E33042223,586,446,119,327,6,28,10,18,101,77,13,5,6,5
E33042224,301,227,48,179,0,12,3,9,59,33,10,11,5,3
E33042225,249,189,61,128,1,19,11,8,40,37,0,3,0,0
E33042226,318,270,76,194,1,9,3,6,37,33,2,2,0,1
E33042227,356,266,81,185,2,16,10,6,67,55,7,3,2,5
E33042228,557,429,137,292,6,65,36,29,56,49,6,1,0,1
E33042229,275,208,72,136,1,32,21,11,34,28,3,1,2,0
E33042230,645,465,127,338,9,50,32,18,119,69,31,3,16,2
E33042231,276,218,56,162,0,14,10,4,44,39,2,2,1,0
E33042232,451,368,96,272,0,22,1,21,58,44,6,6,2,3
E33042233,633,523,149,374,7,51,4,47,49,42,2,4,1,3
E33042234,441,330,83,247,12,46,3,43,52,50,0,1,1,1
E33042235,297,214,66,148,3,20,1,19,55,51,3,0,1,5
E33042236,314,277,77,200,1,23,0,23,12,10,0,2,0,1
E33042237,342,295,81,214,3,10,0,10,34,32,1,1,0,0
E33042238,462,376,88,288,6,31,2,29,44,41,2,1,0,5
E33042239,813,628,182,446,10,61,11,50,110,97,1,5,7,4
E33042240,301,288,91,197,0,2,1,1,11,10,0,1,0,0
E33042241,356,295,92,203,5,13,1,12,39,37,0,2,0,4
E33042242,639,548,135,413,2,19,2,17,67,59,2,3,3,3
E33042243,425,334,98,236,5,46,11,35,36,32,0,2,2,4
E33042244,284,240,66,174,3,11,2,9,29,24,4,1,0,1
E33042245,358,272,54,218,6,50,5,45,30,26,1,3,0,0
E33042246,1185,724,222,502,11,104,28,76,338,121,123,15,79,8
E33042247,405,352,82,270,1,12,1,11,39,34,2,0,3,1
E33042248,435,326,83,243,3,38,13,25,65,59,1,2,3,3
E33042249,741,605,145,460,5,30,7,23,99,90,3,5,1,2
E33042250,669,536,154,382,4,42,12,30,82,72,3,3,4,5
E33042251,265,198,66,132,1,27,8,19,33,28,1,2,2,6
E33042252,447,356,95,261,2,40,2,38,48,44,0,2,2,1
E33042253,274,211,54,157,0,32,1,31,29,26,2,1,0,2
E33042254,656,430,116,314,10,56,12,44,135,113,12,7,3,25
E33042255,272,204,37,167,1,5,1,4,60,56,2,2,0,2
E33042256,520,403,96,307,6,24,5,19,80,73,1,3,3,7
E33042257,456,303,96,207,6,49,12,37,94,85,2,4,3,4
E33042258,558,380,82,298,16,69,4,65,88,78,4,5,1,5
E33042259,314,240,51,189,1,7,2,5,63,60,1,2,0,3
E33042260,363,281,39,242,17,16,2,14,49,49,0,0,0,0
E33042261,321,270,82,188,8,21,1,20,21,18,0,1,2,1
E33042262,313,230,52,178,9,26,2,24,48,40,1,7,0,0
E33042263,390,285,82,203,6,36,1,35,60,56,1,2,1,3
E33042264,248,203,51,152,3,16,4,12,25,25,0,0,0,1
E33042265,369,255,78,177,5,33,3,30,74,59,8,4,3,2
E33042266,361,280,86,194,5,27,2,25,46,38,1,5,2,3
E33042267,683,552,162,390,5,39,5,34,84,75,4,2,3,3
E33042268,440,384,103,281,1,16,4,12,38,31,1,4,2,1
E33042269,383,339,122,217,4,8,4,4,29,26,0,3,0,3
E33042270,425,324,111,213,6,44,5,39,49,36,8,3,2,2
E33042271,403,267,75,192,6,32,4,28,95,88,4,3,0,3
E33042272,317,248,60,188,5,37,1,36,25,22,2,1,0,2
E33042273,273,240,74,166,3,12,4,8,18,17,1,0,0,0
E33042274,296,227,55,172,5,16,2,14,40,35,0,5,0,8
E33042275,330,275,83,192,0,26,2,24,27,20,1,4,2,2
E33042276,401,338,105,233,2,23,4,19,38,33,1,3,1,0
E33042277,368,302,93,209,1,27,0,27,35,30,3,2,0,3
E33042278,353,294,68,226,3,16,1,15,36,26,6,1,3,4
E33042279,302,222,59,163,2,28,4,24,50,35,4,1,10,0
E33042280,368,299,66,233,7,8,1,7,51,47,1,2,1,3
E33042281,293,223,67,156,3,25,4,21,33,32,1,0,0,9
E33042282,620,446,128,318,7,49,11,38,115,69,32,5,9,3
E33042283,282,220,78,142,3,27,6,21,32,30,1,1,0,0
E33042284,300,175,74,101,1,34,1,33,38,20,12,2,4,52
E33042285,258,116,41,75,2,15,1,14,119,40,56,1,22,6
E33042286,266,183,70,113,3,30,3,27,45,32,7,3,3,5
E33042287,526,370,132,238,5,47,6,41,93,65,13,3,12,11
E33042288,266,200,66,134,4,18,1,17,39,35,2,2,0,5
E33042289,411,303,82,221,5,42,6,36,58,45,6,6,1,3
E33042290,470,339,80,259,3,69,28,41,58,48,2,7,1,1
E33042291,361,305,72,233,2,24,14,10,27,25,0,2,0,3
E33042292,272,224,59,165,2,18,11,7,27,23,0,4,0,1
E33042293,399,328,89,239,2,28,12,16,41,36,0,5,0,0
E33042294,349,295,83,212,1,9,6,3,40,37,0,3,0,4
E33042295,474,388,94,294,0,9,1,8,73,67,0,6,0,4
E33042296,478,329,62,267,1,97,21,76,49,46,0,3,0,2
E33042297,459,358,86,272,1,35,20,15,63,59,0,3,1,2
E33042298,305,232,59,173,1,44,8,36,27,24,0,3,0,1
E33042299,854,559,139,420,13,201,140,61,78,65,2,10,1,3
E33042300,341,251,64,187,2,36,4,32,50,45,0,5,0,2
E33042301,289,196,44,152,1,47,14,33,42,39,2,1,0,3
E33042302,528,395,98,297,4,66,19,47,58,49,2,6,1,5
E33042303,343,204,47,157,4,101,82,19,30,26,1,3,0,4
E33042304,784,433,112,321,1,256,185,71,87,80,1,6,0,7
E33042305,541,375,71,304,1,98,54,44,66,59,1,6,0,1
E33042306,420,292,73,219,9,80,59,21,39,35,0,4,0,0
E33042307,350,217,58,159,1,90,58,32,37,31,1,4,1,5
E33042308,350,246,52,194,4,67,44,23,33,26,0,6,1,0
E33042309,336,221,54,167,2,75,44,31,36,34,0,2,0,2
E33042310,462,256,57,199,2,128,86,42,73,66,0,5,2,3
E33042311,460,335,87,248,2,64,49,15,55,49,0,4,2,4
E33042312,1518,1261,345,916,8,94,39,55,150,131,7,11,1,5
E33042313,370,272,56,216,3,42,28,14,49,41,2,4,2,4
E33042314,363,325,60,265,1,13,7,6,22,18,2,2,0,2
E33042315,460,318,103,215,0,42,12,30,97,78,4,14,1,3
E33042316,342,258,85,173,3,36,9,27,43,35,1,7,0,2
E33042317,403,327,128,199,1,24,8,16,49,41,2,5,1,2
E33042318,380,265,90,175,3,55,22,33,55,42,5,2,6,2
E33042319,532,404,131,273,3,53,23,30,68,61,3,3,1,4
E33042320,516,379,149,230,4,41,17,24,87,76,4,3,4,5
E33042321,250,205,67,138,2,20,8,12,20,15,1,4,0,3
E33042322,372,296,93,203,2,28,15,13,45,40,2,3,0,1
E33042323,468,359,87,272,3,31,10,21,73,64,2,7,0,2
E33042324,327,224,79,145,5,45,20,25,50,45,3,1,1,3
E33042325,513,395,101,294,3,37,18,19,73,68,0,4,1,5
E33042326,247,190,37,153,4,23,4,19,30,23,0,6,1,0
E33042327,424,326,109,217,3,34,21,13,56,46,3,6,1,5
E33042328,510,391,125,266,1,48,13,35,69,54,3,12,0,1
E33042329,618,460,148,312,1,40,16,24,105,87,5,7,6,12
E33042330,347,262,74,188,0,27,6,21,52,47,0,3,2,6
E33042331,452,313,107,206,3,45,16,29,88,79,0,9,0,3
E33042332,478,371,120,251,4,42,7,35,60,48,3,7,2,1
E33042333,374,281,95,186,3,29,8,21,58,51,2,4,1,3
E33042334,416,307,102,205,0,25,10,15,83,75,0,7,1,1
E33042335,397,288,102,186,1,36,16,20,67,54,4,9,0,5
E33042336,355,234,73,161,1,37,7,30,76,71,1,2,2,7
E33042337,338,247,108,139,0,25,11,14,61,55,0,6,0,5
E33042338,365,234,93,141,4,44,23,21,71,55,13,3,0,12
E33042339,318,158,59,99,0,28,22,6,92,70,18,3,1,40
E33042340,397,311,88,223,0,29,24,5,50,41,1,5,3,7
E33042341,243,200,107,93,1,5,4,1,33,30,1,1,1,4
E33042342,428,328,126,202,5,27,15,12,60,55,0,5,0,8
E33042343,262,205,101,104,0,21,8,13,32,27,3,2,0,4
E33042344,308,236,84,152,1,16,12,4,52,47,1,4,0,3
E33042345,305,198,91,107,3,22,11,11,75,66,4,2,3,7
E33042346,578,416,148,268,2,46,27,19,107,94,3,6,4,7
E33042347,332,270,91,179,3,31,20,11,26,24,1,1,0,2
E33042348,415,321,97,224,0,45,26,19,47,40,0,7,0,2
E33042349,567,407,112,295,5,85,58,27,70,53,12,4,1,0
E33042350,341,270,65,205,0,19,13,6,48,41,2,5,0,4
E33042351,352,277,73,204,5,35,8,27,34,34,0,0,0,1
E33042352,321,273,57,216,1,13,8,5,32,29,1,2,0,2
E33042353,481,337,90,247,5,59,18,41,78,70,5,2,1,2
E33042354,387,259,75,184,4,51,25,26,69,69,0,0,0,4
E33042355,398,272,75,197,2,36,24,12,85,82,1,1,1,3
E33042356,256,182,53,129,2,23,8,15,48,41,2,2,3,1
E33042357,307,249,67,182,2,16,7,9,39,36,1,1,1,1
E33042358,336,230,61,169,5,59,40,19,41,38,0,3,0,1
E33042359,414,266,68,198,4,65,37,28,75,65,2,6,2,4
E33042360,752,590,170,420,10,74,48,26,76,68,1,6,1,2
E33042361,496,391,86,305,5,35,13,22,63,60,0,3,0,2
E33042362,534,396,95,301,4,36,19,17,94,82,2,10,0,4
E33042363,394,316,82,234,1,23,15,8,51,45,1,4,1,3
E33042364,256,223,84,139,0,9,5,4,22,18,0,4,0,2
E33042365,359,270,93,177,2,41,21,20,43,37,0,6,0,3
E33042366,285,220,77,143,2,26,11,15,34,29,2,1,2,3
E33042367,495,381,132,249,2,52,36,16,58,51,1,4,2,2
E33042368,503,406,125,281,7,37,21,16,48,39,3,4,2,5
E33042369,458,373,130,243,3,23,12,11,52,43,3,3,3,7
E33042370,371,266,75,191,3,41,33,8,60,56,1,3,0,1
E33042371,527,357,138,219,3,34,15,19,120,85,29,3,3,13
E33042372,317,222,83,139,3,19,7,12,63,54,2,7,0,10
E33042373,461,332,109,223,1,30,23,7,83,76,4,3,0,15
E33042374,281,196,86,110,4,22,13,9,47,46,0,0,1,12
E33042375,534,381,126,255,2,72,36,36,76,67,4,4,1,3
E33042376,388,298,62,236,4,22,5,17,64,43,13,6,2,0
E33042377,513,347,106,241,6,81,43,38,74,62,0,10,2,5
E33042378,953,684,197,487,9,105,50,55,149,125,11,13,0,6
E33042379,401,315,81,234,7,32,15,17,44,40,1,1,2,3
E33042380,570,426,114,312,8,66,37,29,61,51,2,6,2,9
E33042381,293,227,79,148,6,16,12,4,44,40,2,2,0,0
E33042382,281,212,68,144,3,19,12,7,45,43,0,2,0,2
E33042383,292,232,70,162,1,32,19,13,24,20,2,2,0,3
E33042384,306,250,94,156,0,15,4,11,41,32,0,8,1,0
E33042385,345,266,103,163,3,19,8,11,51,46,0,5,0,6
E33042386,343,250,89,161,3,13,7,6,68,62,1,5,0,9
E33042387,323,273,113,160,2,14,8,6,31,28,1,1,1,3
E33042388,270,210,78,132,3,15,11,4,41,36,0,5,0,1
E33042389,328,228,68,160,2,22,7,15,75,63,2,4,6,1
E33042390,312,273,109,164,4,8,4,4,25,22,0,3,0,2
E33042391,319,214,62,152,6,58,39,19,40,35,1,2,2,1
E33042392,488,357,106,251,2,76,56,20,51,43,0,6,2,2
E33042393,260,172,46,126,2,31,20,11,53,41,3,4,5,2
E33042394,504,410,144,266,5,42,24,18,40,34,2,4,0,7
E33042395,392,262,82,180,4,27,16,11,96,90,3,3,0,3
E33042396,399,295,73,222,6,24,12,12,74,68,1,5,0,0
E33042397,326,227,61,166,2,23,6,17,72,62,2,7,1,2
E33042398,323,210,45,165,2,26,8,18,78,71,1,6,0,7
E33042399,335,238,74,164,4,21,9,12,67,57,0,9,1,5
E33042400,566,424,117,307,3,53,39,14,79,71,2,6,0,7
E33042401,280,204,73,131,2,29,12,17,43,38,0,5,0,2
E33042402,372,279,82,197,4,39,31,8,49,46,0,1,2,1
E33042403,635,441,129,312,2,111,44,67,72,62,1,6,3,9
E33042404,899,611,160,451,8,97,58,39,181,170,1,10,0,2
E33042405,490,348,78,270,1,69,46,23,69,61,1,7,0,3
E33042406,385,276,79,197,4,62,22,40,39,35,0,2,2,4
E33042407,2893,2285,573,1712,25,181,86,95,394,358,3,28,5,8
E33042408,292,238,89,149,3,11,4,7,38,33,1,4,0,2
E33042409,413,334,111,223,0,44,21,23,32,27,0,4,1,3
E33042410,501,323,106,217,3,66,41,25,100,81,5,10,4,9
E33042411,663,457,152,305,4,96,61,35,93,83,7,2,1,13
E33042412,246,175,77,98,0,19,16,3,42,42,0,0,0,10
E33042413,377,234,97,137,2,59,37,22,80,70,5,5,0,2
E33042414,466,340,134,206,7,26,15,11,87,72,8,7,0,6
E33042415,549,448,204,244,3,38,22,16,53,48,2,0,3,7
E33042416,337,232,87,145,3,33,22,11,61,44,7,5,5,8
E33042417,288,238,86,152,1,17,8,9,31,24,4,1,2,1
E33042418,327,246,90,156,3,18,7,11,48,40,4,4,0,12
E33042419,292,211,86,125,1,24,13,11,52,47,0,3,2,4
E33042420,529,370,137,233,3,39,15,24,98,86,7,5,0,19
E33042421,331,277,84,193,0,15,12,3,39,37,2,0,0,0
E33042422,472,317,151,166,3,59,36,23,82,77,1,4,0,11
E33042423,551,365,148,217,4,59,25,34,104,90,4,8,2,19
E33042424,411,299,123,176,4,33,26,7,70,63,2,5,0,5
E33042425,261,155,59,96,2,30,24,6,67,61,2,4,0,7
E33042426,274,166,61,105,2,33,19,14,70,62,2,5,1,3
E33042427,365,263,84,179,2,19,12,7,77,71,1,5,0,4
E33042428,362,203,81,122,1,22,19,3,93,81,6,3,3,43
E33042429,392,265,108,157,2,45,34,11,69,52,11,6,0,11
E33042430,344,263,110,153,0,23,10,13,50,41,5,2,2,8
E33042431,257,207,81,126,0,20,14,6,28,23,0,3,2,2
E33042432,321,272,105,167,1,11,8,3,35,32,0,3,0,2
E33042433,361,286,84,202,0,22,16,6,51,39,6,5,1,2
E33042434,315,245,66,179,3,17,6,11,46,41,0,4,1,4
E33042435,297,238,85,153,2,23,12,11,29,27,0,2,0,5
E33042436,312,242,92,150,2,30,17,13,36,27,0,8,1,2
E33042437,389,276,78,198,8,29,18,11,75,71,3,1,0,1
E33042438,406,285,106,179,2,38,19,19,79,73,3,3,0,2
E33042439,344,202,56,146,4,90,74,16,45,38,0,5,2,3
E33042440,396,261,91,170,9,65,49,16,60,53,1,6,0,1
E33042441,410,287,93,194,6,57,45,12,56,52,0,4,0,4
E33042442,356,266,95,171,1,17,13,4,69,63,1,1,4,3
E33042443,303,215,73,142,2,55,23,32,29,27,0,2,0,2
E33042444,404,263,81,182,5,53,42,11,79,68,5,6,0,4
E33042445,587,398,136,262,4,99,70,29,80,73,0,7,0,6
E33042446,422,308,112,196,3,54,34,20,47,45,0,2,0,10
E33042447,378,236,75,161,2,56,29,27,81,71,2,6,2,3
E33042448,301,184,70,114,2,40,23,17,72,69,1,1,1,3
E33042449,452,332,113,219,6,35,18,17,77,70,1,6,0,2
E33042450,542,375,127,248,2,66,41,25,98,91,1,6,0,1
E33042451,324,230,74,156,4,24,16,8,63,56,2,5,0,3
E33042452,423,316,106,210,9,32,21,11,62,51,1,5,5,4
E33042453,240,183,84,99,1,9,3,6,38,34,4,0,0,9
E33042454,306,250,83,167,2,13,9,4,35,33,0,2,0,6
E33042455,441,311,119,192,2,29,18,11,94,82,6,5,1,5
E33042456,306,240,90,150,0,1,0,1,64,57,4,3,0,1
E33042457,241,157,63,94,0,27,18,9,55,49,2,1,3,2
E33042458,300,237,84,153,3,25,13,12,29,25,4,0,0,6
E33042459,301,226,79,147,2,9,2,7,54,49,1,3,1,10
E33042460,296,227,111,116,8,13,10,3,44,41,2,0,1,4
E33042461,275,179,68,111,2,40,34,6,49,40,5,4,0,5
E33042462,250,178,80,98,3,12,6,6,56,49,3,4,0,1
E33042463,403,304,127,177,4,21,15,6,70,62,3,2,3,4
E33042464,372,252,106,146,0,41,30,11,76,67,4,5,0,3
E33042465,278,171,53,118,0,53,6,47,47,35,8,2,2,7
E33042466,637,466,110,356,12,63,11,52,91,69,5,14,3,5
E33042467,574,448,86,362,3,70,8,62,48,43,1,1,3,5
E33042468,453,235,34,201,16,125,23,102,53,44,2,6,1,24
E33042469,433,270,54,216,2,96,10,86,61,50,0,9,2,4
E33042470,327,274,65,209,1,16,2,14,33,25,3,3,2,3
E33042471,282,244,47,197,3,6,1,5,29,18,1,2,8,0
E33042472,473,405,76,329,4,20,3,17,44,35,0,8,1,0
E33042473,347,270,70,200,1,18,4,14,53,43,4,3,3,5
E33042474,704,499,97,402,8,73,9,64,118,95,6,12,5,6
E33042475,326,251,63,188,10,29,9,20,34,33,1,0,0,2
E33042476,392,336,103,233,2,16,2,14,33,26,5,1,1,5
E33042477,569,392,87,305,5,64,9,55,105,89,2,7,7,3
E33042478,381,284,65,219,7,44,6,38,44,38,3,0,3,2
E33042479,323,270,69,201,7,14,6,8,28,22,1,5,0,4
E33042480,2102,1586,310,1276,22,80,16,64,410,394,4,7,5,4
E33042481,427,341,73,268,10,16,3,13,60,56,1,3,0,0
E33042482,608,458,125,333,12,53,8,45,79,69,4,4,2,6
E33042483,326,200,38,162,8,67,9,58,50,34,4,8,4,1
E33042484,355,284,81,203,6,19,2,17,42,35,5,2,0,4
E33042485,261,191,47,144,0,26,8,18,40,33,2,5,0,4
E33042486,385,303,83,220,2,38,5,33,41,34,2,2,3,1
E33042487,405,303,77,226,6,17,6,11,78,63,1,12,2,1
E33042488,277,203,48,155,6,26,1,25,39,34,1,1,3,3
E33042489,701,292,76,216,8,88,27,61,313,79,131,4,99,0
E33042490,471,310,81,229,6,67,10,57,87,79,2,1,5,1
E33042491,455,353,100,253,5,20,5,15,74,57,4,6,7,3
E33042492,272,170,43,127,1,30,4,26,69,58,3,4,4,2
E33042493,449,279,71,208,12,62,19,43,90,72,7,6,5,6
E33042494,365,271,59,212,2,36,11,25,55,46,0,8,1,1
E33042495,381,240,60,180,5,37,7,30,97,50,28,5,14,2
E33042496,776,548,95,453,9,55,14,41,161,139,10,8,4,3
E33042497,569,312,70,242,15,70,11,59,170,143,15,7,5,2
E33042498,392,239,68,171,4,46,14,32,102,87,1,10,4,1
E33042499,612,302,77,225,5,110,38,72,194,89,54,5,46,1
E33042500,2521,1859,366,1493,20,151,41,110,483,382,48,26,27,8
E33042501,430,263,74,189,14,70,17,53,81,73,2,4,2,2
E33042502,253,165,44,121,19,26,3,23,39,35,1,2,1,4
E33042503,528,279,55,224,8,58,15,43,180,63,69,3,45,3
E33042504,839,523,149,374,14,81,20,61,216,112,62,8,34,5
E33042505,373,277,65,212,12,20,2,18,58,35,13,6,4,6
E33042506,341,249,58,191,6,19,11,8,66,58,5,3,0,1
E33042507,330,207,35,172,5,65,12,53,51,38,3,6,4,2
E33042508,469,306,68,238,6,45,12,33,108,82,5,16,5,4
E33042509,581,399,130,269,6,89,29,60,86,80,2,4,0,1
E33042510,282,204,35,169,5,25,5,20,44,38,2,4,0,4
E33042511,291,229,45,184,1,29,5,24,32,26,2,3,1,0
E33042512,408,300,80,220,2,33,4,29,68,65,0,2,1,5
E33042513,278,179,58,121,2,24,7,17,71,60,2,3,6,2
E33042514,728,471,111,360,12,66,13,53,171,144,12,4,11,8
E33042515,287,226,66,160,1,18,4,14,41,38,0,2,1,1
E33042516,296,205,42,163,1,19,3,16,71,58,2,9,2,0
E33042517,347,273,64,209,2,21,9,12,44,39,1,2,2,7
E33042518,402,321,81,240,1,26,11,15,49,38,2,2,7,5
E33042519,842,600,160,440,9,114,38,76,113,102,2,8,1,6
E33042520,608,423,124,299,8,84,29,55,90,79,4,5,2,3
E33042521,275,192,53,139,3,48,6,42,29,24,1,0,4,3
E33042522,442,246,65,181,5,118,31,87,65,56,2,5,2,8
E33042523,233,152,55,97,1,13,4,9,53,39,10,1,3,14
E33042524,285,208,62,146,4,27,6,21,40,39,0,1,0,6
E33042525,397,304,59,245,0,35,7,28,57,51,1,4,1,1
E33042526,416,252,89,163,1,40,12,28,76,63,9,2,2,47
E33042527,664,457,93,364,9,94,31,63,100,85,5,8,2,4
E33042528,348,214,40,174,1,97,38,59,33,21,5,5,2,3
E33042529,326,212,48,164,3,71,29,42,39,32,5,1,1,1
E33042530,302,197,63,134,5,52,19,33,46,43,2,0,1,2
E33042531,457,335,93,242,2,51,13,38,64,53,4,5,2,5
E33042532,367,256,71,185,1,43,19,24,64,54,5,4,1,3
E33042533,631,386,120,266,15,94,37,57,128,110,11,5,2,8
E33042534,382,220,62,158,2,91,14,77,65,51,8,2,4,4
E33042535,322,237,68,169,1,32,8,24,49,45,1,3,0,3
E33042536,316,213,67,146,6,37,16,21,51,46,2,3,0,9
E33042537,489,361,76,285,6,58,22,36,63,54,4,2,3,1
E33042538,351,247,75,172,2,52,17,35,46,37,2,6,1,4
E33042539,411,312,96,216,2,43,15,28,54,41,9,2,2,0
E33042540,304,163,48,115,2,37,14,23,93,87,3,1,2,9
E33042541,475,316,85,231,2,54,12,42,93,68,18,3,4,10
E33042542,553,399,95,304,5,50,13,37,97,83,8,3,3,2
E33042543,660,439,104,335,8,92,27,65,115,99,5,6,5,6
E33042544,425,295,67,228,7,44,11,33,72,62,4,5,1,7
E33042545,518,364,123,241,2,58,18,40,81,67,2,7,5,13
E33042546,531,418,114,304,6,36,15,21,65,47,5,6,7,6
E33042547,270,199,58,141,2,24,7,17,42,33,4,2,3,3
E33042548,366,242,59,183,1,45,16,29,74,68,4,2,0,4
E33042549,329,264,85,179,1,9,2,7,52,44,0,8,0,3
E33042550,581,365,118,247,6,38,13,25,158,44,82,3,29,14
E33042551,270,181,51,130,0,22,9,13,60,47,4,4,5,7
E33042552,283,176,48,128,1,27,10,17,72,37,19,0,16,7
E33042553,1200,716,214,502,6,106,40,66,367,123,159,7,78,5
E33042554,354,262,97,165,1,41,13,28,43,34,6,1,2,7
E33042555,383,231,68,163,9,67,23,44,73,62,7,1,3,3
E33042556,341,223,56,167,10,40,11,29,60,47,5,5,3,8
E33042557,427,305,106,199,9,53,21,32,49,41,5,3,0,11
E33042558,561,376,116,260,3,56,25,31,104,81,11,3,9,22
E33042559,250,197,63,134,1,7,3,4,43,28,11,1,3,2
E33042560,360,196,71,125,0,30,14,16,65,61,3,0,1,69
E33042561,329,244,80,164,4,23,6,17,42,34,6,1,1,16
E33042562,330,212,78,134,2,34,8,26,61,50,7,0,4,21
E33042563,233,144,56,88,0,19,7,12,54,40,11,1,2,16
E33042564,242,157,49,108,1,20,9,11,38,25,9,1,3,26
E33042565,528,345,101,244,2,58,27,31,110,92,4,10,4,13
E33042566,274,196,66,130,3,26,8,18,38,32,2,1,3,11
E33042567,309,174,62,112,6,44,15,29,64,49,9,2,4,21
E33042568,302,211,88,123,3,21,4,17,54,41,9,1,3,13
E33042569,521,360,151,209,6,59,21,38,81,70,7,3,1,15
E33042570,712,495,180,315,14,47,14,33,119,86,21,6,6,37
E33042571,362,244,99,145,2,41,11,30,67,55,5,3,4,8
E33042572,291,212,87,125,1,39,7,32,38,35,1,2,0,1
E33042573,236,162,53,109,2,24,12,12,46,44,2,0,0,2
E33042574,279,243,73,170,2,4,1,3,25,24,1,0,0,5
E33042575,314,257,93,164,1,13,7,6,38,32,2,4,0,5
E33042576,327,230,79,151,5,44,20,24,44,40,0,4,0,4
E33042577,645,440,112,328,2,67,31,36,135,126,1,6,2,1
E33042578,489,342,86,256,5,58,17,41,79,73,2,3,1,5
E33042579,322,240,101,139,0,19,6,13,59,58,0,1,0,4
E33042580,488,388,112,276,4,37,21,16,53,47,0,4,2,6
E33042581,470,337,115,222,3,37,14,23,88,77,2,6,3,5
E33042582,288,198,67,131,0,32,16,16,57,48,2,5,2,1
E33042583,265,197,56,141,1,13,5,8,51,48,0,3,0,3
E33042584,346,263,61,202,2,43,20,23,35,29,1,5,0,3
E33042585,336,240,84,156,4,25,8,17,61,55,1,3,2,6
E33042586,418,350,103,247,3,31,8,23,33,28,1,3,1,1
E33042587,259,199,86,113,2,20,4,16,32,25,6,1,0,6
E33042588,832,630,182,448,11,70,32,38,115,109,0,5,1,6
E33042589,173,127,42,85,0,12,4,8,28,22,1,4,1,6
E33042590,228,162,71,91,0,15,11,4,48,25,21,1,1,3
E33042591,613,455,176,279,13,36,13,23,92,74,16,2,0,17
E33042592,788,590,180,410,6,64,24,40,121,113,3,3,2,7
E33042593,353,268,108,160,0,36,17,19,47,26,13,7,1,2
E33042594,318,248,111,137,3,21,11,10,44,33,7,2,2,2
E33042595,374,315,81,234,1,17,4,13,39,34,0,4,1,2
E33042596,417,348,76,272,4,20,2,18,44,42,0,2,0,1
E33042597,322,268,67,201,3,16,6,10,33,31,0,2,0,2
E33042598,385,278,99,179,8,31,16,15,61,56,0,4,1,7
E33042599,315,217,68,149,2,44,29,15,50,43,4,3,0,2
E33042600,412,303,97,206,2,38,19,19,68,61,0,7,0,1
E33042601,366,308,92,216,1,14,11,3,41,38,1,1,1,2
E33042602,423,285,76,209,3,56,18,38,76,55,7,4,10,3
E33042603,382,219,67,152,3,34,14,20,107,99,1,2,5,19
E33042604,217,145,49,96,6,14,7,7,47,40,4,2,1,5
E33042605,416,307,115,192,11,15,4,11,79,35,30,1,13,4
E33042606,307,186,83,103,2,13,8,5,64,55,3,4,2,42
E33042607,391,285,96,189,4,26,15,11,69,57,5,4,3,7
E33042608,422,293,99,194,5,64,41,23,55,45,3,5,2,5
E33042609,865,507,141,366,9,107,61,46,231,96,80,11,44,11
E33042610,214,145,50,95,4,10,4,6,48,38,3,5,2,7
E33042611,437,315,111,204,5,50,25,25,62,40,13,1,8,5
E33042612,574,428,127,301,4,42,23,19,97,88,4,5,0,3
E33042613,298,193,74,119,3,57,34,23,44,36,4,3,1,1
E33042614,1041,814,194,620,6,65,31,34,134,120,7,5,2,22
E33042615,354,281,96,185,0,21,8,13,50,38,10,2,0,2
E33042616,608,392,126,266,6,68,33,35,126,87,25,8,6,16
E33042617,538,367,133,234,13,54,33,21,95,85,5,5,0,9
E33042618,307,231,70,161,2,32,28,4,38,35,1,2,0,4
E33042619,244,133,69,64,2,30,17,13,62,45,8,0,9,17
E33042620,279,186,91,95,2,12,9,3,60,57,3,0,0,19
E33042621,332,224,96,128,5,26,13,13,59,51,2,6,0,18
E33042622,738,582,188,394,12,44,31,13,90,79,1,7,3,10
E33042623,291,180,67,113,8,41,26,15,57,47,5,4,1,5
E33042624,431,321,106,215,4,37,12,25,67,52,6,5,4,2
E33042625,291,222,75,147,1,40,29,11,24,23,0,1,0,4
E33042626,410,252,68,184,6,75,58,17,74,60,4,8,2,3
E33042627,274,211,65,146,2,22,10,12,36,31,3,2,0,3
E33042628,488,334,107,227,6,63,40,23,83,70,6,3,4,2
E33042629,448,270,67,203,3,96,78,18,79,70,2,6,1,0
E33042630,469,320,108,212,5,85,45,40,41,35,5,1,0,18
E33042631,281,191,65,126,2,57,50,7,27,25,1,0,1,4
E33042632,442,300,64,236,8,32,19,13,100,90,3,7,0,2
E33042633,373,207,50,157,6,83,60,23,75,68,1,3,3,2
E33042634,252,153,48,105,2,53,40,13,44,42,0,1,1,0
E33042635,431,287,92,195,2,60,30,30,77,65,3,6,3,5
E33042636,797,474,165,309,7,175,113,62,136,122,3,8,3,5
E33042637,315,220,63,157,3,26,13,13,63,51,8,4,0,3
E33042638,324,203,64,139,3,33,24,9,71,54,10,4,3,14
E33042639,336,214,75,139,6,48,26,22,66,58,1,7,0,2
E33042640,572,386,105,281,12,40,19,21,129,120,2,6,1,5
E33042641,329,215,68,147,3,34,23,11,77,69,2,6,0,0
E33042642,528,337,114,223,6,62,37,25,115,101,4,9,1,8
E33042643,422,262,93,169,4,48,19,29,104,91,2,11,0,4
E33042644,510,249,103,146,3,81,53,28,126,57,63,1,5,51
E33042645,1509,831,283,548,11,279,201,78,369,331,14,19,5,19
E33042646,249,208,79,129,1,16,9,7,24,24,0,0,0,0
E33042647,652,402,140,262,4,92,65,27,147,139,0,8,0,7
E33042648,1443,1198,287,911,2,30,15,15,202,193,1,6,2,11
E33042649,785,610,184,426,6,75,53,22,91,81,2,5,3,3
E33042650,484,354,109,245,4,47,37,10,74,66,1,6,1,5
E33042651,304,225,65,160,1,16,11,5,53,42,2,7,2,9
E33042652,247,196,68,128,1,21,15,6,26,22,0,4,0,3
E33042653,351,271,81,190,2,20,10,10,54,50,2,2,0,4
E33042654,430,334,106,228,2,26,21,5,53,45,3,5,0,15
E33042655,687,526,142,384,6,59,21,38,92,86,1,4,1,4
E33042656,490,364,120,244,1,41,18,23,72,56,6,8,2,12
E33042657,409,284,93,191,3,35,18,17,79,61,11,6,1,8
E33042658,311,255,71,184,1,20,12,8,31,24,5,2,0,4
E33042659,476,342,107,235,3,55,37,18,72,59,2,9,2,4
E33042660,256,177,68,109,0,25,14,11,50,46,1,3,0,4
E33042661,517,399,147,252,2,37,20,17,69,61,0,4,4,10
E33042662,301,219,70,149,0,31,16,15,48,43,0,2,3,3
E33042663,263,195,89,106,0,32,12,20,28,25,3,0,0,8
E33042664,396,308,114,194,0,34,15,19,54,49,1,2,2,0
E33042665,399,314,89,225,4,28,18,10,52,43,2,6,1,1
E33042666,290,217,79,138,1,19,6,13,41,35,1,4,1,12
E33042667,337,236,98,138,5,23,17,6,49,36,8,3,2,24
E33042668,319,245,101,144,4,20,9,11,44,35,1,5,3,6
E33042669,451,372,144,228,5,18,9,9,49,43,3,3,0,7
E33042670,349,277,85,192,0,49,37,12,23,19,3,1,0,0
E33042671,390,286,99,187,3,31,25,6,67,60,0,7,0,3
E33042672,417,305,84,221,0,46,27,19,63,57,0,6,0,3
E33042673,260,191,75,116,3,17,12,5,40,26,3,8,3,9
E33042674,381,304,99,205,4,34,23,11,36,32,0,3,1,3
E33042675,593,417,124,293,9,65,47,18,90,81,3,4,2,12
E33042676,697,491,168,323,11,53,32,21,134,119,1,13,1,8
E33042677,432,315,98,217,2,24,5,19,81,73,0,7,1,10
E33042678,535,413,102,311,6,51,30,21,57,52,1,3,1,8
E33042679,231,180,74,106,1,21,13,8,21,19,0,2,0,8
E33042680,484,346,72,274,10,42,17,25,80,74,1,5,0,6
E33042681,381,282,76,206,6,44,26,18,46,42,3,1,0,3
E33042682,342,230,62,168,5,30,12,18,72,62,4,5,1,5
E33042683,693,523,101,422,7,36,20,16,120,107,2,11,0,7
E33042684,300,254,97,157,0,17,7,10,28,23,2,1,2,1
E33042685,248,195,61,134,0,26,18,8,27,24,0,3,0,0
E33042686,353,290,101,189,2,22,11,11,34,29,1,4,0,5
E33042687,759,594,125,469,9,40,18,22,114,97,2,11,4,2
E33042688,323,266,68,198,2,26,20,6,26,23,0,3,0,3
E33042689,613,375,99,276,6,37,13,24,188,86,57,4,41,7
E33042690,321,229,79,150,3,28,24,4,54,42,5,2,5,7
E33042691,565,416,149,267,1,26,15,11,100,76,14,8,2,22
E33042692,375,259,91,168,7,41,27,14,60,55,3,2,0,8
E33042693,262,180,55,125,3,24,16,8,53,48,1,4,0,2
E33042694,273,204,77,127,1,26,16,10,34,31,1,2,0,8
E33042695,383,246,63,183,4,40,25,15,86,82,1,3,0,7
E33042696,299,207,82,125,4,23,15,8,58,49,7,0,2,7
E33042697,273,200,64,136,4,22,11,11,40,35,0,5,0,7
E33042698,435,334,103,231,4,25,17,8,65,58,0,2,5,7
E33042699,285,232,89,143,4,19,10,9,28,24,0,3,1,2
E33042700,307,223,68,155,5,30,22,8,46,42,0,4,0,3
E33042701,540,407,156,251,7,58,30,28,63,58,2,3,0,5
E33042702,598,448,173,275,5,59,33,26,80,73,2,5,0,6
E33042703,434,349,113,236,5,29,14,15,48,36,0,10,2,3
E33042704,290,226,84,142,1,25,19,6,37,35,0,2,0,1
E33042705,380,275,55,220,3,38,20,18,59,54,1,4,0,5
E33042706,466,325,91,234,4,56,39,17,79,71,2,5,1,2
E33042707,382,303,67,236,8,20,10,10,51,44,0,4,3,0
E33042708,283,224,41,183,4,10,6,4,42,41,0,1,0,3
E33042709,694,466,115,351,15,84,43,41,127,120,2,4,1,2
E33042710,261,188,51,137,7,28,10,18,33,27,2,4,0,5
E33042711,844,569,165,404,11,93,59,34,166,154,1,10,1,5
E33042712,686,563,137,426,12,23,18,5,83,78,0,4,1,5
E33042713,713,555,171,384,5,56,30,26,93,81,3,7,2,4
E33042714,325,224,42,182,3,23,11,12,69,61,1,4,3,6
E33042715,771,466,92,374,8,114,67,47,176,161,3,9,3,7
E33042716,706,516,138,378,8,60,30,30,118,104,3,10,1,4
E33042717,435,293,41,252,6,58,42,16,78,66,0,11,1,0
E33042718,1181,844,207,637,27,77,43,34,228,200,3,24,1,5
E33042719,336,258,79,179,5,26,19,7,46,39,0,7,0,1
E33042720,697,450,90,360,6,79,52,27,158,144,1,11,2,4
E33042721,493,349,83,266,6,55,29,26,81,72,0,8,1,2
E33042722,566,387,100,287,7,51,24,27,121,103,0,12,6,0
E33042723,460,318,96,222,4,51,26,25,80,73,3,4,0,7
E33042724,635,462,115,347,4,46,29,17,117,104,2,10,1,6
E33042725,339,229,52,177,1,34,19,15,72,64,0,7,1,3
E33042726,484,393,111,282,9,19,8,11,58,58,0,0,0,5
E33042727,337,240,64,176,0,39,30,9,53,48,0,4,1,5
E33042728,321,246,70,176,7,18,10,8,48,46,1,1,0,2
E33042729,300,215,64,151,1,27,17,10,54,50,0,4,0,3
E33042730,667,484,98,386,10,46,31,15,119,108,0,10,1,8
E33042731,862,586,135,451,11,135,111,24,125,112,1,12,0,5
E33042732,441,292,65,227,7,39,25,14,99,86,1,11,1,4
E33042733,879,577,122,455,10,165,93,72,121,108,0,12,1,6
E33042734,428,322,58,264,12,38,19,19,55,53,0,2,0,1
E33042735,337,219,47,172,11,28,19,9,79,76,0,3,0,0
E33042736,484,352,74,278,3,46,28,18,76,70,0,4,2,7
E33042737,829,341,76,265,7,80,50,30,400,369,3,20,8,1
E33042738,374,272,43,229,17,11,1,10,71,61,1,4,5,3
E33042739,416,325,63,262,8,22,16,6,61,55,0,5,1,0
E33042740,660,478,111,367,9,48,33,15,122,116,0,5,1,3
E33042741,362,292,76,216,2,24,10,14,39,35,1,1,2,5
E33042742,315,244,99,145,4,13,8,5,48,42,2,3,1,6
E33042743,259,211,72,139,1,13,5,8,30,25,0,2,3,4
E33042744,316,260,80,180,0,13,8,5,38,33,0,4,1,5
E33042745,246,193,69,124,3,15,9,6,31,27,1,2,1,4
E33042746,259,197,81,116,5,20,8,12,37,35,0,1,1,0
E33042747,356,265,73,192,1,27,15,12,59,51,3,2,3,4
E33042748,694,516,130,386,7,29,16,13,132,119,3,8,2,10
E33042749,363,288,111,177,3,23,15,8,44,38,1,3,2,5
E33042750,468,346,140,206,9,45,24,21,59,52,2,4,1,9
E33042751,486,383,134,249,6,46,27,19,45,37,0,7,1,6
E33042752,261,199,94,105,3,20,13,7,34,26,6,2,0,5
E33042753,383,308,122,186,7,20,11,9,46,43,0,3,0,2
E33042754,400,283,64,219,11,22,10,12,80,77,2,1,0,4
E33042755,368,277,72,205,6,26,18,8,52,42,1,7,2,7
E33042756,339,261,94,167,11,29,10,19,38,35,1,1,1,0
E33042757,333,276,97,179,1,15,8,7,39,33,2,4,0,2
E33042758,266,218,97,121,1,17,12,5,26,19,1,5,1,4
E33042759,373,271,86,185,1,49,38,11,44,39,0,5,0,8
E33042760,293,229,65,164,5,23,16,7,32,30,0,2,0,4
E33042761,292,205,61,144,2,28,17,11,52,49,0,1,2,5
E33042762,284,181,77,104,4,53,23,30,41,36,2,3,0,5
E33042763,429,339,95,244,11,21,12,9,52,51,1,0,0,6
E33042764,266,199,99,100,1,29,23,6,29,21,2,6,0,8
E33042765,383,291,98,193,4,22,13,9,60,54,0,5,1,6
E33042766,276,190,85,105,1,29,21,8,51,41,5,5,0,5
E33042767,389,280,101,179,3,55,39,16,48,41,0,4,3,3
E33042768,457,328,124,204,10,45,22,23,64,57,2,4,1,10
E33042769,333,257,114,143,1,37,21,16,33,28,1,3,1,5
E33042770,320,227,93,134,7,33,26,7,46,41,3,2,0,7
E33042771,473,356,118,238,3,29,16,13,79,69,2,8,0,6
E33042772,409,320,98,222,6,35,25,10,44,35,3,4,2,4
E33042773,240,169,53,116,1,12,12,0,55,50,0,5,0,3
E33042774,266,182,34,148,4,13,10,3,59,54,0,4,1,8
E33042775,342,225,68,157,2,22,14,8,90,81,2,6,1,3
E33042776,276,196,64,132,2,11,6,5,60,56,0,3,1,7
E33042777,263,203,66,137,0,15,8,7,41,39,1,1,0,4
E33042778,267,196,55,141,1,17,14,3,53,51,0,2,0,0
E33042779,225,178,79,99,2,3,1,2,39,33,5,1,0,3
E33042780,242,149,36,113,7,12,9,3,70,61,0,7,2,4
E33042781,412,340,83,257,5,12,7,5,54,46,0,8,0,1
E33042782,308,244,81,163,0,13,9,4,43,37,1,5,0,8
E33042783,459,367,120,247,6,18,12,6,65,60,4,1,0,3
E33042784,287,209,56,153,7,13,7,6,52,48,1,3,0,6
E33042785,447,360,98,262,4,26,19,7,55,52,0,3,0,2
E33042786,290,212,54,158,2,30,23,7,45,39,0,6,0,1
E33042787,512,399,122,277,3,31,22,9,73,66,0,7,0,6
E33042788,537,396,124,272,3,28,19,9,102,92,0,7,3,8
E33042789,310,261,55,206,3,11,7,4,34,31,0,2,1,1
E33042790,259,171,65,106,1,28,22,6,53,41,7,5,0,6
E33042791,377,300,77,223,3,20,17,3,52,42,2,8,0,2
E33042792,788,587,163,424,9,49,29,20,138,127,4,6,1,5
E33042793,307,254,83,171,3,6,3,3,40,34,0,6,0,4
E33042794,378,289,102,187,1,36,27,9,49,46,0,3,0,3
E33042795,298,253,65,188,1,12,6,6,29,28,1,0,0,3
E33042796,341,285,84,201,5,8,7,1,41,40,0,1,0,2
E33042797,759,630,172,458,5,41,31,10,79,73,0,4,2,4
E33042798,588,429,130,299,9,49,26,23,97,92,0,5,0,4
E33042799,284,202,56,146,8,22,1,21,48,45,0,3,0,4
E33042800,347,278,85,193,2,8,5,3,56,44,1,7,4,3
E33042801,383,334,81,253,3,6,5,1,39,32,1,3,3,1
E33042802,269,231,52,179,2,9,8,1,26,23,0,3,0,1
E33042803,309,230,73,157,0,18,8,10,54,49,0,5,0,7
E33042804,508,384,125,259,2,24,14,10,93,80,4,7,2,5
E33042805,451,353,98,255,6,27,16,11,62,50,0,7,5,3
E33042806,394,303,98,205,3,20,13,7,65,56,4,4,1,3
E33042807,643,453,156,297,9,49,30,19,128,118,0,10,0,4
E33042808,362,268,66,202,1,22,11,11,64,56,0,8,0,7
E33042809,630,444,129,315,4,34,20,14,145,138,2,3,2,3
E33042810,264,188,56,132,4,7,4,3,63,59,2,2,0,2
E33042811,278,224,90,134,1,10,8,2,40,34,1,3,2,3
E33042812,501,339,100,239,0,36,25,11,116,97,0,14,5,10
E33042813,341,296,79,217,1,15,7,8,23,18,0,5,0,6
E33042814,316,241,98,143,5,25,18,7,42,31,5,2,4,3
E33042815,902,687,150,537,7,31,16,15,170,147,1,20,2,7
E33042816,1373,1031,327,704,16,115,66,49,207,195,2,8,2,4
E33042817,259,183,78,105,1,21,20,1,48,38,2,7,1,6
E33042818,312,234,81,153,2,21,16,5,52,43,4,3,2,3
E33042819,323,245,93,152,2,18,11,7,46,32,4,7,3,12
E33042820,438,302,93,209,4,44,28,16,78,58,11,5,4,10
E33042821,412,231,58,173,5,67,52,15,104,98,1,3,2,5
E33042822,358,280,77,203,1,29,27,2,44,39,0,4,1,4
E33042823,726,540,168,372,3,56,32,24,119,111,2,6,0,8
E33042824,464,318,107,211,6,31,25,6,83,60,8,8,7,26
E33042825,318,218,87,131,1,19,7,12,70,65,0,1,4,10
E33042826,639,501,167,334,2,35,21,14,96,88,4,3,1,5
E33042827,671,528,199,329,2,41,27,14,74,60,7,7,0,26
E33042828,268,148,42,106,0,17,9,8,101,96,5,0,0,2
E33042829,422,238,85,153,3,75,19,56,102,86,4,9,3,4
E33042830,610,431,110,321,14,51,20,31,112,96,1,12,3,2
E33042831,471,287,93,194,3,53,39,14,126,122,0,4,0,2
E33042832,454,290,90,200,9,70,43,27,82,73,2,6,1,3
E33042833,328,108,33,75,2,61,36,25,154,39,47,6,62,3
E33042834,278,143,53,90,7,29,18,11,97,89,2,2,4,2
E33042835,667,422,156,266,5,74,47,27,158,121,6,15,16,8
E33042836,555,381,100,281,8,51,20,31,113,81,19,3,10,2
E33042837,715,412,128,284,11,94,52,42,188,173,1,9,5,10
E33042838,637,330,95,235,16,120,78,42,168,155,5,3,5,3
E33042839,260,158,63,95,2,33,20,13,63,62,0,0,1,4
E33042840,373,237,77,160,3,34,21,13,94,89,1,3,1,5
E33042841,437,338,78,260,5,31,24,7,62,59,0,1,2,1
E33042842,371,282,91,191,6,17,10,7,65,58,0,3,4,1
E33042843,302,188,65,123,7,27,14,13,76,67,1,5,3,4
E33042844,325,231,75,156,3,33,23,10,55,45,4,5,1,3
E33042845,576,442,94,348,7,21,17,4,103,97,0,4,2,3
E33042846,260,179,56,123,0,10,6,4,69,64,0,5,0,2
E33042847,507,316,74,242,4,43,21,22,137,128,4,1,4,7
E33042848,292,242,84,158,1,14,10,4,32,28,0,4,0,3
E33042849,293,229,84,145,2,10,4,6,49,43,2,2,2,3
E33042850,474,345,127,218,6,42,26,16,76,56,6,9,5,5
E33042851,408,316,108,208,4,42,16,26,42,39,1,2,0,4
E33042852,288,214,57,157,1,31,20,11,41,35,1,4,1,1
E33042853,494,334,106,228,3,40,30,10,107,100,3,3,1,10
E33042854,230,140,56,84,1,13,9,4,69,48,15,4,2,7
E33042855,284,212,77,135,5,27,19,8,32,28,0,3,1,8
E33042856,370,271,94,177,3,29,18,11,59,53,2,1,3,8
E33042857,292,182,54,128,2,25,15,10,72,61,8,2,1,11
E33042858,452,226,70,156,2,34,16,18,182,155,15,5,7,8
E33042859,287,174,44,130,1,77,57,20,33,29,1,3,0,2
E33042860,290,200,52,148,3,64,56,8,23,22,0,1,0,0
E33042861,438,325,68,257,10,56,34,22,46,44,0,2,0,1
E33042862,276,182,56,126,6,36,13,23,48,42,0,5,1,4
E33042863,430,316,51,265,9,30,12,18,72,67,2,3,0,3
E33042864,376,269,72,197,3,24,9,15,79,73,1,3,2,1
E33042865,328,184,40,144,8,30,16,14,106,104,1,1,0,0
E33042866,410,268,63,205,4,60,33,27,76,73,0,3,0,2
E33042867,666,391,84,307,5,105,75,30,163,135,23,4,1,2
E33042868,333,232,83,149,3,28,13,15,69,66,0,2,1,1
E33042869,443,295,81,214,8,53,23,30,87,83,1,3,0,0
E33042870,392,319,96,223,5,21,13,8,47,44,0,3,0,0
E33042871,596,457,143,314,10,38,12,26,88,82,1,4,1,3
E33042872,617,430,135,295,4,70,34,36,105,102,1,2,0,8
E33042873,528,375,90,285,5,42,25,17,105,98,1,6,0,1
E33042874,488,326,68,258,3,80,61,19,74,69,0,4,1,5
E33042875,481,291,60,231,17,71,39,32,102,101,0,0,1,0
E33042876,335,236,56,180,4,37,26,11,56,50,2,2,2,2
E33042877,362,220,57,163,2,36,23,13,102,85,0,3,14,2
E33042878,663,456,126,330,14,73,40,33,118,115,1,1,1,2
E33042879,489,348,86,262,3,33,22,11,100,74,0,11,15,5
E33042880,376,264,61,203,2,42,20,22,59,55,3,1,0,9
E33042881,392,238,53,185,9,45,32,13,97,94,0,3,0,3
E33042882,278,182,50,132,3,38,28,10,55,51,1,3,0,0
E33042883,376,258,54,204,2,64,57,7,49,45,1,2,1,3
E33042884,310,247,69,178,0,16,10,6,46,39,0,7,0,1
E33042885,408,355,79,276,0,13,7,6,38,32,1,4,1,2
E33042886,813,608,149,459,7,103,47,56,92,85,0,7,0,3
E33042887,342,284,89,195,1,12,8,4,44,39,3,2,0,1
E33042888,601,451,122,329,6,51,32,19,88,79,2,4,3,5
E33042889,277,191,39,152,2,37,25,12,47,42,0,5,0,0
E33042890,410,273,77,196,10,47,31,16,79,73,0,6,0,1
E33042891,2608,1954,514,1440,37,234,123,111,363,344,3,12,4,20
E33042892,403,258,57,201,9,63,35,28,72,66,0,6,0,1
E33042893,411,285,58,227,1,79,58,21,43,38,0,5,0,3
E33042894,246,176,53,123,4,33,15,18,31,28,0,3,0,2
E33042895,353,293,73,220,3,20,5,15,37,36,0,0,1,0
E33042896,329,275,76,199,1,24,17,7,26,26,0,0,0,3
E33042897,333,286,98,188,1,17,6,11,27,25,0,2,0,2
E33042898,308,243,84,159,1,19,10,9,43,34,5,2,2,2
E33042899,245,201,54,147,3,8,7,1,32,30,0,2,0,1
E33042900,482,369,110,259,7,47,25,22,58,53,0,3,2,1
E33042901,542,426,113,313,6,37,20,17,63,61,0,2,0,10
E33042902,531,384,102,282,12,38,24,14,92,88,2,2,0,5
E33042903,503,395,122,273,4,41,27,14,58,50,4,2,2,5
E33042904,511,382,101,281,4,73,58,15,48,33,1,14,0,4
E33042905,639,426,105,321,5,86,49,37,116,106,3,6,1,6
E33042906,275,237,84,153,1,6,4,2,28,25,0,1,2,3
E33042907,617,466,151,315,4,35,17,18,108,97,3,8,0,4
E33042908,223,143,52,91,1,10,9,1,60,59,0,1,0,9
E33042909,629,444,145,299,5,77,49,28,97,91,2,4,0,6
E33042910,973,751,215,536,6,73,40,33,139,131,1,6,1,4
E33042911,317,242,95,147,3,39,20,19,30,25,3,0,2,3
E33042912,498,366,140,226,6,53,25,28,66,58,4,4,0,7
E33042913,305,208,78,130,1,38,18,20,52,45,1,3,3,6
E33042914,282,191,79,112,1,13,7,6,66,43,19,3,1,11
E33042915,601,449,167,282,2,42,27,15,95,71,15,5,4,13
E33042916,262,198,78,120,0,21,11,10,39,35,2,1,1,4
E33042917,277,202,66,136,0,17,13,4,55,48,0,6,1,3
E33042918,674,481,158,323,1,47,33,14,137,121,5,10,1,8
E33042919,682,512,158,354,4,45,22,23,103,85,4,14,0,18
E33042920,490,339,114,225,1,37,33,4,109,101,2,4,2,4
E33042921,223,162,44,118,0,17,13,4,42,38,0,4,0,2
E33042922,370,249,88,161,0,63,37,26,53,45,1,5,2,5
E33042923,380,289,97,192,4,41,25,16,45,39,1,5,0,1
E33042924,249,177,43,134,0,31,23,8,40,36,0,4,0,1
E33042925,520,375,122,253,6,31,21,10,100,85,2,12,1,8
E33042926,525,380,115,265,2,40,30,10,98,91,2,3,2,5
E33042927,422,297,81,216,4,45,31,14,67,62,2,2,1,9
E33042928,245,191,89,102,0,11,7,4,42,39,0,1,2,1
E33042929,255,199,72,127,1,11,5,6,43,40,0,3,0,1
E33042930,367,254,91,163,2,22,8,14,83,78,1,4,0,6
E33042931,233,127,35,92,2,9,6,3,95,91,1,0,3,0
E33042932,249,180,55,125,1,9,6,3,57,56,0,1,0,2
E33042933,813,601,223,378,4,64,45,19,135,117,5,12,1,9
E33042934,548,393,139,254,4,45,31,14,87,73,3,9,2,19
E33042935,358,242,86,156,3,37,28,9,68,54,5,8,1,8
E33042936,379,291,77,214,0,27,22,5,56,43,0,10,3,5
E33042937,338,230,65,165,2,65,42,23,35,29,1,3,2,6
E33042938,299,176,55,121,3,43,34,9,73,67,3,2,1,4
E33042939,485,336,114,222,4,51,42,9,91,83,1,5,2,3
E33042940,324,210,50,160,4,56,38,18,49,47,1,1,0,5
E33042941,315,238,66,172,1,18,13,5,55,49,2,3,1,3
E33042942,554,402,125,277,0,33,25,8,113,105,1,5,2,6
E33042943,412,272,82,190,5,62,45,17,69,59,1,7,2,4
E33042944,262,182,72,110,1,32,22,10,44,42,0,2,0,3
E33042945,506,387,158,229,2,30,17,13,79,72,2,3,2,8
E33042946,412,317,110,207,3,29,20,9,59,43,3,7,6,4
E33042947,373,269,114,155,0,21,11,10,77,69,1,7,0,6
E33042948,401,308,112,196,3,31,23,8,49,39,3,7,0,10
E33042949,254,201,71,130,0,11,9,2,41,34,0,7,0,1
E33042950,229,170,54,116,0,16,11,5,30,23,3,4,0,13
E33042951,299,224,77,147,3,11,5,6,54,50,2,1,1,7
E33042952,249,193,74,119,6,8,3,5,36,25,5,5,1,6
E33042953,714,463,132,331,6,88,45,43,155,141,3,8,3,2
E33042954,436,277,77,200,3,41,29,12,112,102,2,3,5,3
E33042955,322,266,82,184,2,18,6,12,34,28,1,4,1,2
E33042956,712,536,132,404,10,55,23,32,107,96,2,6,3,4
E33042957,245,161,44,117,0,33,14,19,46,41,1,3,1,5
E33042958,305,260,82,178,3,5,4,1,35,28,0,5,2,2
E33042959,274,216,61,155,0,12,8,4,42,36,0,4,2,4
E33042960,289,210,57,153,2,28,21,7,48,43,0,3,2,1
E33042961,292,178,47,131,2,35,15,20,70,61,2,7,0,7
E33042962,453,294,82,212,4,88,68,20,64,59,1,3,1,3
E33042963,351,231,63,168,0,49,29,20,69,64,1,4,0,2
E33042964,330,241,75,166,2,31,17,14,53,43,4,4,2,3
E33042965,413,297,70,227,9,39,34,5,63,59,1,3,0,5
E33042966,532,394,90,304,4,35,28,7,92,72,4,13,3,7
E33042967,292,186,62,124,2,19,11,8,82,71,1,3,7,3
E33042968,427,287,77,210,5,49,22,27,86,78,0,8,0,0
E33042969,238,129,39,90,1,29,19,10,78,72,1,4,1,1
E33042970,506,345,92,253,4,45,30,15,106,98,2,5,1,6
E33042971,369,245,84,161,5,20,11,9,78,42,24,5,7,21
E33042972,314,189,72,117,0,27,12,15,91,57,9,4,21,7
E33042973,427,286,88,198,2,31,23,8,102,92,3,7,0,6
E33042974,278,219,51,168,0,9,3,6,49,41,0,5,3,1
E33042975,224,153,52,101,2,21,12,9,45,40,0,4,1,3
E33042976,788,621,123,498,5,36,18,18,121,110,2,8,1,5
E33042977,270,176,68,108,2,27,16,11,62,54,0,7,1,3
E33042978,451,320,92,228,1,42,27,15,86,77,0,8,1,2
E33042979,297,195,47,148,1,24,13,11,76,69,2,5,0,1
E33042980,2370,1754,495,1259,19,143,86,57,445,399,7,39,0,9
E33042981,470,366,105,261,2,23,7,16,75,66,3,6,0,4
E33042982,327,261,105,156,3,11,4,7,43,38,1,4,0,9
E33042983,369,283,117,166,2,22,11,11,56,45,3,7,1,6
E33042984,343,242,82,160,4,32,23,9,64,60,0,4,0,1
E33042985,309,168,48,120,3,80,69,11,54,48,1,4,1,4
E33042986,291,200,36,164,5,30,25,5,51,47,0,4,0,5
E33042987,397,217,84,133,4,60,39,21,113,110,0,2,1,3
E33042988,514,326,84,242,2,68,48,20,106,99,0,5,2,12
E33042989,253,144,48,96,2,25,17,8,80,73,0,3,4,2
E33042990,335,249,78,171,1,22,18,4,59,56,1,2,0,4
E33042991,588,398,95,303,6,53,29,24,129,121,0,5,3,2
E33042992,255,134,46,88,2,18,14,4,99,94,0,5,0,2
E33042993,291,218,72,146,4,13,9,4,54,50,1,3,0,2
E33042994,276,167,70,97,1,28,22,6,77,73,1,1,2,3
E33042995,399,279,89,190,1,36,23,13,81,71,0,8,2,2
E33042996,325,222,78,144,1,42,33,9,57,50,0,7,0,3
E33042997,398,310,55,255,2,40,27,13,44,41,1,2,0,2
E33042998,611,492,146,346,2,45,29,16,68,62,2,4,0,4
E33042999,559,389,121,268,7,66,52,14,95,92,1,1,1,2
E33043000,398,230,57,173,6,35,28,7,124,119,0,4,1,3
E33043001,331,224,64,160,2,51,41,10,53,50,0,2,1,1
E33043002,275,176,65,111,1,37,32,5,53,49,1,2,1,8
E33043003,289,219,65,154,6,17,11,6,47,44,1,2,0,0
E33043004,492,318,94,224,2,42,27,15,123,108,10,4,1,7
E33043005,356,273,95,178,1,26,14,12,53,49,0,2,2,3
E33043006,407,299,92,207,1,20,14,6,83,71,3,9,0,4
E33043007,410,305,71,234,5,31,19,12,64,57,4,2,1,5
E33043008,451,359,101,258,0,32,24,8,60,50,0,8,2,0
E33043009,298,226,58,168,8,14,8,6,47,40,0,6,1,3
E33043010,451,268,64,204,13,55,32,23,114,105,0,5,4,1
E33043011,289,197,65,132,5,33,27,6,52,50,0,2,0,2
E33043012,339,251,79,172,5,35,23,12,44,41,1,2,0,4
E33043013,307,219,67,152,3,55,50,5,28,25,0,3,0,2
E33043014,458,342,87,255,5,44,27,17,66,59,0,3,4,1
E33043015,905,613,186,427,8,172,143,29,104,88,4,7,5,8
E33043016,784,633,180,453,6,65,58,7,76,70,0,5,1,4
E33043017,404,352,109,243,2,15,10,5,35,34,0,1,0,0
E33043018,531,393,136,257,3,68,52,16,63,52,1,10,0,4
E33043019,230,174,50,124,3,37,29,8,15,14,0,1,0,1
E33043020,361,249,79,170,3,56,39,17,51,51,0,0,0,2
E33043021,365,294,90,204,5,37,28,9,28,24,0,2,2,1
E33043022,411,321,111,210,3,25,17,8,60,53,0,4,3,2
E33043023,260,225,74,151,2,6,6,0,23,19,0,4,0,4
E33043024,307,245,76,169,1,22,13,9,38,24,5,3,6,1
E33043025,424,344,91,253,2,35,22,13,40,32,3,3,2,3
E33043026,893,613,156,457,6,164,129,35,102,90,1,9,2,8
E33043027,385,333,104,229,1,12,9,3,35,31,0,4,0,4
E33043028,288,235,87,148,1,10,7,3,39,36,2,1,0,3
E33043029,401,328,105,223,6,26,20,6,40,40,0,0,0,1
E33043030,318,256,92,164,1,13,8,5,46,38,3,5,0,2
E33043031,421,336,89,247,3,32,25,7,44,38,1,4,1,6
E33043032,291,230,75,155,2,18,12,6,37,26,5,3,3,4
E33043033,372,336,116,220,2,11,9,2,13,9,0,3,1,10
E33043034,466,371,95,276,6,17,11,6,68,56,6,6,0,4
E33043035,251,205,53,152,1,11,6,5,32,30,1,1,0,2
E33043036,335,261,81,180,8,25,8,17,33,32,0,1,0,8
E33043037,531,452,133,319,9,13,3,10,55,49,0,5,1,2
E33043038,676,545,147,398,3,43,13,30,78,68,3,5,2,7
E33043039,404,301,97,204,1,18,4,14,79,70,1,7,1,5
E33043040,438,334,98,236,8,29,8,21,61,54,2,4,1,6
E33043041,344,263,67,196,1,24,2,22,54,44,2,7,1,2
E33043042,563,407,113,294,1,37,7,30,118,99,8,3,8,0
E33043043,450,357,92,265,8,18,2,16,62,54,4,4,0,5
E33043044,297,254,74,180,2,8,0,8,33,27,0,6,0,0
E33043045,353,300,90,210,2,15,4,11,34,28,2,4,0,2
E33043046,455,363,104,259,3,24,5,19,61,58,1,1,1,4
E33043047,299,192,45,147,3,35,17,18,69,66,2,0,1,0
E33043048,352,257,73,184,7,29,4,25,59,52,1,5,1,0
E33043049,631,238,53,185,8,78,11,67,299,64,107,10,118,8
E33043050,1972,1531,383,1148,28,93,21,72,312,287,3,21,1,8
E33043051,261,191,50,141,2,14,3,11,51,49,0,2,0,3
E33043052,370,246,48,198,3,29,6,23,89,83,3,3,0,3
E33043053,360,274,87,187,3,35,10,25,43,35,3,2,3,5
E33043054,393,274,67,207,8,28,4,24,79,69,0,2,8,4
E33043055,279,198,55,143,4,24,5,19,50,46,0,3,1,3
E33043056,313,281,65,216,3,5,1,4,24,22,2,0,0,0
E33043057,307,234,69,165,6,10,2,8,57,54,0,3,0,0
E33043058,279,236,66,170,3,10,3,7,29,27,0,2,0,1
E33043059,561,442,111,331,1,27,5,22,83,73,1,7,2,8
E33043060,483,390,120,270,6,34,6,28,53,50,0,2,1,0
E33043061,447,365,102,263,5,23,7,16,53,46,0,6,1,1
E33043062,366,268,66,202,9,19,1,18,69,61,6,1,1,1
E33043063,329,220,74,146,3,25,4,21,78,74,2,2,0,3
E33043064,364,253,68,185,11,17,10,7,83,75,1,7,0,0
E33043065,418,271,76,195,3,35,5,30,105,93,6,6,0,4
E33043066,509,309,77,232,9,87,25,62,103,98,4,1,0,1
E33043067,257,176,42,134,6,17,4,13,57,52,0,5,0,1
E33043068,284,215,58,157,4,20,6,14,44,41,0,3,0,1
E33043069,430,263,64,199,4,67,13,54,94,82,0,11,1,2
E33043070,336,211,65,146,5,40,5,35,75,70,3,1,1,5
E33043071,345,303,98,205,0,10,3,7,30,30,0,0,0,2
E33043072,537,448,100,348,2,17,4,13,68,63,0,5,0,2
E33043073,536,416,129,287,2,37,6,31,80,71,0,5,4,1
E33043074,340,265,59,206,3,9,5,4,56,51,2,3,0,7
E33043075,626,458,98,360,15,55,12,43,94,81,4,8,1,4
E33043076,329,243,88,155,2,27,6,21,53,46,2,2,3,4
E33043077,261,174,53,121,1,19,4,15,61,50,3,6,2,6
E33043078,337,243,62,181,4,45,9,36,43,36,3,3,1,2
E33043079,364,264,89,175,5,40,11,29,51,44,1,6,0,4
E33043080,618,442,87,355,7,71,17,54,93,84,0,8,1,5
E33043081,321,225,47,178,2,25,6,19,67,66,0,1,0,2
E33043082,310,164,37,127,4,74,10,64,67,57,2,6,2,1
E33043083,322,228,60,168,3,32,2,30,55,48,0,5,2,4
E33043084,326,235,56,179,4,60,13,47,23,17,0,4,2,4
E33043085,319,276,81,195,4,12,1,11,23,20,1,2,0,4
E33043086,469,357,78,279,5,65,14,51,39,33,0,6,0,3
E33043087,353,293,74,219,7,28,8,20,24,19,0,4,1,1
E33043088,310,235,74,161,3,21,4,17,50,45,2,2,1,1
E33043089,380,319,89,230,6,17,5,12,36,28,3,5,0,2
E33043090,531,397,108,289,7,48,20,28,74,71,0,3,0,5
E33043091,236,157,54,103,1,15,2,13,56,55,0,0,1,7
E33043092,251,203,56,147,2,20,3,17,22,20,0,1,1,4
E33043093,385,281,80,201,7,23,7,16,69,66,0,2,1,5
E33043094,231,199,75,124,0,10,4,6,20,18,1,0,1,2
E33043095,597,398,121,277,11,71,25,46,111,95,5,9,2,6
E33043096,215,167,51,116,3,12,1,11,21,18,0,3,0,12
E33043097,323,253,73,180,2,22,5,17,44,42,0,2,0,2
E33043098,524,421,95,326,10,42,14,28,50,40,1,9,0,1
E33043099,254,202,50,152,1,16,2,14,30,26,0,4,0,5
E33043100,572,495,114,381,4,22,6,16,48,46,0,2,0,3
E33043101,583,422,104,318,7,59,13,46,87,82,0,5,0,8
E33043102,519,431,132,299,1,36,10,26,42,40,1,1,0,9
E33043103,541,424,115,309,9,34,9,25,72,56,3,12,1,2
E33043104,285,213,55,158,4,50,12,38,16,15,0,0,1,2
E33043105,540,385,99,286,7,95,22,73,50,46,1,2,1,3
E33043106,311,170,32,138,9,83,15,68,48,41,4,2,1,1
E33043107,304,193,58,135,5,71,11,60,32,27,3,2,0,3
E33043108,281,140,41,99,5,107,28,79,29,28,1,0,0,0
E33043109,289,204,49,155,2,40,11,29,36,32,0,4,0,7
E33043110,369,275,93,182,3,30,8,22,58,47,2,3,6,3
E33043111,273,213,76,137,6,19,3,16,32,31,0,1,0,3
E33043112,308,265,87,178,1,8,3,5,28,26,0,2,0,6
E33043113,719,536,185,351,4,64,8,56,106,96,6,3,1,9
E33043114,322,243,80,163,8,29,2,27,40,38,1,1,0,2
E33043115,469,338,86,252,5,37,4,33,84,75,4,3,2,5
E33043116,376,294,98,196,1,26,6,20,53,40,9,2,2,2
E33043117,348,264,90,174,7,18,4,14,54,44,8,2,0,5
E33043118,2726,2219,387,1832,48,162,31,131,278,238,7,27,6,19
E33043119,303,245,47,198,8,25,5,20,23,23,0,0,0,2
E33043120,472,384,155,229,2,10,2,8,60,52,3,5,0,16
E33043121,586,446,172,274,6,52,14,38,71,63,2,4,2,11
E33043122,339,273,83,190,5,20,3,17,39,36,0,3,0,2
E33043123,338,258,55,203,2,15,0,15,61,57,2,2,0,2
E33043124,660,515,126,389,9,45,9,36,80,74,0,4,2,11
E33043125,388,298,67,231,5,40,19,21,43,41,0,1,1,2
E33043126,440,363,114,249,3,27,5,22,42,36,2,2,2,5
E33043127,255,218,89,129,0,8,3,5,24,22,0,2,0,5
E33043128,431,322,116,206,2,38,14,24,67,57,3,7,0,2
E33043129,259,204,62,142,1,18,5,13,31,27,0,4,0,5
E33043130,622,387,141,246,5,64,26,38,162,138,14,8,2,4
E33043131,254,194,86,108,2,15,6,9,38,32,4,2,0,5
E33043132,299,236,81,155,3,22,11,11,34,32,2,0,0,4
E33043133,398,254,85,169,1,32,2,30,76,58,15,2,1,35
E33043134,323,258,73,185,1,22,7,15,40,35,1,2,2,2
E33043135,280,187,64,123,3,39,9,30,48,40,4,3,1,3
E33043136,347,260,98,162,3,26,10,16,49,39,3,5,2,9
E33043137,290,218,85,133,2,19,6,13,47,40,5,2,0,4
E33043138,269,194,61,133,3,28,4,24,34,26,5,3,0,10
E33043139,351,210,70,140,3,21,8,13,108,98,7,2,1,9
E33043140,309,221,91,130,1,19,5,14,60,57,0,3,0,8
E33043141,393,306,106,200,5,25,5,20,54,48,1,5,0,3
E33043142,255,223,56,167,0,4,1,3,27,25,0,2,0,1
E33043143,558,394,118,276,9,54,10,44,95,92,1,2,0,6
E33043144,287,217,80,137,2,14,4,10,51,44,4,3,0,3
E33043145,249,203,62,141,5,19,3,16,21,19,0,1,1,1
E33043146,301,247,87,160,5,18,9,9,30,25,0,5,0,1
E33043147,353,252,83,169,5,54,11,43,34,24,4,5,1,8
E33043148,321,273,87,186,5,14,4,10,24,21,1,2,0,5
E33043149,417,304,89,215,5,63,16,47,42,37,1,4,0,3
E33043150,329,247,61,186,6,40,12,28,35,30,3,2,0,1
E33043151,776,488,151,337,10,193,42,151,83,76,0,6,1,2
E33043152,471,299,66,233,17,101,24,77,53,51,0,2,0,1
E33043153,832,592,184,408,19,133,36,97,85,79,0,6,0,3
E33043154,395,257,71,186,10,106,22,84,19,18,0,1,0,3
E33043155,658,560,151,409,7,51,16,35,38,33,1,4,0,2
E33043156,328,258,74,184,1,24,6,18,44,42,0,2,0,1
E33043157,445,357,114,243,5,35,10,25,47,39,4,4,0,1
E33043158,451,315,102,213,8,65,17,48,56,49,0,7,0,7
E33043159,735,620,212,408,6,40,13,27,61,51,1,6,3,8
E33043160,298,231,66,165,2,37,11,26,26,20,4,1,1,2
E33043161,412,307,66,241,16,43,11,32,42,37,1,2,2,4
E33043162,265,211,67,144,4,21,2,19,25,24,0,0,1,4
E33043163,249,192,50,142,8,25,6,19,21,18,1,2,0,3
E33043164,283,200,75,125,5,21,6,15,50,44,2,3,1,7
E33043165,355,238,91,147,4,57,19,38,49,41,2,3,3,7
E33043166,267,234,79,155,1,13,3,10,16,16,0,0,0,3
E33043167,274,231,52,179,2,14,7,7,25,22,2,1,0,2
E33043168,322,257,89,168,8,14,2,12,40,35,2,2,1,3
E33043169,309,241,64,177,9,21,6,15,38,36,2,0,0,0
E33043170,586,457,148,309,7,47,16,31,66,58,6,1,1,9
E33043171,569,436,114,322,9,44,14,30,77,62,12,3,0,3
E33043172,524,347,121,226,24,76,10,66,73,57,2,6,8,4
E33043173,328,273,104,169,4,16,4,12,30,27,0,2,1,5
E33043174,333,256,83,173,2,31,3,28,40,37,0,3,0,4
E33043175,786,499,152,347,27,120,22,98,134,115,4,13,2,6
E33043176,250,169,61,108,7,21,7,14,50,46,3,1,0,3
E33043177,344,271,95,176,5,25,4,21,41,36,0,5,0,2
E33043178,606,425,164,261,7,60,3,57,104,90,3,11,0,10
E33043179,1057,798,277,521,13,51,10,41,190,166,11,11,2,5
E33043180,746,560,173,387,13,61,14,47,102,90,5,6,1,10
E33043181,513,383,153,230,17,59,6,53,48,47,0,1,0,6
E33043182,1064,773,247,526,20,132,24,108,132,118,3,11,0,7
E33043183,392,334,133,201,4,13,0,13,35,30,3,1,1,6
E33043184,281,220,89,131,2,20,2,18,35,26,7,1,1,4
E33043185,431,269,92,177,21,51,10,41,83,79,0,4,0,7
E33043186,370,264,84,180,3,28,2,26,72,67,1,4,0,3
E33043187,335,250,87,163,5,37,4,33,41,38,1,1,1,2
E33043188,538,388,141,247,12,58,12,46,77,71,1,4,1,3
E33043189,306,186,52,134,9,56,6,50,50,48,0,2,0,5
E33043190,276,183,59,124,7,31,0,31,50,49,0,1,0,5
E33043191,252,159,56,103,7,50,7,43,33,25,0,4,4,3
E33043192,331,262,89,173,1,17,1,16,47,44,1,2,0,4
E33043193,214,147,63,84,6,24,1,23,33,31,0,1,1,4
E33043194,336,267,91,176,4,31,6,25,30,29,0,1,0,4
E33043195,344,242,102,140,9,39,11,28,43,40,0,3,0,11
E33043196,298,212,94,118,3,25,3,22,52,47,4,1,0,6
E33043197,297,206,79,127,2,17,1,16,62,44,14,2,2,10
E33043198,427,297,98,199,5,39,3,36,68,64,1,1,2,18
E33043199,1122,866,264,602,14,68,22,46,170,153,8,8,1,4
E33043200,400,299,125,174,6,43,0,43,40,37,2,0,1,12
E33043201,270,193,74,119,2,15,2,13,58,58,0,0,0,2
E33043202,385,255,111,144,6,31,6,25,81,63,11,7,0,12
E33043203,574,369,138,231,8,49,4,45,106,73,30,1,2,42
E33043204,482,335,118,217,11,48,3,45,77,59,14,4,0,11
E33043205,364,276,117,159,7,21,0,21,43,39,3,1,0,17
E33043206,381,282,95,187,9,20,2,18,67,61,0,5,1,3
E33043207,266,184,81,103,0,26,2,24,42,34,6,0,2,14
E33043208,623,470,149,321,16,41,10,31,90,79,1,9,1,6
E33043209,263,212,67,145,5,9,0,9,36,31,2,2,1,1
E33043210,355,278,93,185,4,18,3,15,48,42,1,5,0,7
E33043211,707,521,134,387,16,70,17,53,91,83,3,4,1,9
E33043212,545,407,131,276,1,57,13,44,69,62,3,4,0,11
E33043213,497,372,128,244,9,49,14,35,59,47,5,2,5,8
E33043214,314,241,97,144,5,19,4,15,44,38,3,0,3,5
E33043215,263,199,88,111,1,13,6,7,40,37,1,2,0,10
E33043216,591,420,138,282,8,43,7,36,107,95,6,3,3,13
E33043217,385,315,94,221,4,10,2,8,54,50,2,1,1,2
E33043218,412,257,69,188,14,79,10,69,61,59,1,1,0,1
E33043219,494,352,103,249,8,61,15,46,65,64,0,1,0,8
E33043220,327,233,74,159,5,46,9,37,41,39,0,2,0,2
E33043221,323,204,65,139,14,67,13,54,33,28,4,1,0,5
E33043222,307,249,86,163,7,19,5,14,29,27,0,0,2,3
E33043223,510,369,95,274,8,46,17,29,81,78,0,3,0,6
E33043224,470,292,103,189,16,86,25,61,74,67,0,4,3,2
E33043225,256,178,73,105,6,26,1,25,29,25,1,2,1,17
E33043226,507,353,131,222,7,39,16,23,82,72,4,5,1,26
E33043227,254,180,65,115,2,32,2,30,36,33,0,1,2,4
E33043228,321,237,119,118,4,20,4,16,53,49,0,3,1,7
E33043229,417,300,103,197,2,43,3,40,63,59,0,2,2,9
E33043230,277,200,75,125,4,21,2,19,49,40,4,5,0,3
E33043231,266,181,73,108,2,25,1,24,52,51,1,0,0,6
E33043232,530,426,175,251,1,11,7,4,82,71,3,5,3,10
E33043233,317,244,80,164,3,15,12,3,48,40,2,4,2,7
E33043234,399,324,134,190,2,9,8,1,59,49,1,4,5,5
E33043235,566,448,183,265,6,21,11,10,79,67,4,7,1,12
E33043236,359,220,43,177,3,43,12,31,90,70,2,5,13,3
E33043237,420,281,61,220,1,25,12,13,111,93,2,14,2,2
E33043238,451,330,107,223,7,34,22,12,78,67,4,5,2,2
E33043239,292,218,63,155,4,14,4,10,53,46,1,4,2,3
E33043240,327,196,49,147,7,53,44,9,68,66,0,0,2,3
E33043241,283,187,46,141,6,27,16,11,62,56,0,5,1,1
E33043242,283,211,79,132,0,25,18,7,45,39,0,6,0,2
E33043243,723,485,129,356,7,86,54,32,141,127,0,13,1,4
E33043244,294,231,83,148,1,21,12,9,39,37,0,2,0,2
E33043245,287,196,70,126,3,21,7,14,66,63,1,2,0,1
E33043246,283,164,39,125,0,20,9,11,95,92,1,1,1,4
E33043247,321,191,62,129,2,48,35,13,76,71,1,4,0,4
E33043248,460,299,72,227,3,40,20,20,107,97,2,6,2,11
E33043249,786,563,160,403,7,61,47,14,145,129,1,10,5,10
E33043250,576,343,82,261,7,50,19,31,169,103,29,16,21,7
E33043251,287,199,49,150,1,29,20,9,56,44,5,3,4,2
E33043252,288,170,55,115,4,39,28,11,75,71,0,2,2,0
E33043253,665,440,128,312,3,47,32,15,174,159,1,14,0,1
E33043254,495,393,117,276,4,16,10,6,79,72,2,3,2,3
E33043255,231,151,54,97,1,16,11,5,63,53,5,2,3,0
E33043256,374,247,73,174,5,18,12,6,101,83,6,6,6,3
E33043257,579,406,130,276,1,42,31,11,123,112,2,8,1,7
E33043258,357,237,92,145,2,24,17,7,90,82,2,6,0,4
E33043259,762,628,151,477,4,24,12,12,103,95,3,5,0,3
E33043260,471,341,107,234,2,20,14,6,104,90,3,7,4,4
E33043261,498,384,137,247,4,38,19,19,70,65,0,4,1,2
E33043262,317,222,90,132,1,10,7,3,81,75,1,3,2,3
E33043263,308,253,82,171,2,9,5,4,41,34,2,4,1,3
E33043264,440,333,107,226,4,16,7,9,75,64,2,6,3,12
E33043265,370,254,104,150,2,21,13,8,90,80,4,6,0,3
E33043266,541,382,144,238,7,40,21,19,104,89,7,7,1,8
E33043267,239,183,65,118,2,18,11,7,35,29,1,5,0,1
E33043268,767,554,147,407,15,53,28,25,139,118,4,13,4,6
E33043269,592,442,112,330,6,27,10,17,115,98,3,11,3,2
E33043270,445,368,118,250,0,17,10,7,51,35,6,7,3,9
E33043271,286,183,52,131,2,24,20,4,75,66,1,6,2,2
E33043272,393,254,75,179,1,29,16,13,103,94,3,4,2,6
E33043273,482,327,114,213,3,32,26,6,118,106,3,8,1,2
E33043274,357,267,88,179,1,27,15,12,56,49,2,3,2,6
E33043275,466,306,96,210,6,39,28,11,111,96,7,4,4,4
E33043276,311,230,81,149,3,29,18,11,36,31,1,4,0,13
E33043277,344,245,106,139,3,26,14,12,57,48,6,1,2,13
E33043278,221,171,60,111,1,15,8,7,34,25,0,6,3,0
E33043279,273,209,73,136,0,16,12,4,47,39,3,3,2,1
E33043280,244,174,67,107,3,26,18,8,36,30,1,2,3,5
E33043281,306,231,81,150,1,19,15,4,54,49,0,5,0,1
E33043282,350,242,83,159,4,31,18,13,68,54,3,11,0,5
E33043283,401,306,110,196,0,20,9,11,64,53,4,3,4,11
E33043284,518,416,132,284,1,32,18,14,63,56,2,5,0,6
E33043285,541,397,124,273,1,27,17,10,114,103,1,5,5,2
E33043286,133,100,33,67,0,12,8,4,20,17,0,3,0,1
E33043287,292,214,63,151,1,16,10,6,57,44,0,10,3,4
E33043288,351,279,88,191,2,16,13,3,52,46,2,2,2,2
E33043289,323,238,75,163,1,26,20,6,50,41,3,5,1,8
E33043290,426,285,97,188,3,30,18,12,97,81,4,9,3,11
E33043291,312,185,53,132,1,29,22,7,91,66,10,3,12,6
E33043292,277,168,49,119,3,24,5,19,81,78,2,1,0,1
E33043293,450,316,101,215,5,28,4,24,101,93,0,8,0,0
E33043294,603,399,118,281,7,56,6,50,135,120,2,12,1,6
E33043295,297,191,57,134,2,41,8,33,58,54,1,2,1,5
E33043296,339,221,52,169,2,62,10,52,52,46,1,4,1,2
E33043297,509,331,86,245,5,67,8,59,102,98,2,2,0,4
E33043298,364,246,82,164,4,42,6,36,71,64,2,2,3,1
E33043299,312,265,69,196,1,14,0,14,29,25,0,2,2,3
E33043300,428,352,96,256,3,17,2,15,53,50,0,3,0,3
E33043301,486,338,75,263,22,56,14,42,69,63,1,5,0,1
E33043302,359,286,78,208,4,15,2,13,54,49,1,4,0,0
E33043303,467,369,87,282,9,32,4,28,55,52,0,2,1,2
E33043304,390,305,89,216,3,14,3,11,61,56,0,3,2,7
E33043305,901,701,193,508,4,67,10,57,126,110,5,9,2,3
E33043306,321,240,85,155,1,16,4,12,49,43,2,3,1,15
E33043307,641,461,123,338,6,66,11,55,106,98,4,4,0,2
E33043308,298,229,64,165,1,20,1,19,47,41,0,6,0,1
E33043309,1057,804,178,626,20,45,11,34,173,153,5,13,2,15
E33043310,450,365,116,249,2,21,4,17,51,49,0,2,0,11
E33043311,383,266,91,175,1,33,6,27,69,55,3,8,3,14
E33043312,345,241,45,196,0,64,11,53,39,30,0,7,2,1
E33043313,387,315,49,266,2,20,5,15,49,48,0,1,0,1
E33043314,941,559,130,429,7,86,26,60,286,266,9,10,1,3
E33043315,443,341,52,289,5,30,5,25,61,57,0,4,0,6
E33043316,1310,1029,215,814,15,73,18,55,188,175,0,12,1,5
E33043317,379,291,86,205,4,30,5,25,46,42,2,2,0,8
E33043318,414,326,118,208,3,37,13,24,47,39,3,5,0,1
E33043319,940,597,191,406,7,80,26,54,253,238,9,4,2,3
E33043320,384,278,61,217,4,30,4,26,66,58,0,6,2,6
E33043321,257,216,61,155,3,10,5,5,25,20,0,5,0,3
E33043322,496,415,104,311,3,16,1,15,60,53,1,4,2,2
E33043323,626,480,76,404,11,41,6,35,92,88,0,3,1,2
E33043324,483,359,95,264,8,47,9,38,66,63,0,3,0,3
E33043325,339,258,79,179,4,39,4,35,38,35,1,2,0,0
E33043326,576,469,153,316,6,34,3,31,60,47,5,5,3,7
E33043327,463,334,80,254,4,48,7,41,74,68,0,4,2,3
E33043328,282,224,55,169,1,15,5,10,40,28,4,8,0,2
E33043329,754,567,162,405,11,38,5,33,133,123,2,4,4,5
E33043330,464,297,64,233,10,74,11,63,81,76,2,3,0,2
E33043331,322,253,63,190,4,25,3,22,37,36,0,1,0,3
E33043332,269,175,45,130,3,46,8,38,44,39,0,4,1,1
E33043333,324,228,62,166,3,22,2,20,65,59,0,6,0,6
E33043334,453,356,94,262,5,25,4,21,63,57,0,5,1,4
E33043335,603,470,137,333,1,39,9,30,91,83,1,7,0,2
E33043336,640,480,123,357,9,63,6,57,85,74,2,8,1,3
E33043337,503,386,90,296,5,29,5,24,82,78,1,2,1,1
E33043338,343,299,82,217,1,21,3,18,22,21,0,0,1,0
E33043339,293,262,79,183,1,5,0,5,25,21,0,1,3,0
E33043340,309,230,59,171,1,20,5,15,58,51,1,6,0,0
E33043341,342,255,59,196,4,29,5,24,51,44,0,4,3,3
E33043342,248,183,59,124,2,20,4,16,42,37,0,4,1,1
E33043343,320,253,66,187,8,16,0,16,41,38,0,3,0,2
E33043344,304,232,77,155,7,16,1,15,42,41,0,1,0,7
E33043345,377,293,89,204,1,22,4,18,61,54,0,6,1,0
E33043346,380,315,83,232,0,12,2,10,46,35,5,3,3,7
E33043347,617,457,132,325,12,45,5,40,99,89,1,9,0,4
E33043348,594,496,154,342,9,30,6,24,58,52,1,4,1,1
E33043349,512,395,90,305,8,38,12,26,69,62,0,6,1,2
E33043350,367,276,73,203,5,39,11,28,44,41,1,2,0,3
E33043351,398,285,73,212,5,60,11,49,44,41,1,2,0,4
E33043352,800,590,184,406,9,70,9,61,127,114,2,6,5,4
E33043353,645,439,119,320,9,73,20,53,118,105,7,4,2,6
E33043354,266,194,54,140,5,27,3,24,40,33,2,4,1,0
E33043355,364,252,85,167,7,60,14,46,40,35,0,3,2,5
E33043356,452,345,129,216,2,32,12,20,69,63,2,4,0,4
E33043357,260,209,54,155,1,9,0,9,33,30,1,2,0,8
E33043358,622,472,150,322,5,60,8,52,79,70,2,3,4,6
E33043359,403,268,66,202,3,47,9,38,80,73,3,3,1,5
E33043360,314,235,64,171,1,23,2,21,51,46,0,5,0,4
E33043361,303,208,86,122,3,39,3,36,48,41,5,1,1,5
E33043362,417,318,104,214,6,39,7,32,51,46,0,5,0,3
E33043363,276,193,69,124,0,18,6,12,51,45,4,2,0,14
E33043364,350,252,75,177,2,27,6,21,56,46,5,3,2,13
E33043365,434,311,105,206,2,48,7,41,70,62,0,7,1,3
E33043366,381,291,93,198,1,38,7,31,49,39,2,6,2,2
E33043367,297,224,73,151,3,32,11,21,29,26,0,2,1,9
E33043368,212,149,53,96,1,14,2,12,42,23,16,3,0,6
E33043369,599,422,137,285,5,45,12,33,111,92,6,12,1,16
E33043370,275,171,52,119,1,11,4,7,58,48,5,3,2,34
E33043371,253,155,49,106,0,15,3,12,81,77,0,4,0,2
E33043372,529,396,69,327,2,21,11,10,106,92,3,9,2,4
E33043373,282,126,40,86,1,29,12,17,121,112,3,5,1,5
E33043374,240,132,47,85,1,16,4,12,91,85,0,2,4,0
E33043375,304,183,49,134,2,9,7,2,106,103,0,2,1,4
E33043376,356,157,44,113,1,23,10,13,171,164,0,7,0,4
E33043377,294,148,54,94,3,35,15,20,104,97,0,7,0,4
E33043378,357,221,50,171,1,39,21,18,94,84,2,8,0,2
E33043379,413,330,109,221,1,20,7,13,60,59,0,1,0,2
E33043380,390,310,88,222,1,9,5,4,63,56,0,7,0,7
E33043381,309,232,53,179,3,14,5,9,57,47,2,4,4,3
E33043382,257,186,50,136,1,13,8,5,52,48,0,4,0,5
E33043383,490,342,105,237,2,35,20,15,104,96,1,6,1,7
E33043384,294,173,56,117,0,25,13,12,96,93,2,1,0,0
E33043385,331,234,50,184,1,30,13,17,64,59,1,4,0,2
E33043386,243,163,27,136,0,13,5,8,67,58,2,7,0,0
E33043387,719,469,109,360,4,52,27,25,189,168,12,8,1,5
E33043388,475,303,79,224,6,25,9,16,135,120,4,11,0,6
E33043389,294,191,52,139,1,39,14,25,61,53,4,2,2,2
E33043390,298,220,55,165,2,32,22,10,43,37,0,6,0,1
E33043391,426,287,68,219,1,40,21,19,96,86,0,9,1,2
E33043392,427,293,93,200,0,54,32,22,78,74,0,3,1,2
E33043393,410,253,77,176,3,36,12,24,115,108,2,5,0,3
E33043394,301,218,68,150,0,11,6,5,72,69,0,3,0,0
E33043395,428,349,98,251,1,17,8,9,56,50,2,4,0,5
E33043396,459,335,87,248,0,41,16,25,82,78,0,4,0,1
E33043397,288,214,50,164,1,15,7,8,58,55,0,3,0,0
E33043398,891,602,146,456,2,106,66,40,176,156,1,19,0,5
E33043399,287,211,40,171,0,33,17,16,42,36,0,6,0,1
E33043400,254,188,47,141,0,38,29,9,25,24,0,1,0,3
E33043401,441,319,80,239,2,26,9,17,93,88,0,5,0,1
E33043402,589,399,118,281,2,33,14,19,148,137,2,9,0,7
E33043403,327,197,71,126,1,22,12,10,103,98,1,2,2,4
E33043404,369,268,79,189,1,25,14,11,75,67,3,4,1,0
E33043405,478,304,84,220,1,35,22,13,131,126,0,5,0,7
E33043406,304,229,83,146,1,6,1,5,63,60,1,2,0,5
E33043407,318,242,77,165,1,15,11,4,52,48,1,1,2,8
E33043408,333,255,85,170,0,16,7,9,62,57,0,5,0,0
E33043409,674,453,129,324,1,43,25,18,168,153,5,8,2,9
E33043410,275,220,86,134,1,8,2,6,43,41,0,2,0,3
E33043411,584,465,147,318,1,17,10,7,97,90,2,5,0,4
E33043412,361,265,80,185,0,28,22,6,66,61,1,2,2,2
E33043413,256,182,64,118,0,16,6,10,52,49,2,1,0,6
E33043414,346,297,101,196,1,9,2,7,37,35,0,2,0,2
E33043415,331,205,54,151,3,20,9,11,94,79,2,9,4,9
E33043416,235,150,52,98,1,18,10,8,61,56,1,3,1,5
E33043417,406,288,100,188,0,23,9,14,93,89,0,4,0,2
E33043418,400,287,68,219,3,13,5,8,92,82,2,8,0,5
E33043419,225,177,70,107,2,7,2,5,38,36,0,2,0,1
E33043420,356,238,72,166,2,28,13,15,87,83,0,4,0,1
E33043421,565,432,149,283,1,23,10,13,104,92,0,12,0,5
E33043422,376,293,122,171,1,24,13,11,46,37,2,6,1,12
E33043423,365,285,91,194,2,21,10,11,57,53,0,4,0,0
E33043424,358,274,65,209,1,29,18,11,51,44,1,6,0,3
E33043425,424,296,89,207,0,48,19,29,77,68,1,8,0,3
E33043426,282,207,59,148,2,26,13,13,45,41,0,4,0,2
E33043427,604,426,113,313,0,31,18,13,144,134,0,9,1,3
E33043428,246,160,51,109,1,33,16,17,48,44,0,1,3,4
E33043429,445,320,109,211,0,51,21,30,73,64,0,9,0,1
E33043430,404,277,78,199,1,18,11,7,107,100,0,5,2,1
E33043431,326,214,58,156,1,18,7,11,92,81,1,9,1,1
E33043432,297,216,61,155,0,11,6,5,63,56,0,6,1,7
E33043433,417,303,93,210,0,56,27,29,57,53,1,3,0,1
E33043434,592,386,100,286,1,89,49,40,115,103,0,9,3,1
E33043435,348,250,69,181,1,33,17,16,61,53,2,6,0,3
E33043436,270,206,70,136,0,11,6,5,49,43,1,3,2,4
E33043437,520,376,110,266,6,42,23,19,86,76,2,7,1,10
E33043438,451,346,94,252,0,22,13,9,79,71,0,6,2,4
E33043439,457,307,104,203,3,26,11,15,118,100,7,3,8,3
E33043440,402,288,86,202,0,35,17,18,64,48,4,10,2,15
E33043441,331,213,73,140,1,34,24,10,78,70,0,6,2,5
E33043442,495,347,93,254,0,27,9,18,114,105,3,5,1,7
E33043443,549,408,110,298,1,36,13,23,103,97,0,6,0,1
E33043444,302,212,64,148,0,29,17,12,48,47,0,1,0,13
E33043445,377,255,66,189,0,21,9,12,93,85,1,7,0,8
E33043446,285,186,49,137,0,12,5,7,85,82,2,1,0,2
E33043447,287,149,47,102,0,28,18,10,107,98,4,4,1,3
E33043448,482,364,100,264,4,25,11,14,88,83,0,4,1,1
E33043449,273,186,52,134,2,6,4,2,78,73,0,5,0,1
E33043450,339,219,67,152,0,23,14,9,95,86,0,9,0,2
E33043451,499,266,92,174,1,55,30,25,170,158,2,8,2,7
E33043452,413,240,76,164,0,45,31,14,125,115,1,8,1,3
E33043453,410,270,94,176,1,27,15,12,107,99,1,7,0,5
E33043454,335,253,77,176,0,11,6,5,67,59,0,8,0,4
E33043455,348,251,69,182,1,17,7,10,76,75,0,1,0,3
E33043456,468,360,119,241,1,14,5,9,90,80,1,7,2,3
E33043457,315,211,39,172,6,14,1,13,82,77,1,3,1,2
E33043458,502,373,102,271,2,56,10,46,67,59,1,5,2,4
E33043459,378,285,58,227,5,36,8,28,50,40,1,7,2,2
E33043460,483,353,99,254,4,49,9,40,69,61,0,7,1,8
E33043461,272,206,57,149,5,25,4,21,36,33,0,2,1,0
E33043462,285,244,58,186,3,11,4,7,25,23,0,2,0,2
E33043463,420,368,103,265,1,19,4,15,31,28,1,2,0,1
E33043464,375,233,60,173,7,71,13,58,62,58,1,2,1,2
E33043465,324,264,66,198,2,29,4,25,28,27,0,1,0,1
E33043466,233,148,35,113,5,37,5,32,41,34,0,6,1,2
E33043467,940,578,135,443,17,143,17,126,202,197,2,3,0,0
E33043468,289,214,61,153,4,27,5,22,43,39,0,3,1,1
E33043469,405,314,82,232,2,42,6,36,41,40,0,1,0,6
E33043470,442,331,86,245,6,52,10,42,51,47,1,3,0,2
E33043471,312,251,67,184,8,20,2,18,28,25,1,2,0,5
E33043472,559,431,115,316,12,41,11,30,70,64,2,3,1,5
E33043473,441,343,98,245,10,63,11,52,24,23,0,1,0,1
E33043474,839,566,148,418,17,144,17,127,111,104,1,6,0,1
E33043475,381,303,86,217,7,35,4,31,31,26,0,5,0,5
E33043476,476,366,95,271,11,38,19,19,57,54,1,1,1,4
E33043477,408,297,67,230,8,48,7,41,48,40,1,7,0,7
E33043478,454,356,83,273,9,46,4,42,42,37,0,5,0,1
E33043479,530,359,90,269,9,83,21,62,77,74,0,3,0,2
E33043480,1892,1315,357,958,45,205,44,161,315,293,5,16,1,12
E33043481,815,612,195,417,9,72,13,59,113,92,12,4,5,9
E33043482,393,292,91,201,7,43,9,34,50,46,1,3,0,1
E33043483,555,401,116,285,10,63,5,58,77,65,3,5,4,4
E33043484,234,175,68,107,0,14,1,13,26,22,1,2,1,19
E33043485,261,206,61,145,5,11,1,10,25,21,4,0,0,14
E33043486,364,270,78,192,2,44,6,38,43,37,1,4,1,5
E33043487,477,332,95,237,7,55,12,43,77,59,9,7,2,6
E33043488,215,162,52,110,4,21,1,20,27,23,2,2,0,1
E33043489,403,302,94,208,8,44,10,34,46,43,0,1,2,3
E33043490,573,458,133,325,3,31,7,24,76,64,6,5,1,5
E33043491,286,218,30,188,15,24,4,20,28,28,0,0,0,1
E33043492,281,225,74,151,2,14,6,8,39,33,1,5,0,1
E33043493,301,252,37,215,6,15,2,13,27,25,0,2,0,1
E33043494,567,366,79,287,17,89,8,81,88,83,2,3,0,7
E33043495,437,328,91,237,10,33,6,27,64,60,3,1,0,2
E33043496,921,734,165,569,16,60,13,47,110,105,0,5,0,1
E33043497,474,350,108,242,11,30,4,26,64,59,2,3,0,19
E33043498,358,269,88,181,1,30,6,24,49,40,1,2,6,9
E33043499,595,396,108,288,8,97,15,82,88,72,8,6,2,6
E33043500,292,213,67,146,5,33,3,30,35,27,1,7,0,6
E33043501,405,305,102,203,3,35,2,33,53,47,3,1,2,9
E33043502,360,254,85,169,2,31,6,25,67,49,9,5,4,6
E33043503,700,520,172,348,11,85,10,75,78,65,2,9,2,6
E33043504,278,231,74,157,1,16,2,14,20,16,2,2,0,10
E33043505,440,293,83,210,8,84,8,76,51,48,0,2,1,4
E33043506,304,194,53,141,2,91,10,81,17,12,0,4,1,0
E33043507,400,331,118,213,7,19,1,18,39,34,3,1,1,4
E33043508,747,563,131,432,7,38,9,29,129,103,20,6,0,10
E33043509,606,478,136,342,9,48,7,41,65,59,2,2,2,6
E33043510,279,201,71,130,5,45,8,37,25,21,3,1,0,3
E33043511,282,232,76,156,2,19,2,17,25,24,0,1,0,4
E33043512,354,244,97,147,6,67,10,57,31,29,0,2,0,6
E33043513,416,345,130,215,1,28,1,27,41,37,2,2,0,1
E33043514,553,385,114,271,7,120,12,108,39,34,2,3,0,2
E33043515,260,181,64,117,3,47,9,38,28,24,1,3,0,1
E33043516,695,422,146,276,20,170,20,150,80,75,0,4,1,3
E33043517,528,380,110,270,18,41,6,35,86,86,0,0,0,3
E33043518,388,284,76,208,5,34,6,28,61,55,0,6,0,4
E33043519,470,296,66,230,7,57,10,47,107,98,5,3,1,3
E33043520,890,606,201,405,8,85,12,73,174,120,49,3,2,17
E33043521,301,217,68,149,2,20,4,16,61,58,1,2,0,1
E33043522,418,279,81,198,7,55,4,51,72,66,0,6,0,5
E33043523,392,256,69,187,4,48,12,36,77,70,0,7,0,7
E33043524,392,291,102,189,10,54,3,51,33,30,0,3,0,4
E33043525,397,286,77,209,6,12,3,9,91,86,1,4,0,2
E33043526,469,342,101,241,6,64,7,57,56,52,2,2,0,1
E33043527,660,442,101,341,20,58,12,46,129,119,5,3,2,11
E33043528,340,231,77,154,4,56,5,51,43,42,1,0,0,6
E33043529,398,262,105,157,3,62,8,54,66,59,3,3,1,5
E33043530,425,297,94,203,9,56,8,48,56,43,0,8,5,7
E33043531,271,215,63,152,2,28,3,25,23,21,0,2,0,3
E33043532,342,274,77,197,2,23,3,20,37,30,3,4,0,6
E33043533,830,547,145,402,17,115,14,101,148,142,1,3,2,3
E33043534,756,568,172,396,11,83,9,74,91,81,4,5,1,3
E33043535,326,195,70,125,2,37,5,32,79,60,15,3,1,13
E33043536,308,217,62,155,7,40,5,35,40,37,0,1,2,4
E33043537,584,415,115,300,9,61,3,58,92,89,1,2,0,7
E33043538,494,323,91,232,4,71,13,58,89,82,1,5,1,7
E33043539,466,375,118,257,4,36,2,34,49,44,1,4,0,2
E33043540,318,237,70,167,3,26,0,26,49,45,2,1,1,3
E33043541,251,155,68,87,1,56,9,47,38,32,6,0,0,1
E33043542,483,311,90,221,7,57,7,50,107,103,1,3,0,1
E33043543,1300,840,226,614,16,185,25,160,254,236,3,15,0,5
E33043544,242,171,55,116,2,26,4,22,41,36,2,2,1,2
E33043545,541,354,93,261,11,73,14,59,95,91,1,3,0,8
E33043546,293,218,59,159,3,35,3,32,35,32,1,1,1,2
E33043547,994,644,195,449,16,158,19,139,169,161,0,6,2,7
E33043548,306,207,57,150,8,49,7,42,39,35,1,3,0,3
E33043549,342,241,84,157,2,56,24,32,41,37,1,0,3,2
E33043550,300,232,67,165,3,30,2,28,33,30,0,3,0,2
E33043551,334,247,76,171,1,32,2,30,47,46,0,1,0,7
E33043552,437,334,119,215,3,51,6,45,44,39,1,2,2,5
E33043553,617,450,136,314,5,60,4,56,81,68,4,7,2,21
E33043554,331,167,51,116,4,118,7,111,36,33,0,2,1,6
E33043555,1094,775,219,556,20,130,17,113,165,157,2,6,0,4
E33043556,554,350,114,236,5,141,19,122,52,44,2,5,1,6
E33043557,598,480,142,338,1,42,7,35,71,61,2,5,3,4
E33043558,258,201,77,124,1,21,1,20,31,29,1,1,0,4
E33043559,267,195,70,125,0,7,0,7,55,23,25,4,3,10
E33043560,313,241,88,153,1,29,2,27,36,34,0,1,1,6
E33043561,391,328,125,203,2,14,0,14,34,31,1,2,0,13
E33043562,280,190,45,145,3,25,2,23,60,57,0,3,0,2
E33043563,363,250,78,172,7,15,1,14,83,68,0,12,3,8
E33043564,473,311,95,216,3,43,9,34,108,100,2,4,2,8
E33043565,492,386,113,273,10,21,3,18,71,66,2,2,1,4
E33043566,547,400,118,282,4,30,9,21,109,103,1,4,1,4
E33043567,468,370,131,239,7,31,2,29,56,51,0,5,0,4
E33043568,490,347,107,240,5,31,6,25,100,95,1,2,2,7
E33043569,264,173,65,108,1,14,1,13,72,71,0,1,0,4
E33043570,269,204,73,131,2,13,1,12,44,44,0,0,0,6
E33043571,337,188,61,127,7,41,2,39,96,92,0,4,0,5
E33043572,290,182,57,125,6,14,2,12,87,82,1,3,1,1
E33043573,546,394,97,297,7,29,2,27,115,108,1,6,0,1
E33043574,438,252,81,171,7,49,4,45,127,111,2,13,1,3
E33043575,366,201,40,161,6,62,12,50,96,85,0,6,5,1
E33043576,808,570,153,417,8,34,6,28,183,171,2,10,0,13
E33043577,269,173,55,118,1,28,6,22,65,58,0,7,0,2
E33043578,541,339,114,225,8,82,9,73,105,97,2,1,5,7
E33043579,271,201,75,126,2,25,2,23,43,42,0,1,0,0
E33043580,321,242,82,160,4,18,0,18,55,50,3,2,0,2
E33043581,261,171,42,129,4,41,6,35,45,33,8,1,3,0
E33043582,262,197,75,122,4,17,4,13,39,38,0,1,0,5
E33043583,503,332,144,188,2,65,7,58,99,95,3,1,0,5
E33043584,411,244,74,170,7,33,10,23,127,116,4,4,3,0
E33043585,328,201,65,136,4,66,1,65,57,55,2,0,0,0
E33043586,303,200,69,131,1,52,7,45,46,46,0,0,0,4
E33043587,346,210,64,146,7,56,7,49,70,63,2,5,0,3
E33043588,510,259,96,163,3,99,22,77,149,144,2,3,0,0
E33043589,447,334,114,220,4,27,4,23,58,48,8,2,0,24
E33043590,366,273,127,146,3,25,0,25,54,50,2,2,0,11
E33043591,284,190,70,120,0,18,2,16,68,50,8,5,5,8
E33043592,313,232,88,144,1,22,1,21,52,48,2,2,0,6
E33043593,354,261,86,175,5,37,1,36,48,36,5,5,2,3
E33043594,529,365,123,242,2,58,7,51,88,78,4,5,1,16
E33043595,398,275,94,181,3,35,10,25,77,67,4,6,0,8
E33043596,458,323,85,238,3,38,6,32,84,75,0,9,0,10
E33043597,361,267,127,140,3,20,6,14,67,67,0,0,0,4
E33043598,716,486,131,355,6,42,3,39,177,169,1,6,1,5
E33043599,263,213,80,133,2,4,0,4,43,42,0,1,0,1
E33043600,444,303,118,185,3,55,4,51,76,71,0,2,3,7
E33043601,553,366,154,212,14,54,8,46,100,86,10,3,1,19
E33043602,278,203,80,123,1,22,5,17,42,36,2,3,1,10
E33043603,634,438,147,291,9,92,14,78,81,70,2,7,2,14
E33043604,266,176,45,131,9,55,7,48,25,22,0,2,1,1
E33043605,232,152,60,92,2,28,1,27,46,44,1,1,0,4
E33043606,358,252,87,165,5,39,4,35,37,33,1,3,0,25
E33043607,432,280,102,178,4,49,17,32,93,91,1,1,0,6
E33043608,316,226,80,146,3,22,4,18,57,54,2,1,0,8
E33043609,363,249,67,182,7,31,3,28,72,68,0,3,1,4
E33043610,411,284,86,198,7,47,5,42,64,63,0,0,1,9
E33043611,440,296,99,197,1,63,10,53,70,62,2,6,0,10
E33043612,358,255,84,171,4,31,1,30,60,45,10,4,1,8
E33043613,531,379,147,232,6,54,13,41,75,66,3,5,1,17
E33043614,379,292,106,186,6,40,4,36,27,20,0,7,0,14
E33043615,290,206,74,132,2,28,6,22,49,38,4,3,4,5
E33043616,429,348,143,205,3,20,3,17,51,46,1,1,3,7
E33043617,352,276,92,184,0,24,4,20,49,47,1,1,0,3
E33043618,258,202,81,121,0,11,4,7,39,36,2,1,0,6
E33043619,296,204,70,134,3,24,9,15,62,51,2,4,5,3
E33043620,417,310,60,250,4,28,3,25,74,70,0,4,0,1
E33043621,455,281,54,227,4,68,13,55,97,92,1,3,1,5
E33043622,388,287,71,216,2,20,4,16,75,67,0,8,0,4
E33043623,398,251,69,182,5,61,20,41,78,75,0,3,0,3
E33043624,1590,1193,279,914,18,128,33,95,245,233,1,9,2,6
E33043625,377,246,62,184,5,35,5,30,89,84,2,2,1,2
E33043626,424,289,68,221,2,26,3,23,105,102,0,3,0,2
E33043627,305,177,64,113,1,27,6,21,93,91,1,1,0,7
E33043628,405,290,64,226,4,19,2,17,85,77,3,5,0,7
E33043629,281,156,48,108,3,31,8,23,87,79,2,4,2,4
E33043630,396,239,43,196,0,116,35,81,37,34,0,3,0,4
E33043631,355,257,67,190,2,52,14,38,40,34,1,4,1,4
E33043632,292,237,77,160,0,20,3,17,33,32,0,1,0,2
E33043633,617,482,141,341,6,28,7,21,93,81,3,9,0,8
E33043634,571,444,147,297,3,44,21,23,77,73,3,1,0,3
E33043635,234,174,54,120,1,13,1,12,44,43,0,1,0,2
E33043636,552,440,123,317,4,20,5,15,65,55,2,5,3,23
E33043637,338,264,74,190,1,24,6,18,45,43,0,0,2,4
E33043638,283,240,80,160,0,9,2,7,33,29,0,4,0,1
E33043639,762,565,175,390,8,67,14,53,120,115,0,5,0,2
E33043640,1315,953,250,703,16,110,20,90,234,220,3,10,1,2
E33043641,253,187,59,128,2,19,4,15,44,43,0,0,1,1
E33043642,680,545,180,365,6,38,9,29,77,60,11,5,1,14
E33043643,286,220,75,145,2,14,1,13,48,42,0,5,1,2
E33043644,484,364,132,232,1,22,5,17,92,82,3,6,1,5
E33043645,268,210,61,149,2,17,5,12,34,32,0,2,0,5
E33043646,357,257,93,164,2,26,4,22,61,49,3,5,4,11
E33043647,302,220,81,139,0,24,4,20,52,47,0,1,4,6
E33043648,502,384,148,236,3,16,2,14,84,58,17,5,4,15
E33043649,311,238,102,136,1,25,13,12,37,29,2,2,4,10
E33043650,606,473,172,301,0,32,7,25,73,59,8,3,3,28
E33043651,281,213,74,139,3,35,5,30,25,23,0,2,0,5
E33043652,566,423,126,297,7,28,5,23,99,84,5,9,1,9
E33043653,322,233,91,142,4,23,7,16,55,53,1,1,0,7
E33043654,303,225,106,119,0,24,2,22,46,36,0,3,7,8
E33043655,861,585,186,399,10,64,17,47,198,184,1,8,5,4
E33043656,322,224,73,151,5,15,2,13,69,63,2,3,1,9
E33043657,415,335,129,206,3,36,7,29,35,30,3,1,1,6
E33043658,295,205,63,142,2,41,14,27,42,37,1,1,3,5
E33043659,299,222,62,160,1,10,3,7,44,33,7,3,1,22
E33043660,442,301,71,230,5,41,10,31,93,83,4,4,2,2
E33043661,385,298,101,197,3,21,3,18,52,40,2,8,2,11
E33043662,1002,561,155,406,7,106,24,82,324,123,110,8,83,4
E33043663,339,241,92,149,3,23,4,19,65,50,8,4,3,7
E33043664,293,224,81,143,2,14,6,8,46,38,3,4,1,7
E33043665,305,221,69,152,0,28,10,18,52,45,1,3,3,4
E33043666,333,233,85,148,3,20,2,18,58,50,5,1,2,19
E33043667,638,490,101,389,2,62,11,51,78,73,2,2,1,6
E33043668,428,333,50,283,2,23,0,23,69,66,0,3,0,1
E33043669,459,350,88,262,5,45,13,32,55,50,1,3,1,4
E33043670,589,477,129,348,5,41,13,28,62,59,1,2,0,4
E33043671,295,204,49,155,2,33,12,21,52,44,5,3,0,4
E33043672,453,322,89,233,3,48,5,43,75,69,2,3,1,5
E33043673,389,287,59,228,5,36,8,28,57,50,0,4,3,4
E33043674,337,250,76,174,1,52,15,37,31,28,1,2,0,3
E33043675,300,230,68,162,2,23,6,17,42,40,0,0,2,3
E33043676,271,209,51,158,2,27,6,21,32,30,0,1,1,1
E33043677,523,435,111,324,6,17,4,13,63,58,0,3,2,2
E33043678,527,394,111,283,1,33,9,24,83,77,0,6,0,16
E33043679,823,541,104,437,24,74,21,53,181,168,5,6,2,3
E33043680,488,393,64,329,1,17,1,16,74,70,0,3,1,3
E33043681,231,163,55,108,1,12,4,8,48,37,3,4,4,7
E33043682,230,181,69,112,1,16,6,10,30,23,4,2,1,2
E33043683,1397,1022,261,761,25,110,29,81,231,180,27,6,18,9
E33043684,275,223,80,143,0,11,3,8,37,31,1,1,4,4
E33043685,363,252,77,175,5,31,4,27,65,56,6,2,1,10
E33043686,662,461,123,338,7,56,14,42,121,106,3,10,2,17
E33043687,513,342,125,217,5,64,26,38,99,87,3,9,0,3
E33043688,232,179,70,109,1,21,7,14,26,20,1,4,1,5
E33043689,277,195,74,121,1,46,10,36,34,29,2,3,0,1
E33043690,443,313,99,214,8,26,13,13,80,74,4,2,0,16
E33043691,677,493,148,345,11,72,34,38,94,81,2,10,1,7
E33043692,493,350,106,244,7,42,13,29,71,65,0,6,0,23
E33043693,346,283,115,168,0,21,10,11,36,32,0,3,1,6
E33043694,471,353,110,243,3,47,6,41,63,60,0,3,0,5
E33043695,390,292,110,182,7,42,16,26,43,40,0,3,0,6
E33043696,488,328,92,236,7,53,21,32,96,89,1,6,0,4
E33043697,1195,966,198,768,15,49,15,34,157,144,3,9,1,8
E33043698,796,608,174,434,9,85,27,58,91,86,0,5,0,3
E33043699,300,243,80,163,2,24,10,14,25,23,0,2,0,6
E33043700,686,482,147,335,9,85,42,43,105,95,3,7,0,5
E33043701,521,366,102,264,10,16,2,14,125,116,2,6,1,4
E33043702,251,173,51,122,0,3,1,2,74,71,1,2,0,1
E33043703,247,164,62,102,3,26,11,15,52,51,1,0,0,2
E33043704,728,519,148,371,10,48,30,18,143,136,1,5,1,8
E33043705,261,187,76,111,0,25,20,5,47,43,1,2,1,2
E33043706,386,234,90,144,7,33,21,12,109,99,2,6,2,3
E33043707,255,163,60,103,2,42,36,6,45,45,0,0,0,3
E33043708,524,332,125,207,7,50,28,22,124,82,36,4,2,11
E33043709,301,203,79,124,3,16,6,10,69,64,2,2,1,10
E33043710,308,222,87,135,7,9,3,6,65,57,0,8,0,5
E33043711,374,233,98,135,10,28,12,16,85,75,4,3,3,18
E33043712,285,206,98,108,7,7,7,0,58,55,0,2,1,7
E33043713,197,125,56,69,3,10,6,4,55,51,0,2,2,4
E33043714,255,154,71,83,2,28,21,7,63,59,0,3,1,8
E33043715,647,428,170,258,8,47,31,16,142,129,0,5,8,22
E33043716,268,177,58,119,6,13,4,9,63,58,1,2,2,9
E33043717,291,198,72,126,6,33,21,12,52,48,1,2,1,2
E33043718,281,213,87,126,4,19,16,3,41,40,0,1,0,4
E33043719,372,244,93,151,1,44,37,7,81,74,1,6,0,2
E33043720,397,250,80,170,4,79,56,23,62,58,0,4,0,2
E33043721,440,223,71,152,14,125,104,21,77,71,1,4,1,1
E33043722,325,197,62,135,5,55,41,14,65,62,1,1,1,3
E33043723,555,348,137,211,4,37,25,12,141,135,2,4,0,25
E33043724,489,280,100,180,8,54,33,21,139,128,1,8,2,8
E33043725,300,189,64,125,2,29,17,12,75,70,3,2,0,5
E33043726,362,178,62,116,3,72,50,22,104,94,2,5,3,5
E33043727,407,279,95,184,4,23,11,12,97,91,0,6,0,4
E33043728,391,274,107,167,0,40,16,24,73,66,0,5,2,4
E33043729,599,400,155,245,7,56,35,21,130,119,3,6,2,6
E33043730,275,190,67,123,3,34,27,7,44,38,1,1,4,4
E33043731,284,189,80,109,4,32,23,9,55,48,1,5,1,4
E33043732,416,289,70,219,5,47,38,9,72,66,3,3,0,3
E33043733,416,251,97,154,6,71,54,17,80,77,1,2,0,8
E33043734,663,439,130,309,11,48,18,30,161,149,5,5,2,4
E33043735,274,179,76,103,2,13,6,7,74,68,2,1,3,6
E33043736,455,279,102,177,5,21,9,12,115,100,7,1,7,35
E33043737,255,122,37,85,3,15,6,9,111,104,3,4,0,4
E33043738,393,221,84,137,2,67,27,40,98,86,4,5,3,5
E33043739,476,240,79,161,3,84,38,46,137,123,3,1,10,12
E33043740,345,164,54,110,6,37,25,12,132,127,1,4,0,6
E33043741,381,238,103,135,9,24,15,9,98,85,11,2,0,12
E33043742,709,459,160,299,9,72,40,32,164,148,2,13,1,5
E33043743,2136,1305,370,935,29,251,129,122,539,489,22,23,5,12
E33043744,310,154,57,97,6,83,61,22,61,56,0,3,2,6
E33043745,1923,1258,456,802,26,119,81,38,505,482,2,14,7,15
E33043746,369,229,104,125,7,23,17,6,104,98,2,3,1,6
E33043747,370,243,78,165,4,37,25,12,80,76,1,2,1,6
E33043748,533,274,101,173,8,99,67,32,148,137,2,5,4,4
E33043749,465,234,80,154,0,49,17,32,166,153,0,4,9,16
E33043750,470,231,71,160,10,53,23,30,172,163,0,7,2,4
E33043751,336,149,49,100,8,41,14,27,128,116,1,10,1,10
E33043752,260,134,60,74,4,37,15,22,81,75,0,5,1,4
E33043753,297,137,51,86,3,30,14,16,118,107,0,7,4,9
E33043754,308,190,67,123,8,43,21,22,63,61,0,2,0,4
E33043755,365,190,75,115,1,41,28,13,124,117,1,4,2,9
E33043756,304,181,69,112,3,41,36,5,75,72,0,3,0,4
E33043757,316,184,56,128,6,43,15,28,79,71,2,5,1,4
E33043758,438,248,78,170,11,100,48,52,76,71,1,4,0,3
E33043759,480,333,98,235,9,46,37,9,88,80,2,5,1,4
E33043760,436,303,79,224,7,41,15,26,84,80,1,1,2,1
E33043761,441,286,103,183,5,49,32,17,96,86,1,7,2,5
E33043762,332,180,75,105,6,62,42,20,81,75,2,3,1,3
E33043763,369,200,69,131,17,51,32,19,100,90,0,10,0,1
E33043764,418,267,66,201,8,52,33,19,90,85,2,3,0,1
E33043765,445,292,106,186,8,50,38,12,91,86,2,3,0,4
E33043766,313,206,69,137,10,14,8,6,73,67,0,4,2,10
E33043767,467,307,126,181,9,66,43,23,81,74,0,5,2,4
E33043768,293,177,72,105,7,51,39,12,57,52,0,5,0,1
E33043769,359,192,69,123,11,61,41,20,93,85,2,5,1,2
E33043770,299,186,83,103,2,33,18,15,69,60,6,2,1,9
E33043771,637,327,91,236,13,162,87,75,127,119,0,3,5,8
E33043772,297,186,56,130,6,30,24,6,74,68,1,5,0,1
E33043773,350,243,72,171,9,41,29,12,56,50,0,3,3,1
E33043774,573,311,108,203,19,159,114,45,74,70,1,3,0,10
E33043775,605,382,95,287,10,77,42,35,128,120,2,5,1,8
E33043776,464,242,69,173,13,99,62,37,102,98,1,2,1,8
E33043777,370,247,73,174,3,45,36,9,72,66,0,5,1,3
E33043778,643,323,80,243,12,218,156,62,86,82,0,3,1,4
E33043779,495,227,69,158,35,153,41,112,79,76,0,1,2,1
E33043780,447,221,57,164,9,146,90,56,67,61,1,2,3,4
E33043781,677,550,188,362,5,45,10,35,74,65,4,3,2,3
E33043782,540,399,78,321,6,39,10,29,93,85,0,8,0,3
E33043783,314,240,91,149,4,16,7,9,47,40,0,3,4,7
E33043784,427,347,143,204,6,37,24,13,31,29,0,2,0,6
E33043785,282,182,71,111,0,33,9,24,50,40,6,0,4,17
E33043786,355,243,102,141,2,54,16,38,38,31,5,1,1,18
E33043787,916,676,246,430,8,52,24,28,169,153,6,9,1,11
E33043788,502,386,118,268,6,48,11,37,58,53,0,4,1,4
E33043789,523,369,111,258,7,84,40,44,60,55,2,2,1,3
E33043790,384,312,91,221,5,28,4,24,32,29,0,3,0,7
E33043791,654,473,158,315,6,73,8,65,94,77,5,5,7,8
E33043792,318,242,90,152,4,31,15,16,38,30,3,5,0,3
E33043793,445,291,98,193,6,49,16,33,86,75,8,3,0,13
E33043794,450,277,93,184,9,82,20,62,79,76,0,3,0,3
E33043795,426,307,95,212,4,36,10,26,75,67,2,6,0,4
E33043796,261,210,79,131,0,22,3,19,28,26,1,0,1,1
E33043797,231,182,64,118,4,12,6,6,33,25,6,2,0,0
E33043798,334,204,72,132,5,25,3,22,94,86,6,1,1,6
E33043799,459,354,112,242,3,37,8,29,62,54,1,5,2,3
E33043800,351,258,91,167,8,28,7,21,53,43,3,5,2,4
E33043801,391,298,115,183,2,21,1,20,55,47,1,5,2,15
E33043802,416,329,95,234,4,27,4,23,53,45,2,5,1,3
E33043803,359,276,109,167,3,31,8,23,42,38,1,3,0,7
E33043804,301,219,73,146,7,28,5,23,41,37,0,3,1,6
E33043805,503,415,117,298,6,36,9,27,46,40,0,4,2,0
E33043806,351,286,92,194,3,26,8,18,27,25,0,1,1,9
E33043807,283,199,77,122,4,17,9,8,59,46,4,6,3,4
E33043808,384,286,110,176,2,22,3,19,66,57,1,3,5,8
E33043809,624,440,161,279,10,64,11,53,84,73,7,2,2,26
E33043810,339,231,71,160,2,71,19,52,32,29,1,2,0,3
E33043811,430,254,69,185,7,95,28,67,68,57,7,3,1,6
E33043812,347,279,112,167,5,16,5,11,41,35,2,3,1,6
E33043813,415,322,98,224,4,47,8,39,39,36,1,2,0,3
E33043814,415,298,126,172,3,26,4,22,73,64,0,7,2,15
E33043815,312,211,70,141,4,37,13,24,52,38,11,1,2,8
E33043816,308,215,91,124,6,29,9,20,47,40,5,2,0,11
E33043817,502,377,116,261,3,41,5,36,75,60,5,5,5,6
E33043818,332,232,99,133,4,13,2,11,61,50,4,6,1,22
E33043819,511,349,113,236,2,41,5,36,112,102,4,4,2,7
E33043820,425,271,87,184,2,32,11,21,100,83,9,5,3,20
E33043821,922,674,159,515,9,95,9,86,133,126,3,4,0,11
E33043822,313,235,49,186,6,16,1,15,55,53,2,0,0,1
E33043823,363,212,67,145,2,37,5,32,107,41,38,4,24,5
E33043824,414,296,64,232,4,44,9,35,60,53,2,5,0,10
E33043825,285,211,60,151,3,42,3,39,28,21,2,3,2,1
E33043826,310,243,70,173,2,30,4,26,34,29,3,2,0,1
E33043827,469,316,91,225,11,48,16,32,82,65,5,7,5,12
E33043828,423,295,113,182,1,37,6,31,87,66,15,2,4,3
E33043829,2634,1376,358,1018,31,165,22,143,1044,393,406,20,225,18
E33043830,248,155,66,89,7,21,2,19,51,38,12,0,1,14
E33043831,213,132,55,77,5,21,6,15,50,24,14,1,11,5
E33043832,430,323,107,216,8,29,3,26,66,55,3,5,3,4
E33043833,244,160,69,91,4,15,3,12,55,25,16,4,10,10
E33043834,404,271,66,205,1,54,8,46,73,62,6,4,1,5
E33043835,425,263,96,167,6,58,6,52,97,79,9,3,6,1
E33043836,266,192,66,126,1,22,4,18,47,42,4,1,0,4
E33043837,448,323,88,235,9,57,12,45,58,55,1,1,1,1
E33043838,284,217,96,121,4,26,5,21,35,25,5,1,4,2
E33043839,328,250,74,176,4,21,0,21,51,40,3,5,3,2
E33043840,372,258,71,187,2,49,7,42,60,60,0,0,0,3
E33043841,676,486,129,357,17,78,15,63,92,75,8,9,0,3
E33043842,372,293,84,209,5,32,6,26,40,35,3,2,0,2
E33043843,373,263,74,189,3,50,10,40,52,47,1,2,2,5
E33043844,306,220,66,154,5,27,2,25,44,40,1,2,1,10
E33043845,288,203,78,125,2,35,8,27,42,33,6,3,0,6
E33043846,303,247,84,163,2,10,2,8,34,30,1,3,0,10
E33043847,252,173,52,121,4,27,8,19,48,38,7,0,3,0
E33043848,426,320,104,216,7,44,5,39,49,40,3,4,2,6
E33043849,691,494,169,325,3,50,10,40,119,97,14,6,2,25
E33043850,360,286,111,175,3,44,11,33,26,24,1,1,0,1
E33043851,246,170,54,116,1,23,4,19,46,39,4,3,0,6
E33043852,275,193,61,132,3,11,3,8,67,56,3,4,4,1
E33043853,334,232,86,146,3,31,3,28,65,57,4,1,3,3
E33043854,336,243,87,156,2,37,4,33,49,46,0,2,1,5
E33043855,423,317,131,186,4,40,14,26,60,53,1,6,0,2
E33043856,277,202,84,118,3,33,4,29,38,34,0,2,2,1
E33043857,670,486,144,342,6,32,9,23,140,123,4,7,6,6
E33043858,353,283,115,168,7,22,2,20,38,37,1,0,0,3
E33043859,450,293,86,207,1,55,14,41,91,79,4,2,6,10
E33043860,612,452,162,290,2,41,8,33,79,50,22,7,0,38
E33043861,347,274,112,162,0,20,7,13,50,37,9,3,1,3
E33043862,612,483,146,337,4,28,6,22,90,80,6,3,1,7
E33043863,286,216,76,140,5,23,5,18,36,29,3,4,0,6
E33043864,228,167,70,97,1,16,2,14,36,20,10,1,5,8
E33043865,419,328,120,208,7,40,10,30,37,33,2,2,0,7
E33043866,627,475,183,292,4,38,11,27,98,95,0,3,0,12
E33043867,524,367,132,235,1,28,12,16,111,106,0,2,3,17
E33043868,248,146,57,89,1,15,6,9,56,34,18,2,2,30
E33043869,340,228,74,154,4,30,7,23,61,52,3,4,2,17
E33043870,285,189,66,123,4,28,11,17,34,26,3,5,0,30
E33043871,236,166,56,110,6,14,2,12,43,40,1,2,0,7
E33043872,293,237,104,133,1,17,4,13,34,27,0,4,3,4
E33043873,304,244,102,142,0,21,6,15,37,35,0,0,2,2
E33043874,526,438,151,287,6,37,10,27,40,32,4,3,1,5
E33043875,512,401,134,267,5,50,11,39,54,44,3,6,1,2
E33043876,285,198,60,138,2,19,4,15,53,43,3,2,5,13
E33043877,397,315,100,215,4,28,12,16,46,42,2,1,1,4
E33043878,355,270,101,169,3,34,15,19,43,39,2,2,0,5
E33043879,343,265,82,183,1,19,8,11,55,49,0,4,2,3
E33043880,351,277,71,206,3,26,6,20,41,39,1,0,1,4
E33043881,279,211,81,130,3,27,2,25,27,23,0,3,1,11
E33043882,282,216,86,130,0,25,7,18,37,35,0,1,1,4
E33043883,319,224,74,150,0,17,9,8,74,66,4,2,2,4
E33043884,340,259,90,169,4,32,8,24,41,38,0,3,0,4
E33043885,243,153,57,96,3,22,9,13,58,49,4,3,2,7
E33043886,300,220,84,136,3,24,15,9,51,50,0,1,0,2
E33043887,239,178,55,123,2,12,6,6,44,41,1,1,1,3
E33043888,484,361,114,247,9,24,7,17,81,65,11,3,2,9
E33043889,494,380,142,238,4,29,15,14,73,68,1,0,4,8
E33043890,299,216,61,155,2,46,10,36,30,25,3,1,1,5
E33043891,561,410,145,265,3,65,22,43,66,57,1,5,3,17
E33043892,1236,481,105,376,7,157,39,118,585,156,275,6,148,6
E33043893,496,259,119,140,9,38,12,26,49,37,10,2,0,141
E33043894,423,328,99,229,5,24,6,18,54,45,6,2,1,12
E33043895,572,447,154,293,4,37,13,24,73,62,7,3,1,11
E33043896,235,166,65,101,3,30,8,22,30,26,3,0,1,6
E33043897,433,299,106,193,5,40,11,29,72,43,23,2,4,17
E33043898,304,194,79,115,3,35,12,23,68,59,5,0,4,4
E33043899,545,455,144,311,4,23,6,17,61,53,1,5,2,2
E33043900,560,482,151,331,5,26,6,20,45,42,1,1,1,2
E33043901,351,278,88,190,2,34,10,24,37,30,2,3,2,0
E33043902,349,270,77,193,3,32,9,23,38,24,5,5,4,6
E33043903,398,294,92,202,1,47,20,27,54,45,5,3,1,2
E33043904,352,257,70,187,1,58,6,52,34,28,5,0,1,2
E33043905,512,322,104,218,7,75,13,62,99,82,3,6,8,9
E33043906,412,241,93,148,9,66,9,57,90,74,11,2,3,6
E33043907,471,354,94,260,7,51,12,39,54,44,4,3,3,5
E33043908,429,294,81,213,1,59,12,47,71,62,1,4,4,4
E33043909,396,306,92,214,5,33,2,31,46,42,2,1,1,6
E33043910,541,385,116,269,12,75,17,58,65,60,2,3,0,4
E33043911,416,303,118,185,3,45,7,38,48,39,4,3,2,17
E33043912,720,529,174,355,7,79,29,50,91,75,4,7,5,14
E33043913,320,251,84,167,1,15,5,10,42,37,3,2,0,11
E33043914,623,464,175,289,3,60,7,53,81,75,2,2,2,15
E33043915,662,476,141,335,10,51,8,43,104,92,3,5,4,21
E33043916,455,341,122,219,3,32,10,22,69,48,17,1,3,10
E33043917,344,240,65,175,7,42,9,33,49,43,2,1,3,6
E33043918,750,478,155,323,14,136,35,101,120,107,7,3,3,2
E33043919,451,283,81,202,5,107,25,82,50,44,4,2,0,6
E33043920,626,441,118,323,10,80,8,72,86,79,2,5,0,9
E33043921,559,408,128,280,4,63,14,49,78,69,0,6,3,6
E33043922,239,143,47,96,2,31,5,26,47,38,8,1,0,16
E33043923,284,196,50,146,6,35,7,28,46,36,4,3,3,1
E33043924,394,268,102,166,6,61,12,49,50,48,0,2,0,9
E33043925,378,256,91,165,1,50,8,42,65,63,1,1,0,6
E33043926,290,185,76,109,2,37,12,25,48,43,2,1,2,18
E33043927,251,173,41,132,2,36,3,33,38,32,0,1,5,2
E33043928,374,300,95,205,1,34,8,26,33,28,1,4,0,6
E33043929,411,333,107,226,8,28,5,23,40,40,0,0,0,2
E33043930,287,187,48,139,2,46,12,34,50,44,1,3,2,2
E33043931,319,234,68,166,8,35,9,26,38,31,2,5,0,4
E33043932,285,198,71,127,1,42,11,31,37,30,1,3,3,7
E33043933,2078,1429,325,1104,27,195,48,147,420,391,7,16,6,7
E33043934,344,263,74,189,1,32,6,26,45,38,2,3,2,3
E33043935,725,577,154,423,7,72,12,60,64,48,7,6,3,5
E33043936,420,342,109,233,2,28,3,25,46,32,9,2,3,2
E33043937,450,336,104,232,6,42,2,40,61,56,1,2,2,5
E33043938,361,264,84,180,10,28,4,24,54,46,4,1,3,5
E33043939,315,260,71,189,1,26,1,25,21,19,2,0,0,7
E33043940,488,361,103,258,3,78,10,68,39,29,3,5,2,7
E33043941,698,463,135,328,14,115,24,91,99,86,9,2,2,7
E33043942,267,176,50,126,13,34,6,28,42,36,1,5,0,2
E33043943,333,233,78,155,7,49,10,39,43,40,1,1,1,1
E33043944,462,339,123,216,2,50,10,40,57,48,5,2,2,14
E33043945,1036,828,277,551,11,49,6,43,142,126,3,12,1,6
E33043946,890,637,142,495,11,23,3,20,217,202,2,12,1,2
E33043947,295,202,66,136,6,14,2,12,62,54,3,2,3,11
E33043948,2094,1626,463,1163,14,85,22,63,360,344,6,7,3,9
E33043949,526,401,136,265,7,59,12,47,57,51,2,3,1,2
E33043950,402,242,79,163,5,39,5,34,100,86,8,4,2,16
E33043951,365,262,88,174,2,59,26,33,39,35,1,3,0,3
E33043952,717,521,171,350,8,66,6,60,114,104,3,7,0,8
E33043953,589,445,138,307,5,51,8,43,84,77,3,3,1,4
E33043954,527,384,121,263,9,58,8,50,71,60,4,3,4,5
E33043955,516,348,124,224,11,55,7,48,95,83,1,9,2,7
E33043956,275,189,93,96,2,28,6,22,43,30,8,4,1,13
E33043957,291,220,65,155,2,20,1,19,35,29,3,3,0,14
E33043958,264,179,92,87,2,13,0,13,68,53,6,8,1,2
E33043959,523,350,128,222,6,57,13,44,96,86,5,1,4,14
E33043960,259,144,66,78,1,15,4,11,74,63,6,4,1,25
E33043961,260,200,93,107,5,12,1,11,32,27,2,3,0,11
E33043962,353,218,79,139,4,27,8,19,65,54,11,0,0,39
E33043963,274,200,75,125,2,10,3,7,42,35,5,1,1,20
E33043964,330,237,76,161,5,36,13,23,43,34,3,3,3,9
E33043965,368,247,81,166,3,23,3,20,85,78,3,4,0,10
E33043966,305,210,101,109,1,22,4,18,41,37,3,0,1,31
E33043967,310,196,87,109,6,35,8,27,62,57,4,1,0,11
E33043968,518,371,107,264,5,53,8,45,76,61,6,7,2,13
E33043969,550,354,147,207,8,49,9,40,128,114,5,4,5,11
E33043970,478,371,136,235,1,40,7,33,58,49,3,2,4,8
E33043971,256,186,69,117,4,14,1,13,40,35,1,3,1,12
E33043972,485,384,117,267,5,33,8,25,57,53,2,1,1,6
E33043973,489,350,119,231,3,27,3,24,93,74,15,3,1,16
E33043974,471,324,75,249,11,51,11,40,80,76,1,3,0,5
E33043975,264,147,50,97,1,29,7,22,68,57,9,1,1,19
E33043976,449,359,125,234,3,40,8,32,44,39,2,2,1,3
E33043977,260,203,83,120,1,20,3,17,33,29,0,3,1,3
E33043978,405,315,113,202,10,33,6,27,46,42,0,3,1,1
E33043979,246,185,75,110,1,29,3,26,30,28,0,2,0,1
E33043980,314,250,78,172,1,20,7,13,38,32,1,2,3,5
E33043981,559,384,103,281,7,42,11,31,118,103,5,7,3,8
E33043982,359,301,96,205,4,20,5,15,32,28,1,0,3,2
E33043983,282,198,66,132,0,21,2,19,63,53,3,7,0,0
E33043984,369,263,88,175,8,32,7,25,59,53,1,3,2,7
E33043985,343,246,76,170,4,12,3,9,71,63,4,4,0,10
E33043986,280,224,66,158,4,17,6,11,31,24,1,1,5,4
E33043987,321,219,74,145,7,38,8,30,50,48,1,1,0,7
E33043988,423,265,92,173,2,54,7,47,88,63,19,6,0,14
E33043989,364,294,115,179,5,23,4,19,39,30,0,3,6,3
E33043990,301,196,30,166,11,41,5,36,51,45,3,3,0,2
E33043991,340,249,67,182,4,33,4,29,53,47,1,2,3,1
E33043992,388,309,72,237,7,18,5,13,48,44,1,3,0,6
E33043993,300,242,83,159,2,17,0,17,37,34,1,2,0,2
E33043994,291,215,59,156,2,50,11,39,23,15,0,3,5,1
E33043995,314,239,82,157,6,28,2,26,40,34,1,2,3,1
E33043996,369,249,83,166,6,47,5,42,62,50,5,4,3,5
E33043997,345,271,93,178,4,37,12,25,29,26,1,2,0,4
E33043998,699,518,121,397,8,95,8,87,72,62,1,6,3,6
E33043999,315,213,64,149,8,51,5,46,42,40,0,1,1,1
E33044000,351,257,81,176,4,30,2,28,60,49,4,6,1,0
E33044001,417,283,65,218,8,43,1,42,78,68,6,3,1,5
E33044002,403,267,75,192,11,46,5,41,71,65,1,4,1,8
E33044003,408,301,86,215,8,33,3,30,62,44,4,6,8,4
E33044004,227,146,56,90,4,48,4,44,29,27,0,2,0,0
E33044005,706,489,137,352,16,78,11,67,117,93,5,11,8,6
E33044006,507,351,102,249,9,55,7,48,89,69,10,4,6,3
E33044007,336,264,82,182,6,29,4,25,32,31,1,0,0,5
E33044008,420,331,112,219,5,46,10,36,35,29,1,3,2,3
E33044009,382,277,100,177,4,43,10,33,56,51,3,2,0,2
E33044010,491,379,137,242,4,43,10,33,61,52,5,2,2,4
E33044011,418,270,92,178,7,47,5,42,79,65,4,4,6,15
E33044012,315,203,87,116,3,34,5,29,66,54,7,2,3,9
E33044013,435,303,95,208,4,20,4,16,92,80,7,2,3,16
E33044014,420,298,89,209,8,37,4,33,65,49,8,5,3,12
E33044015,632,408,171,237,5,54,7,47,109,86,15,2,6,56
E33044016,421,282,34,248,9,37,4,33,91,78,9,2,2,2
E33044017,371,263,67,196,3,22,1,21,81,46,23,2,10,2
E33044018,320,212,29,183,4,31,5,26,72,53,8,5,6,1
E33044019,403,232,55,177,4,33,5,28,129,56,42,4,27,5
E33044020,462,285,67,218,6,75,7,68,90,61,20,5,4,6
E33044021,3923,2307,475,1832,48,268,61,207,1284,406,537,17,324,16
E33044022,357,259,65,194,3,46,10,36,46,29,9,2,6,3
E33044023,384,272,71,201,13,30,6,24,66,57,3,6,0,3
E33044024,395,303,88,215,6,30,5,25,49,37,6,3,3,7
E33044025,282,200,66,134,2,36,9,27,37,34,0,0,3,7
E33044026,590,440,132,308,4,35,3,32,97,83,9,4,1,14
E33044027,224,130,52,78,2,20,6,14,56,47,5,2,2,16
E33044028,276,207,59,148,5,12,2,10,49,43,0,5,1,3
E33044029,240,161,60,101,5,39,3,36,31,25,1,4,1,4
E33044030,310,263,83,180,2,9,5,4,35,34,0,0,1,1
E33044031,417,306,94,212,0,41,16,25,69,64,4,1,0,1
E33044032,292,198,68,130,2,32,9,23,60,54,1,5,0,0
E33044033,417,265,82,183,8,23,11,12,109,100,0,8,1,12
E33044034,240,169,60,109,1,13,6,7,55,45,8,1,1,2
E33044035,322,275,74,201,2,7,0,7,32,31,1,0,0,6
E33044036,280,217,67,150,5,9,5,4,49,44,1,4,0,0
E33044037,671,465,122,343,6,71,28,43,121,110,3,5,3,8
E33044038,258,206,58,148,1,7,2,5,42,39,0,3,0,2
E33044039,441,318,104,214,5,32,15,17,84,81,0,2,1,2
E33044040,472,340,87,253,5,37,13,24,89,87,0,2,0,1
E33044041,421,270,69,201,8,67,11,56,72,61,0,10,1,4
E33044042,429,340,100,240,3,41,12,29,45,42,0,2,1,0
E33044043,410,289,67,222,7,33,12,21,81,77,2,1,1,0
E33044044,343,232,36,196,4,44,9,35,63,54,3,5,1,0
E33044045,266,190,37,153,6,37,12,25,31,27,3,0,1,2
E33044046,329,229,58,171,6,51,14,37,39,37,0,2,0,4
E33044047,239,180,50,130,3,17,2,15,39,38,0,1,0,0
E33044048,559,439,145,294,3,23,7,16,89,84,2,2,1,5
E33044049,467,369,114,255,2,20,9,11,71,69,0,1,1,5
E33044050,800,510,126,384,6,64,25,39,216,201,5,9,1,4
E33044051,479,364,111,253,2,17,2,15,88,83,0,5,0,8
E33044052,223,186,46,140,4,11,2,9,22,18,0,2,2,0
E33044053,285,243,58,185,0,16,4,12,26,21,1,4,0,0
E33044054,306,221,74,147,3,25,13,12,55,47,4,3,1,2
E33044055,360,281,83,198,1,25,5,20,47,43,0,4,0,6
E33044056,261,161,38,123,3,16,8,8,81,80,0,1,0,0
E33044057,314,231,73,158,3,35,7,28,44,40,1,3,0,1
E33044058,298,224,71,153,1,23,6,17,47,44,0,2,1,3
E33044059,271,207,66,141,5,22,8,14,34,32,0,1,1,3
E33044060,378,267,64,203,4,25,9,16,80,79,0,1,0,2
E33044061,405,253,75,178,5,53,15,38,92,84,0,8,0,2
E33044062,276,222,80,142,1,13,6,7,38,38,0,0,0,2
E33044063,1079,651,166,485,15,146,52,94,261,251,4,3,3,6
E33044064,281,202,55,147,2,40,16,24,37,35,0,2,0,0
E33044065,267,203,67,136,0,16,7,9,43,34,2,7,0,5
E33044066,329,250,59,191,5,36,10,26,36,33,0,3,0,2
E33044067,373,267,86,181,7,54,16,38,41,38,2,1,0,4
E33044068,366,272,79,193,5,28,13,15,55,47,2,3,3,6
E33044069,234,202,73,129,1,12,3,9,17,17,0,0,0,2
E33044070,480,368,93,275,3,23,6,17,75,66,3,5,1,11
E33044071,358,276,100,176,1,10,2,8,66,64,0,2,0,5
E33044072,296,257,87,170,0,3,2,1,33,31,2,0,0,3
E33044073,252,209,58,151,5,9,1,8,27,24,0,3,0,2
E33044074,239,181,71,110,3,11,1,10,41,32,4,3,2,3
E33044075,483,364,86,278,3,43,12,31,70,60,5,5,0,3
E33044076,259,156,47,109,3,24,8,16,73,72,0,1,0,3
E33044077,333,237,65,172,2,22,3,19,70,69,0,1,0,2
E33044078,616,436,130,306,5,57,23,34,114,109,1,3,1,4
E33044079,316,239,71,168,4,25,9,16,46,43,0,3,0,2
E33044080,274,219,52,167,2,10,3,7,38,37,0,1,0,5
E33044081,385,295,97,198,3,15,6,9,68,62,2,4,0,4
E33044082,469,332,108,224,3,32,9,23,93,82,6,5,0,9
E33044083,279,172,45,127,4,32,11,21,66,61,2,3,0,5
E33044084,606,430,128,302,6,39,16,23,122,113,3,6,0,9
E33044085,469,323,73,250,6,32,17,15,106,92,8,4,2,2
E33044086,266,164,48,116,1,28,14,14,66,62,0,3,1,7
E33044087,274,223,67,156,5,15,3,12,25,22,3,0,0,6
E33044088,575,422,123,299,9,40,16,24,104,99,2,3,0,0
E33044089,385,291,76,215,1,39,13,26,50,49,0,1,0,4
E33044090,319,242,51,191,2,11,5,6,62,57,2,3,0,2
E33044091,369,277,111,166,1,28,8,20,55,47,2,5,1,8
E33044092,438,356,143,213,5,25,11,14,47,45,0,1,1,5
E33044093,315,261,101,160,5,11,2,9,33,28,4,1,0,5
E33044094,637,326,88,238,9,88,34,54,213,202,5,4,2,1
E33044095,277,205,83,122,5,15,5,10,49,41,8,0,0,3
E33044096,650,484,142,342,6,56,22,34,100,87,8,5,0,4
E33044097,372,282,66,216,3,44,13,31,39,34,1,4,0,4
E33044098,282,249,87,162,3,6,3,3,21,20,0,1,0,3
E33044099,284,206,64,142,4,24,9,15,49,47,1,1,0,1
E33044100,678,484,145,339,9,73,22,51,106,101,1,4,0,6
E33044101,634,431,149,282,3,53,13,40,130,98,29,2,1,17
E33044102,589,410,116,294,4,63,20,43,108,98,2,8,0,4
E33044103,280,238,89,149,0,7,1,6,32,31,0,1,0,3
E33044104,569,391,123,268,3,47,14,33,124,119,0,4,1,4
E33044105,318,235,89,146,1,29,7,22,49,47,1,0,1,4
E33044106,645,474,106,368,6,25,10,15,139,127,1,11,0,1
E33044107,427,328,92,236,5,32,10,22,61,53,0,3,5,1
E33044108,246,167,77,90,1,14,8,6,44,41,0,3,0,20
E33044109,539,423,110,313,2,12,5,7,98,92,0,5,1,4
E33044110,342,261,71,190,5,14,3,11,59,56,1,0,2,3
E33044111,240,165,53,112,4,5,1,4,60,55,0,4,1,6
E33044112,453,290,93,197,3,34,13,21,109,94,5,8,2,17
E33044113,475,339,65,274,3,22,9,13,109,100,0,7,2,2
E33044114,348,250,74,176,5,26,12,14,61,57,3,1,0,6
E33044115,305,208,73,135,0,13,6,7,70,45,22,2,1,14
E33044116,437,285,103,182,2,35,9,26,108,92,4,9,3,7
E33044117,527,365,115,250,4,84,28,56,68,57,2,8,1,6
E33044118,238,180,91,89,1,7,6,1,46,43,0,0,3,4
E33044119,289,225,75,150,1,25,14,11,35,30,0,5,0,3
E33044120,357,261,83,178,7,42,12,30,44,43,0,1,0,3
E33044121,589,414,128,286,4,49,22,27,99,86,1,12,0,23
E33044122,315,234,104,130,4,22,9,13,47,45,0,1,1,8
E33044123,272,222,80,142,6,6,2,4,31,23,8,0,0,7
E33044124,269,218,78,140,3,9,4,5,35,34,0,1,0,4
E33044125,548,423,150,273,2,37,9,28,81,70,2,9,0,5
E33044126,368,280,86,194,1,14,6,8,72,69,1,2,0,1
E33044127,604,487,135,352,4,21,2,19,87,84,0,2,1,5
E33044128,361,278,92,186,2,21,13,8,58,55,1,2,0,2
E33044129,476,410,132,278,4,20,5,15,39,37,0,2,0,3
E33044130,429,372,91,281,8,14,6,8,34,28,3,2,1,1
E33044131,553,398,92,306,1,71,9,62,80,68,0,10,2,3
E33044132,352,301,101,200,3,10,4,6,38,34,0,3,1,0
E33044133,315,291,88,203,1,10,1,9,11,11,0,0,0,2
E33044134,364,302,83,219,3,9,2,7,47,47,0,0,0,3
E33044135,334,296,90,206,2,6,2,4,27,26,0,1,0,3
E33044136,506,381,128,253,2,35,9,26,86,76,2,7,1,2
E33044137,428,326,84,242,6,36,4,32,57,49,1,7,0,3
E33044138,331,274,97,177,0,16,3,13,37,36,0,1,0,4
E33044139,372,298,83,215,4,26,8,18,42,35,2,3,2,2
E33044140,468,367,90,277,4,27,6,21,64,56,0,8,0,6
E33044141,315,207,59,148,5,54,3,51,47,43,1,3,0,2
E33044142,527,327,93,234,7,94,22,72,98,95,0,3,0,1
E33044143,509,371,99,272,8,70,22,48,57,53,1,3,0,3
E33044144,481,315,55,260,17,51,12,39,89,76,3,7,3,9
E33044145,1253,827,204,623,13,159,52,107,247,235,1,10,1,7
E33044146,507,322,78,244,7,91,17,74,83,76,1,6,0,4
E33044147,394,279,76,203,5,39,14,25,65,63,0,2,0,6
E33044148,326,269,80,189,2,4,0,4,48,41,2,5,0,3
E33044149,330,262,64,198,4,11,2,9,52,46,1,5,0,1
E33044150,394,279,78,201,3,29,5,24,80,76,2,2,0,3
E33044151,474,324,87,237,9,42,16,26,96,90,0,5,1,3
E33044152,554,386,97,289,4,49,10,39,109,95,1,12,1,6
E33044153,260,185,44,141,2,18,4,14,50,44,1,5,0,5
E33044154,296,209,74,135,1,21,4,17,58,55,2,0,1,7
E33044155,422,308,107,201,7,21,2,19,73,64,5,4,0,13
E33044156,2128,1540,439,1101,31,165,51,114,380,339,23,14,4,12
E33044157,403,258,76,182,4,31,8,23,105,95,1,7,2,5
E33044158,361,268,91,177,3,34,3,31,49,41,0,8,0,7
E33044159,529,338,108,230,4,39,11,28,122,70,49,1,2,26
E33044160,306,252,78,174,1,11,1,10,39,32,1,2,4,3
E33044161,524,424,129,295,2,39,5,34,57,54,0,3,0,2
E33044162,240,183,67,116,2,15,3,12,39,29,7,1,2,1
E33044163,254,162,74,88,2,34,19,15,34,30,2,0,2,22
E33044164,505,344,90,254,3,46,24,22,107,90,7,10,0,5
E33044165,451,384,124,260,2,21,7,14,38,37,0,1,0,6
E33044166,288,211,99,112,5,24,15,9,45,37,1,4,3,3
E33044167,306,222,79,143,0,44,30,14,35,31,1,2,1,5
E33044168,330,254,80,174,3,22,14,8,47,42,0,3,2,4
E33044169,237,196,78,118,2,13,9,4,25,19,1,4,1,1
E33044170,298,204,68,136,8,49,29,20,37,34,2,1,0,0
E33044171,238,199,57,142,1,16,7,9,20,13,3,3,1,2
E33044172,304,178,61,117,2,32,16,16,89,33,26,1,29,3
E33044173,380,267,94,173,7,30,12,18,72,66,0,1,5,4
E33044174,590,438,133,305,10,26,13,13,112,66,31,4,11,4
E33044175,282,231,76,155,1,26,22,4,20,15,3,2,0,4
E33044176,336,253,96,157,8,13,6,7,58,33,15,4,6,4
E33044177,392,321,123,198,0,19,7,12,49,43,2,3,1,3
E33044178,280,208,73,135,2,19,7,12,45,38,5,2,0,6
E33044179,355,291,103,188,0,18,11,7,40,35,0,1,4,6
E33044180,268,214,77,137,2,17,10,7,29,26,1,0,2,6
E33044181,271,179,60,119,5,37,20,17,47,41,0,2,4,3
E33044182,438,346,127,219,3,34,18,16,51,35,9,2,5,4
E33044183,513,404,134,270,9,38,15,23,54,51,0,2,1,8
E33044184,260,215,66,149,2,15,10,5,24,24,0,0,0,4
E33044185,237,168,64,104,3,19,6,13,40,34,2,2,2,7
E33044186,377,280,79,201,2,43,21,22,51,43,2,5,1,1
E33044187,637,419,102,317,5,61,21,40,146,58,47,3,38,6
E33044188,401,334,93,241,0,18,5,13,46,38,4,2,2,3
E33044189,353,283,69,214,0,19,7,12,46,41,3,2,0,5
E33044190,585,402,105,297,6,72,13,59,103,88,3,10,2,2
E33044191,552,390,138,252,10,69,48,21,73,58,12,2,1,10
E33044192,519,419,168,251,5,56,36,20,37,33,0,4,0,2
E33044193,261,180,65,115,3,32,21,11,38,25,8,0,5,8
E33044194,255,181,52,129,3,30,19,11,36,29,4,3,0,5
E33044195,307,213,68,145,1,37,23,14,51,42,0,6,3,5
E33044196,289,246,65,181,4,19,11,8,20,19,0,1,0,0
E33044197,344,245,78,167,10,54,30,24,34,29,2,2,1,1
E33044198,359,232,60,172,18,48,30,18,60,54,5,0,1,1
E33044199,322,223,56,167,1,36,23,13,55,47,1,6,1,7
E33044200,311,205,63,142,7,33,29,4,64,63,0,1,0,2
E33044201,626,455,113,342,33,49,22,27,88,77,3,6,2,1
E33044202,564,333,80,253,18,114,100,14,93,80,9,4,0,6
E33044203,476,340,119,221,8,70,56,14,55,43,7,1,4,3
E33044204,480,287,92,195,8,108,85,23,72,65,0,6,1,5
E33044205,584,378,127,251,13,74,51,23,110,102,1,3,4,9
E33044206,393,277,90,187,5,58,52,6,50,44,1,5,0,3
E33044207,434,338,87,251,6,32,24,8,55,49,1,3,2,3
E33044208,357,248,70,178,8,32,21,11,66,62,2,2,0,3
E33044209,344,257,57,200,18,21,20,1,45,39,1,5,0,3
E33044210,373,252,87,165,3,47,34,13,69,62,1,5,1,2
E33044211,258,175,43,132,5,38,31,7,39,35,2,0,2,1
E33044212,374,287,72,215,5,48,18,30,33,31,0,0,2,1
E33044213,576,415,131,284,8,103,40,63,48,43,1,3,1,2
E33044214,254,191,75,116,1,21,13,8,38,35,3,0,0,3
E33044215,440,344,110,234,11,13,7,6,65,57,0,7,1,7
E33044216,341,273,100,173,2,19,14,5,42,39,1,1,1,5
E33044217,312,226,84,142,5,29,21,8,48,46,0,2,0,4
E33044218,302,256,76,180,2,13,5,8,31,27,1,3,0,0
E33044219,279,219,62,157,2,15,14,1,43,39,2,1,1,0
E33044220,227,177,61,116,2,13,11,2,32,26,3,2,1,3
E33044221,461,315,84,231,5,37,21,16,98,89,1,4,4,6
E33044222,581,312,82,230,15,171,159,12,79,70,6,2,1,4
E33044223,492,228,73,155,10,131,108,23,118,101,4,10,3,5
E33044224,340,181,44,137,9,46,10,36,97,86,3,7,1,7
E33044225,240,161,50,111,2,9,3,6,63,53,7,1,2,5
E33044226,331,256,93,163,4,13,8,5,50,42,4,0,4,8
E33044227,454,315,125,190,5,31,16,15,101,96,5,0,0,2
E33044228,468,311,117,194,5,30,22,8,109,89,4,7,9,13
E33044229,1635,1185,284,901,16,108,65,43,312,289,3,16,4,14
E33044230,331,212,62,150,4,30,17,13,85,78,1,5,1,0
E33044231,519,409,102,307,6,12,6,6,87,82,1,4,0,5
E33044232,488,356,84,272,9,16,11,5,96,87,1,6,2,11
E33044233,648,434,109,325,13,58,33,25,140,123,4,10,3,3
E33044234,256,187,65,122,0,14,8,6,51,45,1,3,2,4
E33044235,509,319,94,225,6,36,20,16,141,124,6,8,3,7
E33044236,300,237,70,167,0,26,15,11,37,34,1,2,0,0
E33044237,355,280,79,201,12,29,18,11,32,29,2,0,1,2
E33044238,414,295,76,219,6,53,30,23,56,53,0,3,0,4
E33044239,465,378,124,254,2,43,19,24,39,32,1,4,2,3
E33044240,245,169,73,96,3,39,34,5,32,32,0,0,0,2
E33044241,269,222,85,137,3,13,11,2,29,25,0,4,0,2
E33044242,290,163,59,104,5,35,20,15,87,76,2,8,1,0
E33044243,291,238,103,135,2,16,11,5,32,26,2,4,0,3
E33044244,369,291,104,187,0,17,12,5,60,51,4,2,3,1
E33044245,255,186,58,128,4,22,10,12,39,35,0,4,0,4
E33044246,227,180,64,116,1,13,10,3,26,23,1,1,1,7
E33044247,272,182,62,120,3,31,18,13,51,47,1,1,2,5
E33044248,429,313,76,237,3,25,21,4,81,72,1,6,2,7
E33044249,293,216,82,134,16,41,29,12,18,14,2,2,0,2
E33044250,299,212,62,150,2,18,13,5,52,51,0,1,0,15
E33044251,244,172,48,124,4,23,11,12,35,28,4,2,1,10
E33044252,406,281,103,178,5,49,44,5,58,49,3,1,5,13
E33044253,424,326,81,245,10,25,16,9,62,54,6,2,0,1
E33044254,415,301,130,171,4,20,8,12,71,64,5,2,0,19
E33044255,379,256,88,168,8,39,18,21,68,58,4,6,0,8
E33044256,368,236,86,150,9,30,18,12,77,68,5,3,1,16
E33044257,414,330,124,206,5,32,20,12,36,30,1,5,0,11
E33044258,233,166,65,101,2,16,5,11,48,44,2,2,0,1
E33044259,250,188,86,102,4,31,21,10,26,21,3,2,0,1
E33044260,370,300,115,185,1,23,5,18,46,41,0,4,1,0
E33044261,508,397,118,279,4,36,11,25,61,53,0,6,2,10
E33044262,338,267,96,171,4,16,1,15,36,33,1,2,0,15
E33044263,268,197,61,136,3,25,2,23,39,37,0,2,0,4
E33044264,384,324,94,230,0,31,3,28,28,23,5,0,0,1
E33044265,590,482,158,324,4,28,7,21,69,59,3,6,1,7
E33044266,344,280,79,201,1,19,1,18,43,40,2,1,0,1
E33044267,261,204,76,128,0,20,6,14,35,34,0,1,0,2
E33044268,604,390,104,286,6,91,17,74,107,87,6,11,3,10
E33044269,648,446,124,322,12,87,24,63,103,93,2,8,0,0
E33044270,2853,2022,578,1444,20,108,34,74,694,667,0,23,4,9
E33044271,437,294,92,202,3,87,24,63,49,45,2,1,1,4
E33044272,660,498,145,353,9,43,17,26,105,94,6,3,2,5
E33044273,218,178,66,112,0,14,2,12,25,19,1,5,0,1
E33044274,297,200,70,130,1,21,3,18,59,44,14,0,1,16
E33044275,310,234,102,132,3,20,6,14,47,42,1,4,0,6
E33044276,503,368,120,248,9,58,10,48,64,56,3,2,3,4
E33044277,417,348,107,241,6,22,5,17,35,32,3,0,0,6
E33044278,1227,829,230,599,4,37,6,31,353,340,5,8,0,4
E33044279,282,234,68,166,1,12,4,8,32,28,1,3,0,3
E33044280,256,214,82,132,1,11,3,8,28,27,0,1,0,2
E33044281,279,241,81,160,2,7,2,5,16,12,2,2,0,13
E33044282,305,228,62,166,4,17,3,14,55,53,0,1,1,1
E33044283,523,440,148,292,0,34,6,28,47,47,0,0,0,2
E33044284,272,236,93,143,0,9,1,8,26,19,0,2,5,1
E33044285,422,318,109,209,1,66,12,54,34,26,4,2,2,3
E33044286,251,178,67,111,2,27,4,23,41,39,0,1,1,3
E33044287,299,267,80,187,0,19,4,15,13,10,1,2,0,0
E33044288,515,382,117,265,3,46,10,36,76,70,0,6,0,8
E33044289,456,360,121,239,0,27,9,18,58,43,10,4,1,11
E33044290,298,256,89,167,0,20,3,17,19,18,0,1,0,3
E33044291,378,299,84,215,2,36,6,30,38,29,2,7,0,3
E33044292,293,222,94,128,4,14,3,11,49,42,0,6,1,4
E33044293,394,330,103,227,1,24,5,19,37,29,7,0,1,2
E33044294,289,193,78,115,3,28,6,22,51,45,2,3,1,14
E33044295,256,176,64,112,0,32,8,24,42,34,1,3,4,6
E33044296,372,282,115,167,3,17,5,12,55,49,1,1,4,15
E33044297,643,376,147,229,5,62,10,52,192,100,47,5,40,8
E33044298,449,371,121,250,5,16,2,14,51,50,0,1,0,6
E33044299,460,341,106,235,10,45,12,33,59,55,2,2,0,5
E33044300,235,162,63,99,1,35,9,26,35,35,0,0,0,2
E33044301,549,362,125,237,7,41,7,34,112,91,8,5,8,27
E33044302,265,202,68,134,4,18,5,13,39,36,0,3,0,2
E33044303,632,441,121,320,8,56,12,44,123,115,4,4,0,4
E33044304,367,268,80,188,3,38,8,30,52,48,1,3,0,6
E33044305,519,394,111,283,11,35,11,24,75,69,1,5,0,4
E33044306,298,196,72,124,2,47,7,40,48,41,4,3,0,5
E33044307,351,221,91,130,1,57,11,46,67,63,0,2,2,5
E33044308,556,366,115,251,3,65,18,47,116,104,3,9,0,6
E33044309,302,215,72,143,3,32,4,28,45,43,0,2,0,7
E33044310,422,242,68,174,11,131,17,114,33,27,4,1,1,5
E33044311,288,223,69,154,0,32,9,23,30,28,1,1,0,3
E33044312,433,301,86,215,3,55,4,51,71,61,2,6,2,3
E33044313,252,167,61,106,2,28,4,24,48,43,0,2,3,7
E33044314,296,207,84,123,2,38,2,36,44,42,0,1,1,5
E33044315,265,175,37,138,6,52,9,43,29,27,1,0,1,3
E33044316,351,189,83,106,6,18,2,16,114,106,3,2,3,24
E33044317,235,170,62,108,4,15,5,10,40,36,3,1,0,6
E33044318,381,298,107,191,4,23,5,18,41,35,1,3,2,15
E33044319,350,243,78,165,4,20,4,16,74,66,3,3,2,9
E33044320,236,153,73,80,1,31,8,23,34,25,4,5,0,17
E33044321,273,218,80,138,3,27,2,25,21,15,4,2,0,4
E33044322,253,183,84,99,0,14,7,7,49,31,4,4,10,7
E33044323,287,228,68,160,3,25,7,18,23,14,2,5,2,8
E33044324,679,457,119,338,7,69,30,39,134,107,1,9,17,12
E33044325,279,232,77,155,2,20,7,13,21,16,3,1,1,4
E33044326,480,353,110,243,6,56,27,29,63,60,0,3,0,2
E33044327,370,240,80,160,7,67,21,46,45,41,2,2,0,11
E33044328,314,283,87,196,2,17,3,14,12,11,1,0,0,0
E33044329,381,297,77,220,2,26,9,17,54,46,1,6,1,2
E33044330,278,245,64,181,1,15,2,13,15,14,0,1,0,2
E33044331,307,247,70,177,1,13,3,10,42,37,3,2,0,4
E33044332,367,277,95,182,1,36,8,28,49,47,1,1,0,4
E33044333,359,279,94,185,6,32,13,19,41,38,0,3,0,1
E33044334,425,384,105,279,2,15,2,13,23,19,1,3,0,1
E33044335,441,351,106,245,7,37,15,22,43,35,6,1,1,3
E33044336,646,468,154,314,6,92,20,72,78,70,0,5,3,2
E33044337,471,383,130,253,0,41,12,29,43,39,0,2,2,4
E33044338,322,252,72,180,4,24,7,17,41,39,1,1,0,1
E33044339,771,630,138,492,3,17,4,13,116,96,3,12,5,5
E33044340,269,204,67,137,3,26,9,17,34,29,3,0,2,2
E33044341,298,251,66,185,3,14,5,9,28,24,0,4,0,2
E33044342,314,252,83,169,5,26,15,11,27,25,0,0,2,4
E33044343,571,465,134,331,1,30,14,16,65,53,6,3,3,10
E33044344,393,295,68,227,7,27,6,21,59,51,2,6,0,5
E33044345,504,357,109,248,16,84,15,69,46,41,0,5,0,1
E33044346,453,297,58,239,6,105,32,73,42,38,1,3,0,3
E33044347,275,246,76,170,2,6,2,4,20,20,0,0,0,1
E33044348,288,222,67,155,2,15,7,8,36,26,2,6,2,13
E33044349,264,230,91,139,0,16,3,13,18,17,0,1,0,0
E33044350,765,583,167,416,11,67,18,49,93,83,5,5,0,11
E33044351,226,154,43,111,2,27,11,16,39,32,3,1,3,4
E33044352,892,389,102,287,7,173,91,82,316,301,1,10,4,7
E33044353,330,255,91,164,3,21,8,13,46,45,0,0,1,5
E33044354,267,209,60,149,1,19,8,11,36,32,2,1,1,2
E33044355,2302,1858,396,1462,21,74,33,41,338,321,1,13,3,11
E33044356,493,414,105,309,3,26,10,16,49,48,0,1,0,1
E33044357,390,271,74,197,7,46,10,36,61,59,0,2,0,5
E33044358,320,241,95,146,0,14,7,7,59,53,4,2,0,6
E33044359,355,248,57,191,7,67,20,47,30,22,4,3,1,3
E33044360,320,237,60,177,2,45,9,36,33,29,0,4,0,3
E33044361,460,282,73,209,5,105,37,68,63,58,3,1,1,5
E33044362,217,130,42,88,1,34,17,17,52,45,6,1,0,0
E33044363,542,398,120,278,7,39,15,24,92,88,1,3,0,6
E33044364,220,169,49,120,1,7,3,4,37,32,5,0,0,6
E33044365,273,209,52,157,2,15,6,9,44,42,0,1,1,3
E33044366,222,136,54,82,1,18,5,13,61,54,2,2,3,6
E33044367,422,346,90,256,7,23,7,16,44,39,4,1,0,2
E33044368,476,314,100,214,5,39,14,25,75,68,3,1,3,43
E33044369,395,274,71,203,3,46,17,29,69,63,0,4,2,3
E33044370,296,198,59,139,4,16,4,12,72,68,0,4,0,6
E33044371,263,193,67,126,0,26,10,16,39,36,2,1,0,5
E33044372,276,201,55,146,2,23,11,12,46,41,1,4,0,4
E33044373,466,378,102,276,1,37,10,27,49,43,4,2,0,1
E33044374,350,240,90,150,3,67,15,52,39,37,0,2,0,1
E33044375,441,302,90,212,11,40,15,25,85,81,0,1,3,3
E33044376,354,259,69,190,4,35,9,26,54,48,5,1,0,2
E33044377,543,339,83,256,6,35,13,22,157,143,7,5,2,6
E33044378,317,205,49,156,4,28,9,19,77,75,0,2,0,3
E33044379,328,255,71,184,1,23,6,17,47,45,0,0,2,2
E33044380,203,122,30,92,3,9,3,6,67,60,0,5,2,2
E33044381,271,186,65,121,1,40,13,27,42,39,1,2,0,2
E33044382,401,320,133,187,4,36,7,29,41,38,0,2,1,0
E33044383,325,217,50,167,1,19,7,12,84,71,2,11,0,4
E33044384,319,212,39,173,21,24,8,16,62,58,1,3,0,0
E33044385,496,316,83,233,10,53,23,30,114,106,1,5,2,3
E33044386,368,275,93,182,3,32,13,19,57,52,2,3,0,1
E33044387,432,271,57,214,13,59,16,43,88,83,0,4,1,1
E33044388,359,270,96,174,9,42,18,24,37,37,0,0,0,1
E33044389,349,278,78,200,7,14,6,8,46,41,2,2,1,4
E33044390,427,330,93,237,8,15,6,9,73,68,1,3,1,1
E33044391,694,512,124,388,15,49,8,41,105,87,9,8,1,13
E33044392,368,269,63,206,4,32,11,21,62,52,3,3,4,1
E33044393,842,631,139,492,8,44,17,27,146,135,1,7,3,13
E33044394,263,200,56,144,1,20,6,14,41,36,0,5,0,1
E33044395,266,218,79,139,1,16,6,10,27,23,2,2,0,4
E33044396,1116,821,170,651,20,101,32,69,170,161,0,9,0,4
E33044397,290,232,82,150,0,27,5,22,29,25,0,3,1,2
E33044398,391,281,73,208,4,53,12,41,47,45,1,1,0,6
E33044399,289,207,49,158,7,31,7,24,40,38,1,1,0,4
E33044400,567,392,108,284,13,79,24,55,81,79,0,1,1,2
E33044401,396,286,83,203,1,55,18,37,52,41,7,4,0,2
E33044402,294,221,60,161,1,16,5,11,51,49,0,2,0,5
E33044403,462,327,103,224,2,65,17,48,64,57,0,7,0,4
E33044404,258,198,47,151,4,39,22,17,16,13,1,2,0,1
E33044405,301,249,71,178,1,23,10,13,27,24,1,2,0,1
E33044406,259,180,54,126,6,34,14,20,39,36,1,2,0,0
E33044407,517,378,108,270,4,44,15,29,77,72,0,4,1,14
E33044408,353,226,55,171,7,90,37,53,28,25,1,2,0,2
E33044409,728,536,161,375,6,73,33,40,107,99,1,6,1,6
E33044410,247,166,42,124,1,49,7,42,30,28,2,0,0,1
E33044411,434,338,83,255,1,58,12,46,36,31,0,4,1,1
E33044412,415,379,125,254,0,11,6,5,23,22,1,0,0,2
E33044413,413,309,73,236,4,7,2,5,91,81,5,2,3,2
E33044414,392,310,95,215,3,23,7,16,49,45,1,3,0,7
E33044415,735,468,145,323,7,119,36,83,139,124,3,9,3,2
E33044416,369,222,67,155,5,27,8,19,111,107,0,4,0,4
E33044417,362,261,77,184,4,37,8,29,57,50,0,3,4,3
E33044418,459,320,85,235,6,37,14,23,95,90,1,2,2,1
E33044419,349,242,65,177,4,51,17,34,46,45,0,1,0,6
E33044420,1017,724,160,564,7,59,38,21,223,219,2,1,1,4
E33044421,669,484,115,369,4,53,34,19,120,112,6,1,1,8
E33044422,585,434,121,313,10,58,27,31,81,72,2,2,5,2
E33044423,629,416,62,354,2,33,14,19,175,171,2,2,0,3
E33044424,512,358,71,287,8,25,10,15,116,109,3,4,0,5
E33044425,586,368,121,247,4,68,42,26,131,112,13,6,0,15
E33044426,367,234,81,153,5,71,48,23,52,49,1,1,1,5
E33044427,1895,1168,351,817,14,84,33,51,616,583,12,13,8,13
E33044428,223,177,60,117,0,7,5,2,38,36,2,0,0,1
E33044429,477,308,82,226,6,41,29,12,113,103,8,2,0,9
E33044430,293,246,56,190,4,20,14,6,21,19,1,1,0,2
E33044431,762,560,141,419,3,34,16,18,161,150,3,7,1,4
E33044432,489,346,90,256,12,69,52,17,59,56,2,1,0,3
E33044433,372,227,52,175,6,75,64,11,59,50,4,4,1,5
E33044434,1335,895,250,645,23,125,50,75,254,210,10,13,21,38
E33044435,666,520,132,388,8,49,24,25,86,77,1,7,1,3
E33044436,466,303,90,213,8,92,58,34,57,53,1,1,2,6
E33044437,483,358,136,222,6,27,14,13,92,82,2,4,4,0
E33044438,539,398,97,301,8,41,16,25,89,87,0,2,0,3
E33044439,496,382,110,272,5,23,12,11,76,65,8,3,0,10
E33044440,329,238,76,162,10,18,8,10,57,53,4,0,0,6
E33044441,294,157,62,95,4,14,5,9,91,79,8,2,2,28
E33044442,315,243,82,161,1,26,12,14,40,36,1,3,0,5
E33044443,380,250,86,164,3,22,9,13,102,97,2,2,1,3
E33044444,577,414,100,314,21,66,48,18,73,70,1,2,0,3
E33044445,496,386,111,275,4,46,24,22,55,55,0,0,0,5
E33044446,479,330,104,226,8,59,35,24,81,73,5,3,0,1
E33044447,535,361,113,248,10,79,50,29,82,75,1,5,1,3
E33044448,432,327,84,243,3,24,7,17,77,73,0,4,0,1
E33044449,369,283,73,210,4,30,22,8,49,45,0,2,2,3
E33044450,657,515,130,385,8,37,18,19,94,79,2,8,5,3
E33044451,379,266,70,196,7,31,19,12,66,59,0,4,3,9
E33044452,734,544,124,420,15,88,48,40,83,76,3,4,0,4
E33044453,313,244,76,168,4,14,6,8,49,44,1,4,0,2
E33044454,453,339,89,250,7,39,25,14,57,47,0,6,4,11
E33044455,585,468,143,325,6,34,26,8,71,67,1,1,2,6
E33044456,1222,916,219,697,13,49,20,29,240,215,6,14,5,4
E33044457,671,496,141,355,9,55,26,29,110,103,1,6,0,1
E33044458,257,179,52,127,4,36,15,21,36,34,0,1,1,2
E33044459,367,278,87,191,3,31,10,21,52,50,0,2,0,3
E33044460,289,229,91,138,3,29,13,16,27,25,0,2,0,1
E33044461,322,244,84,160,1,25,14,11,41,35,0,5,1,11
E33044462,361,256,79,177,1,57,32,25,44,37,1,4,2,3
E33044463,401,311,67,244,2,37,25,12,50,46,1,2,1,1
E33044464,374,279,80,199,4,40,31,9,49,41,2,4,2,2
E33044465,463,368,119,249,5,24,17,7,65,45,17,2,1,1
E33044466,268,194,48,146,4,12,7,5,57,51,2,4,0,1
E33044467,241,181,68,113,3,17,14,3,38,30,6,2,0,2
E33044468,370,302,96,206,8,16,10,6,44,41,2,1,0,0
E33044469,376,274,101,173,4,45,32,13,49,42,4,3,0,4
E33044470,267,208,63,145,0,21,13,8,37,31,2,4,0,1
E33044471,298,240,52,188,7,23,18,5,27,23,0,3,1,1
E33044472,322,252,66,186,2,24,9,15,40,37,0,3,0,4
E33044473,331,271,87,184,3,23,10,13,29,24,2,3,0,5
E33044474,535,325,96,229,20,91,32,59,94,84,1,8,1,5
E33044475,323,186,45,141,16,56,14,42,62,59,1,1,1,3
E33044476,696,441,108,333,17,107,27,80,123,112,3,4,4,8
E33044477,629,428,101,327,13,98,38,60,89,83,0,6,0,1
E33044478,373,213,63,150,11,78,14,64,71,64,4,3,0,0
E33044479,266,179,49,130,6,56,5,51,23,21,0,1,1,2
E33044480,335,196,44,152,7,68,17,51,58,55,0,3,0,6
E33044481,361,313,79,234,4,10,3,7,33,31,0,2,0,1
E33044482,1164,864,284,580,27,106,26,80,150,138,4,5,3,17
E33044483,550,371,68,303,17,64,23,41,92,82,1,5,4,6
E33044484,312,257,91,166,2,15,6,9,34,32,0,2,0,4
E33044485,638,492,142,350,11,44,27,17,87,81,0,6,0,4
E33044486,393,300,94,206,5,30,14,16,51,49,1,1,0,7
E33044487,524,382,92,290,8,30,12,18,100,90,4,4,2,4
E33044488,1129,844,228,616,29,91,30,61,151,133,7,9,2,14
E33044489,399,286,76,210,4,41,14,27,66,63,0,2,1,2
E33044490,520,323,90,233,9,79,30,49,105,91,0,11,3,4
E33044491,683,483,132,351,9,46,13,33,139,128,3,6,2,6
E33044492,665,462,135,327,10,76,26,50,113,107,1,4,1,4
E33044493,752,551,168,383,6,84,25,59,109,102,5,2,0,2
E33044494,391,271,61,210,5,48,22,26,58,54,2,1,1,9
E33044495,426,336,82,254,1,22,6,16,63,60,0,2,1,4
E33044496,337,261,93,168,0,24,7,17,46,42,0,3,1,6
E33044497,535,414,114,300,9,28,4,24,79,70,3,3,3,5
E33044498,377,308,78,230,3,24,9,15,41,36,1,4,0,1
E33044499,314,246,70,176,7,22,6,16,38,35,0,3,0,1
E33044500,372,265,60,205,4,25,8,17,75,69,0,4,2,3
E33044501,710,529,131,398,17,66,23,43,95,89,3,2,1,3
E33044502,332,232,51,181,7,57,8,49,35,32,0,1,2,1
E33044503,319,218,59,159,3,56,12,44,42,42,0,0,0,0
E33044504,481,340,101,239,3,69,17,52,65,62,0,3,0,4
E33044505,311,201,53,148,2,35,11,24,72,68,0,3,1,1
E33044506,356,257,60,197,4,34,7,27,57,54,0,2,1,4
E33044507,377,238,66,172,11,72,23,49,50,48,0,1,1,6
E33044508,1159,752,194,558,24,174,62,112,203,186,3,13,1,6
E33044509,358,270,100,170,6,20,6,14,57,49,4,2,2,5
E33044510,309,264,83,181,0,16,3,13,27,23,0,4,0,2
E33044511,378,294,111,183,4,35,11,24,41,37,0,3,1,4
E33044512,384,311,94,217,6,16,1,15,48,40,2,3,3,3
E33044513,275,176,68,108,5,34,10,24,50,46,2,2,0,10
E33044514,230,176,54,122,1,10,6,4,35,29,1,3,2,8
E33044515,297,212,63,149,1,16,5,11,66,62,2,2,0,2
E33044516,361,289,77,212,6,14,2,12,49,45,0,1,3,3
E33044517,237,175,63,112,4,17,7,10,40,33,0,6,1,1
E33044518,270,211,64,147,4,31,14,17,21,19,0,2,0,3
E33044519,398,274,89,185,1,46,14,32,76,71,3,2,0,1
E33044520,408,308,87,221,1,43,10,33,52,49,0,3,0,4
E33044521,447,345,99,246,8,34,8,26,57,51,3,3,0,3
E33044522,298,203,52,151,5,56,10,46,29,27,0,1,1,5
E33044523,717,520,167,353,12,89,29,60,89,79,1,8,1,7
E33044524,1205,868,209,659,12,104,32,72,206,190,0,16,0,15
E33044525,346,266,56,210,3,47,11,36,24,17,5,1,1,6
E33044526,156,131,39,92,6,6,2,4,13,13,0,0,0,0
E33044527,418,321,118,203,8,32,16,16,45,41,1,3,0,12
E33044528,255,197,57,140,1,6,0,6,45,44,0,1,0,6
E33044529,393,280,93,187,7,41,11,30,61,53,1,6,1,4
E33044530,263,224,69,155,2,20,2,18,17,15,1,1,0,0
E33044531,358,276,82,194,5,18,5,13,56,52,2,2,0,3
E33044532,625,482,123,359,4,50,18,32,87,80,3,3,1,2
E33044533,335,246,79,167,8,32,5,27,48,40,2,5,1,1
E33044534,234,179,63,116,2,20,10,10,29,26,1,2,0,4
E33044535,253,199,65,134,0,17,3,14,35,33,1,1,0,2
E33044536,487,343,91,252,3,15,3,12,123,117,4,2,0,3
E33044537,328,262,69,193,1,40,6,34,24,16,5,1,2,1
E33044538,699,515,159,356,4,42,13,29,118,104,3,9,2,20
E33044539,646,534,175,359,3,33,14,19,62,54,3,4,1,14
E33044540,251,192,86,106,1,19,3,16,35,25,10,0,0,4
E33044541,259,194,57,137,1,12,4,8,40,31,6,3,0,12
E33044542,413,329,76,253,3,20,3,17,57,52,1,3,1,4
E33044543,726,509,136,373,6,71,14,57,131,108,19,3,1,9
E33044544,280,208,55,153,2,35,4,31,34,29,0,3,2,1
E33044545,383,323,102,221,0,23,4,19,32,30,0,2,0,5
E33044546,286,258,81,177,0,4,3,1,23,20,0,3,0,1
E33044547,298,243,76,167,2,9,3,6,41,35,4,2,0,3
E33044548,339,268,68,200,2,39,8,31,29,22,1,5,1,1
E33044549,711,561,161,400,8,45,12,33,95,91,2,2,0,2
E33044550,334,241,62,179,1,23,3,20,67,58,6,1,2,2
E33044551,423,238,47,191,5,127,21,106,52,29,10,7,6,1
E33044552,573,403,91,312,5,70,10,60,90,77,8,3,2,5
E33044553,693,552,139,413,9,39,5,34,88,76,5,6,1,5
E33044554,434,346,73,273,3,16,6,10,68,64,1,0,3,1
E33044555,436,379,125,254,0,16,4,12,36,32,3,1,0,5
E33044556,239,201,58,143,2,6,1,5,30,23,3,2,2,0
E33044557,325,258,84,174,4,14,4,10,47,45,0,2,0,2
E33044558,531,395,98,297,6,53,34,19,76,68,2,3,3,1
E33044559,321,276,83,193,0,13,2,11,29,25,1,2,1,3
E33044560,256,170,70,100,3,14,6,8,69,62,1,5,1,0
E33044561,537,434,106,328,12,29,5,24,60,52,3,2,3,2
E33044562,341,291,79,212,4,7,2,5,35,30,0,3,2,4
E33044563,420,332,97,235,1,25,7,18,29,22,6,0,1,33
E33044564,268,216,66,150,2,19,12,7,30,25,2,1,2,1
E33044565,325,286,79,207,1,6,4,2,32,28,1,2,1,0
E33044566,465,397,103,294,4,12,2,10,47,38,2,5,2,5
E33044567,316,258,60,198,3,18,8,10,37,35,0,1,1,0
E33044568,311,225,75,150,9,20,4,16,57,41,14,1,1,0
E33044569,591,453,132,321,5,64,15,49,68,56,3,6,3,1
E33044570,212,141,24,117,1,25,3,22,44,40,0,4,0,1
E33044571,616,371,87,284,16,55,5,50,167,152,2,10,3,7
E33044572,382,254,72,182,3,44,11,33,77,71,2,3,1,4
E33044573,522,396,108,288,5,56,12,44,61,55,1,4,1,4
E33044574,314,239,56,183,0,33,6,27,39,32,3,2,2,3
E33044575,439,349,91,258,7,33,3,30,47,42,2,1,2,3
E33044576,271,178,49,129,5,26,4,22,61,52,0,6,3,1
E33044577,417,345,98,247,1,16,8,8,54,51,0,2,1,1
E33044578,393,310,86,224,4,21,5,16,54,41,1,10,2,4
E33044579,313,267,83,184,1,17,7,10,28,22,3,2,1,0
E33044580,394,367,89,278,2,7,1,6,18,18,0,0,0,0
E33044581,1486,1107,239,868,31,47,10,37,289,276,4,7,2,12
E33044582,396,286,67,219,5,58,12,46,46,45,0,0,1,1
E33044583,471,399,122,277,2,10,1,9,58,50,2,4,2,2
E33044584,597,458,97,361,5,62,19,43,66,56,3,4,3,6
E33044585,274,229,64,165,1,18,4,14,24,21,2,0,1,2
E33044586,324,264,69,195,3,10,2,8,45,36,1,8,0,2
E33044587,690,488,122,366,10,80,16,64,111,101,3,6,1,1
E33044588,341,242,66,176,2,19,5,14,76,53,11,8,4,2
E33044589,330,259,53,206,2,18,0,18,41,35,2,2,2,10
E33044590,341,264,79,185,1,17,7,10,55,40,9,6,0,4
E33044591,418,243,59,184,8,37,8,29,122,49,40,2,31,8
E33044592,409,307,86,221,2,46,21,25,51,34,2,10,5,3
E33044593,274,230,93,137,0,18,12,6,26,22,0,4,0,0
E33044594,532,428,135,293,4,38,24,14,59,53,1,5,0,3
E33044595,260,192,66,126,9,19,5,14,39,38,0,1,0,1
E33044596,324,248,77,171,5,14,6,8,56,54,0,1,1,1
E33044597,292,232,62,170,3,15,7,8,40,38,1,1,0,2
E33044598,378,273,68,205,6,25,15,10,71,68,0,2,1,3
E33044599,637,454,136,318,13,72,19,53,92,85,0,4,3,6
E33044600,599,457,144,313,5,57,29,28,77,68,5,4,0,3
E33044601,367,243,59,184,10,59,24,35,50,43,2,4,1,5
E33044602,500,398,102,296,4,38,24,14,50,44,3,1,2,10
E33044603,492,324,64,260,12,68,31,37,84,74,6,4,0,4
E33044604,352,278,66,212,9,30,22,8,35,32,1,2,0,0
E33044605,386,306,103,203,2,34,23,11,39,36,1,0,2,5
E33044606,409,323,95,228,6,28,13,15,52,50,0,2,0,0
E33044607,304,237,64,173,3,17,9,8,46,41,5,0,0,1
E33044608,433,317,110,207,1,13,9,4,87,71,9,4,3,15
E33044609,321,224,70,154,5,32,24,8,56,52,4,0,0,4
E33044610,372,248,89,159,1,30,20,10,54,44,5,2,3,39
E33044611,582,419,100,319,4,65,45,20,87,85,1,1,0,7
E33044612,485,373,115,258,4,47,33,14,59,51,6,2,0,2
E33044613,240,198,56,142,1,22,7,15,19,17,0,2,0,0
E33044614,365,304,107,197,2,24,11,13,27,24,3,0,0,8
E33044615,311,263,86,177,2,19,15,4,25,20,0,3,2,2
E33044616,590,452,103,349,4,50,27,23,79,75,1,3,0,5
E33044617,448,363,113,250,3,19,7,12,56,51,3,1,1,7
E33044618,406,322,116,206,10,19,11,8,46,40,0,5,1,9
E33044619,457,377,155,222,3,27,18,9,46,37,6,2,1,4
E33044620,398,313,109,204,2,25,17,8,57,51,2,2,2,1
E33044621,353,263,85,178,4,31,23,8,45,35,8,2,0,10
E33044622,636,490,174,316,9,65,36,29,65,57,7,1,0,7
E33044623,318,240,73,167,2,31,16,15,36,30,5,1,0,9
E33044624,474,337,111,226,4,62,28,34,69,62,3,4,0,2
E33044625,427,296,96,200,2,40,22,18,83,78,0,5,0,6
E33044626,297,201,53,148,2,38,19,19,49,46,3,0,0,7
E33044627,297,224,52,172,1,40,30,10,28,21,4,3,0,4
E33044628,372,274,93,181,1,72,47,25,24,20,3,1,0,1
E33044629,382,252,73,179,7,80,53,27,40,38,1,1,0,3
E33044630,352,252,73,179,3,57,39,18,36,36,0,0,0,4
E33044631,286,204,77,127,3,31,15,16,42,39,2,1,0,6
E33044632,275,212,79,133,2,21,9,12,36,32,1,3,0,4
E33044633,481,376,120,256,5,33,21,12,59,49,8,1,1,8
E33044634,261,201,64,137,1,15,7,8,43,40,0,2,1,1
E33044635,595,413,103,310,9,73,43,30,94,84,2,4,4,6
E33044636,299,229,82,147,3,25,19,6,36,35,1,0,0,6
E33044637,209,168,57,111,1,22,17,5,15,8,5,1,1,3
E33044638,309,228,73,155,2,30,16,14,39,31,4,4,0,10
E33044639,244,171,45,126,1,23,10,13,46,38,4,4,0,3
E33044640,244,179,51,128,2,19,13,6,43,35,6,0,2,1
E33044641,522,368,83,285,6,71,46,25,70,59,5,3,3,7
E33044642,268,200,65,135,0,31,20,11,35,33,1,1,0,2
E33044643,474,364,110,254,7,41,26,15,52,50,0,2,0,10
E33044644,312,242,72,170,1,11,2,9,55,40,9,5,1,3
E33044645,245,190,74,116,3,19,12,7,29,26,2,1,0,4
E33044646,338,276,87,189,0,13,6,7,48,43,0,5,0,1
E33044647,354,273,83,190,2,40,27,13,34,30,2,2,0,5
E33044648,339,262,88,174,0,29,21,8,42,32,7,0,3,6
E33044649,362,265,68,197,7,47,19,28,38,31,2,4,1,5
E33044650,396,304,75,229,4,31,10,21,46,44,1,1,0,11
E33044651,314,217,66,151,3,30,14,16,61,56,1,3,1,3
E33044652,298,222,68,154,5,27,13,14,44,41,2,1,0,0
E33044653,458,306,91,215,5,53,32,21,75,60,9,2,4,19
E33044654,279,216,60,156,3,20,6,14,30,29,0,1,0,10
E33044655,569,430,123,307,5,50,21,29,74,60,4,9,1,10
E33044656,339,286,83,203,1,16,9,7,36,33,0,0,3,0
E33044657,355,268,84,184,5,40,33,7,41,33,2,5,1,1
E33044658,640,493,126,367,8,52,22,30,84,75,4,3,2,3
E33044659,303,248,73,175,2,20,14,6,29,29,0,0,0,4
E33044660,442,337,112,225,0,66,25,41,36,31,3,1,1,3
E33044661,449,368,98,270,6,17,6,11,57,54,1,2,0,1
E33044662,525,386,94,292,6,22,7,15,103,95,2,6,0,8
E33044663,603,423,112,311,5,43,25,18,127,123,0,3,1,5
E33044664,297,209,74,135,10,58,41,17,19,16,0,3,0,1
E33044665,531,399,111,288,2,31,12,19,97,85,0,9,3,2
E33044666,393,280,77,203,5,42,24,18,65,59,2,3,1,1
E33044667,340,264,83,181,6,26,19,7,41,35,1,4,1,3
E33044668,546,432,141,291,4,37,14,23,71,63,7,1,0,2
E33044669,355,290,103,187,0,21,7,14,29,27,1,1,0,15
E33044670,369,301,95,206,2,26,17,9,36,27,4,3,2,4
E33044671,437,341,100,241,7,21,11,10,58,54,0,1,3,10
E33044672,306,259,86,173,1,15,12,3,24,17,6,0,1,7
E33044673,274,183,32,151,3,34,29,5,53,49,1,2,1,1
E33044674,297,207,51,156,5,50,42,8,33,24,6,1,2,2
E33044675,290,190,75,115,9,58,53,5,31,29,0,0,2,2
E33044676,343,241,89,152,6,40,27,13,55,47,0,3,5,1
E33044677,391,243,86,157,6,85,43,42,54,49,2,1,2,3
E33044678,308,222,54,168,2,40,33,7,40,37,1,1,1,4
E33044679,426,318,100,218,7,28,15,13,69,63,1,4,1,4
E33044680,403,307,99,208,2,39,34,5,49,44,1,3,1,6
E33044681,312,266,96,170,6,5,2,3,34,34,0,0,0,1
E33044682,573,334,127,207,5,71,44,27,116,70,36,4,6,47
E33044683,505,356,97,259,5,23,18,5,116,109,0,6,1,5
E33044684,259,189,70,119,2,17,13,4,48,42,1,5,0,3
E33044685,583,473,148,325,8,36,28,8,62,53,2,6,1,4
E33044686,368,233,60,173,6,34,24,10,89,80,3,4,2,6
E33044687,340,232,74,158,2,36,28,8,65,44,17,4,0,5
E33044688,1049,784,191,593,19,47,31,16,190,172,4,13,1,9
E33044689,331,282,110,172,2,13,8,5,28,25,0,1,2,6
E33044690,345,274,91,183,2,16,12,4,44,39,2,2,1,9
E33044691,366,286,118,168,3,28,21,7,43,35,5,1,2,6
E33044692,254,168,55,113,6,23,18,5,50,48,2,0,0,7
E33044693,678,483,154,329,13,64,52,12,111,88,18,4,1,7
E33044694,291,258,95,163,1,8,6,2,24,22,0,2,0,0
E33044695,336,257,64,193,3,26,15,11,45,37,0,6,2,5
E33044696,278,232,72,160,2,6,1,5,38,35,2,1,0,0
E33044697,397,279,73,206,3,49,30,19,58,52,3,2,1,8
E33044698,342,234,76,158,2,67,54,13,31,29,1,1,0,8
E33044699,664,537,194,343,11,35,20,15,78,66,9,1,2,3
E33044700,533,450,158,292,2,21,14,7,52,49,0,3,0,8
E33044701,414,283,76,207,11,21,15,6,95,89,6,0,0,4
E33044702,484,345,129,216,5,62,52,10,65,63,1,0,1,7
E33044703,309,220,66,154,5,43,29,14,35,31,0,1,3,6
E33044704,308,242,91,151,6,24,16,8,27,22,0,5,0,9
E33044705,281,217,65,152,6,29,23,6,26,23,2,0,1,3
E33044706,376,264,103,161,8,52,41,11,44,40,1,3,0,8
E33044707,233,168,72,96,3,21,14,7,34,27,5,0,2,7
E33044708,460,335,131,204,7,21,11,10,82,69,7,2,4,15
E33044709,579,407,137,270,2,52,36,16,104,80,21,3,0,14
E33044710,438,276,100,176,6,50,43,7,69,53,9,3,4,37
E33044711,267,216,77,139,1,11,8,3,25,20,2,1,2,14
E33044712,389,283,94,189,8,56,51,5,31,25,2,4,0,11
E33044713,496,372,136,236,3,31,16,15,73,61,6,2,4,17
E33044714,399,274,81,193,6,67,37,30,44,35,5,4,0,8
E33044715,289,238,65,173,2,15,10,5,30,24,2,4,0,4
E33044716,302,220,69,151,2,41,31,10,39,34,3,2,0,0
E33044717,327,273,83,190,4,16,14,2,27,23,2,2,0,7
E33044718,456,352,150,202,4,44,27,17,49,40,5,4,0,7
E33044719,611,378,145,233,8,52,31,21,130,73,46,5,6,43
E33044720,832,552,164,388,8,145,87,58,119,105,7,7,0,8
E33044721,297,191,56,135,4,40,20,20,59,45,13,1,0,3
E33044722,304,236,88,148,2,18,8,10,38,38,0,0,0,10
E33044723,340,236,103,133,14,29,16,13,39,36,3,0,0,22
E33044724,306,189,75,114,7,57,23,34,45,38,3,3,1,8
E33044725,332,247,84,163,2,51,32,19,22,15,6,1,0,10
E33044726,763,504,141,363,10,75,34,41,152,138,6,7,1,22
E33044727,273,195,77,118,5,32,21,11,25,23,1,0,1,16
E33044728,267,165,46,119,1,24,17,7,64,47,7,10,0,13
E33044729,438,318,100,218,4,46,35,11,60,55,1,4,0,10
E33044730,344,244,71,173,4,53,43,10,38,35,1,2,0,5
E33044731,263,177,65,112,0,30,20,10,54,54,0,0,0,2
E33044732,407,291,97,194,8,73,60,13,31,24,3,4,0,4
E33044733,320,252,79,173,0,18,9,9,44,37,1,5,1,6
E33044734,292,219,63,156,2,23,10,13,44,43,0,1,0,4
E33044735,267,218,73,145,1,21,16,5,21,14,2,4,1,6
E33044736,404,218,64,154,2,87,56,31,97,93,4,0,0,0
E33044737,373,248,58,190,8,49,31,18,62,52,1,5,4,6
E33044738,239,156,36,120,4,37,23,14,41,35,0,5,1,1
E33044739,328,256,84,172,0,38,35,3,34,31,0,3,0,0
E33044740,456,355,113,242,5,29,17,12,61,58,0,0,3,6
E33044741,461,350,106,244,3,36,18,18,58,44,4,7,3,14
E33044742,335,270,71,199,2,16,11,5,46,43,0,3,0,1
E33044743,275,209,63,146,3,19,11,8,42,41,0,1,0,2
E33044744,326,238,56,182,5,24,19,5,56,49,0,7,0,3
E33044745,380,294,62,232,1,50,44,6,31,27,4,0,0,4
E33044746,280,240,97,143,2,17,10,7,21,18,0,1,2,0
E33044747,465,381,123,258,5,39,23,16,37,33,0,3,1,3
E33044748,460,379,109,270,3,22,12,10,54,48,1,5,0,2
E33044749,527,388,96,292,3,34,24,10,101,79,11,6,5,1
E33044750,280,229,74,155,2,7,3,4,41,38,0,2,1,1
E33044751,438,321,112,209,2,27,15,12,83,81,0,2,0,5
E33044752,1830,1327,264,1063,22,77,38,39,390,372,3,10,5,14
E33044753,525,356,108,248,16,81,44,37,68,65,0,3,0,4
E33044754,258,206,78,128,4,13,10,3,32,26,1,1,4,3
E33044755,476,343,121,222,5,63,32,31,59,51,1,4,3,6
E33044756,269,223,49,174,2,13,10,3,27,26,0,0,1,4
E33044757,306,215,56,159,10,26,12,14,53,43,6,3,1,2
E33044758,355,283,94,189,1,15,6,9,50,47,2,1,0,6
E33044759,447,265,58,207,6,96,73,23,77,75,0,2,0,3
E33044760,419,277,72,205,0,41,25,16,97,87,3,3,4,4
E33044761,272,157,50,107,4,23,16,7,86,73,10,3,0,2
E33044762,294,196,49,147,3,50,36,14,41,32,4,4,1,4
E33044763,357,226,61,165,6,45,28,17,70,62,1,6,1,10
E33044764,433,254,84,170,8,78,48,30,90,88,1,1,0,3
E33044765,642,495,146,349,8,46,25,21,90,83,3,2,2,3
E33044766,575,424,88,336,8,57,36,21,82,71,3,8,0,4
E33044767,320,198,39,159,7,67,62,5,45,42,0,3,0,3
E33044768,435,341,120,221,7,22,16,6,54,49,3,1,1,11
E33044769,378,280,98,182,3,32,13,19,55,53,0,2,0,8
E33044770,395,274,88,186,5,54,35,19,60,57,3,0,0,2
E33044771,420,314,100,214,6,21,16,5,76,72,3,1,0,3
E33044772,529,348,122,226,7,52,27,25,110,100,6,3,1,12
E33044773,474,356,88,268,9,47,31,16,56,52,1,3,0,6
E33044774,379,277,64,213,12,37,25,12,51,42,5,4,0,2
E33044775,307,231,75,156,12,14,9,5,50,48,1,0,1,0
E33044776,652,437,116,321,15,86,40,46,106,93,8,5,0,8
E33044777,566,365,112,253,10,49,22,27,136,129,0,7,0,6
E33044778,793,592,183,409,12,49,27,22,131,120,5,4,2,9
E33044779,448,290,88,202,7,44,13,31,104,94,2,7,1,3
E33044780,267,185,56,129,2,34,27,7,43,40,0,0,3,3
E33044781,447,338,91,247,6,33,23,10,49,45,1,3,0,21
E33044782,546,402,129,273,2,43,17,26,98,85,3,5,5,1
E33044783,266,184,42,142,1,21,9,12,58,50,6,0,2,2
E33044784,713,483,122,361,2,59,26,33,161,151,1,9,0,8
E33044785,288,238,70,168,2,10,4,6,37,27,7,3,0,1
E33044786,501,343,84,259,5,68,29,39,82,75,2,4,1,3
E33044787,314,224,60,164,4,33,15,18,49,37,5,2,5,4
E33044788,475,353,103,250,7,34,21,13,76,69,2,5,0,5
E33044789,632,467,135,332,14,49,29,20,97,91,2,3,1,5
E33044790,296,234,76,158,3,10,4,6,43,38,2,3,0,6
E33044791,319,253,85,168,7,22,10,12,36,28,4,2,2,1
E33044792,350,263,80,183,0,23,9,14,60,56,0,4,0,4
E33044793,376,235,62,173,5,71,59,12,62,54,1,4,3,3
E33044794,280,197,54,143,3,28,21,7,52,45,3,4,0,0
E33044795,314,205,48,157,3,34,19,15,71,66,0,3,2,1
E33044796,331,259,99,160,0,37,34,3,31,30,1,0,0,4
E33044797,424,317,95,222,6,50,39,11,50,43,3,2,2,1
E33044798,431,311,85,226,3,50,37,13,63,61,0,2,0,4
E33044799,331,238,70,168,3,35,25,10,53,43,2,6,2,2
E33044800,415,284,76,208,6,62,37,25,60,51,4,3,2,3
E33044801,212,170,52,118,3,19,16,3,19,16,0,1,2,1
E33044802,289,233,70,163,1,11,4,7,36,31,2,1,2,8
E33044803,531,389,110,279,8,58,39,19,69,58,3,2,6,7
E33044804,254,198,59,139,0,14,11,3,30,29,1,0,0,12
E33044805,323,244,67,177,4,26,17,9,45,36,4,2,3,4
E33044806,405,308,82,226,4,45,16,29,44,38,3,1,2,4
E33044807,323,253,72,181,2,22,18,4,43,38,2,3,0,3
E33044808,453,352,104,248,2,33,24,9,61,59,0,2,0,5
E33044809,383,270,62,208,0,49,43,6,60,52,0,7,1,4
E33044810,336,261,68,193,0,26,14,12,49,47,1,1,0,0
E33044811,248,187,52,135,2,32,21,11,27,25,0,2,0,0
E33044812,471,416,130,286,3,10,4,6,37,32,0,5,0,5
E33044813,1543,1132,338,794,5,173,111,62,225,207,0,17,1,8
E33044814,310,247,60,187,4,20,11,9,37,32,0,5,0,2
E33044815,489,358,123,235,2,31,21,10,52,36,12,2,2,46
E33044816,647,550,154,396,6,21,16,5,64,54,3,5,2,6
E33044817,363,286,98,188,1,24,18,6,50,45,1,4,0,2
E33044818,378,260,58,202,4,30,23,7,75,70,2,3,0,9
E33044819,578,385,99,286,5,78,62,16,107,101,1,4,1,3
E33044820,870,649,219,430,13,98,70,28,104,99,1,4,0,6
E33044821,290,197,60,137,0,40,24,16,51,46,0,5,0,2
E33044822,359,243,65,178,4,60,35,25,49,45,0,3,1,3
E33044823,316,223,60,163,5,52,24,28,35,29,0,6,0,1
E33044824,305,230,76,154,1,10,2,8,61,56,0,5,0,3
E33044825,304,225,76,149,3,10,5,5,63,58,0,5,0,3
E33044826,360,267,57,210,2,19,8,11,70,58,2,10,0,2
E33044827,314,255,79,176,1,11,5,6,42,41,0,1,0,5
E33044828,430,316,71,245,3,31,16,15,75,70,0,5,0,5
E33044829,249,187,55,132,2,18,9,9,40,37,0,3,0,2
E33044830,337,250,67,183,0,35,26,9,47,41,1,5,0,5
E33044831,288,198,54,144,1,39,25,14,44,36,0,8,0,6
E33044832,619,448,121,327,5,54,36,18,108,96,4,6,2,4
E33044833,582,446,146,300,1,49,35,14,76,71,2,3,0,10
E33044834,453,295,66,229,4,69,33,36,82,74,0,7,1,3
E33044835,324,256,52,204,2,20,12,8,44,33,4,7,0,2
E33044836,430,335,114,221,2,35,19,16,52,49,1,2,0,6
E33044837,373,270,91,179,1,46,23,23,55,49,3,3,0,1
E33044838,416,289,92,197,5,38,25,13,79,77,0,2,0,5
E33044839,612,427,104,323,3,71,45,26,108,101,0,5,2,3
E33044840,313,248,75,173,2,22,18,4,39,38,1,0,0,2
E33044841,240,174,74,100,0,9,8,1,50,47,1,1,1,7
E33044842,396,264,92,172,2,26,16,10,63,54,6,1,2,41
E33044843,309,198,88,110,0,8,4,4,82,69,10,1,2,21
E33044844,246,180,70,110,1,23,11,12,40,38,1,0,1,2
E33044845,338,247,80,167,5,25,11,14,55,50,1,3,1,6
E33044846,293,235,70,165,1,6,3,3,47,40,0,5,2,4
E33044847,519,399,115,284,6,46,25,21,64,55,3,5,1,4
E33044848,278,213,77,136,2,12,9,3,37,29,5,3,0,14
E33044849,447,318,101,217,2,23,12,11,99,77,16,4,2,5
E33044850,323,238,82,156,4,26,13,13,47,41,1,3,2,8
E33044851,432,339,106,233,2,33,15,18,56,50,1,5,0,2
E33044852,402,281,103,178,1,28,18,10,85,80,1,4,0,7
E33044853,286,242,78,164,3,3,2,1,34,29,0,4,1,4
E33044854,400,277,95,182,1,37,14,23,80,76,1,2,1,5
E33044855,299,237,72,165,3,21,12,9,35,32,1,2,0,3
E33044856,266,214,65,149,2,17,12,5,28,24,0,1,3,5
E33044857,352,269,93,176,2,18,9,9,61,55,1,5,0,2
E33044858,364,260,96,164,2,27,13,14,74,69,4,0,1,1
E33044859,483,351,77,274,2,55,35,20,75,68,0,5,2,0
E33044860,331,212,72,140,6,40,25,15,73,66,1,5,1,0
E33044861,504,308,90,218,8,91,57,34,96,90,1,5,0,1
E33044862,619,464,119,345,18,26,16,10,110,104,1,5,0,1
E33044863,380,248,73,175,5,30,12,18,93,87,1,4,1,4
E33044864,668,448,79,369,10,42,15,27,166,157,0,9,0,2
E33044865,303,204,46,158,9,25,7,18,60,56,0,3,1,5
E33044866,534,329,91,238,9,75,44,31,120,108,2,9,1,1
E33044867,621,484,124,360,4,32,11,21,94,88,3,2,1,7
E33044868,742,554,179,375,6,82,38,44,97,92,0,5,0,3
E33044869,348,273,94,179,2,17,7,10,49,45,0,3,1,7
E33044870,385,301,83,218,6,40,22,18,37,34,2,1,0,1
E33044871,292,190,61,129,1,45,18,27,53,50,0,2,1,3
E33044872,442,338,97,241,6,22,10,12,74,66,2,5,1,2
E33044873,1089,785,201,584,15,86,33,53,195,180,1,13,1,8
E33044874,552,384,135,249,6,58,33,25,97,72,16,9,0,7
E33044875,232,182,57,125,2,9,3,6,33,32,0,1,0,6
E33044876,525,382,134,248,7,30,16,14,94,89,1,3,1,12
E33044877,426,313,90,223,6,34,11,23,70,63,0,6,1,3
E33044878,338,284,65,219,2,23,9,14,25,23,0,1,1,4
E33044879,500,395,133,262,5,26,8,18,71,64,2,3,2,3
E33044880,429,320,72,248,2,16,2,14,86,80,0,4,2,5
E33044881,330,257,77,180,5,19,6,13,42,40,0,2,0,7
E33044882,284,228,94,134,1,16,8,8,36,33,0,3,0,3
E33044883,292,256,117,139,0,8,2,6,24,23,0,0,1,4
E33044884,261,206,69,137,1,14,5,9,40,32,0,8,0,0
E33044885,564,425,135,290,4,47,20,27,86,79,1,6,0,2
E33044886,329,286,88,198,1,6,1,5,35,32,0,3,0,1
E33044887,285,224,74,150,3,14,5,9,41,37,0,4,0,3
E33044888,301,226,70,156,2,20,6,14,51,44,1,6,0,2
E33044889,713,514,103,411,9,50,30,20,137,118,9,9,1,3
E33044890,787,638,190,448,7,39,14,25,92,84,2,5,1,11
E33044891,256,219,100,119,0,11,3,8,23,21,0,2,0,3
E33044892,226,162,56,106,3,23,6,17,35,32,0,3,0,3
E33044893,223,159,62,97,1,20,8,12,42,39,0,3,0,1
E33044894,591,461,157,304,7,34,11,23,88,81,1,6,0,1
E33044895,393,290,99,191,3,24,12,12,72,71,0,1,0,4
E33044896,284,241,81,160,0,11,4,7,30,29,1,0,0,2
E33044897,575,342,112,230,3,53,23,30,171,163,2,4,2,6
E33044898,395,255,81,174,2,27,14,13,109,103,0,6,0,2
E33044899,496,327,97,230,5,43,20,23,120,108,2,8,2,1
E33044900,305,187,58,129,3,15,3,12,98,90,3,5,0,2
E33044901,526,414,117,297,5,34,7,27,67,63,1,3,0,6
E33044902,373,307,88,219,2,21,14,7,36,27,0,8,1,7
E33044903,259,193,76,117,3,14,5,9,45,44,0,1,0,4
E33044904,306,248,80,168,1,10,6,4,45,43,1,1,0,2
E33044905,419,345,107,238,0,22,12,10,46,39,0,5,2,6
E33044906,459,346,145,201,2,25,9,16,77,70,1,6,0,9
E33044907,273,175,53,122,4,23,10,13,69,61,2,5,1,2
E33044908,620,447,129,318,3,54,22,32,113,103,2,6,2,3
E33044909,409,275,77,198,4,46,12,34,82,77,1,4,0,2
E33044910,646,411,135,276,11,76,41,35,146,125,1,20,0,2
E33044911,335,239,46,193,4,48,26,22,42,37,0,3,2,2
E33044912,460,374,107,267,7,23,10,13,54,51,0,2,1,2
E33044913,344,254,95,159,2,14,3,11,73,65,1,5,2,1
E33044914,368,313,107,206,0,10,5,5,44,43,0,1,0,1
E33044915,279,236,88,148,1,3,0,3,38,35,1,2,0,1
E33044916,390,330,116,214,1,12,7,5,45,40,1,4,0,2
E33044917,463,287,74,213,7,65,26,39,101,98,0,3,0,3
E33044918,709,530,132,398,9,74,45,29,91,82,0,8,1,5
E33044919,324,218,71,147,5,37,14,23,62,53,1,8,0,2
E33044920,498,262,79,183,7,40,16,24,184,166,13,5,0,5
E33044921,512,328,77,251,7,46,23,23,126,120,1,5,0,5
E33044922,343,188,73,115,0,26,9,17,123,115,1,7,0,6
E33044923,359,204,61,143,5,42,22,20,105,100,2,3,0,3
E33044924,803,495,167,328,6,77,35,42,217,195,2,14,6,8
E33044925,268,170,59,111,2,12,2,10,82,71,2,4,5,2
E33044926,251,180,68,112,1,28,13,15,41,38,0,3,0,1
E33044927,341,212,70,142,2,20,11,9,101,94,1,6,0,6
E33044928,409,278,88,190,5,25,5,20,96,89,0,6,1,5
E33044929,310,201,85,116,4,19,6,13,83,80,1,2,0,3
E33044930,295,242,92,150,1,9,4,5,41,37,4,0,0,2
E33044931,333,276,102,174,0,8,1,7,44,41,0,2,1,5
E33044932,301,245,94,151,2,16,5,11,38,31,0,4,3,0
E33044933,309,270,79,191,2,13,4,9,23,20,0,3,0,1
E33044934,322,253,73,180,3,32,8,24,31,28,1,2,0,3
E33044935,436,370,114,256,3,16,6,10,45,33,7,5,0,2
E33044936,384,305,126,179,1,17,4,13,58,49,4,5,0,3
E33044937,402,282,111,171,10,56,15,41,51,45,1,2,3,3
E33044938,359,290,92,198,4,25,5,20,37,31,3,2,1,3
E33044939,235,145,42,103,3,29,14,15,55,52,1,2,0,3
E33044940,390,254,110,144,3,55,8,47,59,54,4,1,0,19
E33044941,316,255,110,145,0,27,6,21,26,19,1,3,3,8
E33044942,283,188,87,101,2,29,4,25,39,36,0,2,1,25
E33044943,274,229,101,128,1,10,2,8,25,20,3,2,0,9
E33044944,311,232,90,142,2,25,4,21,43,41,0,2,0,9
E33044945,250,215,68,147,0,7,2,5,20,15,4,1,0,8
E33044946,274,191,80,111,0,29,8,21,36,33,2,1,0,18
E33044947,387,258,103,155,0,45,10,35,71,60,1,9,1,13
E33044948,285,213,85,128,1,17,3,14,42,34,4,2,2,12
E33044949,307,190,92,98,2,30,9,21,78,58,17,3,0,7
E33044950,376,247,107,140,3,54,7,47,63,53,7,3,0,9
E33044951,266,205,76,129,1,21,0,21,33,28,1,4,0,6
E33044952,285,208,74,134,0,41,5,36,32,29,1,1,1,4
E33044953,514,295,102,193,10,118,20,98,88,77,4,7,0,3
E33044954,364,227,89,138,6,68,19,49,55,47,2,4,2,8
E33044955,382,246,77,169,4,58,13,45,62,49,6,4,3,12
E33044956,234,137,63,74,3,32,9,23,57,48,2,2,5,5
E33044957,499,337,138,199,2,82,11,71,69,60,3,5,1,9
E33044958,420,236,82,154,4,61,11,50,103,88,9,1,5,16
E33044959,360,198,68,130,6,91,32,59,58,50,5,2,1,7
E33044960,349,211,79,132,0,24,9,15,89,65,19,1,4,25
E33044961,334,212,72,140,2,27,6,21,80,68,5,7,0,13
E33044962,535,361,155,206,4,46,16,30,108,96,8,4,0,16
E33044963,453,291,81,210,3,53,27,26,95,86,2,6,1,11
E33044964,346,210,91,119,1,37,8,29,73,67,3,2,1,25
E33044965,279,134,58,76,1,23,2,21,78,58,16,0,4,43
E33044966,492,352,123,229,5,35,11,24,90,82,6,2,0,10
E33044967,501,380,162,218,6,38,8,30,74,62,6,3,3,3
E33044968,523,347,131,216,4,35,5,30,124,99,12,9,4,13
E33044969,508,334,123,211,8,54,12,42,98,82,3,8,5,14
E33044970,235,190,57,133,1,17,4,13,24,22,0,2,0,3
E33044971,338,243,101,142,1,46,16,30,48,42,1,3,2,0
E33044972,237,167,54,113,2,42,14,28,21,18,1,1,1,5
E33044973,243,149,64,85,5,32,6,26,47,34,11,1,1,10
E33044974,273,219,84,135,3,19,3,16,31,28,0,3,0,1
E33044975,415,337,122,215,3,32,16,16,41,33,4,3,1,2
E33044976,339,219,111,108,1,28,7,21,72,56,9,3,4,19
E33044977,285,192,70,122,1,32,5,27,55,54,1,0,0,5
E33044978,3492,2363,656,1707,69,350,71,279,686,579,48,37,22,24
E33044979,225,141,52,89,2,26,3,23,54,38,4,4,8,2
E33044980,511,291,96,195,6,95,13,82,116,105,2,9,0,3
E33044981,339,239,70,169,6,37,7,30,56,50,2,3,1,1
E33044982,345,254,80,174,2,45,8,37,40,38,2,0,0,4
E33044983,235,164,67,97,1,13,2,11,51,48,1,2,0,6
E33044984,344,155,61,94,7,78,14,64,97,91,2,4,0,7
E33044985,284,191,85,106,1,20,5,15,67,45,18,3,1,5
E33044986,400,285,130,155,4,41,15,26,66,51,9,3,3,4
E33044987,402,295,133,162,4,37,11,26,57,49,6,2,0,9
E33044988,812,303,65,238,1,88,31,57,412,128,157,6,121,8
E33044989,300,217,94,123,4,24,4,20,51,45,0,6,0,4
E33044990,572,431,159,272,0,47,13,34,86,75,3,4,4,8
E33044991,305,211,67,144,4,41,7,34,44,43,0,1,0,5
E33044992,500,344,120,224,8,44,10,34,99,88,4,6,1,5
E33044993,504,307,94,213,6,65,16,49,105,93,2,8,2,21
E33044994,343,239,76,163,3,28,8,20,69,54,4,11,0,4
E33044995,408,261,57,204,7,44,11,33,95,84,4,7,0,1
E33044996,673,544,136,408,5,33,8,25,90,82,3,4,1,1
E33044997,471,313,92,221,4,23,7,16,125,111,2,12,0,6
E33044998,242,185,80,105,2,17,5,12,38,37,0,1,0,0
E33044999,332,242,68,174,3,24,3,21,54,51,2,1,0,9
E33045000,357,266,93,173,4,33,8,25,45,41,2,2,0,9
E33045001,237,178,64,114,2,19,4,15,29,27,1,1,0,9
E33045002,341,270,89,181,3,22,4,18,43,40,1,2,0,3
E33045003,243,164,50,114,3,41,6,35,32,30,0,2,0,3
E33045004,324,206,65,141,1,38,9,29,78,64,7,5,2,1
E33045005,222,151,29,122,6,29,5,24,33,28,0,4,1,3
E33045006,464,272,87,185,5,25,6,19,158,153,2,2,1,4
E33045007,284,189,56,133,3,32,7,25,56,47,5,4,0,4
E33045008,412,291,103,188,2,43,10,33,72,62,0,10,0,4
E33045009,319,221,73,148,2,43,12,31,47,40,3,4,0,6
E33045010,456,316,70,246,2,60,10,50,74,66,3,5,0,4
E33045011,570,414,188,226,4,36,9,27,102,93,2,4,3,14
E33045012,330,252,95,157,2,27,6,21,44,39,2,3,0,5
E33045013,354,257,86,171,5,36,2,34,56,54,1,0,1,0
E33045014,565,398,145,253,5,45,7,38,105,93,4,7,1,12
E33045015,296,202,74,128,3,34,6,28,54,45,4,5,0,3
E33045016,277,228,72,156,2,16,4,12,25,23,0,2,0,6
E33045017,334,247,90,157,3,25,3,22,55,50,0,5,0,4
E33045018,347,256,97,159,4,19,5,14,60,49,5,4,2,8
E33045019,259,190,61,129,1,25,4,21,43,39,2,2,0,0
E33045020,365,270,98,172,8,26,8,18,59,49,1,8,1,2
E33045021,482,356,94,262,4,54,10,44,66,54,3,6,3,2
E33045022,380,320,82,238,2,17,2,15,36,35,0,1,0,5
E33045023,552,412,118,294,2,47,5,42,88,81,0,6,1,3
E33045024,448,324,126,198,0,43,6,37,81,67,8,4,2,0
E33045025,396,269,89,180,5,40,4,36,81,78,1,0,2,1
E33045026,315,198,46,152,3,62,42,20,50,43,0,4,3,2
E33045027,292,199,56,143,4,48,39,9,39,36,0,3,0,2
E33045028,608,360,87,273,13,136,92,44,93,85,0,4,4,6
E33045029,261,202,55,147,1,25,14,11,30,26,0,2,2,3
E33045030,430,347,121,226,1,19,14,5,61,59,0,2,0,2
E33045031,505,405,102,303,1,28,17,11,70,63,3,4,0,1
E33045032,745,460,113,347,5,186,152,34,87,77,3,7,0,7
E33045033,303,191,46,145,2,66,55,11,44,44,0,0,0,0
E33045034,280,173,44,129,3,56,49,7,46,41,0,2,3,2
E33045035,216,135,18,117,2,18,16,2,55,54,0,1,0,6
E33045036,398,279,77,202,3,63,52,11,48,42,1,4,1,5
E33045037,534,360,79,281,14,54,40,14,103,94,2,5,2,3
E33045038,836,624,172,452,8,105,79,26,95,86,1,7,1,4
E33045039,695,457,105,352,22,89,59,30,125,120,2,3,0,2
E33045040,242,163,44,119,1,38,30,8,34,30,2,2,0,6
E33045041,373,260,57,203,7,48,38,10,56,51,0,4,1,2
E33045042,305,203,47,156,2,50,46,4,47,40,4,2,1,3
E33045043,1177,799,217,582,19,139,107,32,213,200,5,7,1,7
E33045044,316,200,41,159,9,47,39,8,56,53,1,1,1,4
E33045045,346,252,65,187,4,61,51,10,29,27,0,2,0,0
E33045046,786,571,140,431,8,58,43,15,146,137,0,9,0,3
E33045047,418,319,79,240,5,46,30,16,42,37,0,5,0,6
E33045048,342,230,54,176,2,52,36,16,53,51,0,2,0,5
E33045049,295,196,55,141,2,55,36,19,40,38,0,0,2,2
E33045050,536,404,99,305,2,68,57,11,60,52,4,4,0,2
E33045051,297,181,34,147,2,61,53,8,52,42,0,5,5,1
E33045052,291,177,46,131,3,54,42,12,54,47,3,3,1,3
E33045053,1273,928,256,672,12,171,115,56,156,142,5,8,1,6
E33045054,326,187,23,164,2,59,34,25,77,75,1,0,1,1
E33045055,285,169,37,132,0,60,48,12,56,53,0,1,2,0
E33045056,382,240,51,189,3,35,21,14,103,97,0,4,2,1
E33045057,540,381,94,287,7,62,38,24,87,85,0,1,1,3
E33045058,644,483,132,351,6,55,42,13,98,93,3,1,1,2
E33045059,536,397,87,310,11,37,25,12,89,86,0,3,0,2
E33045060,484,358,78,280,4,36,25,11,78,73,2,2,1,8
E33045061,357,278,55,223,1,11,4,7,65,64,0,1,0,2
E33045062,352,241,72,169,1,50,40,10,54,51,1,1,1,6
E33045063,454,306,42,264,6,46,25,21,95,91,0,4,0,1
E33045064,489,363,115,248,4,60,44,16,62,59,0,3,0,0
E33045065,716,417,52,365,8,188,179,9,100,94,0,6,0,3
E33045066,360,231,52,179,8,69,62,7,48,44,1,3,0,4
E33045067,586,426,87,339,5,105,90,15,49,43,1,5,0,1
E33045068,298,199,58,141,2,59,51,8,36,34,1,1,0,2
E33045069,287,211,58,153,4,44,36,8,26,24,0,2,0,2
E33045070,680,444,70,374,9,131,117,14,88,79,2,6,1,8
E33045071,577,298,80,218,7,189,86,103,81,75,2,2,2,2
E33045072,425,247,36,211,3,108,73,35,66,60,0,6,0,1
E33045073,514,397,115,282,6,29,8,21,66,62,1,3,0,16
E33045074,468,307,79,228,3,79,52,27,73,68,0,5,0,6
E33045075,352,220,54,166,2,58,8,50,70,60,4,6,0,2
E33045076,498,357,110,247,7,44,12,32,82,74,1,3,4,8
E33045077,349,245,64,181,6,35,2,33,56,50,3,2,1,7
E33045078,306,240,75,165,0,31,2,29,30,26,4,0,0,5
E33045079,371,315,68,247,5,12,3,9,38,36,0,2,0,1
E33045080,1261,970,217,753,9,49,8,41,228,219,0,9,0,5
E33045081,512,421,133,288,4,22,0,22,64,63,1,0,0,1
E33045082,468,399,131,268,6,16,3,13,47,47,0,0,0,0
E33045083,260,178,58,120,4,37,2,35,33,30,1,2,0,8
E33045084,264,217,66,151,0,8,1,7,38,35,1,2,0,1
E33045085,563,429,117,312,6,54,10,44,63,54,1,8,0,11
E33045086,251,181,53,128,0,37,6,31,30,26,0,4,0,3
E33045087,304,220,66,154,1,20,2,18,60,51,2,5,2,3
E33045088,377,282,80,202,3,56,8,48,33,29,0,3,1,3
E33045089,514,390,104,286,2,46,7,39,71,61,1,9,0,5
E33045090,335,256,91,165,4,16,3,13,56,49,2,5,0,3
E33045091,618,466,163,303,5,77,16,61,69,61,0,8,0,1
E33045092,342,237,71,166,2,44,11,33,57,52,1,3,1,2
E33045093,357,283,106,177,7,37,10,27,24,19,3,1,1,6
E33045094,683,451,145,306,5,79,14,65,142,101,31,7,3,6
E33045095,279,214,83,131,2,25,6,19,35,27,5,2,1,3
E33045096,298,245,68,177,0,13,3,10,36,27,8,1,0,4
E33045097,270,190,72,118,0,12,2,10,48,34,7,3,4,20
E33045098,530,389,114,275,6,52,8,44,67,60,1,6,0,16
E33045099,771,529,140,389,7,84,12,72,143,124,8,8,3,8
E33045100,394,295,69,226,2,29,7,22,66,61,0,5,0,2
E33045101,298,240,80,160,1,19,2,17,36,33,0,2,1,2
E33045102,583,400,87,313,6,71,25,46,106,100,3,2,1,0
E33045103,467,288,84,204,6,102,21,81,64,60,1,3,0,7
E33045104,345,264,73,191,3,26,10,16,52,50,0,0,2,0
E33045105,805,653,195,458,8,66,13,53,73,70,1,2,0,5
E33045106,255,204,75,129,2,17,2,15,29,24,4,1,0,3
E33045107,451,339,107,232,4,46,7,39,53,49,0,4,0,9
E33045108,516,271,87,184,3,32,5,27,115,52,55,3,5,95
E33045109,235,170,57,113,1,26,6,20,32,30,0,2,0,6
E33045110,470,372,133,239,2,30,4,26,57,48,1,6,2,9
E33045111,453,387,112,275,2,31,9,22,31,30,1,0,0,2
E33045112,493,359,112,247,2,44,6,38,79,73,4,2,0,9
E33045113,294,235,46,189,6,27,1,26,22,16,1,4,1,4
E33045114,411,347,62,285,4,22,0,22,38,36,1,1,0,0
E33045115,521,427,117,310,6,48,0,48,39,29,4,5,1,1
E33045116,1023,778,189,589,27,44,12,32,167,150,3,11,3,7
E33045117,415,281,54,227,4,32,2,30,97,93,1,1,2,1
E33045118,460,298,84,214,4,79,9,70,69,62,1,5,1,10
E33045119,322,245,67,178,3,35,8,27,30,29,1,0,0,9
E33045120,1002,759,192,567,13,109,23,86,116,107,0,8,1,5
E33045121,326,242,92,150,6,28,6,22,42,37,5,0,0,8
E33045122,278,180,53,127,3,58,4,54,36,33,0,3,0,1
E33045123,519,408,141,267,9,39,9,30,60,52,0,7,1,3
E33045124,336,226,75,151,3,31,4,27,71,61,3,6,1,5
E33045125,469,362,109,253,5,19,5,14,71,58,5,7,1,12
E33045126,383,287,82,205,3,38,5,33,53,46,4,3,0,2
E33045127,298,241,114,127,1,14,3,11,35,27,4,2,2,7
E33045128,231,174,57,117,0,7,1,6,37,30,1,4,2,13
E33045129,337,266,59,207,1,18,4,14,48,45,1,2,0,4
E33045130,725,513,139,374,6,61,21,40,139,122,4,12,1,6
E33045131,484,406,159,247,1,24,4,20,44,39,2,3,0,9
E33045132,373,278,109,169,2,19,1,18,65,51,3,7,4,9
E33045133,313,253,94,159,1,25,4,21,30,28,0,2,0,4
E33045134,306,271,125,146,0,5,1,4,29,27,0,1,1,1
E33045135,310,237,78,159,2,28,8,20,40,33,0,7,0,3
E33045136,267,195,68,127,0,28,8,20,32,22,5,4,1,12
E33045137,306,239,91,148,2,24,1,23,31,27,0,2,2,10
E33045138,380,241,69,172,6,76,15,61,54,45,3,5,1,3
E33045139,235,162,54,108,1,29,6,23,43,32,1,6,4,0
E33045140,518,392,131,261,3,56,14,42,63,59,1,1,2,4
E33045141,554,377,124,253,4,89,19,70,79,66,2,6,5,5
E33045142,295,199,96,103,1,29,7,22,58,43,9,2,4,8
E33045143,574,412,130,282,2,62,6,56,89,77,4,6,2,9
E33045144,370,270,91,179,5,34,14,20,58,53,1,2,2,3
E33045145,504,370,115,255,3,53,28,25,77,71,2,4,0,1
E33045146,642,496,198,298,3,54,16,38,79,71,2,5,1,10
E33045147,513,350,139,211,0,57,10,47,101,89,3,9,0,5
E33045148,829,620,234,386,7,56,24,32,133,116,9,6,2,13
E33045149,481,199,54,145,2,30,7,23,245,245,0,0,0,5
E33045150,618,407,135,272,5,76,14,62,127,117,1,8,1,3
E33045151,580,306,69,237,12,32,11,21,218,209,3,6,0,12
E33045152,344,260,75,185,1,24,4,20,49,42,3,2,2,10
E33045153,245,181,68,113,1,29,4,25,31,26,1,4,0,3
E33045154,272,176,48,128,1,9,4,5,77,70,2,5,0,9
E33045155,322,257,71,186,1,22,4,18,39,34,3,2,0,3
E33045156,333,242,77,165,1,25,6,19,57,52,3,1,1,8
E33045157,273,243,82,161,2,14,5,9,13,12,1,0,0,1
E33045158,334,268,81,187,2,15,5,10,47,47,0,0,0,2
E33045159,540,409,136,273,1,45,9,36,82,70,3,9,0,3
E33045160,241,201,69,132,1,4,1,3,29,29,0,0,0,6
E33045161,365,290,112,178,4,17,6,11,54,50,0,4,0,0
E33045162,379,308,103,205,1,36,9,27,29,27,0,2,0,5
E33045163,320,265,97,168,0,15,5,10,37,33,0,2,2,3
E33045164,278,221,70,151,3,13,1,12,40,34,1,5,0,1
E33045165,617,466,106,360,9,57,15,42,84,80,1,3,0,1
E33045166,464,344,108,236,2,25,6,19,87,83,0,4,0,6
E33045167,560,393,114,279,10,75,15,60,79,74,1,0,4,3
E33045168,600,451,120,331,7,54,12,42,82,77,1,3,1,6
E33045169,321,234,79,155,6,41,1,40,38,34,1,3,0,2
E33045170,360,221,73,148,2,66,3,63,69,68,0,0,1,2
E33045171,268,200,60,140,6,23,9,14,37,33,1,3,0,2
E33045172,497,350,115,235,4,46,6,40,95,86,0,5,4,2
E33045173,521,339,89,250,12,76,20,56,90,86,2,2,0,4
E33045174,235,180,42,138,1,18,12,6,34,34,0,0,0,2
E33045175,307,262,66,196,0,11,4,7,34,27,2,5,0,0
E33045176,428,311,90,221,7,41,17,24,65,65,0,0,0,4
E33045177,731,468,161,307,5,58,21,37,146,120,8,8,10,54
E33045178,457,344,113,231,4,26,3,23,63,59,0,4,0,20
E33045179,474,404,107,297,2,11,2,9,56,53,0,2,1,1
E33045180,284,244,74,170,2,5,3,2,32,31,0,1,0,1
E33045181,513,414,96,318,7,11,3,8,77,74,0,1,2,4
E33045182,419,335,85,250,1,23,5,18,57,51,0,6,0,3
E33045183,306,262,64,198,1,10,4,6,32,31,0,1,0,1
E33045184,562,427,117,310,6,36,7,29,88,78,5,5,0,5
E33045185,293,214,73,141,2,21,1,20,46,33,8,4,1,10
E33045186,322,285,90,195,3,5,1,4,28,25,0,3,0,1
E33045187,300,259,63,196,1,13,3,10,22,19,0,2,1,5
E33045188,207,148,47,101,4,25,9,16,28,26,0,2,0,2
E33045189,317,218,82,136,5,29,10,19,59,57,0,2,0,6
E33045190,304,251,72,179,3,13,6,7,34,28,0,6,0,3
E33045191,643,448,166,282,10,30,4,26,120,86,24,8,2,35
E33045192,392,300,118,182,2,33,5,28,45,39,1,4,1,12
E33045193,273,201,69,132,2,23,4,19,30,25,2,1,2,17
E33045194,266,193,85,108,2,35,2,33,32,29,0,2,1,4
E33045195,261,197,65,132,2,33,3,30,25,23,1,0,1,4
E33045196,301,237,87,150,4,24,3,21,32,28,1,0,3,4
E33045197,352,238,57,181,1,44,12,32,66,56,5,4,1,3
E33045198,304,180,60,120,7,40,12,28,67,60,1,1,5,10
E33045199,242,178,41,137,0,10,4,6,35,34,0,0,1,19
E33045200,372,239,73,166,5,30,5,25,72,59,6,2,5,26
E33045201,307,205,85,120,1,35,4,31,57,48,9,0,0,9
E33045202,279,203,74,129,0,14,2,12,57,47,2,5,3,5
E33045203,281,197,58,139,1,25,4,21,41,37,1,1,2,17
E33045204,527,335,97,238,13,78,44,34,90,83,1,6,0,11
E33045205,291,214,73,141,4,31,8,23,33,26,6,1,0,9
E33045206,405,347,127,220,1,22,7,15,35,33,0,1,1,0
E33045207,500,379,148,231,3,35,1,34,74,66,4,3,1,9
E33045208,250,219,68,151,3,8,1,7,18,16,1,1,0,2
E33045209,308,238,69,169,1,23,3,20,35,29,4,2,0,11
E33045210,963,642,187,455,13,104,23,81,197,176,3,14,4,7
E33045211,272,210,76,134,2,26,2,24,30,25,1,2,2,4
E33045212,625,463,148,315,11,31,4,27,114,109,0,3,2,6
E33045213,652,435,106,329,7,45,11,34,160,147,9,4,0,5
E33045214,270,190,56,134,4,30,3,27,44,34,2,7,1,2
E33045215,566,380,90,290,6,34,4,30,144,139,0,5,0,2
E33045216,801,540,169,371,9,106,14,92,141,132,0,9,0,5
E33045217,659,442,136,306,10,66,7,59,137,129,0,8,0,4
E33045218,304,207,56,151,2,22,7,15,66,64,0,0,2,7
E33045219,830,565,110,455,16,44,7,37,203,193,1,8,1,2
E33045220,579,417,109,308,7,25,4,21,125,118,1,6,0,5
E33045221,364,233,66,167,10,76,4,72,40,37,1,2,0,5
E33045222,385,273,77,196,4,67,6,61,40,37,0,3,0,1
E33045223,290,205,62,143,4,34,2,32,43,37,2,4,0,4
E33045224,403,315,100,215,1,32,4,28,52,44,1,7,0,3
E33045225,493,382,94,288,5,33,4,29,69,56,4,5,4,4
E33045226,332,252,71,181,8,35,4,31,36,32,0,3,1,1
E33045227,573,421,138,283,7,42,11,31,92,82,3,4,3,11
E33045228,513,406,151,255,10,24,3,21,61,59,1,1,0,12
E33045229,240,175,53,122,1,27,1,26,31,28,0,3,0,6
E33045230,328,243,80,163,3,31,0,31,41,37,0,4,0,10
E33045231,402,301,82,219,4,33,3,30,59,56,0,3,0,5
E33045232,333,258,57,201,6,22,7,15,47,43,0,4,0,0
E33045233,664,438,124,314,7,69,20,49,147,141,0,5,1,3
E33045234,347,270,64,206,5,37,6,31,35,29,1,4,1,0
E33045235,465,366,72,294,9,21,6,15,67,66,0,1,0,2
E33045236,645,517,141,376,8,60,5,55,50,47,2,1,0,10
E33045237,477,380,111,269,6,31,4,27,58,55,0,3,0,2
E33045238,322,228,55,173,5,46,4,42,40,36,0,2,2,3
E33045239,282,206,55,151,4,32,8,24,39,36,1,1,1,1
E33045240,282,201,67,134,3,20,3,17,54,46,0,8,0,4
E33045241,401,268,72,196,3,68,13,55,60,56,0,4,0,2
E33045242,1109,805,155,650,14,39,10,29,246,231,2,10,3,5
E33045243,368,273,95,178,6,55,9,46,32,29,1,1,1,2
E33045244,1000,730,220,510,17,86,16,70,160,143,1,16,0,7
E33045245,391,248,59,189,8,27,2,25,100,89,1,5,5,8
E33045246,472,363,98,265,9,19,4,15,80,79,1,0,0,1
E33045247,302,270,83,187,1,12,0,12,19,14,1,4,0,0
E33045248,805,659,212,447,8,51,5,46,79,73,1,5,0,8
E33045249,341,260,68,192,5,26,2,24,46,42,1,1,2,4
E33045250,498,361,103,258,9,42,2,40,81,70,5,4,2,5
E33045251,494,356,101,255,5,30,10,20,95,83,0,9,3,8
E33045252,722,488,142,346,8,68,4,64,129,109,12,7,1,29
E33045253,347,237,85,152,4,22,5,17,73,68,2,2,1,11
E33045254,744,529,147,382,6,94,19,75,107,94,6,6,1,8
E33045255,551,381,97,284,12,67,10,57,80,65,2,11,2,11
E33045256,418,315,127,188,4,44,6,38,53,49,2,2,0,2
E33045257,348,287,108,179,1,7,0,7,46,42,1,3,0,7
E33045258,280,230,75,155,2,11,4,7,32,27,0,5,0,5
E33045259,307,247,82,165,3,29,1,28,27,26,1,0,0,1
E33045260,310,231,72,159,0,34,6,28,43,39,2,2,0,2
E33045261,281,222,71,151,4,20,4,16,32,30,0,2,0,3
E33045262,255,194,71,123,2,29,8,21,29,27,1,1,0,1
E33045263,306,265,88,177,1,2,2,0,36,33,0,3,0,2
E33045264,311,281,80,201,3,2,1,1,20,19,1,0,0,5
E33045265,262,223,49,174,2,6,1,5,30,24,1,4,1,1
E33045266,463,395,138,257,2,17,6,11,48,44,2,2,0,1
E33045267,292,233,59,174,0,19,6,13,38,37,0,1,0,2
E33045268,270,222,55,167,0,16,4,12,30,25,0,5,0,2
E33045269,288,242,68,174,0,14,4,10,30,27,0,3,0,2
E33045270,300,231,58,173,1,19,3,16,48,45,1,1,1,1
E33045271,422,336,91,245,1,19,2,17,63,61,0,2,0,3
E33045272,286,187,53,134,1,43,16,27,54,48,0,6,0,1
E33045273,245,175,55,120,0,32,13,19,38,37,0,1,0,0
E33045274,357,272,62,210,4,32,6,26,48,43,1,4,0,1
E33045275,293,235,63,172,2,21,5,16,34,34,0,0,0,1
E33045276,821,668,175,493,8,49,13,36,92,84,1,7,0,4
E33045277,513,383,95,288,2,40,18,22,85,79,1,4,1,3
E33045278,376,318,91,227,0,6,2,4,51,48,1,1,1,1
E33045279,802,681,192,489,3,18,6,12,95,83,1,8,3,5
E33045280,319,251,58,193,3,18,9,9,47,43,0,1,3,0
E33045281,309,239,69,170,4,14,6,8,50,45,0,5,0,2
E33045282,482,338,99,239,5,42,15,27,96,89,0,6,1,1
E33045283,439,361,98,263,1,14,4,10,58,51,1,5,1,5
E33045284,1580,1167,291,876,20,87,37,50,300,271,4,19,6,6
E33045285,431,343,85,258,4,23,16,7,61,54,0,6,1,0
E33045286,467,333,81,252,2,55,13,42,73,63,0,8,2,4
E33045287,1102,790,232,558,9,131,41,90,163,151,0,10,2,9
E33045288,431,366,110,256,0,20,7,13,44,42,0,2,0,1
E33045289,277,227,47,180,1,20,3,17,29,28,0,0,1,0
E33045290,326,258,79,179,0,14,7,7,53,49,0,2,2,1
E33045291,277,212,49,163,0,18,5,13,46,40,0,4,2,1
E33045292,698,526,155,371,7,61,23,38,101,90,1,10,0,3
E33045293,298,232,69,163,2,19,7,12,45,42,0,3,0,0
E33045294,279,174,50,124,1,41,11,30,63,58,0,1,4,0
E33045295,393,279,72,207,2,20,11,9,89,78,0,11,0,3
E33045296,364,274,71,203,4,19,6,13,59,51,2,5,1,8
E33045297,291,209,48,161,2,12,2,10,66,59,0,7,0,2
E33045298,319,219,45,174,0,25,8,17,74,66,1,7,0,1
E33045299,462,289,81,208,5,39,16,23,127,117,0,10,0,2
E33045300,372,244,62,182,2,29,8,21,90,79,1,5,5,7
E33045301,419,290,69,221,2,23,8,15,103,89,0,14,0,1
E33045302,770,521,121,400,6,81,26,55,158,149,3,6,0,4
E33045303,281,186,43,143,3,20,5,15,71,69,0,2,0,1
E33045304,274,175,49,126,2,24,8,16,71,68,0,2,1,2
E33045305,261,145,45,100,6,26,8,18,84,79,0,4,1,0
E33045306,301,200,61,139,2,26,6,20,68,61,0,5,2,5
E33045307,260,167,51,116,0,20,9,11,72,65,0,7,0,1
E33045308,491,262,69,193,3,51,22,29,168,150,5,13,0,7
E33045309,456,308,88,220,6,23,5,18,113,103,2,6,2,6
E33045310,399,254,64,190,1,38,18,20,103,98,1,4,0,3
E33045311,474,342,76,266,1,32,7,25,97,84,2,10,1,2
E33045312,697,461,124,337,3,48,15,33,173,165,2,3,3,12
E33045313,552,378,103,275,4,45,16,29,123,111,1,8,3,2
E33045314,515,309,89,220,1,52,25,27,151,141,4,6,0,2
E33045315,609,426,119,307,6,17,7,10,151,138,3,7,3,9
E33045316,495,293,99,194,3,38,13,25,158,138,3,13,4,3
E33045317,625,470,140,330,3,27,8,19,118,112,1,4,1,7
E33045318,352,271,101,170,0,12,3,9,68,67,0,1,0,1
E33045319,290,237,65,172,0,14,7,7,37,31,0,6,0,2
E33045320,268,187,68,119,0,12,2,10,67,65,0,2,0,2
E33045321,339,261,67,194,1,23,10,13,54,50,0,4,0,0
E33045322,279,233,85,148,1,8,5,3,35,32,2,1,0,2
E33045323,307,239,67,172,2,20,11,9,43,40,1,2,0,3
E33045324,357,279,111,168,3,17,9,8,55,54,0,1,0,3
E33045325,227,197,79,118,3,6,2,4,18,15,0,3,0,3
E33045326,248,194,56,138,3,14,6,8,37,35,0,2,0,0
E33045327,344,273,80,193,1,5,2,3,65,61,0,3,1,0
E33045328,298,225,76,149,1,18,7,11,52,48,0,4,0,2
E33045329,464,329,91,238,4,75,51,24,52,48,0,2,2,4
E33045330,403,308,84,224,3,35,25,10,53,48,0,5,0,4
E33045331,299,197,82,115,1,32,21,11,65,50,11,2,2,4
E33045332,412,328,84,244,3,39,26,13,39,33,1,3,2,3
E33045333,339,284,93,191,0,13,9,4,32,25,0,4,3,10
E33045334,641,486,127,359,4,48,25,23,96,90,1,5,0,7
E33045335,304,238,63,175,1,19,9,10,45,14,25,2,4,1
E33045336,417,299,69,230,0,49,26,23,69,64,0,5,0,0
E33045337,326,233,61,172,2,37,22,15,51,43,1,5,2,3
E33045338,343,279,87,192,2,24,10,14,34,30,0,3,1,4
E33045339,520,373,97,276,4,92,53,39,48,38,1,9,0,3
E33045340,260,186,45,141,0,38,20,18,35,26,1,8,0,1
E33045341,271,205,54,151,2,38,30,8,22,17,0,1,4,4
E33045342,421,321,96,225,3,32,8,24,64,59,0,5,0,1
E33045343,213,143,67,76,4,31,8,23,32,31,1,0,0,3
E33045344,404,332,104,228,1,32,11,21,35,32,0,1,2,4
E33045345,427,314,116,198,8,37,12,25,61,49,2,2,8,7
E33045346,343,281,115,166,2,26,6,20,31,27,4,0,0,3
E33045347,559,477,147,330,4,41,15,26,32,32,0,0,0,5
E33045348,415,345,114,231,4,16,6,10,40,39,0,1,0,10
E33045349,310,238,75,163,4,23,10,13,36,28,5,2,1,9
E33045350,344,288,111,177,2,25,12,13,27,22,1,2,2,2
E33045351,401,345,88,257,1,12,5,7,40,35,3,0,2,3
E33045352,432,338,98,240,5,33,7,26,56,49,2,5,0,0
E33045353,412,335,109,226,0,12,5,7,61,53,3,4,1,4
E33045354,323,271,89,182,2,16,8,8,28,24,2,2,0,6
E33045355,355,308,97,211,2,13,4,9,31,26,0,5,0,1
E33045356,521,401,128,273,2,49,25,24,68,56,3,7,2,1
E33045357,267,207,73,134,2,20,6,14,36,31,2,3,0,2
E33045358,681,518,165,353,7,69,25,44,82,68,0,13,1,5
E33045359,910,618,141,477,9,209,132,77,68,59,1,8,0,6
E33045360,300,245,74,171,1,25,12,13,25,22,3,0,0,4
E33045361,282,226,47,179,1,26,6,20,28,21,2,5,0,1
E33045362,299,253,64,189,3,12,7,5,27,25,0,2,0,4
E33045363,342,277,85,192,3,17,12,5,41,34,2,4,1,4
E33045364,507,371,115,256,7,48,10,38,78,64,1,10,3,3
E33045365,326,284,79,205,3,6,3,3,32,27,0,5,0,1
E33045366,300,249,73,176,4,18,9,9,28,25,0,3,0,1
E33045367,606,446,111,335,5,64,28,36,85,79,2,4,0,6
E33045368,248,187,46,141,2,19,1,18,38,33,0,1,4,2
E33045369,338,254,79,175,3,42,5,37,33,30,0,1,2,6
E33045370,523,371,130,241,3,40,9,31,102,87,15,0,0,7
E33045371,465,372,114,258,3,29,7,22,52,44,1,7,0,9
E33045372,454,351,114,237,3,43,6,37,50,35,10,4,1,7
E33045373,421,338,92,246,4,40,2,38,36,33,2,1,0,3
E33045374,269,211,73,138,4,11,3,8,34,27,2,3,2,9
E33045375,304,219,68,151,3,51,9,42,28,22,3,1,2,3
E33045376,362,263,82,181,3,29,8,21,63,44,9,8,2,4
E33045377,691,527,161,366,2,42,17,25,115,96,12,6,1,5
E33045378,409,335,122,213,2,23,9,14,42,41,1,0,0,7
E33045379,468,379,142,237,3,22,8,14,58,50,4,3,1,6
E33045380,700,521,152,369,8,59,20,39,105,97,2,3,3,7
E33045381,452,395,129,266,2,13,6,7,39,35,1,1,2,3
E33045382,275,221,71,150,1,17,3,14,36,35,0,1,0,0
E33045383,259,174,70,104,0,43,6,37,40,30,6,4,0,2
E33045384,330,268,86,182,0,17,4,13,41,36,2,2,1,4
E33045385,427,337,106,231,6,35,4,31,44,38,0,0,6,5
E33045386,227,185,52,133,3,8,4,4,23,16,6,0,1,8
E33045387,273,238,81,157,1,2,1,1,29,27,0,2,0,3
E33045388,508,383,129,254,6,32,17,15,58,52,0,2,4,29
E33045389,387,295,92,203,3,39,25,14,45,40,0,5,0,5
E33045390,216,173,63,110,1,20,16,4,19,13,3,1,2,3
E33045391,314,205,64,141,3,25,14,11,76,71,1,3,1,5
E33045392,286,204,60,144,7,24,16,8,47,44,1,1,1,4
E33045393,309,270,91,179,1,15,12,3,17,16,0,1,0,6
E33045394,555,377,144,233,1,40,15,25,126,110,9,6,1,11
E33045395,362,280,106,174,1,21,16,5,44,33,7,0,4,16
E33045396,584,375,113,262,2,81,61,20,120,114,2,4,0,6
E33045397,268,134,48,86,1,48,39,9,84,77,2,5,0,1
E33045398,415,283,90,193,5,37,21,16,88,79,1,6,2,2
E33045399,524,316,96,220,5,68,41,27,130,115,9,6,0,5
E33045400,255,156,50,106,5,30,21,9,62,60,0,2,0,2
E33045401,339,237,87,150,3,30,11,19,67,65,0,2,0,2
E33045402,496,301,115,186,9,30,20,10,142,133,3,6,0,14
E33045403,527,316,96,220,12,37,16,21,155,148,1,4,2,7
E33045404,285,157,53,104,2,9,7,2,110,99,5,6,0,7
E33045405,641,384,139,245,4,56,43,13,147,112,19,7,9,50
E33045406,472,328,97,231,5,69,42,27,68,59,1,5,3,2
E33045407,248,144,51,93,2,26,12,14,72,62,1,7,2,4
E33045408,440,273,76,197,6,66,40,26,91,82,1,7,1,4
E33045409,322,225,68,157,3,17,6,11,74,64,2,4,4,3
E33045410,255,198,62,136,1,6,4,2,48,44,1,3,0,2
E33045411,333,261,85,176,1,15,8,7,55,51,1,1,2,1
E33045412,270,182,47,135,1,20,7,13,66,62,0,3,1,1
E33045413,418,275,80,195,5,54,35,19,81,73,1,7,0,3
E33045414,698,475,138,337,5,64,44,20,152,142,0,9,1,2
E33045415,1151,657,199,458,19,164,75,89,304,281,5,16,2,7
E33045416,372,235,64,171,1,8,4,4,126,122,0,3,1,2
E33045417,356,268,70,198,1,2,0,2,85,83,0,2,0,0
E33045418,336,204,57,147,2,20,13,7,104,98,2,3,1,6
E33045419,242,144,39,105,0,15,12,3,81,74,1,4,2,2
E33045420,599,290,88,202,7,73,37,36,221,204,2,12,3,8
E33045421,441,251,79,172,2,45,23,22,139,133,0,3,3,4
E33045422,300,168,63,105,0,15,9,6,112,100,0,6,6,5
E33045423,468,294,89,205,0,42,26,16,126,122,1,3,0,6
E33045424,266,147,50,97,1,21,10,11,95,85,4,6,0,2
E33045425,524,266,88,178,7,13,9,4,231,210,6,9,6,7
E33045426,466,276,74,202,2,25,10,15,155,141,7,7,0,8
E33045427,267,173,66,107,3,15,12,3,73,60,2,11,0,3
E33045428,292,130,39,91,1,23,16,7,136,123,4,4,5,2
E33045429,538,333,104,229,2,49,28,21,152,134,0,8,10,2
E33045430,303,136,42,94,3,32,17,15,127,118,2,5,2,5
E33045431,248,168,61,107,1,32,7,25,36,27,4,4,1,11
E33045432,293,196,61,135,2,24,5,19,55,49,2,2,2,16
E33045433,389,259,88,171,3,39,6,33,72,62,3,3,4,16
E33045434,272,186,79,107,4,15,1,14,55,53,1,1,0,12
E33045435,402,264,79,185,4,36,5,31,90,41,35,6,8,8
E33045436,272,195,64,131,1,30,3,27,39,34,1,3,1,7
E33045437,242,134,59,75,0,28,10,18,56,42,9,3,2,24
E33045438,323,182,57,125,3,48,11,37,64,46,7,0,11,26
E33045439,418,326,118,208,3,31,6,25,54,42,6,4,2,4
E33045440,210,141,36,105,1,13,2,11,52,48,0,4,0,3
E33045441,217,127,32,95,1,8,3,5,81,74,3,4,0,0
E33045442,209,116,35,81,2,14,6,8,76,70,1,5,0,1
E33045443,348,226,54,172,0,23,4,19,96,91,0,4,1,3
E33045444,233,123,30,93,1,27,7,20,77,73,0,4,0,5
E33045445,256,124,39,85,1,43,11,32,85,78,1,6,0,3
E33045446,201,113,27,86,3,15,2,13,67,62,1,4,0,3
E33045447,235,142,39,103,1,29,8,21,60,56,0,4,0,3
E33045448,516,356,114,242,3,48,7,41,106,100,3,2,1,3
E33045449,340,235,86,149,3,23,3,20,79,71,0,8,0,0
E33045450,260,148,51,97,0,18,2,16,93,90,0,3,0,1
E33045451,295,175,34,141,2,15,4,11,100,93,1,6,0,3
E33045452,380,212,61,151,1,31,10,21,134,127,1,5,1,2
E33045453,236,128,35,93,0,22,7,15,83,80,0,2,1,3
E33045454,252,186,45,141,4,9,1,8,53,50,0,3,0,0
E33045455,565,393,102,291,6,24,8,16,138,129,2,4,3,4
E33045456,245,158,38,120,2,13,1,12,68,59,4,5,0,4
E33045457,248,157,46,111,1,12,1,11,76,75,0,1,0,2
E33045458,519,238,58,180,3,39,9,30,229,220,1,8,0,10
E33045459,467,329,106,223,4,34,11,23,97,94,0,3,0,3
E33045460,389,220,79,141,3,40,10,30,123,118,1,4,0,3
E33045461,227,171,37,134,0,9,4,5,46,42,1,2,1,1
E33045462,318,178,46,132,2,27,6,21,110,100,0,9,1,1
E33045463,340,173,48,125,4,37,3,34,124,119,1,4,0,2
E33045464,824,473,156,317,6,93,25,68,248,233,0,9,6,4
E33045465,231,158,43,115,5,12,3,9,55,50,3,2,0,1
E33045466,223,116,29,87,2,12,5,7,90,86,0,4,0,3
E33045467,317,205,48,157,0,15,2,13,90,85,2,3,0,7
E33045468,702,481,170,311,2,73,24,49,140,122,6,11,1,6
E33045469,355,256,38,218,2,31,5,26,64,58,1,4,1,2
E33045470,475,321,99,222,0,77,19,58,73,70,0,3,0,4
E33045471,348,181,67,114,4,55,20,35,105,97,2,5,1,3
E33045472,288,217,44,173,1,7,3,4,62,58,1,2,1,1
E33045473,366,221,60,161,3,30,7,23,112,104,1,7,0,0
E33045474,230,133,43,90,0,20,4,16,76,67,0,9,0,1
E33045475,874,495,135,360,7,79,24,55,288,276,1,9,2,5
E33045476,587,384,121,263,6,53,7,46,138,127,2,8,1,6
E33045477,314,234,74,160,3,9,4,5,68,65,0,2,1,0
E33045478,900,636,214,422,11,36,11,25,207,189,5,4,9,10
E33045479,560,462,125,337,4,26,7,19,67,58,1,8,0,1
E33045480,1075,851,224,627,2,67,24,43,150,138,1,9,2,5
E33045481,539,413,134,279,1,49,17,32,75,67,1,4,3,1
E33045482,637,478,142,336,5,66,34,32,86,80,1,5,0,2
E33045483,299,228,50,178,2,32,11,21,35,31,0,4,0,2
E33045484,307,222,68,154,2,36,12,24,44,39,0,4,1,3
E33045485,334,261,79,182,0,34,9,25,39,38,0,1,0,0
E33045486,539,438,125,313,5,31,18,13,63,56,0,6,1,2
E33045487,223,174,39,135,1,18,8,10,28,25,0,2,1,2
E33045488,924,758,239,519,4,57,18,39,101,94,2,4,1,4
E33045489,801,520,97,423,5,18,4,14,252,242,0,6,4,6
E33045490,274,213,67,146,1,10,3,7,48,39,0,8,1,2
E33045491,262,189,52,137,2,11,1,10,55,52,0,3,0,5
E33045492,256,121,40,81,0,35,12,23,99,96,0,2,1,1
E33045493,317,205,46,159,2,33,9,24,77,70,0,6,1,0
E33045494,365,216,67,149,0,72,18,54,77,74,0,3,0,0
E33045495,341,248,67,181,1,17,4,13,74,70,0,4,0,1
E33045496,677,413,118,295,6,52,8,44,198,185,2,8,3,8
E33045497,2111,1670,439,1231,8,92,16,76,314,244,36,18,16,27
E33045498,237,174,47,127,0,13,2,11,43,40,1,2,0,7
E33045499,309,218,70,148,0,15,4,11,48,35,9,3,1,28
E33045500,347,249,81,168,2,42,12,30,50,48,0,2,0,4
E33045501,905,726,241,485,9,56,13,43,108,94,6,7,1,6
E33045502,461,372,126,246,2,35,10,25,50,48,0,2,0,2
E33045503,261,200,63,137,1,24,8,16,36,35,0,1,0,0
E33045504,293,227,66,161,1,17,6,11,47,42,3,1,1,1
E33045505,317,247,82,165,1,25,6,19,42,37,0,5,0,2
E33045506,4400,3228,878,2350,32,348,88,260,778,710,12,44,12,14
E33045507,659,501,141,360,3,57,13,44,95,86,0,9,0,3
E33045508,694,573,180,393,6,45,18,27,66,60,0,6,0,4
E33045509,224,168,50,118,1,16,5,11,38,38,0,0,0,1
E33045510,646,447,120,327,3,68,19,49,126,118,2,6,0,2
E33045511,1136,958,272,686,6,69,17,52,100,93,0,7,0,3
E33045512,654,510,149,361,1,59,22,37,80,73,1,6,0,4
E33045513,246,172,55,117,0,27,5,22,47,40,0,7,0,0
E33045514,649,530,170,360,5,41,12,29,65,59,2,4,0,8
E33045515,2072,1515,379,1136,28,80,26,54,442,414,5,18,5,7
E33045516,402,253,32,221,2,29,7,22,117,116,0,1,0,1
E33045517,786,562,129,433,3,25,6,19,187,176,1,7,3,9
E33045518,228,173,53,120,2,19,4,15,34,33,0,1,0,0
E33045519,250,214,65,149,3,6,1,5,26,23,1,2,0,1
E33045520,514,317,85,232,7,47,27,20,143,139,0,4,0,0
E33045521,208,158,50,108,0,21,18,3,29,25,1,3,0,0
E33045522,782,588,155,433,4,57,37,20,131,125,1,5,0,2
E33045523,544,398,102,296,5,41,29,12,98,92,1,5,0,2
E33045524,537,387,92,295,4,62,45,17,83,75,0,6,2,1
E33045525,457,340,84,256,5,55,39,16,55,46,1,7,1,2
E33045526,591,452,102,350,4,50,34,16,80,68,3,9,0,5
E33045527,252,175,55,120,2,38,31,7,35,34,0,1,0,2
E33045528,386,212,52,160,1,60,47,13,112,108,0,4,0,1
E33045529,861,639,158,481,6,93,72,21,123,114,1,8,0,0
E33045530,386,257,71,186,4,40,24,16,82,80,1,0,1,3
E33045531,246,184,62,122,3,27,19,8,32,31,0,1,0,0
E33045532,646,490,149,341,5,72,47,25,78,70,2,6,0,1
E33045533,291,218,64,154,3,18,17,1,52,46,0,6,0,0
E33045534,282,198,48,150,3,21,17,4,56,53,0,2,1,4
E33045535,458,317,65,252,2,51,40,11,87,79,1,7,0,1
E33045536,268,175,46,129,3,33,21,12,55,52,0,2,1,2
E33045537,594,338,76,262,8,59,42,17,187,176,3,8,0,2
E33045538,478,292,56,236,4,65,47,18,116,111,3,2,0,1
E33045539,211,157,43,114,3,26,18,8,25,24,0,1,0,0
E33045540,236,172,48,124,2,20,12,8,42,37,0,5,0,0
E33045541,551,430,92,338,6,41,22,19,73,64,0,7,2,1
E33045542,887,629,133,496,7,90,62,28,160,152,1,5,2,1
E33045543,591,398,93,305,4,70,51,19,115,105,2,7,1,4
E33045544,937,658,169,489,6,118,93,25,151,141,1,8,1,4
E33045545,1085,799,221,578,4,100,72,28,176,165,2,9,0,6
E33045546,213,111,45,66,1,30,20,10,69,68,0,1,0,2
E33045547,585,428,123,305,5,42,25,17,105,102,0,2,1,5
E33045548,725,552,120,432,5,56,37,19,108,98,1,9,0,4
E33045549,693,497,137,360,5,82,56,26,106,99,1,6,0,3
E33045550,254,186,62,124,1,20,13,7,46,41,1,4,0,1
E33045551,302,216,56,160,2,38,26,12,45,40,0,4,1,1
E33045552,507,359,107,252,8,66,42,24,66,58,0,8,0,8
E33045553,235,171,46,125,1,18,13,5,44,36,0,7,1,1
E33045554,589,430,107,323,2,64,42,22,92,85,0,6,1,1
E33045555,929,646,194,452,8,97,55,42,175,158,2,14,1,3
E33045556,734,565,165,400,7,55,35,20,101,91,1,9,0,6
E33045557,584,459,154,305,4,63,36,27,56,52,0,4,0,2
E33045558,811,541,107,434,10,41,27,14,218,196,3,16,3,1
E33045559,935,537,165,372,1,27,13,14,368,347,5,12,4,2
E33045560,292,186,42,144,1,15,5,10,90,89,0,1,0,0
E33045561,320,148,47,101,0,11,5,6,160,152,1,6,1,1
E33045562,300,161,38,123,1,12,8,4,124,119,1,4,0,2
E33045563,210,135,26,109,3,4,2,2,65,57,0,8,0,3
E33045564,478,256,52,204,4,48,28,20,168,160,1,6,1,2
E33045565,303,197,67,130,3,19,13,6,83,73,2,8,0,1
E33045566,337,243,69,174,3,8,5,3,83,79,1,3,0,0
E33045567,338,168,42,126,3,12,8,4,153,147,1,5,0,2
E33045568,380,126,25,101,4,26,13,13,219,210,0,8,1,5
E33045569,277,177,50,127,3,4,2,2,92,88,0,4,0,1
E33045570,320,177,56,121,2,14,10,4,124,121,0,3,0,3
E33045571,626,362,102,260,2,19,7,12,240,230,2,3,5,3
E33045572,365,257,64,193,2,18,11,7,79,76,1,2,0,9
E33045573,1452,1031,279,752,7,53,27,26,354,340,3,9,2,7
E33045574,333,214,64,150,1,8,5,3,108,104,1,3,0,2
E33045575,414,284,84,200,4,13,5,8,112,109,0,3,0,1
E33045576,285,209,56,153,4,17,10,7,53,50,1,1,1,2
E33045577,222,139,45,94,3,19,13,6,56,52,1,3,0,5
E33045578,379,266,64,202,3,31,14,17,77,75,0,2,0,2
E33045579,227,69,19,50,0,26,17,9,131,123,2,3,3,1
E33045580,470,271,50,221,3,10,7,3,186,178,1,7,0,0
E33045581,353,247,44,203,3,3,2,1,100,94,0,5,1,0
E33045582,449,273,82,191,3,16,10,6,155,146,0,6,3,2
E33045583,228,154,62,92,1,15,14,1,55,51,1,3,0,3
E33045584,477,272,63,209,5,22,13,9,175,165,2,2,6,3
E33045585,693,458,86,372,6,15,8,7,210,200,2,8,0,4
E33045586,315,210,61,149,1,11,6,5,89,84,0,4,1,4
E33045587,415,240,59,181,2,17,5,12,153,146,0,7,0,3
E33045588,474,308,72,236,1,57,36,21,106,95,1,8,2,2
E33045589,804,611,161,450,5,111,90,21,75,70,1,3,1,2
E33045590,275,189,55,134,1,30,12,18,55,53,0,2,0,0
E33045591,1163,786,223,563,13,153,96,57,198,187,1,9,1,13
E33045592,297,207,58,149,1,41,25,16,44,40,2,1,1,4
E33045593,966,684,177,507,5,152,123,29,121,113,0,8,0,4
E33045594,267,202,59,143,3,14,9,5,46,43,1,2,0,2
E33045595,645,507,138,369,1,45,33,12,91,84,0,7,0,1
E33045596,322,227,59,168,2,17,9,8,74,68,0,6,0,2
E33045597,321,201,58,143,2,26,13,13,89,81,0,6,2,3
E33045598,599,438,138,300,3,70,51,19,86,82,1,3,0,2
E33045599,582,379,108,271,4,62,41,21,135,117,1,15,2,2
E33045600,407,257,66,191,3,50,37,13,94,89,0,5,0,3
E33045601,209,120,28,92,3,26,15,11,60,55,0,4,1,0
E33045602,833,609,111,498,5,14,6,8,198,192,0,5,1,7
E33045603,324,229,66,163,3,41,29,12,50,46,0,4,0,1
E33045604,3149,2348,469,1879,27,107,57,50,656,618,1,33,4,11
E33045605,482,330,86,244,2,66,47,19,83,80,1,2,0,1
E33045606,986,765,220,545,7,37,21,16,175,166,0,9,0,2
E33045607,843,600,130,470,8,43,26,17,186,178,2,5,1,6
E33045608,332,233,71,162,2,38,18,20,59,55,1,2,1,0
E33045609,281,229,66,163,3,13,5,8,36,33,1,1,1,0
E33045610,401,290,83,207,2,41,25,16,65,61,0,4,0,3
E33045611,393,262,63,199,3,51,31,20,74,71,0,3,0,3
E33045612,260,179,53,126,3,16,10,6,62,61,0,0,1,0
E33045613,828,701,191,510,8,34,20,14,82,73,1,7,1,3
E33045614,327,267,94,173,3,24,16,8,32,31,0,1,0,1
E33045615,239,188,48,140,1,19,12,7,30,26,0,4,0,1
E33045616,355,243,65,178,3,50,31,19,58,52,0,6,0,1
E33045617,202,104,34,70,3,38,21,17,53,45,1,7,0,4
E33045618,641,394,105,289,6,93,60,33,147,140,0,7,0,1
E33045619,423,311,63,248,4,32,20,12,72,67,0,4,1,4
E33045620,1543,724,159,565,7,153,94,59,647,623,2,16,6,12
E33045621,243,157,41,116,1,51,41,10,32,32,0,0,0,2
E33045622,256,207,58,149,1,23,13,10,23,22,1,0,0,2
E33045623,1339,788,175,613,19,181,110,71,338,314,0,21,3,13
E33045624,617,400,115,285,3,93,66,27,119,105,0,12,2,2
E33045625,359,265,58,207,2,26,18,8,63,54,1,8,0,3
E33045626,603,448,124,324,6,33,21,12,112,105,2,5,0,4
E33045627,815,567,140,427,4,107,74,33,134,123,3,8,0,3
E33045628,412,347,109,238,2,20,11,9,43,39,0,4,0,0
E33045629,240,178,48,130,1,15,8,7,39,35,1,2,1,7
E33045630,218,155,39,116,3,9,2,7,47,40,2,5,0,4
E33045631,273,197,49,148,2,16,4,12,55,50,2,2,1,3
E33045632,396,319,85,234,1,13,6,7,63,56,0,7,0,0
E33045633,663,546,147,399,3,20,3,17,91,79,1,11,0,3
E33045634,212,169,50,119,2,12,6,6,27,26,0,1,0,2
E33045635,718,550,155,395,2,40,14,26,121,112,2,7,0,5
E33045636,595,429,116,313,2,61,39,22,99,90,2,5,2,4
E33045637,209,166,38,128,2,12,7,5,27,26,1,0,0,2
E33045638,371,278,68,210,7,32,21,11,51,46,0,4,1,3
E33045639,244,169,36,133,2,18,12,6,53,51,0,2,0,2
E33045640,408,303,90,213,3,21,7,14,70,61,0,8,1,11
E33045641,208,172,52,120,0,11,6,5,24,21,0,3,0,1
E33045642,209,156,40,116,2,17,8,9,33,30,0,3,0,1
E33045643,401,320,77,243,2,22,9,13,56,47,2,7,0,1
E33045644,422,329,98,231,6,18,8,10,68,61,0,7,0,1
E33045645,727,560,123,437,10,53,21,32,100,94,1,4,1,4
E33045646,305,248,62,186,2,15,7,8,38,36,0,2,0,2
E33045647,366,245,61,184,4,23,9,14,93,86,0,6,1,1
E33045648,271,191,44,147,2,24,11,13,53,46,0,6,1,1
E33045649,212,117,35,82,3,18,10,8,72,69,0,3,0,2
E33045650,618,500,117,383,4,21,9,12,89,83,0,6,0,4
E33045651,270,216,56,160,2,6,0,6,43,36,1,4,2,3
E33045652,231,132,26,106,2,19,9,10,77,68,4,5,0,1
E33045653,778,473,128,345,9,80,35,45,212,201,0,10,1,4
E33045654,782,563,103,460,6,74,34,40,136,127,0,6,3,3
E33045655,325,191,54,137,3,26,13,13,104,96,3,5,0,1
E33045656,606,385,127,258,2,43,17,26,168,147,2,17,2,8
E33045657,270,191,46,145,3,19,8,11,56,53,0,2,1,1
E33045658,2015,1583,409,1174,13,94,47,47,315,288,5,19,3,10
E33045659,1013,648,168,480,5,118,56,62,231,218,0,13,0,11
E33045660,364,239,62,177,5,30,6,24,87,76,1,9,1,3
E33045661,207,147,23,124,2,15,5,10,41,37,2,2,0,2
E33045662,307,245,62,183,1,23,14,9,37,35,0,2,0,1
E33045663,369,272,78,194,3,27,9,18,66,61,2,3,0,1
E33045664,591,425,94,331,2,51,26,25,112,101,0,10,1,1
E33045665,327,234,64,170,1,28,14,14,62,55,1,5,1,2
E33045666,363,278,100,178,1,18,9,9,63,57,0,5,1,3
E33045667,293,224,56,168,3,11,7,4,51,46,1,4,0,4
E33045668,693,510,126,384,8,39,19,20,133,116,0,17,0,3
E33045669,232,162,72,90,2,12,7,5,47,42,1,4,0,9
E33045670,2295,1570,402,1168,22,153,80,73,534,489,6,38,1,16
E33045671,443,318,90,228,2,15,11,4,108,101,1,6,0,0
E33045672,209,165,52,113,0,8,5,3,31,28,0,3,0,5
E33045673,904,672,163,509,10,53,22,31,163,152,1,9,1,6
E33045674,313,239,48,191,2,12,5,7,60,57,0,3,0,0
E33045675,3643,2600,709,1891,19,311,179,132,690,645,4,40,1,23
E33045676,282,187,32,155,1,26,14,12,68,64,1,3,0,0
E33045677,353,211,51,160,4,48,36,12,87,83,0,4,0,3
E33045678,472,268,58,210,6,97,60,37,101,100,0,1,0,0
E33045679,288,164,49,115,4,49,34,15,69,60,2,2,5,2
E33045680,404,210,55,155,2,35,21,14,157,150,0,6,1,0
E33045681,603,331,104,227,5,158,103,55,103,99,0,3,1,6
E33045682,453,337,73,264,2,30,23,7,83,77,1,3,2,1
E33045683,322,218,81,137,1,32,9,23,63,48,4,10,1,8
E33045684,757,537,126,411,13,67,29,38,135,123,0,12,0,5
E33045685,261,184,46,138,1,25,12,13,49,45,2,2,0,2
E33045686,840,584,132,452,6,45,28,17,203,195,0,8,0,2
E33045687,1202,879,171,708,6,65,22,43,248,234,1,12,1,4
E33045688,186,111,22,89,2,1,0,1,62,59,0,2,1,10
E33045689,302,209,34,175,2,30,13,17,59,56,1,2,0,2
E33045690,302,210,47,163,0,15,10,5,74,67,3,4,0,3
E33045691,265,206,44,162,2,8,4,4,48,47,0,1,0,1
E33045692,270,206,65,141,2,24,13,11,38,35,0,3,0,0
E33045693,398,313,92,221,3,28,8,20,52,49,0,3,0,2
E33045694,543,427,98,329,4,19,10,9,90,74,2,14,0,3
E33045695,430,329,81,248,8,26,3,23,63,59,0,4,0,4
E33045696,439,355,96,259,3,23,8,15,56,50,0,5,1,2
E33045697,277,201,43,158,2,18,3,15,56,54,0,1,1,0
E33045698,2073,1570,336,1234,12,76,37,39,410,390,2,15,3,5
E33045699,1739,1208,323,885,13,222,158,64,287,273,0,14,0,9
E33045700,213,159,57,102,2,17,5,12,34,28,0,4,2,1
E33045701,332,259,66,193,1,22,11,11,50,46,0,4,0,0
E33045702,436,319,96,223,2,60,17,43,54,50,0,4,0,1
E33045703,243,196,63,133,3,20,5,15,20,19,0,1,0,4
E33045704,220,167,30,137,2,24,12,12,27,25,0,1,1,0
E33045705,1360,945,271,674,6,101,34,67,304,290,3,11,0,4
E33045706,218,167,37,130,1,22,4,18,27,22,0,3,2,1
E33045707,329,261,76,185,2,25,13,12,40,38,0,2,0,1
E33045708,838,636,193,443,7,83,22,61,109,98,1,10,0,3
E33045709,1005,798,206,592,4,91,29,62,109,99,0,10,0,3
E33045710,262,192,42,150,4,16,10,6,47,44,0,2,1,3
E33045711,270,189,31,158,2,13,6,7,63,57,4,2,0,3
E33045712,340,264,52,212,1,8,5,3,66,61,0,4,1,1
E33045713,1924,1365,247,1118,12,83,31,52,457,434,0,23,0,7
E33045714,528,400,60,340,0,11,6,5,117,115,0,2,0,0
E33045715,922,618,106,512,6,40,16,24,253,244,1,7,1,5
E33045716,255,192,28,164,4,13,11,2,46,46,0,0,0,0
E33045717,341,278,53,225,4,14,8,6,43,41,0,2,0,2
E33045718,558,440,89,351,4,30,10,20,82,74,1,7,0,2
E33045719,1191,774,139,635,6,42,21,21,365,349,2,12,2,4
E33045720,494,364,62,302,6,16,8,8,106,98,0,8,0,2
E33045721,523,343,67,276,4,13,8,5,163,155,0,6,2,0
E33045722,477,375,77,298,3,20,8,12,77,72,0,4,1,2
E33045723,790,516,121,395,10,99,60,39,161,137,1,22,1,4
E33045724,1294,888,200,688,14,140,82,58,247,236,2,8,1,5
E33045725,2126,1491,347,1144,10,214,128,86,397,374,3,18,2,14
E33045726,866,607,111,496,6,45,16,29,197,177,0,18,2,11
E33045727,325,267,93,174,0,18,9,9,35,27,5,3,0,5
E33045728,339,261,59,202,3,9,4,5,55,52,1,2,0,11
E33045729,2170,1053,282,771,19,452,292,160,631,600,3,23,5,15
E33045730,771,541,138,403,3,73,35,38,153,134,8,8,3,1
E33045731,302,219,68,151,2,39,17,22,39,37,0,2,0,3
E33045732,409,339,88,251,3,21,10,11,46,43,0,2,1,0
E33045733,558,450,131,319,1,34,18,16,71,64,0,5,2,2
E33045734,407,359,109,250,4,26,5,21,18,17,0,1,0,0
E33045735,324,229,50,179,1,24,8,16,70,65,1,4,0,0
E33045736,210,161,45,116,2,12,7,5,35,33,1,1,0,0
E33045737,461,361,64,297,1,9,4,5,89,84,0,5,0,1
E33045738,469,333,118,215,2,43,17,26,91,86,2,2,1,0
E33045739,1778,1355,249,1106,7,64,25,39,349,328,0,21,0,3
E33045740,222,185,53,132,1,12,6,6,20,15,0,5,0,4
E33045741,1093,905,254,651,5,55,21,34,122,115,0,6,1,6
E33045742,260,187,74,113,0,15,5,10,54,51,0,3,0,4
E33045743,316,249,74,175,2,9,5,4,55,51,0,4,0,1
E33045744,219,171,64,107,1,21,2,19,26,21,0,2,3,0
E33045745,320,234,89,145,1,14,4,10,71,65,2,2,2,0
E33045746,1670,1178,307,871,8,148,79,69,331,299,7,21,4,5
E33045747,249,194,54,140,1,14,8,6,38,35,0,3,0,2
E33045748,540,388,88,300,4,53,19,34,91,84,1,6,0,4
E33045749,921,752,190,562,8,61,28,33,99,89,1,9,0,1
E33045750,946,808,248,560,5,39,10,29,92,88,0,4,0,2
E33045751,133,100,27,73,0,8,2,6,24,22,0,2,0,1
E33045752,127,101,33,68,0,11,7,4,14,14,0,0,0,1
E33045753,502,317,88,229,4,48,24,24,130,123,1,5,1,3
E33045754,1564,1204,313,891,10,106,54,52,236,216,3,14,3,8
E33045755,502,334,84,250,5,60,33,27,95,86,1,8,0,8
E33045756,339,268,74,194,3,25,9,16,40,35,1,3,1,3
E33045757,249,190,56,134,1,23,12,11,34,32,0,2,0,1
E33045758,428,340,88,252,1,22,7,15,61,53,0,7,1,4
E33045759,676,551,154,397,1,27,10,17,96,84,1,7,4,1
E33045760,325,268,63,205,1,14,5,9,40,40,0,0,0,2
E33045761,212,175,53,122,0,14,6,8,23,21,1,1,0,0
E33045762,370,274,69,205,0,26,12,14,64,60,1,1,2,6
E33045763,669,456,123,333,5,56,24,32,151,143,0,6,2,1
E33045764,394,274,58,216,3,41,15,26,72,64,2,5,1,4
E33045765,724,541,139,402,3,64,28,36,115,95,5,11,4,1
E33045766,217,119,42,77,1,24,12,12,70,68,0,2,0,3
E33045767,485,332,55,277,5,40,21,19,104,86,4,14,0,4
E33045768,304,155,38,117,0,29,15,14,118,110,2,5,1,2
E33045769,504,367,91,276,2,32,13,19,99,93,2,4,0,4
E33045770,3909,2873,537,2336,31,240,115,125,759,422,196,30,111,6
E33045771,324,195,66,129,3,24,10,14,101,94,0,5,2,1
E33045772,3298,2245,688,1557,18,117,41,76,892,833,3,49,7,26
E33045773,234,138,30,108,1,20,9,11,72,68,2,2,0,3
E33045774,667,495,126,369,6,89,30,59,76,67,2,7,0,1
E33045775,936,631,170,461,5,107,51,56,189,169,1,17,2,4
E33045776,846,586,179,407,4,141,53,88,111,97,3,7,4,4
E33045777,359,273,76,197,2,24,12,12,59,53,2,4,0,1
E33045778,413,297,74,223,7,34,15,19,69,58,1,7,3,6
E33045779,301,185,48,137,4,35,18,17,73,69,1,3,0,4
E33045780,886,632,193,439,8,96,49,47,146,130,3,13,0,4
E33045781,362,273,66,207,3,26,6,20,56,44,0,6,6,4
E33045782,703,515,132,383,11,87,32,55,88,81,0,6,1,2
E33045783,291,177,48,129,3,42,18,24,68,56,2,10,0,1
E33045784,275,218,77,141,1,17,10,7,39,34,2,3,0,0
E33045785,385,296,91,205,1,40,15,25,47,40,3,3,1,1
E33045786,403,290,66,224,4,46,24,22,61,50,1,9,1,2
E33045787,285,188,51,137,6,20,7,13,66,56,1,8,1,5
E33045788,558,334,94,240,10,55,28,27,157,146,2,7,2,2
E33045789,927,614,141,473,14,115,41,74,178,163,4,9,2,6
E33045790,357,250,70,180,5,35,15,20,61,51,4,4,2,6
E33045791,732,567,155,412,7,61,36,25,95,85,4,4,2,2
E33045792,425,308,75,233,1,24,9,15,89,81,0,7,1,3
E33045793,529,299,74,225,5,52,25,27,164,145,1,14,4,9
E33045794,1906,1529,380,1149,13,118,43,75,237,201,14,17,5,9
E33045795,298,240,62,178,1,12,5,7,42,36,2,3,1,3
E33045796,1045,632,181,451,6,165,84,81,237,209,4,15,9,5
E33045797,670,423,111,312,4,67,30,37,173,156,1,13,3,3
E33045798,306,186,45,141,1,37,16,21,81,72,3,6,0,1
E33045799,284,150,37,113,3,44,18,26,86,76,3,7,0,1
E33045800,474,248,70,178,6,47,17,30,164,147,8,6,3,9
E33045801,481,292,63,229,7,53,25,28,122,105,3,11,3,7
E33045802,312,244,64,180,4,15,7,8,47,40,3,3,1,2
E33045803,1500,1060,199,861,20,143,62,81,274,250,4,19,1,3
E33045804,343,175,42,133,0,39,15,24,123,113,2,5,3,6
E33045805,408,238,53,185,4,43,22,21,121,110,2,9,0,2
E33045806,818,656,111,545,13,21,8,13,125,109,2,14,0,3
E33045807,275,150,34,116,6,34,13,21,81,74,2,4,1,4
E33045808,212,136,40,96,0,28,9,19,48,41,1,6,0,0
E33045809,372,194,53,141,4,76,39,37,96,89,0,5,2,2
E33045810,963,579,127,452,10,87,31,56,279,249,1,27,2,8
E33045811,317,185,36,149,3,43,25,18,86,77,0,7,2,0
E33045812,362,256,65,191,3,17,9,8,86,74,3,9,0,0
E33045813,319,186,74,112,4,44,19,25,83,76,3,2,2,2
E33045814,589,333,90,243,3,55,23,32,192,113,34,5,40,6
E33045815,705,435,120,315,9,135,59,76,122,105,8,7,2,4
E33045816,250,158,45,113,7,22,10,12,61,53,3,5,0,2
E33045817,299,219,60,159,1,26,11,15,52,46,2,3,1,1
E33045818,225,131,42,89,5,23,14,9,66,62,1,3,0,0
E33045819,503,338,80,258,0,79,45,34,82,77,1,4,0,4
E33045820,400,231,62,169,3,54,30,24,110,101,0,9,0,2
E33045821,396,257,56,201,4,45,17,28,88,76,7,4,1,2
E33045822,226,159,29,130,0,18,8,10,47,38,5,4,0,2
E33045823,715,483,120,363,7,66,32,34,153,133,3,16,1,6
E33045824,202,153,52,101,0,3,0,3,45,44,0,1,0,1
E33045825,319,209,76,133,2,10,1,9,97,86,2,4,5,1
E33045826,233,153,43,110,0,8,0,8,70,63,0,4,3,2
E33045827,202,137,67,70,4,5,1,4,56,53,1,2,0,0
E33045828,203,142,47,95,5,12,4,8,42,30,0,12,0,2
E33045829,235,173,52,121,4,7,0,7,50,42,2,6,0,1
E33045830,485,359,120,239,5,23,4,19,94,88,1,4,1,4
E33045831,414,312,83,229,9,20,2,18,69,62,0,6,1,4
E33045832,421,319,75,244,2,25,2,23,73,64,1,8,0,2
E33045833,1083,785,206,579,24,54,3,51,215,188,0,25,2,5
E33045834,365,260,83,177,4,18,4,14,81,74,0,7,0,2
E33045835,215,151,46,105,2,18,1,17,42,39,0,3,0,2
E33045836,262,195,55,140,4,9,2,7,53,48,1,4,0,1
E33045837,257,197,52,145,6,5,0,5,48,44,1,3,0,1
E33045838,272,176,34,142,5,13,0,13,74,73,1,0,0,4
E33045839,221,181,60,121,1,4,1,3,34,30,0,4,0,1
E33045840,217,163,60,103,0,13,6,7,39,34,0,5,0,2
E33045841,215,144,47,97,4,7,0,7,59,52,3,4,0,1
E33045842,238,147,44,103,0,15,1,14,76,72,0,4,0,0
E33045843,416,260,76,184,1,26,4,22,123,115,1,6,1,6
E33045844,288,210,60,150,4,9,1,8,62,58,0,3,1,3
E33045845,799,606,167,439,11,32,3,29,147,137,0,9,1,3
E33045846,757,592,137,455,13,27,4,23,120,107,0,13,0,5
E33045847,1128,850,236,614,22,52,10,42,196,178,3,14,1,8
E33045848,461,343,101,242,4,19,3,16,92,86,0,5,1,3
E33045849,3238,2537,631,1906,41,104,18,86,546,497,3,46,0,10
E33045850,213,143,45,98,2,8,2,6,60,51,0,8,1,0
E33045851,387,234,47,187,5,16,1,15,126,110,2,14,0,6
E33045852,256,154,49,105,7,9,0,9,83,73,3,7,0,3
E33045853,397,235,52,183,7,22,2,20,128,120,0,7,1,5
E33045854,560,389,114,275,12,25,1,24,130,117,0,13,0,4
E33045855,237,175,39,136,3,10,1,9,46,42,1,3,0,3
E33045856,335,239,58,181,5,17,0,17,72,63,0,7,2,2
E33045857,233,154,38,116,5,10,1,9,62,58,1,3,0,2
E33045858,359,263,53,210,1,19,3,16,73,71,1,1,0,3
E33045859,361,222,63,159,6,14,3,11,115,104,1,8,2,4
E33045860,246,166,61,105,1,9,0,9,68,64,1,3,0,2
E33045861,846,637,167,470,12,40,6,34,154,139,2,12,1,3
E33045862,234,137,47,90,3,10,2,8,82,76,0,6,0,2
E33045863,370,255,72,183,1,19,1,18,94,85,0,9,0,1
E33045864,233,134,44,90,2,10,1,9,87,84,1,1,1,0
E33045865,334,223,65,158,3,16,4,12,91,85,0,6,0,1
E33045866,378,237,50,187,4,19,2,17,115,111,0,4,0,3
E33045867,247,207,50,157,2,1,0,1,37,33,3,1,0,0
E33045868,241,108,31,77,1,10,5,5,119,114,0,3,2,3
E33045869,235,140,22,118,1,15,9,6,78,74,0,4,0,1
E33045870,240,124,27,97,4,10,4,6,101,95,0,5,1,1
E33045871,323,173,44,129,2,11,1,10,137,125,0,10,2,0
E33045872,319,185,45,140,1,7,3,4,125,118,0,7,0,1
E33045873,249,176,46,130,3,13,5,8,56,51,0,5,0,1
E33045874,455,272,79,193,5,12,5,7,165,147,1,15,2,1
E33045875,267,202,54,148,2,5,4,1,57,53,0,4,0,1
E33045876,477,343,91,252,6,17,5,12,108,98,0,10,0,3
E33045877,210,145,36,109,1,8,2,6,54,51,2,0,1,2
E33045878,275,145,28,117,2,11,5,6,116,110,0,6,0,1
E33045879,385,191,56,135,3,15,5,10,176,159,7,10,0,0
E33045880,567,382,88,294,1,35,13,22,147,130,3,13,1,2
E33045881,403,299,90,209,3,16,8,8,82,76,0,4,2,3
E33045882,1523,1028,212,816,16,48,27,21,423,392,1,28,2,8
E33045883,241,115,21,94,6,34,14,20,86,82,0,2,2,0
E33045884,225,125,31,94,2,13,6,7,84,80,1,2,1,1
E33045885,223,112,28,84,0,20,7,13,89,86,0,2,1,2
E33045886,203,106,28,78,5,6,2,4,85,80,0,5,0,1
E33045887,400,219,61,158,5,16,7,9,159,149,1,9,0,1
E33045888,213,108,26,82,0,13,5,8,92,84,6,1,1,0
E33045889,408,246,85,161,6,21,6,15,135,133,0,2,0,0
E33045890,241,123,36,87,3,7,3,4,107,100,0,5,2,1
E33045891,661,379,113,266,6,31,9,22,237,227,2,8,0,8
E33045892,244,148,56,92,0,8,2,6,86,83,1,2,0,2
E33045893,297,118,25,93,1,25,9,16,149,145,0,2,2,4
E33045894,390,198,60,138,2,16,8,8,172,165,0,6,1,2
E33045895,582,239,78,161,10,44,17,27,285,267,6,12,0,4
E33045896,307,188,64,124,2,20,8,12,96,89,1,5,1,1
E33045897,786,535,131,404,9,42,22,20,199,186,1,10,2,1
E33045898,218,154,41,113,1,23,11,12,40,38,0,2,0,0
E33045899,485,288,84,204,5,60,41,19,130,124,0,6,0,2
E33045900,741,451,131,320,10,94,58,36,184,174,0,10,0,2
E33045901,552,312,88,224,11,74,42,32,149,139,1,9,0,6
E33045902,387,257,71,186,4,38,25,13,86,78,2,5,1,2
E33045903,1393,887,201,686,15,127,58,69,358,339,4,11,4,6
E33045904,470,294,81,213,4,19,8,11,150,140,0,8,2,3
E33045905,658,306,98,208,3,36,13,23,312,300,3,8,1,1
E33045906,260,163,46,117,5,10,3,7,76,73,1,2,0,6
E33045907,364,237,64,173,6,20,13,7,95,91,2,2,0,6
E33045908,304,177,55,122,2,21,6,15,101,95,0,6,0,3
E33045909,213,127,44,83,0,32,19,13,54,46,0,8,0,0
E33045910,219,146,41,105,0,22,15,7,46,43,0,3,0,5
E33045911,323,215,68,147,0,30,18,12,78,69,1,8,0,0
E33045912,220,112,24,88,2,25,13,12,77,71,0,6,0,4
E33045913,535,340,87,253,8,51,23,28,133,123,1,9,0,3
E33045914,384,281,75,206,2,36,21,15,65,55,1,6,3,0
E33045915,528,370,111,259,3,53,35,18,100,93,1,5,1,2
E33045916,600,330,111,219,4,49,21,28,212,206,0,4,2,5
E33045917,1038,719,191,528,11,64,33,31,235,221,4,10,0,9
E33045918,245,164,45,119,5,27,25,2,48,43,0,5,0,1
E33045919,442,298,80,218,7,36,22,14,99,94,1,4,0,2
E33045920,256,157,36,121,3,19,8,11,75,57,2,14,2,2
E33045921,340,250,77,173,4,29,14,15,55,49,0,5,1,2
E33045922,369,267,64,203,1,14,8,6,86,80,2,3,1,1
E33045923,353,279,85,194,5,17,8,9,51,50,0,1,0,1
E33045924,285,234,67,167,3,6,1,5,40,38,0,2,0,2
E33045925,219,195,35,160,0,7,1,6,14,10,0,3,1,3
E33045926,423,313,112,201,2,31,19,12,75,69,1,4,1,2
E33045927,222,160,37,123,3,26,14,12,32,27,0,5,0,1
E33045928,302,202,46,156,1,29,6,23,68,60,1,7,0,2
E33045929,911,669,195,474,6,52,27,25,182,163,5,10,4,2
E33045930,130,97,30,67,0,5,2,3,27,27,0,0,0,1
E33045931,335,228,67,161,4,23,12,11,77,73,0,4,0,3
E33045932,494,332,85,247,6,29,8,21,122,114,1,7,0,5
E33045933,295,204,47,157,3,32,15,17,55,49,0,5,1,1
E33045934,299,220,73,147,3,22,10,12,53,48,0,5,0,1
E33045935,330,222,72,150,4,47,29,18,55,51,2,2,0,2
E33045936,657,513,153,360,7,56,32,24,81,69,0,12,0,0
E33045937,493,341,125,216,4,27,9,18,114,103,2,7,2,7
E33045938,872,705,189,516,4,48,23,25,114,104,1,8,1,1
E33045939,252,171,46,125,2,19,8,11,58,49,1,8,0,2
E33045940,250,186,66,120,3,24,13,11,37,32,0,5,0,0
E33045941,206,129,52,77,4,24,13,11,49,46,0,3,0,0
E33045942,509,388,78,310,8,33,14,19,79,74,0,5,0,1
E33045943,810,616,176,440,5,47,22,25,141,130,2,9,0,1
E33045944,755,529,114,415,4,90,35,55,128,113,3,12,0,4
E33045945,964,543,98,445,8,100,53,47,307,123,137,8,39,6
E33045946,611,442,113,329,6,65,28,37,97,90,0,4,3,1
E33045947,390,294,79,215,5,36,17,19,54,45,1,6,2,1
E33045948,572,429,105,324,10,40,14,26,90,81,0,9,0,3
E33045949,270,166,15,151,3,17,5,12,79,70,0,8,1,5
E33045950,1216,765,193,572,15,156,96,60,274,256,1,13,4,6
E33045951,217,158,41,117,3,20,6,14,34,31,1,2,0,2
E33045952,212,148,57,91,1,20,9,11,41,36,1,2,2,2
E33045953,736,458,116,342,2,52,19,33,218,204,3,11,0,6
E33045954,201,146,36,110,1,15,9,6,39,33,0,4,2,0
E33045955,471,324,88,236,5,43,23,20,97,95,0,2,0,2
E33045956,578,380,90,290,15,60,21,39,120,107,0,11,2,3
E33045957,328,239,48,191,7,30,17,13,50,46,0,3,1,2
E33045958,558,416,102,314,3,26,11,15,110,103,2,3,2,3
E33045959,1080,716,164,552,13,56,29,27,293,271,3,18,1,2
E33045960,228,167,41,126,5,15,8,7,37,34,3,0,0,4
E33045961,1617,1230,335,895,15,103,44,59,262,223,15,13,11,7
E33045962,991,749,214,535,12,48,25,23,172,153,4,14,1,10
E33045963,157,91,30,61,3,11,5,6,52,46,0,5,1,0
E33045964,466,281,68,213,3,29,14,15,148,135,3,7,3,5
E33045965,219,144,45,99,0,14,8,6,60,59,0,1,0,1
E33045966,1457,648,175,473,11,102,56,46,685,664,9,8,4,11
E33045967,414,297,69,228,4,34,16,18,76,69,1,5,1,3
E33045968,318,235,63,172,9,15,8,7,56,52,0,4,0,3
E33045969,553,445,114,331,10,27,14,13,68,62,1,4,1,3
E33045970,636,431,116,315,5,50,16,34,149,140,6,3,0,1
E33045971,508,359,89,270,9,16,7,9,121,110,2,7,2,3
E33045972,1132,734,140,594,16,86,40,46,288,267,2,17,2,8
E33045973,791,490,108,382,12,55,21,34,231,210,1,20,0,3
E33045974,256,175,43,132,9,25,14,11,46,43,0,3,0,1
E33045975,461,339,71,268,7,49,33,16,63,56,0,7,0,3
E33045976,636,511,88,423,7,39,16,23,77,64,2,10,1,2
E33045977,570,391,103,288,5,49,38,11,125,120,1,1,3,0
E33045978,601,354,71,283,9,60,32,28,176,166,1,6,3,2
E33045979,4297,3204,438,2766,81,310,166,144,693,649,7,30,7,9
E33045980,327,230,55,175,6,24,15,9,66,62,0,4,0,1
E33045981,530,372,108,264,4,85,51,34,67,58,2,5,2,2
E33045982,685,417,87,330,6,59,42,17,202,186,1,12,3,1
E33045983,500,339,84,255,8,63,33,30,88,77,0,8,3,2
E33045984,848,520,139,381,12,151,103,48,162,156,0,4,2,3
E33045985,394,297,81,216,3,16,12,4,76,69,2,4,1,2
E33045986,1234,933,197,736,17,63,38,25,217,188,1,26,2,4
E33045987,538,394,104,290,6,45,29,16,92,85,1,5,1,1
E33045988,227,189,32,157,4,12,7,5,22,20,0,2,0,0
E33045989,734,584,133,451,8,50,29,21,90,84,1,5,0,2
E33045990,1096,807,168,639,18,100,72,28,168,154,0,11,3,3
E33045991,930,648,162,486,12,86,52,34,180,170,1,9,0,4
E33045992,607,468,129,339,7,75,56,19,54,50,0,4,0,3
E33045993,924,595,173,422,22,119,80,39,181,173,1,5,2,7
E33045994,472,361,111,250,8,39,22,17,61,49,1,11,0,3
E33045995,1432,1117,311,806,10,123,63,60,176,155,5,15,1,6
E33045996,380,237,50,187,8,28,19,9,106,100,3,3,0,1
E33045997,961,636,146,490,14,134,94,40,172,157,2,8,5,5
E33045998,334,196,40,156,2,46,27,19,89,78,2,8,1,1
E33045999,262,175,63,112,4,27,16,11,53,51,1,1,0,3
E33046000,216,162,37,125,2,12,4,8,38,35,0,3,0,2
E33046001,383,232,39,193,5,42,24,18,102,96,1,3,2,2
E33046002,432,301,75,226,8,40,25,15,81,74,0,5,2,2
E33046003,538,376,73,303,2,63,40,23,92,84,3,5,0,5
E33046004,217,148,43,105,4,11,5,6,53,47,1,5,0,1
E33046005,221,173,60,113,1,5,1,4,40,37,0,2,1,2
E33046006,239,172,40,132,6,25,19,6,36,33,1,2,0,0
E33046007,321,222,56,166,3,28,17,11,65,63,0,2,0,3
E33046008,505,405,94,311,9,23,11,12,67,59,1,7,0,1
E33046009,1099,809,123,686,17,82,55,27,188,176,2,9,1,3
E33046010,754,528,90,438,11,46,21,25,167,154,2,9,2,2
E33046011,646,477,98,379,3,36,22,14,129,121,0,7,1,1
E33046012,1309,933,214,719,8,57,29,28,307,287,3,12,5,4
E33046013,1705,1331,248,1083,19,85,38,47,268,250,3,12,3,2
E33046014,229,166,52,114,4,27,19,8,32,29,1,1,1,0
E33046015,381,284,64,220,7,22,18,4,68,61,0,5,2,0
E33046016,284,218,37,181,2,17,7,10,46,46,0,0,0,1
E33046017,581,484,114,370,6,16,10,6,73,69,1,3,0,2
E33046018,219,146,39,107,2,35,30,5,34,32,0,2,0,2
E33046019,358,262,56,206,5,31,19,12,57,53,0,3,1,3
E33046020,553,401,65,336,15,36,17,19,101,94,1,6,0,0
E33046021,346,243,47,196,9,50,36,14,44,41,1,2,0,0
E33046022,420,307,82,225,3,47,31,16,63,60,1,2,0,0
E33046023,667,396,65,331,6,53,34,19,209,198,4,4,3,3
E33046024,1001,691,134,557,11,32,18,14,265,259,3,3,0,2
E33046025,543,335,63,272,15,22,13,9,169,153,2,8,6,2
E33046026,833,668,118,550,17,25,17,8,122,119,0,1,2,1
E33046027,784,541,142,399,8,94,53,41,139,127,0,10,2,2
E33046028,344,261,79,182,6,30,19,11,46,40,0,6,0,1
E33046029,1272,1003,216,787,6,118,83,35,140,125,4,10,1,5
E33046030,938,615,121,494,7,106,72,34,202,181,6,13,2,8
E33046031,653,501,113,388,6,37,25,12,104,94,0,10,0,5
E33046032,490,335,76,259,9,33,15,18,110,99,4,5,2,3
E33046033,312,241,45,196,3,19,11,8,48,42,0,6,0,1
E33046034,311,256,63,193,3,14,5,9,36,27,4,5,0,2
E33046035,283,218,39,179,4,20,11,9,40,35,1,4,0,1
E33046036,348,253,59,194,6,33,20,13,56,48,0,7,1,0
E33046037,440,321,80,241,8,41,28,13,69,60,0,9,0,1
E33046038,267,213,54,159,1,9,1,8,43,41,0,1,1,1
E33046039,493,430,93,337,2,9,5,4,52,45,1,6,0,0
E33046040,254,181,40,141,0,34,26,8,38,36,0,2,0,1
E33046041,1807,1446,305,1141,20,61,39,22,274,253,2,17,2,6
E33046042,335,248,61,187,2,27,12,15,58,55,1,2,0,0
E33046043,448,311,74,237,5,52,34,18,80,76,0,4,0,0
E33046044,890,675,155,520,8,31,14,17,175,159,3,10,3,1
E33046045,269,172,52,120,7,34,19,15,55,53,0,1,1,1
E33046046,753,519,138,381,9,120,87,33,102,97,0,4,1,3
E33046047,209,153,49,104,4,29,19,10,23,20,0,3,0,0
E33046048,946,708,179,529,19,53,30,23,157,142,5,6,4,9
E33046049,1212,714,181,533,21,149,82,67,316,300,1,15,0,12
E33046050,344,232,62,170,4,26,16,10,78,66,2,7,3,4
E33046051,465,355,109,246,1,29,21,8,76,67,0,9,0,4
E33046052,226,173,59,114,1,15,8,7,35,31,1,3,0,2
E33046053,203,143,42,101,3,10,7,3,44,34,0,10,0,3
E33046054,399,270,90,180,1,40,24,16,82,72,0,10,0,6
E33046055,350,257,92,165,2,34,22,12,53,45,1,5,2,4
E33046056,338,220,82,138,3,31,21,10,77,66,1,8,2,7
E33046057,218,157,43,114,1,19,9,10,38,32,3,3,0,3
E33046058,552,371,70,301,7,48,26,22,121,107,4,6,4,5
E33046059,1346,936,237,699,7,98,51,47,299,185,74,19,21,6
E33046060,244,147,52,95,4,23,14,9,68,62,0,6,0,2
E33046061,202,117,46,71,1,13,9,4,69,61,0,7,1,2
E33046062,232,125,36,89,4,20,10,10,73,67,0,5,1,10
E33046063,392,223,80,143,1,23,14,9,138,123,1,13,1,7
E33046064,278,185,57,128,4,34,21,13,53,46,1,6,0,2
E33046065,222,148,47,101,1,15,7,8,55,48,0,5,2,3
E33046066,242,173,49,124,1,13,7,6,53,48,0,4,1,2
E33046067,278,172,55,117,4,15,10,5,77,68,1,6,2,10
E33046068,203,124,48,76,3,17,12,5,58,52,1,4,1,1
E33046069,2825,2240,649,1591,25,160,90,70,377,331,6,38,2,23
E33046070,313,246,82,164,3,4,0,4,57,52,0,5,0,3
E33046071,415,297,84,213,4,23,13,10,86,77,0,6,3,5
E33046072,399,250,94,156,5,62,37,25,80,77,0,3,0,2
E33046073,429,321,88,233,9,14,8,6,82,78,0,4,0,3
E33046074,381,282,86,196,0,31,15,16,66,60,1,5,0,2
E33046075,203,122,29,93,1,14,8,6,64,52,0,9,3,2
E33046076,228,166,52,114,5,13,7,6,42,34,0,7,1,2
E33046077,480,381,110,271,5,17,8,9,69,59,1,7,2,8
E33046078,504,324,107,217,4,36,18,18,136,121,1,12,2,4
E33046079,290,230,74,156,4,11,7,4,43,39,0,4,0,2
E33046080,302,178,55,123,3,27,21,6,86,80,0,5,1,8
E33046081,826,636,192,444,11,46,27,19,128,107,0,19,2,5
E33046082,1443,1073,358,715,19,102,45,57,244,223,0,19,2,5
E33046083,822,552,201,351,7,101,64,37,154,143,0,9,2,8
E33046084,395,252,70,182,5,39,27,12,92,82,0,8,2,7
E33046085,1037,783,243,540,11,48,21,27,183,164,0,19,0,12
E33046086,639,429,145,284,2,70,31,39,136,123,1,12,0,2
E33046087,225,144,44,100,3,16,5,11,60,54,0,6,0,2
E33046088,253,179,53,126,2,20,12,8,51,44,1,5,1,1
E33046089,215,150,56,94,1,14,3,11,50,44,1,3,2,0
E33046090,545,381,137,244,3,32,7,25,126,97,14,8,7,3
E33046091,683,427,165,262,14,67,23,44,170,150,2,13,5,5
E33046092,1358,1080,369,711,11,56,14,42,197,171,3,21,2,14
E33046093,262,185,59,126,4,24,12,12,49,45,0,4,0,0
E33046094,802,481,138,343,11,86,32,54,221,208,2,8,3,3
E33046095,492,335,119,216,10,67,15,52,75,64,0,11,0,5
E33046096,249,186,55,131,1,21,9,12,39,34,1,4,0,2
E33046097,299,222,72,150,0,37,12,25,39,35,1,3,0,1
E33046098,259,159,41,118,4,17,5,12,78,73,0,5,0,1
E33046099,637,473,146,327,11,43,23,20,104,86,2,15,1,6
E33046100,443,342,109,233,3,24,5,19,68,60,0,7,1,6
E33046101,1889,1404,429,975,14,126,35,91,334,313,1,19,1,11
E33046102,207,140,46,94,4,14,4,10,46,40,0,6,0,3
E33046103,335,249,73,176,2,24,8,16,59,53,1,5,0,1
E33046104,221,158,49,109,2,20,7,13,40,34,0,6,0,1
E33046105,778,564,203,361,8,57,31,26,140,121,4,13,2,9
E33046106,801,526,178,348,8,93,58,35,167,153,2,12,0,7
E33046107,376,254,80,174,5,39,24,15,76,66,0,8,2,2
E33046108,312,218,74,144,4,35,15,20,53,45,0,8,0,2
E33046109,1250,685,212,473,18,137,82,55,407,380,4,21,2,3
E33046110,294,215,81,134,4,28,19,9,44,37,0,5,2,3
E33046111,345,251,90,161,4,33,25,8,55,50,0,5,0,2
E33046112,474,351,92,259,7,32,14,18,79,67,2,10,0,5
E33046113,316,261,73,188,4,15,10,5,36,35,0,1,0,0
E33046114,492,290,100,190,2,65,37,28,132,113,2,15,2,3
E33046115,231,165,71,94,2,20,6,14,41,38,0,3,0,3
E33046116,338,230,84,146,4,24,10,14,74,58,4,10,2,6
E33046117,573,397,173,224,7,39,21,18,121,104,0,17,0,9
E33046118,240,157,49,108,5,22,13,9,49,47,0,2,0,7
E33046119,254,193,80,113,1,15,6,9,36,34,1,1,0,9
E33046120,533,376,121,255,13,46,33,13,94,89,1,3,1,4
E33046121,378,257,86,171,3,27,17,10,79,67,1,11,0,12
E33046122,409,305,120,185,2,19,9,10,77,69,1,5,2,6
E33046123,351,253,86,167,2,31,23,8,63,56,0,7,0,2
E33046124,292,184,68,116,2,22,8,14,83,77,0,6,0,1
E33046125,637,373,136,237,4,78,54,24,174,134,25,14,1,8
E33046126,958,526,180,346,7,63,33,30,353,331,2,15,5,9
E33046127,735,504,161,343,10,59,44,15,157,148,0,9,0,5
E33046128,220,163,77,86,1,19,9,10,31,30,0,1,0,6
E33046129,364,245,87,158,2,41,28,13,76,66,1,9,0,0
E33046130,306,222,83,139,3,25,16,9,53,48,0,3,2,3
E33046131,205,142,57,85,3,19,17,2,39,33,1,5,0,2
E33046132,498,358,107,251,9,39,5,34,86,73,2,11,0,6
E33046133,251,163,63,100,6,27,2,25,49,45,0,4,0,6
E33046134,573,372,136,236,5,73,11,62,118,108,0,9,1,5
E33046135,302,201,97,104,2,34,7,27,64,60,0,3,1,1
E33046136,288,208,67,141,5,25,7,18,49,42,0,5,2,1
E33046137,282,173,65,108,1,29,6,23,72,57,4,11,0,7
E33046138,286,193,55,138,3,27,0,27,63,55,2,3,3,0
E33046139,336,235,100,135,2,17,3,14,79,72,0,7,0,3
E33046140,277,216,84,132,1,17,3,14,42,38,0,3,1,1
E33046141,484,280,88,192,0,70,11,59,124,109,2,13,0,10
E33046142,287,181,61,120,1,51,5,46,54,50,0,4,0,0
E33046143,332,208,72,136,2,32,8,24,87,79,1,6,1,3
E33046144,245,165,73,92,1,13,2,11,63,56,0,5,2,3
E33046145,384,229,95,134,7,50,8,42,94,84,1,9,0,4
E33046146,308,208,67,141,4,42,13,29,52,47,0,5,0,2
E33046147,224,178,72,106,2,8,5,3,35,32,0,2,1,1
E33046148,208,129,41,88,3,31,2,29,45,42,0,0,3,0
E33046149,416,314,118,196,5,33,16,17,58,54,0,4,0,6
E33046150,623,465,149,316,11,56,19,37,89,80,0,9,0,2
E33046151,287,210,62,148,8,27,7,20,41,33,1,7,0,1
E33046152,817,626,197,429,12,33,13,20,141,124,3,13,1,5
E33046153,246,132,37,95,2,16,5,11,96,87,2,5,2,0
E33046154,220,156,52,104,4,9,5,4,49,40,1,7,1,2
E33046155,286,180,52,128,3,12,0,12,83,73,0,7,3,8
E33046156,252,141,46,95,2,18,4,14,85,77,2,6,0,6
E33046157,212,151,43,108,6,9,3,6,45,37,1,7,0,1
E33046158,470,293,82,211,4,29,9,20,143,116,11,14,2,1
E33046159,385,264,77,187,5,15,2,13,101,98,0,2,1,0
E33046160,667,535,188,347,8,31,17,14,87,80,1,6,0,6
E33046161,230,156,52,104,2,18,3,15,50,45,0,5,0,4
E33046162,477,348,127,221,15,34,11,23,77,64,2,11,0,3
E33046163,203,138,35,103,6,18,4,14,39,36,0,3,0,2
E33046164,295,218,46,172,3,19,8,11,48,41,3,4,0,7
E33046165,376,301,95,206,3,18,5,13,52,44,4,3,1,2
E33046166,300,228,69,159,3,13,3,10,53,44,1,7,1,3
E33046167,824,558,194,364,12,55,12,43,189,158,5,22,4,10
E33046168,681,475,171,304,3,37,16,21,160,71,58,6,25,6
E33046169,1177,749,234,515,20,90,39,51,300,277,2,13,8,18
E33046170,311,240,62,178,4,16,6,10,48,44,2,1,1,3
E33046171,683,546,175,371,9,34,8,26,93,82,3,7,1,1
E33046172,330,218,78,140,7,36,8,28,64,56,2,5,1,5
E33046173,208,150,48,102,2,14,5,9,41,36,1,4,0,1
E33046174,267,173,63,110,3,36,20,16,52,47,1,4,0,3
E33046175,212,151,55,96,1,24,14,10,36,32,0,4,0,0
E33046176,369,258,79,179,3,51,28,23,55,49,2,4,0,2
E33046177,358,222,70,152,4,49,17,32,70,51,7,5,7,13
E33046178,285,198,58,140,3,21,9,12,58,52,2,4,0,5
E33046179,2009,1518,357,1161,18,82,38,44,380,345,0,34,1,11
E33046180,886,598,165,433,12,76,43,33,199,184,2,10,3,1
E33046181,518,369,109,260,3,51,31,20,90,76,2,12,0,5
E33046182,251,186,57,129,2,12,4,8,46,40,0,5,1,5
E33046183,614,434,133,301,5,47,31,16,127,109,6,12,0,1
E33046184,220,166,48,118,2,15,9,6,37,32,1,4,0,0
E33046185,315,233,70,163,2,13,9,4,65,56,5,4,0,2
E33046186,428,285,72,213,2,43,25,18,94,87,0,5,2,4
E33046187,331,216,72,144,0,22,15,7,85,75,5,4,1,8
E33046188,504,317,95,222,2,56,33,23,123,110,5,8,0,6
E33046189,427,290,106,184,0,60,43,17,72,66,1,5,0,5
E33046190,487,343,125,218,2,39,24,15,99,89,0,10,0,4
E33046191,179,102,41,61,2,17,15,2,55,46,4,3,2,3
E33046192,282,197,89,108,4,27,16,11,46,43,2,1,0,8
E33046193,429,285,126,159,4,43,34,9,94,85,3,6,0,3
E33046194,551,371,92,279,9,47,26,21,123,109,5,9,0,1
E33046195,769,575,163,412,9,47,26,21,130,111,1,16,2,8
E33046196,247,173,49,124,4,18,9,9,51,48,0,3,0,1
E33046197,552,412,114,298,4,45,21,24,90,84,0,6,0,1
E33046198,376,262,75,187,3,30,14,16,80,74,0,5,1,1
E33046199,445,331,78,253,3,24,7,17,84,76,0,7,1,3
E33046200,247,161,44,117,4,22,15,7,60,49,0,10,1,0
E33046201,768,529,138,391,5,91,56,35,134,124,0,8,2,9
E33046202,409,294,92,202,5,45,26,19,63,56,0,7,0,2
E33046203,337,228,68,160,7,41,23,18,56,51,2,2,1,5
E33046204,866,575,175,400,4,84,43,41,196,172,4,18,2,7
E33046205,225,155,58,97,3,33,17,16,33,31,0,2,0,1
E33046206,682,444,152,292,5,86,55,31,144,130,0,12,2,3
E33046207,251,171,46,125,0,24,11,13,53,47,0,6,0,3
E33046208,462,328,90,238,5,55,30,25,72,69,2,1,0,2
E33046209,593,414,141,273,8,66,36,30,102,97,0,4,1,3
E33046210,230,131,37,94,3,8,6,2,85,80,0,5,0,3
E33046211,561,349,116,233,5,28,13,15,175,167,1,6,1,4
E33046212,511,321,111,210,5,17,10,7,163,157,0,6,0,5
E33046213,194,127,45,82,2,8,4,4,57,51,0,6,0,0
E33046214,113,88,33,55,0,5,4,1,20,18,0,2,0,0
E33046215,1647,1004,334,670,6,69,28,41,556,532,3,19,2,12
E33046216,246,125,38,87,2,36,22,14,80,74,0,6,0,3
E33046217,207,132,35,97,3,24,11,13,47,44,0,2,1,1
E33046218,242,178,53,125,1,14,9,5,47,42,2,1,2,2
E33046219,925,528,160,368,18,118,67,51,260,250,0,9,1,1
E33046220,232,162,54,108,0,25,14,11,45,41,1,2,1,0
E33046221,221,159,53,106,2,24,12,12,35,34,0,1,0,1
E33046222,386,262,110,152,1,17,15,2,104,95,0,9,0,2
E33046223,309,225,49,176,8,32,18,14,42,36,2,3,1,2
E33046224,425,308,71,237,1,45,36,9,68,63,0,5,0,3
E33046225,6057,4464,1188,3276,71,390,246,144,1108,993,34,59,22,24
E33046226,290,207,58,149,1,18,9,9,64,57,3,2,2,0
E33046227,307,177,52,125,6,48,24,24,71,62,0,9,0,5
E33046228,203,108,28,80,1,30,17,13,57,55,0,2,0,7
E33046229,294,165,51,114,5,32,18,14,90,74,6,9,1,2
E33046230,304,173,46,127,3,36,21,15,91,85,0,5,1,1
E33046231,474,252,69,183,4,31,15,16,184,175,2,7,0,3
E33046232,337,212,73,139,0,33,14,19,90,87,1,2,0,2
E33046233,204,141,50,91,2,24,18,6,37,35,0,2,0,0
E33046234,309,176,45,131,5,28,16,12,100,94,0,6,0,0
E33046235,377,267,67,200,4,27,15,12,76,70,4,2,0,3
E33046236,298,247,70,177,3,13,5,8,32,32,0,0,0,3
E33046237,844,564,126,438,6,68,35,33,199,181,1,15,2,7
E33046238,298,227,80,147,2,18,14,4,46,40,0,4,2,5
E33046239,2142,1778,521,1257,20,75,48,27,259,238,6,14,1,10
E33046240,797,605,202,403,1,80,49,31,110,107,0,3,0,1
E33046241,842,614,155,459,6,100,70,30,120,115,0,5,0,2
E33046242,683,541,169,372,6,31,15,16,98,92,0,5,1,7
E33046243,693,540,142,398,4,39,18,21,108,100,0,5,3,2
E33046244,803,565,145,420,7,66,40,26,162,150,1,10,1,3
E33046245,718,495,125,370,6,41,23,18,176,163,1,10,2,0
E33046246,481,346,92,254,7,45,24,21,83,79,1,3,0,0
E33046247,215,128,35,93,3,34,20,14,47,44,0,2,1,3
E33046248,239,183,46,137,2,17,7,10,37,34,1,1,1,0
E33046249,321,202,42,160,3,33,17,16,81,77,1,2,1,2
E33046250,1205,869,176,693,4,86,46,40,240,216,1,22,1,6
E33046251,212,135,40,95,0,23,11,12,53,50,0,3,0,1
E33046252,271,206,43,163,0,17,15,2,44,42,0,2,0,4
E33046253,423,326,74,252,2,19,16,3,75,73,0,2,0,1
E33046254,724,539,129,410,4,31,15,16,149,137,0,11,1,1
E33046255,495,333,101,232,7,23,11,12,130,120,6,4,0,2
E33046256,443,352,107,245,6,30,19,11,55,51,0,3,1,0
E33046257,2334,1771,433,1338,16,76,44,32,468,439,0,27,2,3
E33046258,1596,1114,256,858,19,59,25,34,397,372,2,23,0,7
E33046259,505,345,114,231,6,57,42,15,96,90,3,3,0,1
E33046260,423,279,95,184,5,63,32,31,71,66,1,3,1,5
E33046261,446,331,92,239,5,38,26,12,70,62,0,8,0,2
E33046262,224,152,56,96,4,19,16,3,48,39,3,4,2,1
E33046263,643,452,168,284,3,63,47,16,121,103,4,12,2,4
E33046264,258,168,49,119,3,22,14,8,56,48,2,6,0,9
E33046265,503,320,106,214,7,56,42,14,114,102,5,3,4,6
E33046266,247,143,43,100,9,37,28,9,52,51,0,1,0,6
E33046267,424,327,93,234,10,28,20,8,55,47,1,7,0,4
E33046268,250,174,50,124,4,17,11,6,50,45,0,5,0,5
E33046269,878,614,171,443,8,91,55,36,159,150,2,7,0,6
E33046270,409,301,99,202,7,29,19,10,68,60,4,4,0,4
E33046271,1130,524,144,380,24,131,85,46,448,442,2,4,0,3
E33046272,414,265,88,177,5,62,50,12,79,74,4,1,0,3
E33046273,298,212,65,147,2,33,23,10,48,45,1,2,0,3
E33046274,228,166,55,111,4,11,1,10,46,43,0,3,0,1
E33046275,607,462,130,332,7,36,10,26,100,86,1,12,1,2
E33046276,467,312,102,210,11,43,10,33,100,96,1,3,0,1
E33046277,254,158,63,95,1,18,6,12,69,57,6,5,1,8
E33046278,358,234,74,160,1,33,15,18,88,78,0,9,1,2
E33046279,998,680,206,474,8,82,21,61,216,194,7,12,3,12
E33046280,726,565,161,404,9,30,6,24,120,103,1,15,1,2
E33046281,221,150,37,113,1,17,4,13,50,48,1,1,0,3
E33046282,301,195,68,127,2,27,9,18,74,71,1,2,0,3
E33046283,378,289,74,215,4,9,2,7,74,65,2,4,3,2
E33046284,386,272,73,199,8,29,8,21,75,69,1,5,0,2
E33046285,199,136,33,103,2,15,5,10,45,37,0,2,6,1
E33046286,327,219,65,154,4,21,6,15,79,69,1,8,1,4
E33046287,207,140,40,100,1,14,6,8,50,46,1,2,1,2
E33046288,232,169,60,109,0,20,4,16,41,37,2,1,1,2
E33046289,239,184,49,135,2,12,3,9,41,37,0,3,1,0
E33046290,299,243,84,159,2,14,4,10,38,36,1,1,0,2
E33046291,260,157,50,107,2,31,6,25,65,58,2,3,2,5
E33046292,254,178,51,127,2,15,4,11,56,50,1,3,2,3
E33046293,885,655,146,509,8,33,11,22,188,169,0,17,2,1
E33046294,339,195,71,124,3,23,6,17,115,105,0,8,2,3
E33046295,247,186,58,128,2,9,2,7,47,43,1,3,0,3
E33046296,268,199,60,139,2,22,5,17,43,40,0,3,0,2
E33046297,287,207,62,145,4,14,5,9,61,50,0,10,1,1
E33046298,775,525,162,363,5,78,20,58,165,151,3,11,0,2
E33046299,381,277,78,199,6,38,3,35,58,54,0,4,0,2
E33046300,673,469,131,338,12,69,20,49,117,108,2,7,0,6
E33046301,347,260,84,176,3,28,5,23,49,44,0,4,1,7
E33046302,209,124,38,86,2,18,3,15,65,56,2,4,3,0
E33046303,401,306,86,220,5,24,9,15,62,59,0,2,1,4
E33046304,741,500,157,343,4,47,10,37,188,156,19,10,3,2
E33046305,2268,1684,495,1189,24,93,24,69,452,393,23,29,7,15
E33046306,684,495,154,341,10,33,9,24,143,130,1,11,1,3
E33046307,668,446,159,287,12,52,29,23,153,140,3,9,1,5
E33046308,625,441,128,313,5,37,8,29,137,125,1,11,0,5
E33046309,475,351,130,221,4,30,12,18,81,71,1,9,0,9
E33046310,1136,787,178,609,8,131,68,63,202,196,0,5,1,8
E33046311,1698,1162,317,845,20,147,66,81,359,322,2,30,5,10
E33046312,1136,670,149,521,17,134,48,86,305,271,5,28,1,10
E33046313,391,269,78,191,0,36,13,23,75,66,1,8,0,11
E33046314,344,229,90,139,5,33,3,30,72,61,6,5,0,5
E33046315,341,247,90,157,7,24,3,21,62,53,4,5,0,1
E33046316,225,123,49,74,7,35,6,29,56,49,0,6,1,4
E33046317,200,147,54,93,0,13,3,10,38,32,2,4,0,2
E33046318,316,172,70,102,3,47,4,43,90,74,7,8,1,4
E33046319,287,209,66,143,3,21,8,13,49,45,0,4,0,5
E33046320,475,338,96,242,6,32,15,17,98,80,12,6,0,1
E33046321,1312,932,254,678,11,144,44,100,218,200,2,13,3,7
E33046322,392,278,72,206,6,45,13,32,62,54,1,6,1,1
E33046323,214,168,58,110,3,6,1,5,32,27,0,4,1,5
E33046324,512,380,105,275,4,46,9,37,78,67,2,8,1,4
E33046325,409,248,87,161,8,58,6,52,90,81,0,9,0,5
E33046326,252,148,49,99,6,22,5,17,74,56,11,7,0,2
E33046327,203,160,65,95,1,9,2,7,30,27,0,3,0,3
E33046328,333,224,75,149,7,30,8,22,70,64,0,6,0,2
E33046329,431,329,106,223,5,31,6,25,62,57,1,4,0,4
E33046330,230,169,51,118,5,18,3,15,37,36,0,1,0,1
E33046331,707,529,177,352,11,43,8,35,122,112,2,8,0,2
E33046332,332,234,74,160,7,24,6,18,62,55,2,5,0,5
E33046333,592,398,131,267,9,42,6,36,139,127,0,12,0,4
E33046334,258,172,75,97,2,16,3,13,65,60,1,4,0,3
E33046335,745,525,176,349,8,77,12,65,133,115,4,10,4,2
E33046336,342,182,79,103,6,69,20,49,82,78,3,1,0,3
E33046337,801,600,169,431,8,42,15,27,146,125,3,16,2,5
E33046338,447,301,75,226,5,43,10,33,97,92,0,5,0,1
E33046339,1056,719,196,523,10,99,43,56,224,213,0,10,1,4
E33046340,345,258,65,193,4,21,4,17,58,53,0,5,0,4
E33046341,244,182,45,137,2,24,8,16,35,29,0,6,0,1
E33046342,203,144,35,109,4,23,10,13,28,27,0,1,0,4
E33046343,197,143,32,111,2,11,5,6,41,38,0,3,0,0
E33046344,241,173,60,113,2,7,3,4,58,50,0,8,0,1
E33046345,422,290,87,203,7,33,7,26,90,82,0,8,0,2
E33046346,408,303,72,231,3,17,3,14,82,75,0,7,0,3
E33046347,577,423,121,302,8,44,13,31,97,82,3,9,3,5
E33046348,437,337,116,221,3,22,5,17,74,66,0,8,0,1
E33046349,328,245,51,194,1,22,6,16,57,51,0,6,0,3
E33046350,358,243,66,177,3,39,11,28,70,63,1,5,1,3
E33046351,557,376,102,274,9,49,15,34,119,101,8,10,0,4
E33046352,1076,804,229,575,6,50,15,35,205,186,1,16,2,11
E33046353,256,174,44,130,6,21,4,17,54,50,0,4,0,1
E33046354,387,294,89,205,5,17,9,8,69,65,0,4,0,2
E33046355,464,369,165,204,3,23,6,17,66,54,2,9,1,3
E33046356,219,161,59,102,1,12,4,8,41,41,0,0,0,4
E33046357,438,316,102,214,2,13,1,12,106,93,3,8,2,1
E33046358,314,215,65,150,5,13,2,11,79,73,1,5,0,2
E33046359,406,320,103,217,3,19,4,15,58,53,0,4,1,6
E33046360,473,311,98,213,9,36,7,29,115,102,2,11,0,2
E33046361,305,235,57,178,4,20,3,17,46,38,0,8,0,0
E33046362,423,314,111,203,6,39,7,32,59,48,1,10,0,5
E33046363,642,429,121,308,11,63,13,50,130,112,3,13,2,9
E33046364,584,381,131,250,6,51,8,43,145,134,1,10,0,1
E33046365,555,414,184,230,4,30,6,24,103,94,2,6,1,4
E33046366,332,265,101,164,5,13,4,9,45,38,3,4,0,4
E33046367,308,223,87,136,5,26,6,20,46,42,1,3,0,8
E33046368,385,282,122,160,1,23,2,21,77,68,1,7,1,2
E33046369,218,158,58,100,0,15,4,11,43,40,2,1,0,2
E33046370,226,153,64,89,1,29,8,21,41,40,0,1,0,2
E33046371,248,152,57,95,4,27,5,22,62,59,0,3,0,3
E33046372,481,352,135,217,2,36,13,23,89,78,1,9,1,2
E33046373,318,225,81,144,4,22,10,12,62,59,1,2,0,5
E33046374,481,353,135,218,6,36,10,26,83,68,3,12,0,3
E33046375,749,494,141,353,9,79,25,54,164,158,1,4,1,3
E33046376,330,220,63,157,6,31,4,27,69,64,0,4,1,4
E33046377,605,396,116,280,13,66,19,47,129,119,2,7,1,1
E33046378,227,164,46,118,4,22,2,20,34,30,3,1,0,3
E33046379,579,426,143,283,8,52,12,40,92,84,1,6,1,1
E33046380,322,201,45,156,4,16,4,12,99,94,0,4,1,2
E33046381,1196,896,278,618,7,52,17,35,234,217,0,15,2,7
E33046382,396,275,64,211,2,29,11,18,89,82,2,4,1,1
E33046383,1593,1198,332,866,15,104,38,66,271,244,4,23,0,5
E33046384,232,168,53,115,0,10,7,3,53,45,0,6,2,1
E33046385,360,268,73,195,5,16,4,12,69,67,0,2,0,2
E33046386,370,259,96,163,5,25,7,18,77,70,2,3,2,4
E33046387,276,179,54,125,3,32,6,26,62,57,1,4,0,0
E33046388,318,214,51,163,4,30,2,28,68,64,0,4,0,2
E33046389,256,168,54,114,5,24,5,19,55,52,2,1,0,4
E33046390,351,240,53,187,5,27,5,22,76,72,1,2,1,3
E33046391,327,227,69,158,4,30,3,27,66,62,0,3,1,0
E33046392,338,244,77,167,2,19,3,16,70,68,2,0,0,3
E33046393,647,422,158,264,11,72,16,56,130,119,1,6,4,12
E33046394,250,175,55,120,2,27,6,21,44,39,1,4,0,2
E33046395,603,466,169,297,4,49,10,39,80,71,0,7,2,4
E33046396,245,180,50,130,5,16,3,13,41,36,1,4,0,3
E33046397,1554,1103,320,783,11,95,29,66,342,330,2,9,1,3
E33046398,267,205,70,135,4,17,5,12,40,39,0,1,0,1
E33046399,329,256,69,187,2,21,8,13,48,45,0,3,0,2
E33046400,342,261,93,168,2,30,14,16,48,43,0,5,0,1
E33046401,257,195,48,147,2,27,11,16,32,27,2,3,0,1
E33046402,248,171,36,135,2,24,7,17,50,46,2,2,0,1
E33046403,423,318,97,221,4,28,12,16,71,65,1,5,0,2
E33046404,396,261,52,209,3,34,20,14,95,87,3,2,3,3
E33046405,557,381,89,292,3,39,18,21,132,120,1,11,0,2
E33046406,259,191,47,144,3,26,11,15,37,35,0,1,1,2
E33046407,342,265,78,187,4,21,12,9,51,44,1,6,0,1
E33046408,336,232,72,160,1,30,10,20,71,68,1,2,0,2
E33046409,608,469,115,354,2,41,20,21,95,89,1,5,0,1
E33046410,225,154,47,107,1,25,12,13,39,33,0,1,5,6
E33046411,118,95,27,68,0,5,0,5,18,14,0,1,3,0
E33046412,221,149,43,106,0,35,18,17,37,31,1,3,2,0
E33046413,203,156,58,98,0,11,0,11,33,28,2,2,1,3
E33046414,367,262,77,185,2,34,8,26,60,56,0,2,2,9
E33046415,245,178,64,114,0,17,4,13,43,40,0,3,0,7
E33046416,652,407,147,260,6,55,8,47,165,83,50,5,27,19
E33046417,241,149,32,117,5,28,2,26,54,36,8,7,3,5
E33046418,213,138,43,95,3,32,2,30,38,33,3,1,1,2
E33046419,236,156,48,108,1,34,2,32,43,38,2,3,0,2
E33046420,654,479,155,324,6,65,12,53,95,83,4,3,5,9
E33046421,714,535,160,375,6,65,4,61,104,95,1,7,1,4
E33046422,256,170,52,118,7,31,10,21,46,43,0,3,0,2
E33046423,216,136,43,93,1,32,4,28,46,45,0,1,0,1
E33046424,398,292,98,194,3,40,4,36,59,47,7,2,3,4
E33046425,238,154,51,103,2,23,7,16,58,53,3,2,0,1
E33046426,977,581,155,426,15,118,26,92,260,243,1,13,3,3
E33046427,377,275,122,153,3,23,3,20,50,45,5,0,0,26
E33046428,716,503,153,350,11,71,3,68,121,102,5,9,5,10
E33046429,972,643,172,471,8,110,13,97,206,187,2,15,2,5
E33046430,584,408,141,267,5,55,11,44,102,86,1,11,4,14
E33046431,239,155,64,91,1,24,6,18,53,45,5,3,0,6
E33046432,458,302,94,208,1,28,8,20,107,102,3,2,0,20
E33046433,381,274,85,189,3,24,13,11,80,72,4,4,0,0
E33046434,322,236,79,157,2,32,12,20,51,50,0,1,0,1
E33046435,740,499,144,355,10,71,26,45,156,140,1,13,2,4
E33046436,243,145,49,96,1,22,10,12,69,57,10,1,1,6
E33046437,597,414,162,252,4,62,15,47,105,95,3,7,0,12
E33046438,495,375,106,269,3,45,9,36,71,60,5,6,0,1
E33046439,1060,883,209,674,12,23,4,19,132,110,5,13,4,10
E33046440,629,499,164,335,6,43,10,33,77,69,6,2,0,4
E33046441,641,448,141,307,6,60,5,55,123,115,3,5,0,4
E33046442,434,288,91,197,6,43,2,41,92,82,0,9,1,5
E33046443,574,338,144,194,9,85,8,77,135,119,2,10,4,7
E33046444,588,390,161,229,3,69,6,63,123,110,6,7,0,3
E33046445,267,196,84,112,1,19,3,16,38,30,5,2,1,13
E33046446,459,321,114,207,1,32,6,26,83,66,8,6,3,22
E33046447,246,185,60,125,1,16,1,15,41,38,0,3,0,3
E33046448,585,412,128,284,2,43,16,27,123,113,1,9,0,5
E33046449,325,241,78,163,3,32,1,31,47,44,3,0,0,2
E33046450,216,178,54,124,0,9,1,8,27,22,1,3,1,2
E33046451,421,283,91,192,8,41,8,33,86,78,1,7,0,3
E33046452,378,270,85,185,10,37,4,33,60,53,0,6,1,1
E33046453,405,306,107,199,8,28,4,24,59,54,0,5,0,4
E33046454,650,458,142,316,9,55,6,49,114,100,3,11,0,14
E33046455,232,160,45,115,1,29,3,26,39,35,1,3,0,3
E33046456,260,176,48,128,3,42,2,40,36,34,1,1,0,3
E33046457,261,175,44,131,2,28,2,26,54,45,1,7,1,2
E33046458,221,164,51,113,4,22,5,17,27,23,1,3,0,4
E33046459,242,152,48,104,2,35,6,29,50,48,0,2,0,3
E33046460,505,332,106,226,7,60,6,54,97,91,1,5,0,9
E33046461,2313,1812,557,1255,33,129,18,111,321,294,4,19,4,18
E33046462,2899,2143,643,1500,30,209,26,183,487,443,9,29,6,30
E33046463,461,334,111,223,6,48,6,42,67,59,3,4,1,6
E33046464,450,314,90,224,7,35,4,31,85,76,1,8,0,9
E33046465,213,126,61,65,2,8,0,8,74,55,19,0,0,3
E33046466,342,256,111,145,6,33,7,26,42,36,1,5,0,5
E33046467,501,308,115,193,5,81,10,71,98,90,4,4,0,9
E33046468,496,340,97,243,6,42,15,27,103,94,1,7,1,5
E33046469,779,469,141,328,4,96,35,61,204,185,5,12,2,6
E33046470,252,156,59,97,3,36,13,23,56,50,1,2,3,1
E33046471,486,300,96,204,4,49,15,34,128,114,2,10,2,5
E33046472,203,133,31,102,0,29,14,15,38,34,1,2,1,3
E33046473,514,315,86,229,4,64,18,46,125,112,3,7,3,6
E33046474,214,139,63,76,2,29,12,17,44,40,0,2,2,0
E33046475,350,198,67,131,4,49,20,29,88,79,3,5,1,11
E33046476,210,150,54,96,3,17,6,11,40,34,1,5,0,0
E33046477,311,186,50,136,2,32,6,26,87,69,4,13,1,4
E33046478,250,158,50,108,3,34,11,23,54,47,0,6,1,1
E33046479,280,152,48,104,6,38,14,24,81,77,0,3,1,3
E33046480,279,196,52,144,2,21,9,12,60,53,2,5,0,0
E33046481,451,309,75,234,2,33,17,16,106,92,1,12,1,1
E33046482,468,249,47,202,10,40,20,20,160,151,0,8,1,9
E33046483,227,148,44,104,3,15,7,8,61,56,2,3,0,0
E33046484,624,392,137,255,6,65,34,31,158,146,1,10,1,3
E33046485,222,120,26,94,5,19,14,5,75,70,2,2,1,3
E33046486,655,509,112,397,6,19,9,10,120,112,0,6,2,1
E33046487,493,292,72,220,4,27,18,9,167,158,0,9,0,3
E33046488,286,204,46,158,4,14,8,6,60,58,0,2,0,4
E33046489,374,209,69,140,3,27,12,15,131,125,0,4,2,4
E33046490,458,350,104,246,3,11,5,6,92,88,0,4,0,2
E33046491,333,190,63,127,3,30,12,18,108,102,0,5,1,2
E33046492,243,182,47,135,2,11,4,7,43,41,0,1,1,5
E33046493,650,338,89,249,3,61,36,25,244,226,3,12,3,4
E33046494,522,340,109,231,4,24,11,13,152,141,0,11,0,2
E33046495,817,545,130,415,11,26,10,16,228,220,1,7,0,7
E33046496,740,532,136,396,9,72,35,37,125,119,1,5,0,2
E33046497,328,191,48,143,2,10,6,4,124,121,2,1,0,1
E33046498,1314,984,200,784,11,35,17,18,275,255,0,16,4,9
E33046499,406,284,68,216,3,27,15,12,92,86,1,5,0,0
E33046500,230,130,35,95,0,14,8,6,82,77,1,3,1,4
E33046501,390,212,56,156,2,32,17,15,142,133,0,6,3,2
E33046502,269,181,67,114,2,13,5,8,73,70,0,2,1,0
E33046503,384,224,69,155,2,12,6,6,145,136,2,4,3,1
E33046504,230,143,35,108,4,15,10,5,66,58,0,7,1,2
E33046505,488,345,70,275,4,19,10,9,116,107,2,6,1,4
E33046506,269,180,47,133,2,13,7,6,74,71,0,3,0,0
E33046507,208,123,38,85,1,6,5,1,78,76,0,2,0,0
E33046508,336,185,49,136,5,40,24,16,103,97,3,3,0,3
E33046509,467,306,99,207,8,22,12,10,125,120,0,5,0,6
E33046510,264,213,59,154,0,14,6,8,34,29,1,4,0,3
E33046511,458,326,81,245,3,26,13,13,101,91,0,10,0,2
E33046512,1142,834,234,600,10,95,50,45,176,160,2,7,7,27
E33046513,252,162,45,117,1,15,9,6,72,71,0,0,1,2
E33046514,287,144,28,116,1,22,8,14,119,115,0,4,0,1
E33046515,539,245,65,180,4,109,67,42,177,170,1,3,3,4
E33046516,230,121,34,87,2,21,10,11,86,79,0,7,0,0
E33046517,675,418,119,299,11,89,51,38,150,140,0,8,2,7
E33046518,551,347,98,249,9,82,43,39,111,105,0,6,0,2
E33046519,348,202,61,141,1,43,20,23,102,94,3,5,0,0
E33046520,316,229,60,169,2,31,14,17,52,48,1,3,0,2
E33046521,597,376,119,257,16,56,8,48,130,124,1,4,1,19
E33046522,205,129,45,84,6,23,2,21,40,31,7,2,0,7
E33046523,321,253,74,179,3,29,5,24,35,32,0,3,0,1
E33046524,1000,717,212,505,13,45,21,24,198,176,6,13,3,27
E33046525,428,338,85,253,4,29,5,24,56,51,1,3,1,1
E33046526,586,442,133,309,10,48,6,42,78,61,5,9,3,8
E33046527,629,496,130,366,7,26,7,19,98,90,1,7,0,2
E33046528,489,311,108,203,3,66,7,59,105,94,3,8,0,4
E33046529,233,168,46,122,3,19,1,18,41,38,0,3,0,2
E33046530,519,320,87,233,6,74,14,60,116,95,9,8,4,3
E33046531,389,261,92,169,4,51,6,45,62,57,1,4,0,11
E33046532,262,184,47,137,2,19,8,11,54,46,5,2,1,3
E33046533,323,206,58,148,6,35,8,27,73,61,4,6,2,3
E33046534,203,134,25,109,1,15,6,9,46,43,1,2,0,7
E33046535,991,721,262,459,11,77,12,65,176,148,16,5,7,6
E33046536,255,174,48,126,6,22,5,17,47,42,4,1,0,6
E33046537,681,477,123,354,16,73,9,64,112,101,1,8,2,3
E33046538,636,418,131,287,16,71,10,61,118,96,14,6,2,13
E33046539,230,152,65,87,5,27,5,22,43,32,3,6,2,3
E33046540,1015,805,267,538,7,88,20,68,110,96,0,12,2,5
E33046541,236,182,66,116,5,12,3,9,36,33,0,3,0,1
E33046542,247,198,83,115,0,24,2,22,24,23,0,1,0,1
E33046543,502,378,128,250,0,62,5,57,61,55,0,6,0,1
E33046544,252,187,64,123,0,27,8,19,37,34,1,1,1,1
E33046545,381,332,112,220,4,11,2,9,32,28,0,4,0,2
E33046546,721,579,162,417,2,49,13,36,90,86,0,3,1,1
E33046547,1108,812,234,578,14,99,23,76,177,155,2,17,3,6
E33046548,2685,2014,447,1567,36,147,74,73,473,419,6,44,4,15
E33046549,2164,1772,481,1291,11,46,23,23,329,312,3,14,0,6
E33046550,231,151,29,122,3,24,13,11,52,45,0,6,1,1
E33046551,314,234,46,188,5,16,9,7,56,46,0,10,0,3
E33046552,571,417,122,295,7,40,23,17,104,96,1,6,1,3
E33046553,609,460,137,323,4,69,36,33,74,68,0,3,3,2
E33046554,361,284,77,207,4,26,13,13,47,41,1,4,1,0
E33046555,222,158,53,105,4,22,8,14,38,37,0,1,0,0
E33046556,219,176,53,123,0,16,8,8,25,23,0,1,1,2
E33046557,1459,1021,262,759,8,106,52,54,319,285,5,26,3,5
E33046558,943,698,215,483,5,89,44,45,148,136,3,6,3,3
E33046559,663,555,163,392,5,30,15,15,67,58,1,7,1,6
E33046560,379,266,64,202,3,31,14,17,79,72,1,6,0,0
E33046561,647,483,118,365,6,45,26,19,109,95,2,7,5,4
E33046562,599,415,105,310,5,69,36,33,108,103,2,2,1,2
E33046563,357,254,63,191,1,37,21,16,61,57,1,3,0,4
E33046564,283,180,43,137,2,37,16,21,62,56,1,5,0,2
E33046565,382,303,103,200,3,30,13,17,46,41,0,5,0,0
E33046566,319,230,61,169,4,37,19,18,47,43,0,4,0,1
E33046567,419,309,71,238,3,39,21,18,66,58,0,7,1,2
E33046568,337,217,64,153,3,57,32,25,58,55,0,3,0,2
E33046569,323,254,58,196,2,26,12,14,40,32,0,8,0,1
E33046570,350,212,60,152,7,39,24,15,92,84,3,4,1,0
E33046571,562,416,123,293,8,48,22,26,90,81,0,9,0,0
E33046572,276,206,53,153,3,17,10,7,48,48,0,0,0,2
E33046573,854,722,117,605,9,19,11,8,99,91,2,6,0,5
E33046574,365,236,54,182,5,47,24,23,76,66,3,6,1,1
E33046575,322,246,55,191,4,8,4,4,64,59,0,3,2,0
E33046576,482,373,82,291,6,31,16,15,68,61,2,4,1,4
E33046577,639,517,95,422,5,45,18,27,71,64,1,5,1,1
E33046578,831,627,140,487,12,64,32,32,124,106,3,14,1,4
E33046579,740,609,186,423,5,37,18,19,86,76,1,7,2,3
E33046580,333,216,67,149,4,28,11,17,84,77,2,5,0,1
E33046581,339,251,75,176,5,21,13,8,62,58,0,2,2,0
E33046582,200,125,35,90,0,21,11,10,52,50,0,2,0,2
E33046583,1645,1372,412,960,17,66,33,33,182,158,4,16,4,8
E33046584,222,160,49,111,2,21,9,12,30,26,3,0,1,9
E33046585,253,176,41,135,1,12,7,5,62,56,2,3,1,2
E33046586,204,122,29,93,2,15,4,11,63,58,0,5,0,2
E33046587,288,210,54,156,2,19,10,9,55,51,2,2,0,2
E33046588,295,183,37,146,2,36,12,24,72,68,0,2,2,2
E33046589,588,359,111,248,4,82,38,44,141,124,2,14,1,2
E33046590,232,172,56,116,4,2,2,0,49,35,11,2,1,5
E33046591,233,144,50,94,2,36,19,17,50,45,0,5,0,1
E33046592,284,205,54,151,4,26,15,11,46,45,0,1,0,3
E33046593,212,172,47,125,0,6,4,2,32,29,1,2,0,2
E33046594,199,142,44,98,2,20,8,12,35,34,0,1,0,0
E33046595,234,185,68,117,2,16,9,7,30,29,0,1,0,1
E33046596,321,203,51,152,4,35,21,14,77,70,2,4,1,2
E33046597,358,293,59,234,3,9,6,3,52,48,2,2,0,1
E33046598,796,632,168,464,3,38,17,21,118,115,1,1,1,5
E33046599,365,301,89,212,5,22,9,13,36,33,1,2,0,1
E33046600,479,342,94,248,4,37,12,25,96,91,0,5,0,0
E33046601,295,247,68,179,0,11,3,8,35,30,1,3,1,2
E33046602,1126,892,199,693,7,45,20,25,178,169,0,9,0,4
E33046603,676,514,155,359,7,57,28,29,95,86,1,7,1,3
E33046604,730,577,186,391,5,47,35,12,99,97,1,1,0,2
E33046605,241,160,38,122,2,24,15,9,53,52,0,1,0,2
E33046606,247,177,71,106,1,32,18,14,35,30,1,4,0,2
E33046607,248,174,45,129,0,25,17,8,44,42,0,2,0,5
E33046608,280,225,68,157,3,19,12,7,33,30,2,1,0,0
E33046609,237,174,39,135,2,15,8,7,45,40,0,4,1,1
E33046610,248,176,59,117,0,26,16,10,46,43,0,3,0,0
E33046611,204,140,40,100,1,22,16,6,39,35,0,3,1,2
E33046612,256,174,41,133,4,25,18,7,53,52,0,1,0,0
E33046613,427,330,94,236,5,38,20,18,48,43,1,4,0,6
E33046614,345,262,97,165,0,36,23,13,46,42,1,2,1,1
E33046615,454,333,93,240,6,38,24,14,75,67,1,7,0,2
E33046616,270,216,76,140,3,14,11,3,36,33,2,1,0,1
E33046617,483,352,116,236,9,67,51,16,54,50,1,3,0,1
E33046618,304,176,52,124,1,50,36,14,77,72,2,3,0,0
E33046619,207,159,54,105,1,19,14,5,26,25,0,1,0,2
E33046620,452,302,110,192,8,78,63,15,61,57,1,3,0,3
E33046621,221,170,62,108,3,17,13,4,28,25,1,1,1,3
E33046622,393,280,89,191,4,38,30,8,64,54,10,0,0,7
E33046623,208,139,40,99,1,26,15,11,40,36,2,2,0,2
E33046624,655,417,103,314,9,77,39,38,147,130,2,14,1,5
E33046625,267,203,75,128,4,17,12,5,41,39,1,1,0,2
E33046626,760,550,192,358,5,86,57,29,112,99,6,6,1,7
E33046627,580,352,122,230,4,87,38,49,130,79,24,5,22,7
E33046628,453,321,79,242,2,46,29,17,81,70,1,10,0,3
E33046629,2346,1606,374,1232,18,176,114,62,538,524,1,13,0,8
E33046630,1042,685,166,519,12,122,78,44,220,210,0,9,1,3
E33046631,1708,1261,361,900,16,131,88,43,296,284,3,9,0,4
E33046632,566,453,119,334,3,20,17,3,84,77,0,5,2,6
E33046633,110,92,28,64,1,4,1,3,12,11,0,1,0,1
E33046634,853,610,162,448,11,78,32,46,150,141,0,7,2,4
E33046635,334,239,55,184,3,38,20,18,51,46,1,4,0,3
E33046636,671,386,91,295,5,50,35,15,222,212,2,7,1,8
E33046637,965,707,156,551,14,80,34,46,162,151,1,9,1,2
E33046638,1694,1403,380,1023,7,98,42,56,181,168,1,12,0,5
E33046639,527,410,119,291,2,34,17,17,76,72,0,4,0,5
E33046640,417,318,77,241,3,17,7,10,76,64,0,10,2,3
E33046641,684,573,178,395,4,24,10,14,81,79,0,2,0,2
E33046642,1529,1207,276,931,13,40,14,26,260,241,1,18,0,9
E33046643,230,158,56,102,0,24,6,18,46,43,0,2,1,2
E33046644,2300,1656,388,1268,28,171,70,101,433,406,1,26,0,12
E33046645,947,707,126,581,10,39,22,17,189,183,1,5,0,2
E33046646,767,643,144,499,1,18,8,10,101,89,4,8,0,4
E33046647,870,387,107,280,5,70,16,54,407,111,186,2,108,1
E33046648,851,573,156,417,9,100,34,66,165,159,0,4,2,4
E33046649,1360,1057,273,784,19,86,28,58,192,177,1,14,0,6
E33046650,325,234,77,157,1,24,11,13,63,56,0,6,1,3
E33046651,740,537,110,427,11,33,8,25,154,146,4,4,0,5
E33046652,297,201,42,159,4,28,8,20,64,57,1,5,1,0
E33046653,1320,970,262,708,19,101,32,69,227,208,1,17,1,3
E33046654,355,286,70,216,3,13,4,9,52,46,2,4,0,1
E33046655,261,187,41,146,6,16,6,10,51,47,1,3,0,1
E33046656,224,121,34,87,2,31,10,21,70,67,1,2,0,0
E33046657,910,680,148,532,14,45,16,29,164,156,1,7,0,7
E33046658,334,252,60,192,4,24,10,14,52,49,0,3,0,2
E33046659,876,627,189,438,16,93,20,73,138,123,5,10,0,2
E33046660,292,195,61,134,4,34,10,24,52,40,9,3,0,7
E33046661,527,343,96,247,10,70,12,58,101,93,0,3,5,3
E33046662,274,201,50,151,3,25,4,21,42,34,5,2,1,3
E33046663,500,370,115,255,4,37,6,31,87,78,1,5,3,2
E33046664,250,182,62,120,3,19,4,15,45,38,1,6,0,1
E33046665,552,349,109,240,6,67,30,37,124,110,3,10,1,6
E33046666,241,187,65,122,2,27,6,21,25,23,0,2,0,0
E33046667,404,301,103,198,5,37,16,21,61,54,1,5,1,0
E33046668,420,278,84,194,2,53,22,31,87,81,1,5,0,0
E33046669,446,282,84,198,5,58,18,40,100,86,0,13,1,1
E33046670,295,237,68,169,2,29,9,20,27,24,0,3,0,0
E33046671,255,204,59,145,2,16,6,10,31,25,2,4,0,2
E33046672,444,325,127,198,1,31,10,21,83,77,0,5,1,4
E33046673,237,166,52,114,4,15,4,11,50,45,0,5,0,2
E33046674,340,251,82,169,4,25,3,22,53,49,0,4,0,7
E33046675,524,342,111,231,12,56,17,39,112,106,0,5,1,2
E33046676,433,316,118,198,9,41,7,34,66,59,3,4,0,1
E33046677,211,139,45,94,2,15,2,13,54,52,0,2,0,1
E33046678,386,267,118,149,10,32,7,25,76,73,1,2,0,1
E33046679,209,141,43,98,2,12,1,11,53,48,1,2,2,1
E33046680,315,234,78,156,1,19,6,13,48,41,3,3,1,13
E33046681,817,535,147,388,15,69,13,56,189,172,4,10,3,9
E33046682,644,500,136,364,16,42,7,35,82,79,2,1,0,4
E33046683,1931,1438,404,1034,21,117,39,78,340,324,2,13,1,15
E33046684,344,237,72,165,7,31,10,21,65,58,1,6,0,4
E33046685,369,265,88,177,2,26,7,19,73,67,0,2,4,3
E33046686,558,379,125,254,4,48,14,34,118,104,0,11,3,9
E33046687,218,164,47,117,1,21,3,18,25,23,1,1,0,7
E33046688,226,169,59,110,4,14,2,12,38,29,6,2,1,1
E33046689,304,238,63,175,3,16,6,10,45,41,0,4,0,2
E33046690,432,355,109,246,6,20,4,16,49,43,1,5,0,2
E33046691,234,189,70,119,2,10,7,3,31,26,0,4,1,2
E33046692,373,300,77,223,3,13,4,9,55,49,0,6,0,2
E33046693,325,233,75,158,0,35,19,16,53,46,0,6,1,4
E33046694,2057,1415,336,1079,9,158,80,78,471,439,2,25,5,4
E33046695,202,118,22,96,2,20,10,10,58,54,0,4,0,4
E33046696,592,448,138,310,1,47,24,23,91,81,1,8,1,5
E33046697,331,243,55,188,0,34,22,12,52,48,1,2,1,2
E33046698,428,311,104,207,2,40,23,17,73,68,1,4,0,2
E33046699,727,457,141,316,4,94,55,39,170,158,1,10,1,2
E33046700,470,328,73,255,2,55,34,21,80,73,0,5,2,5
E33046701,281,230,50,180,2,9,3,6,40,40,0,0,0,0
E33046702,233,183,60,123,0,13,7,6,35,31,1,3,0,2
E33046703,296,193,60,133,6,34,23,11,59,54,0,5,0,4
E33046704,232,163,61,102,1,26,15,11,41,41,0,0,0,1
E33046705,771,563,137,426,4,87,43,44,114,99,1,13,1,3
E33046706,213,168,54,114,1,17,9,8,26,19,3,3,1,1
E33046707,353,284,78,206,2,11,7,4,55,47,0,7,1,1
E33046708,267,219,42,177,1,11,1,10,36,33,0,3,0,0
E33046709,227,138,53,85,0,36,22,14,51,43,1,7,0,2
E33046710,372,220,46,174,3,65,46,19,81,73,0,8,0,3
E33046711,366,222,54,168,2,62,35,27,79,72,0,5,2,1
E33046712,354,252,65,187,2,32,16,16,65,63,0,1,1,3
E33046713,309,225,67,158,1,30,15,15,51,44,0,6,1,2
E33046714,242,164,40,124,7,15,8,7,53,44,2,7,0,3
E33046715,1131,933,248,685,8,61,31,30,125,114,0,10,1,4
E33046716,251,180,68,112,2,16,5,11,47,36,1,8,2,6
E33046717,211,162,71,91,1,9,3,6,35,34,1,0,0,4
E33046718,456,320,106,214,4,42,24,18,88,76,0,10,2,2
E33046719,293,227,70,157,5,20,14,6,38,33,3,2,0,3
E33046720,253,203,76,127,0,19,8,11,30,29,0,1,0,1
E33046721,520,401,118,283,1,25,14,11,86,79,2,5,0,7
E33046722,469,316,80,236,7,63,39,24,81,77,0,3,1,2
E33046723,754,502,169,333,7,76,40,36,167,147,11,8,1,2
E33046724,686,373,101,272,8,49,17,32,253,246,1,6,0,3
E33046725,814,535,137,398,7,72,33,39,194,177,2,14,1,6
E33046726,377,273,97,176,3,28,17,11,71,63,2,4,2,2
E33046727,436,355,95,260,4,17,7,10,59,47,4,3,5,1
E33046728,562,408,114,294,10,76,30,46,65,57,3,4,1,3
E33046729,533,378,99,279,3,60,16,44,89,80,2,7,0,3
E33046730,1587,1085,274,811,20,175,56,119,297,263,9,23,2,10
E33046731,246,172,59,113,4,28,11,17,41,40,0,1,0,1
E33046732,382,287,89,198,5,37,9,28,49,40,6,3,0,4
E33046733,914,666,226,440,4,102,30,72,133,121,0,10,2,9
E33046734,499,336,100,236,4,51,12,39,105,94,1,10,0,3
E33046735,233,174,55,119,1,22,2,20,35,34,0,1,0,1
E33046736,261,191,62,129,3,18,5,13,47,43,1,2,1,2
E33046737,349,234,96,138,5,28,12,16,78,71,0,6,1,4
E33046738,1082,679,220,459,14,143,56,87,240,219,2,16,3,6
E33046739,217,162,51,111,2,13,4,9,35,31,2,2,0,5
E33046740,2190,1621,427,1194,17,132,41,91,409,354,26,20,9,11
E33046741,241,166,42,124,3,19,12,7,48,34,4,10,0,5
E33046742,406,319,95,224,7,17,5,12,58,51,0,7,0,5
E33046743,209,157,52,105,2,18,6,12,32,25,4,2,1,0
E33046744,325,230,77,153,1,45,14,31,46,42,2,1,1,3
E33046745,246,174,60,114,3,25,6,19,39,35,1,3,0,5
E33046746,231,190,59,131,2,15,2,13,24,22,0,1,1,0
E33046747,674,413,94,319,14,108,34,74,133,124,2,6,1,6
E33046748,306,202,57,145,3,42,12,30,55,43,6,6,0,4
E33046749,228,115,33,82,5,59,26,33,45,41,1,3,0,4
E33046750,290,185,44,141,0,44,15,29,61,57,0,4,0,0
E33046751,242,148,26,122,4,42,13,29,48,42,1,3,2,0
E33046752,259,158,35,123,0,35,9,26,63,61,0,1,1,3
E33046753,385,273,84,189,1,53,22,31,53,51,1,1,0,5
E33046754,222,158,35,123,1,21,5,16,38,32,0,5,1,4
E33046755,210,112,17,95,1,19,3,16,70,62,5,3,0,8
E33046756,324,204,43,161,4,46,21,25,66,59,2,3,2,4
E33046757,283,218,74,144,3,21,7,14,39,29,3,4,3,2
E33046758,920,688,186,502,11,79,32,47,138,122,3,13,0,4
E33046759,869,715,196,519,12,51,17,34,86,78,0,7,1,5
E33046760,1081,852,216,636,13,56,20,36,152,111,23,11,7,8
E33046761,888,676,170,506,2,87,25,62,118,103,2,9,4,5
E33046762,337,252,65,187,0,29,11,18,51,37,0,9,5,5
E33046763,4367,3679,931,2748,29,152,52,100,488,430,20,32,6,19
E33046764,731,547,149,398,7,57,16,41,116,103,3,9,1,4
E33046765,262,186,63,123,0,28,18,10,43,38,2,3,0,5
E33046766,283,169,49,120,1,36,29,7,77,73,0,4,0,0
E33046767,255,189,49,140,0,9,4,5,56,49,1,6,0,1
E33046768,201,142,36,106,0,14,8,6,42,33,7,2,0,3
E33046769,505,364,114,250,4,61,42,19,72,64,2,6,0,4
E33046770,568,437,119,318,3,39,25,14,88,77,3,6,2,1
E33046771,1173,928,245,683,3,72,34,38,165,150,2,9,4,5
E33046772,238,157,44,113,1,31,21,10,38,33,2,2,1,11
E33046773,270,202,53,149,2,13,7,6,51,46,0,3,2,2
E33046774,363,261,75,186,5,19,10,9,75,69,1,5,0,3
E33046775,280,187,46,141,1,38,24,14,52,47,1,4,0,2
E33046776,548,330,93,237,4,67,47,20,141,133,0,8,0,6
E33046777,445,318,100,218,3,69,47,22,54,51,0,2,1,1
E33046778,863,637,185,452,5,81,47,34,134,116,2,14,2,6
E33046779,390,230,67,163,2,67,43,24,85,81,0,4,0,6
E33046780,761,565,141,424,5,39,16,23,147,131,1,14,1,5
E33046781,917,529,161,368,8,209,153,56,167,152,2,13,0,4
E33046782,290,192,52,140,2,35,23,12,59,54,2,3,0,2
E33046783,505,274,86,188,4,105,65,40,120,115,0,5,0,2
E33046784,694,514,151,363,6,31,19,12,139,122,4,13,0,4
E33046785,4388,3203,857,2346,30,300,184,116,832,754,20,42,16,23
E33046786,512,381,129,252,0,44,31,13,86,78,2,5,1,1
E33046787,869,623,190,433,4,46,26,20,193,181,0,10,2,3
E33046788,2923,2380,672,1708,22,115,53,62,386,343,1,41,1,20
E33046789,748,592,169,423,6,61,28,33,85,80,0,5,0,4
E33046790,554,408,99,309,4,60,40,20,76,72,0,3,1,6
E33046791,1139,744,178,566,7,161,118,43,217,200,0,16,1,10
E33046792,248,165,68,97,0,24,6,18,47,36,7,3,1,12
E33046793,348,206,66,140,3,39,2,37,94,86,0,7,1,6
E33046794,315,215,71,144,0,36,2,34,59,51,2,6,0,5
E33046795,1234,1063,297,766,6,29,15,14,124,104,4,16,0,12
E33046796,989,659,194,465,17,149,15,134,155,133,18,3,1,9
E33046797,583,414,156,258,10,76,11,65,75,59,4,6,6,8
E33046798,299,207,68,139,5,36,5,31,49,43,2,4,0,2
E33046799,229,156,44,112,4,36,6,30,33,26,2,3,2,0
E33046800,354,225,61,164,10,61,7,54,58,46,8,4,0,0
E33046801,464,290,82,208,8,93,10,83,67,57,1,5,4,6
E33046802,947,582,170,412,11,173,29,144,166,145,6,11,4,15
E33046803,274,177,65,112,0,32,7,25,61,51,3,5,2,4
E33046804,169,114,33,81,3,25,4,21,24,22,1,0,1,3
E33046805,786,466,106,360,5,97,30,67,214,107,60,5,42,4
E33046806,738,491,144,347,15,70,19,51,155,143,2,8,2,7
E33046807,1165,912,217,695,10,55,9,46,182,131,35,6,10,6
E33046808,736,460,126,334,8,122,11,111,141,127,4,3,7,5
E33046809,472,359,108,251,3,34,4,30,70,66,1,2,1,6
E33046810,251,190,54,136,2,25,5,20,30,27,1,1,1,4
E33046811,318,244,68,176,3,19,1,18,49,46,0,2,1,3
E33046812,528,362,100,262,4,42,2,40,116,96,6,9,5,4
E33046813,265,198,57,141,3,27,5,22,36,29,1,5,1,1
E33046814,1029,756,193,563,12,96,23,73,160,151,2,7,0,5
E33046815,655,495,99,396,5,39,10,29,114,107,1,4,2,2
E33046816,422,318,81,237,2,36,2,34,65,58,2,4,1,1
E33046817,1198,936,212,724,6,88,11,77,163,147,4,11,1,5
E33046818,248,189,50,139,3,15,1,14,37,32,2,2,1,4
E33046819,701,507,162,345,11,74,46,28,99,84,3,12,0,10
E33046820,226,161,57,104,3,26,5,21,33,30,1,0,2,3
E33046821,738,429,125,304,5,123,23,100,180,171,1,7,1,1
E33046822,734,503,175,328,8,76,6,70,140,114,13,10,3,7
E33046823,312,228,83,145,3,40,7,33,35,29,1,2,3,6
E33046824,237,171,42,129,0,13,2,11,50,44,0,2,4,3
E33046825,1212,880,196,684,9,79,17,62,242,121,80,6,35,2
E33046826,349,233,73,160,4,50,15,35,56,45,4,5,2,6
E33046827,774,561,128,433,8,58,39,19,141,133,1,4,3,6
E33046828,289,230,59,171,2,12,6,6,42,39,2,1,0,3
E33046829,362,269,62,207,7,35,10,25,49,37,2,9,1,2
E33046830,512,355,92,263,1,66,11,55,85,72,3,6,4,5
E33046831,243,163,51,112,5,24,6,18,47,39,2,3,3,4
E33046832,279,159,58,101,5,42,25,17,70,50,8,2,10,3
E33046833,390,236,70,166,5,75,41,34,66,47,8,3,8,8
E33046834,522,322,104,218,4,45,26,19,134,110,12,6,6,17
E33046835,3171,2145,624,1521,45,283,159,124,671,466,116,30,59,27
E33046836,361,237,93,144,6,51,32,19,66,61,2,3,0,1
E33046837,325,243,79,164,2,28,18,10,51,50,1,0,0,1
E33046838,417,268,75,193,5,67,38,29,75,66,2,6,1,2
E33046839,446,284,90,194,8,51,25,26,97,84,2,8,3,6
E33046840,473,326,89,237,3,79,54,25,65,56,2,4,3,0
E33046841,276,187,68,119,8,37,26,11,44,39,2,2,1,0
E33046842,537,255,81,174,3,89,65,24,185,172,7,4,2,5
E33046843,229,157,58,99,3,21,11,10,42,34,2,0,6,6
E33046844,471,249,83,166,1,85,56,29,132,116,5,10,1,4
E33046845,522,337,100,237,4,70,38,32,106,95,1,3,7,5
E33046846,500,317,82,235,10,48,26,22,121,108,6,6,1,4
E33046847,263,179,53,126,3,23,13,10,52,43,3,5,1,6
E33046848,339,186,57,129,5,71,45,26,71,57,7,4,3,6
E33046849,478,271,89,182,4,90,52,38,110,91,11,3,5,3
E33046850,363,207,48,159,5,61,29,32,86,70,4,5,7,4
E33046851,263,193,58,135,2,13,9,4,54,46,1,6,1,1
E33046852,360,245,74,171,2,31,17,14,78,66,7,4,1,4
E33046853,209,151,49,102,0,9,7,2,46,41,0,4,1,3
E33046854,253,161,52,109,0,29,17,12,60,57,0,2,1,3
E33046855,1036,734,161,573,19,59,28,31,212,182,6,14,10,12
E33046856,284,159,37,122,4,49,31,18,68,60,4,3,1,4
E33046857,421,220,65,155,5,57,28,29,128,109,10,4,5,11
E33046858,492,300,86,214,7,79,43,36,106,89,3,12,2,0
E33046859,516,312,91,221,3,61,38,23,132,110,7,8,7,8
E33046860,258,196,70,126,0,13,11,2,28,23,2,3,0,21
E33046861,204,136,51,85,2,22,10,12,36,28,2,5,1,8
E33046862,566,341,107,234,5,105,65,40,107,104,0,2,1,8
E33046863,271,164,46,118,3,29,19,10,75,59,2,12,2,0
E33046864,427,236,61,175,6,93,58,35,86,73,3,7,3,6
E33046865,213,152,47,105,3,18,10,8,40,27,7,4,2,0
E33046866,203,124,30,94,2,15,12,3,58,46,4,5,3,4
E33046867,264,154,46,108,1,39,29,10,65,53,5,6,1,5
E33046868,227,154,53,101,3,13,8,5,52,46,1,2,3,5
E33046869,270,188,58,130,3,18,14,4,58,48,2,1,7,3
E33046870,215,129,34,95,6,27,16,11,53,37,7,7,2,0
E33046871,355,225,64,161,8,36,18,18,84,71,6,4,3,2
E33046872,781,558,155,403,3,101,53,48,110,95,7,4,4,9
E33046873,449,313,86,227,1,53,20,33,78,51,11,2,14,4
E33046874,1113,705,177,528,9,94,15,79,300,278,2,17,3,5
E33046875,789,582,115,467,3,48,5,43,153,139,1,11,2,3
E33046876,607,401,68,333,10,45,5,40,147,130,6,8,3,4
E33046877,348,235,55,180,2,22,6,16,88,82,1,5,0,1
E33046878,460,340,106,234,3,48,9,39,67,61,0,6,0,2
E33046879,612,442,129,313,5,77,11,66,87,76,2,7,2,1
E33046880,406,298,74,224,1,35,4,31,68,62,0,6,0,4
E33046881,287,215,66,149,1,32,2,30,38,35,0,3,0,1
E33046882,246,175,37,138,0,31,9,22,36,33,0,1,2,4
E33046883,667,506,134,372,2,63,9,54,90,79,3,6,2,6
E33046884,203,138,44,94,0,25,3,22,38,35,1,2,0,2
E33046885,258,204,68,136,0,13,0,13,41,32,0,7,2,0
E33046886,239,154,52,102,2,28,5,23,53,47,2,3,1,2
E33046887,923,765,223,542,1,53,3,50,100,93,2,4,1,4
E33046888,294,246,53,193,4,13,2,11,30,29,1,0,0,1
E33046889,709,554,118,436,2,52,2,50,101,97,0,4,0,0
E33046890,316,240,68,172,1,27,3,24,46,39,4,3,0,2
E33046891,445,347,98,249,1,31,3,28,64,55,1,7,1,2
E33046892,277,128,58,70,1,20,5,15,98,71,24,0,3,30
E33046893,339,263,48,215,1,8,1,7,64,58,2,3,1,3
E33046894,735,557,129,428,5,60,7,53,109,100,1,6,2,4
E33046895,384,272,86,186,4,24,5,19,83,59,13,1,10,1
E33046896,535,351,111,240,1,57,10,47,112,89,11,6,6,14
E33046897,500,390,139,251,4,28,12,16,70,64,0,6,0,8
E33046898,1127,758,234,524,18,112,75,37,202,177,4,21,0,37
E33046899,289,211,66,145,6,25,13,12,46,45,0,1,0,1
E33046900,299,229,81,148,2,17,10,7,48,45,1,2,0,3
E33046901,387,280,104,176,3,38,11,27,60,58,0,2,0,6
E33046902,874,624,160,464,12,87,46,41,144,127,3,12,2,7
E33046903,1110,720,218,502,7,112,58,54,268,254,1,13,0,3
E33046904,3292,2375,490,1885,25,204,65,139,669,350,198,28,93,19
E33046905,761,483,175,308,4,102,9,93,160,130,7,19,4,12
E33046906,228,135,51,84,4,23,5,18,63,56,0,6,1,3
E33046907,1167,674,175,499,13,133,35,98,341,137,120,7,77,6
E33046908,206,127,40,87,0,24,3,21,51,46,0,4,1,4
E33046909,367,218,81,137,4,34,6,28,71,53,14,4,0,40
E33046910,226,131,32,99,1,30,3,27,58,50,4,3,1,6
E33046911,265,189,46,143,7,25,11,14,44,40,0,3,1,0
E33046912,348,247,59,188,3,29,13,16,68,64,0,3,1,1
E33046913,369,277,61,216,8,20,6,14,64,56,1,6,1,0
E33046914,387,284,67,217,3,34,20,14,62,59,1,1,1,4
E33046915,555,393,115,278,7,68,11,57,85,81,1,2,1,2
E33046916,365,264,49,215,10,43,4,39,46,45,0,1,0,2
E33046917,212,155,50,105,5,28,10,18,22,22,0,0,0,2
E33046918,471,330,94,236,6,75,10,65,56,47,1,5,3,4
E33046919,1430,874,218,656,22,245,34,211,283,264,3,13,3,6
E33046920,415,286,78,208,1,55,9,46,71,65,3,2,1,2
E33046921,1483,1211,339,872,13,81,13,68,163,147,5,9,2,15
E33046922,273,213,56,157,2,21,2,19,37,34,0,3,0,0
E33046923,974,643,173,470,5,139,18,121,181,150,9,20,2,6
E33046924,234,144,43,101,2,35,5,30,48,41,1,6,0,5
E33046925,211,129,35,94,1,36,4,32,44,41,0,3,0,1
E33046926,265,204,43,161,1,26,5,21,33,30,0,2,1,1
E33046927,274,200,60,140,0,25,2,23,47,42,1,2,2,2
E33046928,718,472,138,334,6,64,36,28,170,155,4,6,5,6
E33046929,478,298,80,218,5,72,37,35,103,80,14,1,8,0
E33046930,353,178,44,134,8,64,22,42,103,87,12,2,2,0
E33046931,1989,1483,349,1134,25,107,53,54,365,239,70,14,42,9
E33046932,275,182,54,128,1,36,9,27,56,50,5,1,0,0
E33046933,377,272,67,205,1,22,1,21,81,76,0,4,1,1
E33046934,580,225,42,183,5,52,13,39,296,63,130,3,100,2
E33046935,1077,585,144,441,10,134,61,73,342,117,115,3,107,6
E33046936,607,234,38,196,4,88,35,53,278,72,124,3,79,3
E33046937,898,398,63,335,9,88,26,62,401,108,195,6,92,2
E33046938,1359,622,122,500,12,141,47,94,582,136,261,6,179,2
E33046939,350,160,42,118,5,60,14,46,125,44,54,0,27,0
E33046940,1067,406,91,315,8,138,35,103,509,120,240,4,145,6
E33046941,668,272,57,215,8,63,23,40,321,74,150,3,94,4
E33046942,466,193,38,155,2,61,18,43,208,54,108,2,44,2
E33046943,222,174,37,137,0,17,2,15,31,26,0,5,0,0
E33046944,440,266,55,211,4,103,8,95,64,53,3,3,5,3
E33046945,303,219,54,165,4,35,2,33,44,35,4,4,1,1
E33046946,237,164,38,126,1,26,1,25,45,39,2,3,1,1
E33046947,466,282,83,199,6,88,61,27,86,82,0,4,0,4
E33046948,1033,742,140,602,20,86,52,34,181,165,3,10,3,4
E33046949,384,247,73,174,5,47,33,14,81,72,0,6,3,4
E33046950,772,609,120,489,12,33,17,16,115,103,3,8,1,3
E33046951,428,276,52,224,6,62,43,19,83,77,1,5,0,1
E33046952,345,239,64,175,6,46,35,11,53,50,1,2,0,1
E33046953,400,229,53,176,10,70,56,14,90,84,0,5,1,1
E33046954,1755,1416,263,1153,24,58,33,25,255,236,3,14,2,2
E33046955,337,226,29,197,6,22,11,11,82,71,2,7,2,1
E33046956,706,522,130,392,14,45,32,13,121,107,0,14,0,4
E33046957,622,362,68,294,8,62,37,25,190,177,2,10,1,0
E33046958,957,682,123,559,9,84,61,23,173,163,4,2,4,9
E33046959,860,682,138,544,1,19,12,7,154,144,1,9,0,4
E33046960,397,302,76,226,4,28,13,15,57,52,1,4,0,6
E33046961,328,244,69,175,4,14,7,7,65,56,2,4,3,1
E33046962,273,160,41,119,0,36,29,7,74,70,2,2,0,3
E33046963,371,233,66,167,0,64,45,19,72,69,1,2,0,2
E33046964,212,136,42,94,2,20,12,8,53,48,1,3,1,1
E33046965,249,169,34,135,2,16,6,10,60,57,0,2,1,2
E33046966,463,344,107,237,3,28,14,14,86,80,0,6,0,2
E33046967,302,194,67,127,3,37,30,7,66,61,0,3,2,2
E33046968,309,213,58,155,3,34,25,9,54,46,0,8,0,5
E33046969,245,137,38,99,5,33,17,16,63,58,1,4,0,7
E33046970,256,195,60,135,1,25,15,10,31,28,0,3,0,4
E33046971,305,216,59,157,2,13,11,2,69,65,0,3,1,5
E33046972,295,206,84,122,5,29,18,11,54,51,0,2,1,1
E33046973,217,154,39,115,3,12,8,4,44,40,0,4,0,4
E33046974,316,176,41,135,2,53,38,15,84,79,1,3,1,1
E33046975,350,199,58,141,4,58,41,17,88,83,2,3,0,1
E33046976,458,348,90,258,1,21,15,6,83,75,0,7,1,5
E33046977,303,219,60,159,3,16,7,9,65,61,1,3,0,0
E33046978,620,465,96,369,1,23,11,12,130,122,1,6,1,1
E33046979,302,198,42,156,1,12,4,8,88,84,0,4,0,3
E33046980,681,503,133,370,1,40,22,18,135,122,6,5,2,2
E33046981,397,251,68,183,2,27,16,11,116,108,3,4,1,1
E33046982,327,215,66,149,3,36,11,25,72,67,0,2,3,1
E33046983,425,282,75,207,4,33,14,19,100,92,1,5,2,6
E33046984,3426,2636,713,1923,29,181,97,84,564,524,6,31,3,16
E33046985,1570,949,318,631,12,58,14,44,540,523,2,14,1,11
E33046986,1515,982,327,655,8,61,17,44,456,439,3,12,2,8
E33046987,315,228,59,169,0,25,11,14,61,57,0,3,1,1
E33046988,538,380,102,278,1,55,19,36,99,94,0,3,2,3
E33046989,574,370,127,243,5,99,10,89,96,86,3,6,1,4
E33046990,249,164,52,112,3,41,1,40,39,37,2,0,0,2
E33046991,277,205,73,132,5,35,3,32,30,30,0,0,0,2
E33046992,628,436,116,320,9,52,23,29,122,108,2,8,4,9
E33046993,280,193,46,147,1,8,6,2,75,69,0,6,0,3
E33046994,315,259,67,192,4,12,6,6,40,36,0,2,2,0
E33046995,278,197,40,157,1,17,10,7,61,58,0,2,1,2
E33046996,214,142,37,105,3,15,6,9,54,51,1,2,0,0
E33046997,246,189,52,137,5,8,1,7,44,37,1,6,0,0
E33046998,516,287,74,213,10,54,28,26,159,148,0,10,1,6
E33046999,268,129,40,89,2,25,11,14,106,105,0,1,0,6
E33047000,409,322,90,232,2,14,8,6,69,64,1,4,0,2
E33047001,231,101,21,80,1,36,18,18,91,84,0,7,0,2
E33047002,512,309,89,220,5,38,17,21,157,146,2,8,1,3
E33047003,312,192,45,147,1,17,8,9,100,95,0,5,0,2
E33047004,563,348,92,256,7,51,28,23,152,141,1,10,0,5
E33047005,349,266,69,197,2,14,9,5,65,63,0,2,0,2
E33047006,1147,813,253,560,8,117,68,49,199,183,3,12,1,10
E33047007,786,430,135,295,2,83,49,34,264,243,3,16,2,7
E33047008,199,126,32,94,6,14,4,10,53,51,1,1,0,0
E33047009,322,181,53,128,2,21,13,8,113,105,0,6,2,5
E33047010,233,158,49,109,3,18,6,12,39,35,3,1,0,15
E33047011,388,308,96,212,2,11,8,3,64,63,0,1,0,3
E33047012,306,251,64,187,0,7,5,2,47,44,0,3,0,1
E33047013,205,146,43,103,4,15,8,7,39,37,0,2,0,1
E33047014,611,474,114,360,13,7,2,5,116,107,0,8,1,1
E33047015,214,128,43,85,3,23,7,16,58,54,0,4,0,2
E33047016,311,191,45,146,2,26,12,14,89,80,0,8,1,3
E33047017,369,219,34,185,8,30,9,21,110,92,2,12,4,2
E33047018,287,194,47,147,2,33,16,17,58,52,2,3,1,0
E33047019,262,179,36,143,3,23,10,13,54,48,0,6,0,3
E33047020,1717,970,226,744,26,214,91,123,502,456,8,31,7,5
E33047021,544,402,88,314,6,31,10,21,102,86,4,10,2,3
E33047022,237,168,35,133,3,9,2,7,54,48,3,3,0,3
E33047023,659,476,105,371,8,40,14,26,129,120,3,3,3,6
E33047024,780,519,103,416,6,85,35,50,163,151,1,10,1,7
E33047025,568,421,109,312,5,48,22,26,92,81,5,4,2,2
E33047026,781,592,180,412,11,42,17,25,129,116,1,10,2,7
E33047027,898,767,186,581,7,22,11,11,98,90,0,6,2,4
E33047028,472,378,71,307,8,27,11,16,57,47,6,3,1,2
E33047029,270,185,44,141,4,29,14,15,48,44,0,3,1,4
E33047030,7606,5447,1278,4169,77,578,244,334,1474,1268,75,86,45,30
E33047031,216,154,52,102,1,31,15,16,30,23,1,6,0,0
E33047032,500,378,96,282,3,33,14,19,84,70,6,7,1,2
E33047033,1058,750,190,560,14,108,56,52,184,169,3,10,2,2
E33047034,590,433,128,305,3,37,9,28,91,62,21,3,5,26
E33047035,966,701,187,514,13,58,26,32,191,179,1,11,0,3
E33047036,1262,860,211,649,11,120,53,67,266,248,4,10,4,5
E33047037,251,189,58,131,4,12,9,3,45,42,0,3,0,1
E33047038,229,139,29,110,0,24,9,15,66,61,0,4,1,0
E33047039,202,111,27,84,6,21,12,9,57,54,0,2,1,7
E33047040,465,283,67,216,10,65,33,32,107,96,1,10,0,0
E33047041,275,170,53,117,2,28,15,13,73,65,3,5,0,2
E33047042,350,239,55,184,5,29,10,19,76,70,0,6,0,1
E33047043,575,384,124,260,8,54,29,25,125,111,4,9,1,4
E33047044,402,272,67,205,4,52,23,29,74,67,0,6,1,0
E33047045,226,120,42,78,7,18,7,11,78,74,0,4,0,3
E33047046,347,241,55,186,8,14,3,11,82,76,2,4,0,2
E33047047,317,199,52,147,4,36,23,13,77,73,0,4,0,1
E33047048,1289,812,195,617,8,92,33,59,370,346,0,23,1,7
E33047049,460,353,121,232,6,22,10,12,77,68,0,9,0,2
E33047050,1509,1176,344,832,14,74,33,41,238,220,1,15,2,7
E33047051,221,121,42,79,3,13,4,9,84,79,0,5,0,0
E33047052,497,215,66,149,4,59,23,36,219,213,0,6,0,0
E33047053,380,254,59,195,0,7,2,5,113,104,2,6,1,6
E33047054,612,491,82,409,11,17,5,12,88,69,3,14,2,5
E33047055,638,450,135,315,8,37,21,16,135,120,6,8,1,8
E33047056,4536,3469,1037,2432,39,209,96,113,792,693,23,67,9,27
E33047057,268,160,85,75,0,40,27,13,66,55,5,6,0,2
E33047058,533,344,99,245,4,32,16,16,150,136,0,13,1,3
E33047059,543,380,102,278,2,34,15,19,120,107,3,9,1,7
E33047060,241,140,47,93,2,29,14,15,65,60,1,2,2,5
E33047061,340,225,79,146,2,22,15,7,89,80,1,7,1,2
E33047062,223,152,57,95,0,15,9,6,55,50,0,4,1,1
E33047063,186,112,46,66,3,12,7,5,58,47,0,10,1,1
E33047064,305,207,71,136,1,32,20,12,64,58,0,5,1,1
E33047065,398,327,97,230,7,17,8,9,44,41,1,2,0,3
E33047066,217,156,46,110,1,6,3,3,52,50,0,2,0,2
E33047067,738,486,162,324,8,83,63,20,157,142,4,8,3,4
E33047068,1345,839,249,590,9,84,53,31,407,362,8,30,7,6
E33047069,451,332,106,226,5,40,25,15,71,61,2,8,0,3
E33047070,230,186,44,142,2,8,4,4,33,27,0,6,0,1
E33047071,801,567,155,412,11,58,38,20,163,142,1,19,1,2
E33047072,262,183,60,123,2,24,15,9,51,44,1,5,1,2
E33047073,1281,932,187,745,8,40,19,21,296,275,2,16,3,5
E33047074,1148,852,199,653,6,27,9,18,260,244,2,12,2,3
E33047075,337,259,63,196,3,28,13,15,47,45,0,2,0,0
E33047076,3413,2617,835,1782,11,110,51,59,665,640,1,20,4,10
E33047077,129,86,13,73,0,9,5,4,34,33,0,1,0,0
E33047078,464,327,101,226,8,38,23,15,90,88,0,2,0,1
E33047079,212,108,39,69,1,15,11,4,86,81,0,4,1,2
E33047080,223,113,35,78,3,14,12,2,86,81,0,5,0,7
E33047081,694,467,115,352,5,38,20,18,177,166,0,10,1,7
E33047082,1565,868,187,681,15,114,67,47,559,533,1,23,2,9
E33047083,1612,1152,316,836,13,185,132,53,256,236,2,18,0,6
E33047084,388,244,61,183,2,7,3,4,133,128,0,5,0,2
E33047085,532,374,115,259,6,21,14,7,123,118,0,5,0,8
E33047086,517,340,78,262,2,28,14,14,146,135,2,9,0,1
E33047087,558,333,88,245,4,74,37,37,141,132,0,7,2,6
E33047088,435,280,62,218,6,55,28,27,90,81,0,8,1,4
E33047089,907,597,132,465,13,55,30,25,238,222,1,14,1,4
E33047090,284,173,43,130,0,18,7,11,92,84,0,8,0,1
E33047091,603,433,99,334,4,17,11,6,146,140,0,6,0,3
E33047092,329,223,61,162,4,16,8,8,86,78,5,3,0,0
E33047093,528,348,87,261,6,39,14,25,134,127,1,6,0,1
E33047094,475,253,65,188,2,50,30,20,168,161,1,5,1,2
E33047095,811,550,166,384,6,88,55,33,161,151,1,9,0,6
E33047096,247,186,59,127,3,15,10,5,43,38,0,4,1,0
E33047097,458,229,65,164,2,32,16,16,192,178,0,13,1,3
E33047098,279,161,41,120,2,13,11,2,101,95,0,3,3,2
E33047099,1136,791,179,612,11,35,21,14,290,265,2,22,1,9
E33047100,788,546,103,443,13,33,17,16,189,181,0,8,0,7
E33047101,340,282,80,202,4,25,16,9,28,25,0,3,0,1
E33047102,391,260,53,207,2,16,8,8,110,106,0,4,0,3
E33047103,783,585,135,450,8,20,10,10,166,159,0,7,0,4
E33047104,289,238,59,179,0,5,3,2,45,45,0,0,0,1
E33047105,788,612,105,507,6,14,9,5,153,148,0,5,0,3
E33047106,235,103,22,81,1,33,18,15,98,95,0,3,0,0
E33047107,1634,1079,303,776,13,147,95,52,389,369,4,15,1,6
E33047108,765,441,145,296,4,138,92,46,179,170,0,9,0,3
E33047109,297,143,33,110,2,29,13,16,122,116,0,6,0,1
E33047110,840,483,104,379,9,30,17,13,311,287,3,18,3,7
E33047111,522,233,56,177,5,47,26,21,233,222,0,10,1,4
E33047112,201,100,22,78,1,30,21,9,69,68,0,1,0,1
E33047113,1902,1331,297,1034,13,102,60,42,444,410,5,27,2,12
E33047114,239,132,42,90,4,34,18,16,67,62,0,5,0,2
E33047115,624,410,97,313,4,40,25,15,169,157,0,10,2,1
E33047116,1056,773,151,622,8,28,16,12,242,228,0,12,2,5
E33047117,695,475,118,357,2,41,21,20,175,168,1,6,0,2
E33047118,712,500,123,377,5,25,15,10,180,172,0,7,1,2
E33047119,404,266,74,192,2,22,16,6,110,93,11,4,2,4
E33047120,595,319,89,230,3,37,22,15,231,221,0,7,3,5
E33047121,517,339,102,237,7,86,68,18,80,73,1,4,2,5
E33047122,236,141,21,120,2,45,38,7,46,43,0,2,1,2
E33047123,360,233,46,187,6,43,26,17,77,75,0,1,1,1
E33047124,445,286,69,217,3,40,25,15,115,106,0,8,1,1
E33047125,420,272,76,196,6,49,35,14,93,91,0,2,0,0
E33047126,174,129,44,85,1,18,9,9,26,24,0,2,0,0
E33047127,593,388,115,273,4,50,29,21,149,140,0,6,3,2
E33047128,208,137,42,95,2,18,12,6,49,45,0,4,0,2
E33047129,416,306,81,225,3,39,29,10,68,62,1,4,1,0
E33047130,227,128,37,91,1,26,14,12,70,65,0,3,2,2
E33047131,250,160,35,125,1,22,13,9,65,62,1,2,0,2
E33047132,287,206,56,150,6,26,18,8,43,43,0,0,0,6
E33047133,457,267,55,212,3,19,10,9,166,160,0,6,0,2
E33047134,532,354,108,246,5,32,21,11,134,131,1,2,0,7
E33047135,371,264,53,211,1,19,7,12,84,79,2,3,0,3
E33047136,649,436,98,338,4,27,17,10,178,166,3,9,0,4
E33047137,334,228,43,185,7,6,4,2,93,87,2,3,1,0
E33047138,255,174,23,151,2,10,5,5,66,58,0,7,1,3
E33047139,253,106,29,77,2,54,37,17,91,81,0,10,0,0
E33047140,667,487,112,375,6,41,23,18,131,121,2,7,1,2
E33047141,356,123,33,90,3,36,24,12,194,182,2,7,3,0
E33047142,511,374,78,296,3,26,15,11,106,98,1,7,0,2
E33047143,760,415,114,301,4,84,53,31,254,243,1,10,0,3
E33047144,364,215,65,150,2,42,25,17,100,93,1,6,0,5
E33047145,591,352,61,291,3,28,20,8,205,195,0,10,0,3
E33047146,595,322,63,259,5,23,12,11,242,225,0,16,1,3
E33047147,521,301,55,246,3,42,18,24,171,159,0,12,0,4
E33047148,241,154,37,117,7,23,8,15,55,54,0,1,0,2
E33047149,287,177,37,140,1,23,14,9,84,81,1,2,0,2
E33047150,237,137,33,104,2,7,4,3,91,88,0,3,0,0
E33047151,203,110,27,83,2,13,5,8,78,74,1,3,0,0
E33047152,589,403,85,318,10,27,17,10,147,141,0,6,0,2
E33047153,358,179,35,144,2,18,7,11,158,146,0,10,2,1
E33047154,466,304,61,243,8,13,10,3,137,131,0,4,2,4
E33047155,266,151,49,102,0,35,29,6,78,72,0,5,1,2
E33047156,237,167,49,118,1,6,4,2,57,55,1,1,0,6
E33047157,559,423,109,314,4,24,13,11,105,96,2,6,1,3
E33047158,204,133,27,106,2,6,3,3,62,55,3,4,0,1
E33047159,482,375,118,257,4,25,16,9,76,71,0,4,1,2
E33047160,2703,2099,342,1757,18,69,38,31,504,486,1,16,1,13
E33047161,1117,810,195,615,11,75,45,30,217,199,6,12,0,4
E33047162,813,577,167,410,5,60,39,21,169,161,2,6,0,2
E33047163,795,555,134,421,5,41,19,22,193,177,1,15,0,1
E33047164,516,380,96,284,4,13,5,8,115,112,0,2,1,4
E33047165,573,376,73,303,4,18,8,10,165,156,2,7,0,10
E33047166,318,211,57,154,4,12,8,4,89,84,0,4,1,2
E33047167,521,309,69,240,5,11,9,2,194,183,3,8,0,2
E33047168,325,203,46,157,4,28,15,13,88,82,0,5,1,2
E33047169,312,242,53,189,0,13,3,10,57,55,0,2,0,0
E33047170,846,564,114,450,8,41,14,27,227,201,1,24,1,6
E33047171,354,220,46,174,3,36,10,26,95,89,0,6,0,0
E33047172,810,596,192,404,5,57,32,25,150,140,0,9,1,2
E33047173,529,359,71,288,4,20,12,8,142,125,7,7,3,4
E33047174,411,246,52,194,2,15,9,6,145,137,1,6,1,3
E33047175,295,179,40,139,1,15,7,8,94,84,1,9,0,6
E33047176,361,245,50,195,4,31,16,15,79,77,1,0,1,2
E33047177,694,501,77,424,3,26,13,13,162,156,1,5,0,2
E33047178,315,236,66,170,4,43,8,35,30,27,0,3,0,2
E33047179,706,526,170,356,1,84,39,45,89,77,1,11,0,6
E33047180,311,212,63,149,1,51,18,33,44,37,0,6,1,3
E33047181,472,371,108,263,3,38,13,25,57,46,1,9,1,3
E33047182,508,404,98,306,1,37,14,23,60,54,1,4,1,6
E33047183,451,406,134,272,2,13,6,7,29,29,0,0,0,1
E33047184,415,308,105,203,2,36,9,27,69,64,0,3,2,0
E33047185,368,271,99,172,0,22,6,16,70,64,1,5,0,5
E33047186,531,347,97,250,6,31,6,25,139,119,6,5,9,8
E33047187,287,197,55,142,0,28,11,17,59,48,1,5,5,3
E33047188,336,250,88,162,1,38,9,29,42,38,0,4,0,5
E33047189,408,247,93,154,1,42,18,24,115,104,1,8,2,3
E33047190,278,208,70,138,3,19,4,15,44,40,0,4,0,4
E33047191,244,181,57,124,3,7,0,7,52,52,0,0,0,1
E33047192,378,271,78,193,3,17,2,15,87,80,0,5,2,0
E33047193,507,280,89,191,6,86,25,61,135,125,1,7,2,0
E33047194,365,211,59,152,2,44,7,37,105,96,2,7,0,3
E33047195,424,286,85,201,3,31,13,18,101,97,0,4,0,3
E33047196,566,367,111,256,2,38,4,34,157,152,2,3,0,2
E33047197,277,194,74,120,0,7,1,6,71,68,0,2,1,5
E33047198,451,290,64,226,1,27,6,21,132,125,0,7,0,1
E33047199,334,177,46,131,1,23,2,21,131,122,0,9,0,2
E33047200,298,178,70,108,1,24,5,19,95,88,2,2,3,0
E33047201,248,125,50,75,1,23,5,18,90,79,0,7,4,9
E33047202,220,160,54,106,0,15,2,13,44,43,1,0,0,1
E33047203,295,225,86,139,2,27,6,21,37,29,3,4,1,4
E33047204,489,367,100,267,4,61,17,44,55,49,0,6,0,2
E33047205,855,656,159,497,9,56,19,37,125,119,2,4,0,9
E33047206,407,303,99,204,2,35,9,26,66,63,0,3,0,1
E33047207,404,238,96,142,1,37,5,32,118,109,3,6,0,10
E33047208,272,166,66,100,0,24,6,18,80,72,3,3,2,2
E33047209,624,397,116,281,5,56,9,47,162,153,0,8,1,4
E33047210,562,386,108,278,4,70,17,53,99,93,0,6,0,3
E33047211,439,310,92,218,1,33,14,19,91,83,1,4,3,4
E33047212,374,277,107,170,3,19,4,15,64,53,1,8,2,11
E33047213,476,326,124,202,2,30,4,26,92,80,12,0,0,26
E33047214,459,375,119,256,4,24,7,17,56,45,2,8,1,0
E33047215,317,230,82,148,0,25,6,19,55,51,1,3,0,7
E33047216,269,204,60,144,5,7,1,6,53,52,0,1,0,0
E33047217,322,241,98,143,3,23,6,17,46,45,0,1,0,9
E33047218,273,212,93,119,3,10,3,7,39,35,1,3,0,9
E33047219,316,261,87,174,0,4,1,3,46,39,2,5,0,5
E33047220,342,268,109,159,0,30,9,21,42,33,6,3,0,2
E33047221,471,275,77,198,3,104,27,77,85,75,2,5,3,4
E33047222,532,335,87,248,1,121,28,93,74,66,0,7,1,1
E33047223,289,201,44,157,3,37,9,28,48,41,1,6,0,0
E33047224,298,228,94,134,2,20,6,14,36,30,4,2,0,12
E33047225,248,168,77,91,5,17,1,16,56,50,2,4,0,2
E33047226,285,194,56,138,1,15,3,12,74,62,3,6,3,1
E33047227,715,464,149,315,4,85,23,62,158,145,1,12,0,4
E33047228,380,253,84,169,0,46,18,28,72,69,0,3,0,9
E33047229,316,222,69,153,2,20,5,15,67,64,0,3,0,5
E33047230,220,148,49,99,1,27,9,18,41,39,0,1,1,3
E33047231,308,212,61,151,0,19,7,12,75,72,0,3,0,2
E33047232,241,159,58,101,0,28,4,24,48,42,2,4,0,6
E33047233,301,218,68,150,1,14,5,9,65,55,0,10,0,3
E33047234,283,155,61,94,1,23,10,13,103,95,0,5,3,1
E33047235,292,201,51,150,0,27,8,19,58,51,1,6,0,6
E33047236,431,299,95,204,6,47,18,29,77,66,2,8,1,2
E33047237,391,256,90,166,3,41,10,31,88,86,1,1,0,3
E33047238,226,137,46,91,1,18,7,11,67,62,0,4,1,3
E33047239,302,202,54,148,5,44,16,28,50,44,1,5,0,1
E33047240,281,188,51,137,3,33,6,27,56,49,0,5,2,1
E33047241,713,505,169,336,5,113,32,81,84,73,0,10,1,6
E33047242,429,340,136,204,0,39,10,29,46,40,1,5,0,4
E33047243,465,327,92,235,3,38,12,26,91,78,3,4,6,6
E33047244,276,229,87,142,0,21,8,13,24,22,0,1,1,2
E33047245,282,235,93,142,0,26,10,16,15,15,0,0,0,6
E33047246,279,219,95,124,0,27,7,20,30,23,1,6,0,3
E33047247,228,182,69,113,0,14,6,8,31,28,0,3,0,1
E33047248,253,203,88,115,2,26,13,13,21,15,0,4,2,1
E33047249,299,242,97,145,1,25,7,18,27,17,2,5,3,4
E33047250,360,292,111,181,1,20,8,12,45,40,0,4,1,2
E33047251,272,197,62,135,0,30,8,22,37,36,0,1,0,8
E33047252,280,201,78,123,1,26,10,16,48,44,1,3,0,4
E33047253,255,185,59,126,2,28,7,21,39,35,2,2,0,1
E33047254,554,376,113,263,1,104,36,68,70,58,2,7,3,3
E33047255,294,206,66,140,3,36,8,28,47,42,0,3,2,2
E33047256,332,258,87,171,2,16,6,10,50,42,1,7,0,6
E33047257,271,182,51,131,2,39,9,30,41,37,0,1,3,7
E33047258,283,219,69,150,3,22,6,16,38,38,0,0,0,1
E33047259,358,242,46,196,5,25,9,16,84,65,6,7,6,2
E33047260,288,205,55,150,9,34,3,31,40,36,0,2,2,0
E33047261,310,262,76,186,1,12,5,7,35,31,0,4,0,0
E33047262,279,220,63,157,3,26,9,17,27,25,0,0,2,3
E33047263,387,314,91,223,5,27,13,14,39,35,0,2,2,2
E33047264,270,221,79,142,2,16,7,9,28,27,0,1,0,3
E33047265,507,413,106,307,2,31,22,9,51,46,0,4,1,10
E33047266,368,301,111,190,1,30,11,19,28,23,3,2,0,8
E33047267,456,370,143,227,6,20,6,14,54,45,4,4,1,6
E33047268,318,257,100,157,0,12,4,8,44,40,3,1,0,5
E33047269,234,177,80,97,0,20,11,9,35,26,3,1,5,2
E33047270,322,246,84,162,3,28,8,20,40,39,0,1,0,5
E33047271,397,305,119,186,1,28,8,20,61,50,3,6,2,2
E33047272,251,197,87,110,0,16,7,9,26,19,1,3,3,12
E33047273,396,306,102,204,4,21,7,14,58,49,6,3,0,7
E33047274,438,353,117,236,5,36,16,20,42,35,4,2,1,2
E33047275,332,243,85,158,1,17,6,11,62,60,0,2,0,9
E33047276,382,320,97,223,1,19,6,13,40,33,1,3,3,2
E33047277,400,318,87,231,1,23,6,17,51,46,1,4,0,7
E33047278,436,357,100,257,1,21,11,10,54,50,1,1,2,3
E33047279,385,316,105,211,2,35,14,21,29,28,0,0,1,3
E33047280,673,511,184,327,5,49,24,25,104,94,1,7,2,4
E33047281,393,290,113,177,4,32,16,16,66,49,11,4,2,1
E33047282,286,229,66,163,0,16,2,14,37,34,1,1,1,4
E33047283,327,275,92,183,0,23,8,15,27,23,2,2,0,2
E33047284,424,299,88,211,3,47,9,38,74,66,2,5,1,1
E33047285,444,348,114,234,1,49,18,31,42,38,0,4,0,4
E33047286,670,529,164,365,5,47,22,25,85,76,1,7,1,4
E33047287,265,200,66,134,1,31,14,17,31,25,2,4,0,2
E33047288,320,279,87,192,1,8,4,4,29,29,0,0,0,3
E33047289,481,382,115,267,1,35,11,24,57,48,6,3,0,6
E33047290,532,432,125,307,0,42,11,31,52,50,0,2,0,6
E33047291,437,349,110,239,2,10,1,9,73,69,0,4,0,3
E33047292,357,284,74,210,1,34,15,19,37,30,2,5,0,1
E33047293,481,395,115,280,2,19,2,17,63,62,0,1,0,2
E33047294,281,234,67,167,2,11,1,10,30,28,1,1,0,4
E33047295,427,320,105,215,5,45,10,35,55,51,2,1,1,2
E33047296,364,237,48,189,1,66,61,5,55,51,0,3,1,5
E33047297,322,208,43,165,1,57,50,7,54,51,0,3,0,2
E33047298,227,126,29,97,2,76,70,6,22,20,0,2,0,1
E33047299,343,210,47,163,3,40,28,12,85,84,0,1,0,5
E33047300,492,341,111,230,3,50,42,8,95,88,3,2,2,3
E33047301,417,248,76,172,3,122,106,16,43,37,2,2,2,1
E33047302,350,229,72,157,7,54,45,9,58,54,0,4,0,2
E33047303,393,298,89,209,2,37,30,7,54,51,0,3,0,2
E33047304,327,206,52,154,6,66,60,6,49,43,0,5,1,0
E33047305,371,254,62,192,2,51,40,11,61,58,1,1,1,3
E33047306,783,509,165,344,1,116,94,22,150,142,0,8,0,7
E33047307,238,128,33,95,1,68,63,5,37,36,0,1,0,4
E33047308,343,215,74,141,2,75,58,17,51,49,1,0,1,0
E33047309,361,227,69,158,0,81,68,13,49,44,2,3,0,4
E33047310,354,249,60,189,0,65,50,15,36,31,0,5,0,4
E33047311,313,157,45,112,1,116,107,9,36,33,0,1,2,3
E33047312,268,185,54,131,1,41,35,6,39,36,1,2,0,2
E33047313,5080,3837,1049,2788,37,361,240,121,828,776,6,45,1,17
E33047314,262,176,55,121,2,29,19,10,54,51,0,3,0,1
E33047315,482,352,114,238,1,38,28,10,91,87,1,3,0,0
E33047316,283,170,55,115,0,39,31,8,74,60,7,7,0,0
E33047317,327,167,31,136,2,23,11,12,129,119,3,6,1,6
E33047318,409,260,74,186,7,66,30,36,73,70,0,0,3,3
E33047319,556,318,95,223,6,109,74,35,120,113,0,6,1,3
E33047320,296,230,59,171,3,11,7,4,48,44,1,3,0,4
E33047321,475,354,87,267,3,36,23,13,78,70,0,8,0,4
E33047322,319,243,79,164,1,15,13,2,53,49,1,2,1,7
E33047323,435,314,78,236,4,42,30,12,71,63,2,5,1,4
E33047324,654,468,125,343,4,56,39,17,114,103,2,7,2,12
E33047325,327,204,66,138,2,62,47,15,55,52,0,3,0,4
E33047326,447,328,96,232,2,40,29,11,68,68,0,0,0,9
E33047327,442,327,101,226,4,50,41,9,59,53,0,5,1,2
E33047328,360,239,62,177,0,91,83,8,28,28,0,0,0,2
E33047329,448,309,83,226,0,86,72,14,50,42,0,5,3,3
E33047330,273,203,55,148,0,23,17,6,40,38,0,1,1,7
E33047331,325,200,49,151,0,66,61,5,56,53,1,2,0,3
E33047332,444,309,69,240,3,54,33,21,74,69,0,4,1,4
E33047333,284,210,51,159,4,23,21,2,45,40,0,3,2,2
E33047334,574,371,113,258,4,94,70,24,97,90,0,7,0,8
E33047335,309,252,74,178,0,14,12,2,39,31,0,6,2,4
E33047336,312,248,90,158,2,18,13,5,34,30,1,2,1,10
E33047337,283,230,77,153,0,23,14,9,25,23,0,2,0,5
E33047338,273,217,75,142,0,20,13,7,32,27,0,1,4,4
E33047339,409,281,83,198,2,25,6,19,98,93,0,4,1,3
E33047340,272,174,51,123,4,19,17,2,72,68,0,4,0,3
E33047341,347,236,46,190,3,14,11,3,92,84,2,6,0,2
E33047342,318,189,69,120,2,22,15,7,104,94,1,7,2,1
E33047343,214,161,53,108,0,24,19,5,29,26,0,3,0,0
E33047344,278,226,70,156,0,19,15,4,33,32,0,1,0,0
E33047345,304,237,83,154,1,29,18,11,35,32,0,3,0,2
E33047346,469,354,132,222,3,49,35,14,63,58,0,3,2,0
E33047347,302,210,64,146,3,43,20,23,44,38,1,4,1,2
E33047348,326,213,71,142,1,22,11,11,86,78,3,5,0,4
E33047349,361,233,68,165,2,47,34,13,65,56,2,5,2,14
E33047350,252,168,65,103,1,26,14,12,49,48,1,0,0,8
E33047351,269,187,66,121,0,25,11,14,55,53,0,2,0,2
E33047352,301,185,61,124,3,17,8,9,95,95,0,0,0,1
E33047353,470,300,93,207,0,88,62,26,75,68,1,6,0,7
E33047354,342,239,71,168,1,36,25,11,63,49,1,13,0,3
E33047355,615,409,124,285,4,33,22,11,165,151,2,10,2,4
E33047356,700,523,139,384,6,79,66,13,90,82,0,8,0,2
E33047357,272,189,56,133,1,41,29,12,41,39,1,1,0,0
E33047358,499,286,92,194,4,67,48,19,140,129,3,5,3,2
E33047359,425,280,64,216,1,39,31,8,103,96,0,7,0,2
E33047360,288,214,79,135,3,34,29,5,33,30,0,3,0,4
E33047361,1406,1040,236,804,9,72,38,34,269,198,38,11,22,16
E33047362,358,238,101,137,1,16,13,3,87,77,0,9,1,16
E33047363,422,340,116,224,1,33,30,3,47,40,2,4,1,1
E33047364,216,178,58,120,0,13,11,2,23,21,1,0,1,2
E33047365,382,245,99,146,0,58,42,16,79,75,3,1,0,0
E33047366,178,124,41,83,1,15,10,5,35,33,0,2,0,3
E33047367,425,260,68,192,3,36,23,13,121,114,1,6,0,5
E33047368,465,332,93,239,0,24,16,8,106,99,3,3,1,3
E33047369,448,305,93,212,2,33,20,13,106,103,0,3,0,2
E33047370,301,197,59,138,2,15,9,6,85,80,0,5,0,2
E33047371,900,642,187,455,7,48,28,20,196,183,3,7,3,7
E33047372,274,200,55,145,3,6,4,2,63,62,0,1,0,2
E33047373,301,237,67,170,0,10,4,6,52,49,0,3,0,2
E33047374,641,380,135,245,1,42,22,20,215,201,2,11,1,3
E33047375,313,252,79,173,4,9,5,4,41,37,0,4,0,7
E33047376,267,188,57,131,1,9,7,2,63,60,0,2,1,6
E33047377,543,395,139,256,2,38,25,13,99,92,0,7,0,9
E33047378,630,410,116,294,4,54,35,19,156,141,1,13,1,6
E33047379,603,419,112,307,2,58,44,14,121,111,3,5,2,3
E33047380,524,351,95,256,4,85,71,14,82,65,1,12,4,2
E33047381,401,274,75,199,6,34,20,14,86,77,0,6,3,1
E33047382,283,190,36,154,4,23,12,11,64,61,0,3,0,2
E33047383,474,356,104,252,3,33,23,10,78,64,0,12,2,4
E33047384,301,207,48,159,0,24,8,16,61,53,6,2,0,9
E33047385,360,237,68,169,3,41,27,14,77,70,0,7,0,2
E33047386,471,316,101,215,3,23,14,9,127,111,0,16,0,2
E33047387,274,175,59,116,2,11,6,5,84,80,0,4,0,2
E33047388,309,189,73,116,4,11,8,3,105,97,1,7,0,0
E33047389,259,205,75,130,0,6,3,3,47,42,0,3,2,1
E33047390,399,256,94,162,1,11,5,6,130,126,0,4,0,1
E33047391,386,192,48,144,5,29,19,10,156,145,0,11,0,4
E33047392,646,367,128,239,9,53,31,22,215,197,5,11,2,2
E33047393,411,313,85,228,2,30,21,9,64,57,0,6,1,2
E33047394,227,159,43,116,2,24,12,12,41,34,0,7,0,1
E33047395,468,340,91,249,2,34,22,12,91,88,0,3,0,1
E33047396,373,266,70,196,2,34,25,9,67,58,0,8,1,4
E33047397,602,463,135,328,3,47,23,24,86,78,1,7,0,3
E33047398,512,404,130,274,4,40,28,12,57,52,0,5,0,7
E33047399,273,151,55,96,1,18,11,7,101,96,0,4,1,2
E33047400,282,125,34,91,0,23,11,12,129,125,1,2,1,5
E33047401,323,178,54,124,1,37,21,16,104,97,0,7,0,3
E33047402,634,390,87,303,8,43,25,18,191,178,3,10,0,2
E33047403,424,290,92,198,5,41,17,24,86,84,0,2,0,2
E33047404,233,158,72,86,2,10,8,2,61,52,5,4,0,2
E33047405,234,129,43,86,3,15,10,5,86,81,1,4,0,1
E33047406,231,148,38,110,1,9,3,6,71,67,0,3,1,2
E33047407,374,263,70,193,2,17,8,9,91,86,0,5,0,1
E33047408,304,140,43,97,6,68,33,35,85,78,1,6,0,5
E33047409,249,138,28,110,1,56,47,9,52,50,0,1,1,2
E33047410,486,310,71,239,1,60,27,33,110,102,1,5,2,5
E33047411,467,269,83,186,4,45,23,22,146,138,0,8,0,3
E33047412,278,182,52,130,1,24,9,15,71,65,0,6,0,0
E33047413,367,175,65,110,2,48,14,34,139,129,0,9,1,3
E33047414,375,132,38,94,8,75,29,46,152,139,0,13,0,8
E33047415,309,185,47,138,6,33,10,23,83,80,0,3,0,2
E33047416,288,165,46,119,1,29,15,14,87,81,1,5,0,6
E33047417,348,189,66,123,3,44,20,24,110,102,0,5,3,2
E33047418,433,195,66,129,8,67,42,25,155,150,0,3,2,8
E33047419,391,195,70,125,2,30,17,13,160,157,1,2,0,4
E33047420,298,170,52,118,0,11,7,4,116,109,2,5,0,1
E33047421,343,216,83,133,4,30,23,7,88,77,2,8,1,5
E33047422,340,202,46,156,0,55,35,20,83,70,6,5,2,0
E33047423,454,243,89,154,3,46,36,10,153,147,1,3,2,9
E33047424,460,285,74,211,4,22,10,12,146,141,1,4,0,3
E33047425,563,306,57,249,8,28,16,12,215,201,2,10,2,6
E33047426,501,303,72,231,2,9,5,4,183,176,0,6,1,4
E33047427,554,340,119,221,3,32,21,11,174,162,4,7,1,5
E33047428,295,186,34,152,3,6,4,2,100,95,0,5,0,0
E33047429,333,152,40,112,3,21,13,8,154,144,2,7,1,3
E33047430,336,214,84,130,0,9,5,4,110,103,0,6,1,3
E33047431,297,194,45,149,1,6,4,2,92,90,2,0,0,4
E33047432,309,197,61,136,2,12,5,7,97,92,2,3,0,1
E33047433,352,225,54,171,1,14,10,4,110,104,0,4,2,2
E33047434,315,232,71,161,2,32,17,15,47,36,9,2,0,2
E33047435,581,434,98,336,1,46,23,23,97,85,3,6,3,3
E33047436,325,245,62,183,3,21,14,7,55,46,0,6,3,1
E33047437,327,245,53,192,0,19,16,3,62,60,0,2,0,1
E33047438,427,288,61,227,3,45,31,14,85,77,0,8,0,6
E33047439,553,404,131,273,3,55,32,23,90,82,0,8,0,1
E33047440,348,199,42,157,4,31,16,15,107,97,0,8,2,7
E33047441,308,197,63,134,2,26,18,8,81,79,2,0,0,2
E33047442,252,156,39,117,2,36,25,11,56,52,0,3,1,2
E33047443,411,287,89,198,4,38,26,12,79,74,0,3,2,3
E33047444,539,378,120,258,6,55,41,14,97,94,0,3,0,3
E33047445,239,144,32,112,1,17,9,8,77,72,0,5,0,0
E33047446,261,177,42,135,0,21,14,7,59,55,0,4,0,4
E33047447,304,202,49,153,5,32,21,11,63,58,1,4,0,2
E33047448,290,198,53,145,4,22,16,6,66,63,1,2,0,0
E33047449,275,164,57,107,3,6,5,1,100,95,0,3,2,2
E33047450,361,263,85,178,1,13,9,4,80,77,0,3,0,4
E33047451,292,208,45,163,0,14,10,4,66,64,1,1,0,4
E33047452,283,190,72,118,2,14,9,5,73,65,3,5,0,4
E33047453,684,375,103,272,4,35,19,16,260,245,3,10,2,10
E33047454,301,180,64,116,2,19,11,8,94,88,0,4,2,6
E33047455,514,366,116,250,2,41,25,16,78,71,4,3,0,27
E33047456,392,199,71,128,1,11,4,7,173,158,5,9,1,8
E33047457,600,402,125,277,4,66,51,15,122,107,1,14,0,6
E33047458,950,563,133,430,14,37,22,15,330,317,0,13,0,6
E33047459,474,210,61,149,5,35,20,15,222,203,4,9,6,2
E33047460,699,426,111,315,13,62,31,31,196,188,2,5,1,2
E33047461,236,133,43,90,5,20,16,4,74,70,0,4,0,4
E33047462,1588,1213,241,972,12,30,10,20,327,314,2,9,2,6
E33047463,4835,3329,806,2523,42,355,226,129,1091,995,39,51,6,18
E33047464,1229,868,223,645,7,30,17,13,313,299,0,12,2,11
E33047465,728,468,126,342,6,43,21,22,207,192,1,13,1,4
E33047466,297,171,55,116,3,23,10,13,97,93,0,4,0,3
E33047467,477,375,100,275,0,15,7,8,86,78,1,7,0,1
E33047468,451,351,87,264,2,34,21,13,63,56,0,7,0,1
E33047469,288,190,76,114,3,27,19,8,67,66,0,1,0,1
E33047470,324,193,73,120,1,16,7,9,105,93,0,5,7,9
E33047471,289,157,63,94,0,16,9,7,111,105,0,6,0,5
E33047472,306,144,52,92,6,62,32,30,92,84,0,4,4,2
E33047473,319,175,49,126,3,28,12,16,108,105,0,3,0,5
E33047474,282,204,54,150,3,25,17,8,46,40,1,5,0,4
E33047475,388,263,78,185,9,53,24,29,58,52,0,5,1,5
E33047476,533,373,85,288,2,60,46,14,95,89,2,4,0,3
E33047477,821,616,115,501,9,79,46,33,114,103,0,11,0,3
E33047478,344,202,40,162,4,43,32,11,91,89,0,2,0,4
E33047479,739,545,144,401,4,89,68,21,99,89,2,8,0,2
E33047480,343,234,55,179,1,30,17,13,77,67,0,10,0,1
E33047481,274,182,53,129,2,20,15,5,69,65,0,4,0,1
E33047482,324,208,54,154,3,16,5,11,93,87,0,6,0,4
E33047483,705,505,135,370,6,58,41,17,130,121,1,5,3,6
E33047484,554,389,92,297,6,44,27,17,113,107,0,6,0,2
E33047485,324,199,52,147,2,25,19,6,97,89,2,6,0,1
E33047486,781,488,123,365,7,64,50,14,218,199,0,17,2,4
E33047487,322,199,55,144,3,37,22,15,82,78,0,4,0,1
E33047488,249,148,37,111,7,28,16,12,63,59,1,3,0,3
E33047489,337,260,55,205,8,16,13,3,52,48,1,3,0,1
E33047490,322,216,55,161,1,18,10,8,84,79,0,5,0,3
E33047491,693,431,106,325,11,75,32,43,171,153,1,11,6,5
E33047492,415,324,85,239,1,21,14,7,65,61,0,3,1,4
E33047493,376,297,88,209,3,47,43,4,29,25,0,4,0,0
E33047494,278,212,51,161,4,25,21,4,37,35,0,2,0,0
E33047495,246,173,57,116,2,20,17,3,50,43,0,4,3,1
E33047496,273,179,51,128,1,31,22,9,62,58,1,1,2,0
E33047497,280,182,50,132,1,38,30,8,55,51,0,4,0,4
E33047498,654,389,103,286,7,100,69,31,156,150,1,5,0,2
E33047499,302,188,62,126,2,56,47,9,52,50,0,2,0,4
E33047500,585,333,94,239,4,105,83,22,142,133,2,7,0,1
E33047501,309,184,53,131,2,54,44,10,66,60,2,3,1,3
E33047502,351,224,67,157,2,41,36,5,79,74,0,5,0,5
E33047503,275,206,60,146,3,29,23,6,36,30,0,6,0,1
E33047504,367,234,60,174,8,53,46,7,65,64,0,1,0,7
E33047505,329,214,54,160,1,40,33,7,70,64,0,6,0,4
E33047506,321,206,57,149,0,17,10,7,97,90,3,4,0,1
E33047507,310,209,51,158,3,21,16,5,77,72,0,5,0,0
E33047508,288,205,43,162,0,23,16,7,58,57,0,1,0,2
E33047509,488,356,86,270,3,50,36,14,75,69,0,6,0,4
E33047510,630,496,127,369,6,31,19,12,95,85,0,10,0,2
E33047511,311,231,61,170,1,36,28,8,40,34,1,5,0,3
E33047512,293,237,86,151,1,11,9,2,39,37,0,1,1,5
E33047513,295,236,78,158,0,19,13,6,39,37,0,2,0,1
E33047514,309,255,74,181,2,12,11,1,39,33,0,6,0,1
E33047515,356,263,81,182,2,46,34,12,42,40,0,2,0,3
E33047516,313,241,55,186,0,16,11,5,55,54,0,1,0,1
E33047517,615,454,128,326,5,55,36,19,100,91,2,7,0,1
E33047518,265,194,53,141,2,13,7,6,54,45,0,9,0,2
E33047519,616,453,133,320,3,78,58,20,82,76,0,4,2,0
E33047520,594,467,118,349,4,50,38,12,71,65,0,6,0,2
E33047521,362,289,98,191,2,39,33,6,31,27,1,3,0,1
E33047522,297,185,43,142,2,70,63,7,36,36,0,0,0,4
E33047523,588,392,87,305,6,111,96,15,74,68,0,5,1,5
E33047524,378,234,63,171,4,77,71,6,58,54,0,4,0,5
E33047525,591,360,94,266,3,107,91,16,118,112,0,6,0,3
E33047526,460,345,68,277,5,62,50,12,46,39,0,7,0,2
E33047527,349,249,66,183,1,52,50,2,45,43,0,2,0,2
E33047528,327,262,72,190,3,17,13,4,42,41,0,1,0,3
E33047529,466,376,92,284,3,34,27,7,51,45,0,6,0,2
E33047530,508,372,69,303,1,26,20,6,108,100,0,8,0,1
E33047531,256,192,55,137,4,18,15,3,41,35,5,0,1,1
E33047532,651,437,112,325,3,91,68,23,112,104,2,5,1,8
E33047533,473,339,98,241,2,47,23,24,83,79,0,4,0,2
E33047534,349,228,55,173,0,70,56,14,49,39,0,10,0,2
E33047535,547,430,111,319,6,40,31,9,68,61,0,7,0,3
E33047536,485,340,99,241,4,86,60,26,54,49,0,5,0,1
E33047537,383,271,80,191,4,45,37,8,62,52,4,5,1,1
E33047538,433,363,95,268,2,20,18,2,47,36,3,8,0,1
E33047539,504,382,111,271,2,66,51,15,53,50,0,3,0,1
E33047540,375,254,88,166,2,69,61,8,47,44,0,3,0,3
E33047541,344,292,96,196,0,26,18,8,25,23,0,2,0,1
E33047542,352,274,86,188,3,41,26,15,31,27,0,4,0,3
E33047543,299,251,73,178,1,25,22,3,22,16,0,2,4,0
E33047544,448,342,99,243,3,54,39,15,48,43,0,4,1,1
E33047545,288,210,69,141,3,28,20,8,44,39,0,4,1,3
E33047546,733,479,120,359,9,156,140,16,83,75,0,8,0,6
E33047547,639,389,91,298,3,169,136,33,73,62,2,8,1,5
E33047548,734,634,207,427,4,25,17,8,67,57,0,7,3,4
E33047549,326,279,87,192,1,17,13,4,28,26,0,1,1,1
E33047550,571,329,84,245,2,171,142,29,65,59,0,4,2,4
E33047551,337,205,60,145,4,91,76,15,35,32,0,2,1,2
E33047552,289,250,67,183,1,8,3,5,28,26,0,2,0,2
E33047553,318,236,50,186,3,9,6,3,69,64,2,3,0,1
E33047554,291,237,70,167,2,16,5,11,35,32,0,2,1,1
E33047555,561,408,101,307,8,62,28,34,76,70,1,4,1,7
E33047556,545,433,132,301,4,48,17,31,56,46,0,8,2,4
E33047557,342,257,59,198,1,24,13,11,58,54,0,4,0,2
E33047558,296,268,94,174,0,5,1,4,22,20,0,2,0,1
E33047559,268,200,63,137,0,14,2,12,52,48,0,4,0,2
E33047560,1704,1468,292,1176,15,31,14,17,185,178,2,3,2,5
E33047561,487,390,97,293,3,27,15,12,61,55,1,5,0,6
E33047562,262,201,19,182,6,15,1,14,40,38,0,2,0,0
E33047563,445,357,99,258,2,25,14,11,55,47,1,7,0,6
E33047564,298,237,76,161,1,16,5,11,42,37,0,5,0,2
E33047565,406,342,67,275,2,3,0,3,58,54,0,4,0,1
E33047566,336,267,71,196,0,24,11,13,45,43,0,1,1,0
E33047567,825,626,145,481,1,50,27,23,140,125,4,8,3,8
E33047568,572,410,112,298,1,40,27,13,117,105,2,10,0,4
E33047569,274,228,61,167,3,8,3,5,31,26,2,1,2,4
E33047570,293,193,81,112,3,31,17,14,61,58,2,1,0,5
E33047571,482,343,86,257,1,58,31,27,77,74,1,2,0,3
E33047572,438,349,115,234,3,14,8,6,71,63,1,7,0,1
E33047573,318,251,84,167,3,10,6,4,52,47,0,5,0,2
E33047574,407,347,87,260,0,5,1,4,51,35,2,7,7,4
E33047575,313,231,78,153,1,18,8,10,63,57,1,5,0,0
E33047576,213,159,65,94,1,8,3,5,44,41,1,2,0,1
E33047577,385,292,89,203,2,15,5,10,75,69,1,4,1,1
E33047578,301,241,78,163,2,17,3,14,41,36,1,4,0,0
E33047579,531,384,108,276,4,29,12,17,106,98,1,6,1,8
E33047580,267,209,69,140,1,15,10,5,37,33,1,2,1,5
E33047581,260,192,58,134,2,21,10,11,43,39,1,3,0,2
E33047582,223,190,69,121,0,4,0,4,26,24,0,2,0,3
E33047583,324,246,77,169,4,17,13,4,51,48,0,3,0,6
E33047584,274,223,65,158,2,11,7,4,37,29,3,3,2,1
E33047585,1118,803,171,632,15,106,61,45,187,176,1,10,0,7
E33047586,451,345,63,282,8,31,10,21,67,61,1,5,0,0
E33047587,246,197,65,132,2,8,6,2,37,31,3,3,0,2
E33047588,660,515,146,369,6,20,8,12,116,111,0,5,0,3
E33047589,360,283,98,185,4,22,13,9,51,45,0,5,1,0
E33047590,331,246,73,173,2,23,11,12,55,50,0,4,1,5
E33047591,322,229,74,155,3,12,2,10,75,72,1,2,0,3
E33047592,368,295,85,210,1,22,11,11,49,45,0,4,0,1
E33047593,241,191,65,126,4,12,8,4,34,31,0,3,0,0
E33047594,295,227,73,154,2,25,8,17,37,33,2,2,0,4
E33047595,259,211,72,139,2,10,6,4,36,32,0,3,1,0
E33047596,332,238,72,166,4,37,15,22,53,44,2,7,0,0
E33047597,318,243,80,163,4,23,10,13,46,44,0,2,0,2
E33047598,355,301,95,206,0,16,11,5,36,31,0,3,2,2
E33047599,622,433,133,300,3,93,47,46,90,84,0,6,0,3
E33047600,608,466,139,327,1,33,22,11,103,96,0,7,0,5
E33047601,323,266,77,189,1,13,4,9,42,39,0,2,1,1
E33047602,310,273,63,210,0,9,4,5,26,23,1,2,0,2
E33047603,502,386,130,256,0,42,25,17,68,61,1,4,2,6
E33047604,320,283,76,207,0,2,1,1,32,26,2,3,1,3
E33047605,846,701,206,495,4,46,19,27,89,84,2,2,1,6
E33047606,523,439,125,314,1,9,4,5,72,64,1,7,0,2
E33047607,542,426,121,305,4,34,12,22,76,68,0,8,0,2
E33047608,339,290,77,213,4,8,3,5,35,30,0,5,0,2
E33047609,287,236,82,154,0,16,8,8,35,34,0,1,0,0
E33047610,349,287,69,218,3,14,8,6,41,35,0,6,0,4
E33047611,329,294,87,207,1,12,7,5,22,21,0,1,0,0
E33047612,425,339,115,224,3,21,10,11,59,50,3,6,0,3
E33047613,238,181,52,129,5,10,5,5,39,35,0,4,0,3
E33047614,331,261,90,171,0,15,11,4,48,39,2,7,0,7
E33047615,400,307,89,218,5,26,10,16,61,53,1,7,0,1
E33047616,729,542,143,399,3,38,16,22,143,130,0,10,3,3
E33047617,388,301,97,204,5,16,4,12,63,58,0,4,1,3
E33047618,420,309,127,182,0,50,25,25,58,49,4,3,2,3
E33047619,565,467,126,341,3,20,8,12,73,65,1,7,0,2
E33047620,249,197,66,131,2,14,11,3,29,25,0,4,0,7
E33047621,272,229,70,159,3,13,8,5,27,24,0,3,0,0
E33047622,299,220,72,148,0,40,34,6,36,30,2,2,2,3
E33047623,305,254,89,165,1,10,6,4,39,37,1,1,0,1
E33047624,365,289,111,178,5,19,9,10,44,41,0,2,1,8
E33047625,215,177,64,113,3,6,3,3,28,22,1,5,0,1
E33047626,238,198,91,107,1,11,4,7,28,19,1,8,0,0
E33047627,706,557,191,366,11,30,10,20,101,88,2,9,2,7
E33047628,401,310,96,214,3,35,17,18,49,43,0,6,0,4
E33047629,413,325,109,216,2,26,9,17,54,49,0,5,0,6
E33047630,373,302,88,214,2,16,6,10,47,43,1,3,0,6
E33047631,501,325,101,224,1,31,12,19,138,125,7,4,2,6
E33047632,886,669,183,486,8,42,24,18,157,145,0,8,4,10
E33047633,621,539,110,429,6,6,3,3,65,52,0,12,1,5
E33047634,339,289,63,226,3,4,0,4,41,35,0,5,1,2
E33047635,288,224,50,174,3,29,12,17,29,25,0,4,0,3
E33047636,331,265,67,198,8,11,4,7,47,37,0,8,2,0
E33047637,682,563,162,401,5,28,8,20,85,72,1,11,1,1
E33047638,245,167,53,114,6,19,10,9,52,46,0,5,1,1
E33047639,287,234,65,169,2,8,2,6,41,36,0,5,0,2
E33047640,283,251,78,173,1,7,4,3,23,20,0,3,0,1
E33047641,370,319,102,217,5,12,7,5,33,29,1,3,0,1
E33047642,355,285,76,209,1,11,7,4,57,55,0,2,0,1
E33047643,410,349,90,259,3,10,3,7,41,37,1,3,0,7
E33047644,319,243,55,188,4,27,17,10,44,35,0,7,2,1
E33047645,432,241,66,175,2,21,8,13,163,154,2,7,0,5
E33047646,610,430,127,303,6,43,19,24,124,111,2,11,0,7
E33047647,273,219,54,165,1,13,8,5,39,37,0,2,0,1
E33047648,489,318,107,211,1,31,13,18,136,129,0,7,0,3
E33047649,734,491,146,345,7,42,20,22,188,178,0,10,0,6
E33047650,447,328,95,233,3,19,7,12,96,90,1,5,0,1
E33047651,333,194,42,152,1,27,14,13,105,99,1,5,0,6
E33047652,365,245,77,168,2,30,12,18,81,76,1,4,0,7
E33047653,316,179,46,133,0,25,7,18,107,99,0,8,0,5
E33047654,209,168,44,124,5,4,1,3,31,29,0,2,0,1
E33047655,307,194,56,138,0,24,11,13,85,77,2,6,0,4
E33047656,257,185,36,149,2,22,9,13,45,39,2,4,0,3
E33047657,252,203,42,161,1,9,6,3,38,36,0,2,0,1
E33047658,483,327,93,234,2,34,14,20,117,107,1,9,0,3
E33047659,500,349,80,269,3,37,12,25,108,98,0,10,0,3
E33047660,382,258,60,198,4,32,16,16,83,77,0,6,0,5
E33047661,893,588,150,438,5,113,63,50,182,168,1,13,0,5
E33047662,414,259,72,187,2,109,71,38,42,38,0,4,0,2
E33047663,596,396,100,296,5,65,26,39,127,118,0,9,0,3
E33047664,436,298,79,219,0,22,8,14,114,107,2,3,2,2
E33047665,446,263,70,193,2,39,21,18,139,136,0,3,0,3
E33047666,323,257,79,178,2,11,5,6,47,43,0,4,0,6
E33047667,432,330,106,224,0,25,12,13,73,67,2,2,2,4
E33047668,332,251,85,166,2,22,13,9,52,47,0,5,0,5
E33047669,284,242,79,163,1,8,6,2,31,27,0,4,0,2
E33047670,241,205,70,135,1,7,6,1,28,27,0,1,0,0
E33047671,360,286,66,220,5,9,7,2,56,48,0,6,2,4
E33047672,340,267,81,186,1,32,22,10,39,35,0,2,2,1
E33047673,321,275,75,200,1,11,5,6,31,26,1,4,0,3
E33047674,606,463,168,295,10,19,7,12,110,89,15,6,0,4
E33047675,263,204,74,130,1,9,5,4,45,43,0,2,0,4
E33047676,804,462,139,323,6,52,24,28,276,264,4,5,3,8
E33047677,603,348,106,242,8,8,6,2,232,220,4,1,7,7
E33047678,299,216,86,130,2,15,10,5,62,56,4,2,0,4
E33047679,404,309,105,204,2,18,9,9,71,64,0,2,5,4
E33047680,348,290,125,165,1,8,6,2,41,24,11,4,2,8
E33047681,332,287,112,175,4,14,4,10,27,25,0,2,0,0
E33047682,380,301,125,176,0,16,11,5,57,47,0,10,0,6
E33047683,221,174,51,123,0,11,3,8,34,31,2,1,0,2
E33047684,367,267,54,213,0,41,24,17,58,49,0,9,0,1
E33047685,456,354,106,248,3,33,18,15,64,59,2,3,0,2
E33047686,358,281,92,189,2,19,10,9,55,50,1,3,1,1
E33047687,447,370,116,254,1,16,7,9,57,50,1,6,0,3
E33047688,297,262,75,187,2,9,0,9,24,21,0,3,0,0
E33047689,266,195,42,153,0,15,8,7,56,55,0,1,0,0
E33047690,712,536,130,406,2,46,24,22,122,97,5,18,2,6
E33047691,372,307,104,203,2,29,7,22,34,29,0,4,1,0
E33047692,443,362,106,256,0,17,4,13,58,54,0,3,1,6
E33047693,1288,919,247,672,12,81,35,46,268,246,1,19,2,8
E33047694,659,500,139,361,5,64,25,39,88,82,0,6,0,2
E33047695,372,298,77,221,3,17,5,12,46,42,0,4,0,8
E33047696,393,314,87,227,3,14,9,5,58,53,0,5,0,4
E33047697,301,241,72,169,1,14,4,10,41,36,0,5,0,4
E33047698,474,388,120,268,5,18,8,10,63,59,1,2,1,0
E33047699,339,277,72,205,1,20,6,14,38,35,2,1,0,3
E33047700,442,339,116,223,7,37,14,23,56,50,1,5,0,3
E33047701,291,216,76,140,3,23,7,16,41,35,4,2,0,8
E33047702,328,265,86,179,1,14,5,9,44,40,0,4,0,4
E33047703,370,323,79,244,2,11,2,9,32,29,1,2,0,2
E33047704,394,300,80,220,4,17,9,8,69,63,5,1,0,4
E33047705,332,278,110,168,1,14,6,8,33,27,0,3,3,6
E33047706,283,220,81,139,3,18,4,14,40,34,2,4,0,2
E33047707,400,300,110,190,0,28,17,11,62,55,0,7,0,10
E33047708,247,205,72,133,0,9,5,4,32,27,0,5,0,1
E33047709,1116,947,374,573,5,40,23,17,119,104,3,12,0,5
E33047710,307,250,70,180,1,12,7,5,42,37,1,2,2,2
E33047711,345,281,74,207,3,21,11,10,39,37,0,2,0,1
E33047712,460,362,118,244,3,31,18,13,59,54,2,3,0,5
E33047713,239,190,59,131,2,21,10,11,26,24,1,1,0,0
E33047714,526,423,114,309,1,26,15,11,72,63,0,6,3,4
E33047715,289,239,63,176,1,13,7,6,35,31,2,2,0,1
E33047716,284,209,60,149,5,28,8,20,38,33,0,4,1,4
E33047717,275,214,46,168,3,28,5,23,29,26,0,3,0,1
E33047718,360,296,74,222,2,12,4,8,41,36,0,4,1,9
E33047719,364,311,79,232,0,9,2,7,41,39,0,2,0,3
E33047720,598,480,131,349,3,24,11,13,89,83,2,4,0,2
E33047721,303,234,57,177,0,26,11,15,41,39,1,1,0,2
E33047722,443,354,88,266,4,23,4,19,60,50,1,9,0,2
E33047723,330,283,74,209,2,8,2,6,35,28,0,7,0,2
E33047724,293,268,76,192,2,3,1,2,19,18,0,1,0,1
E33047725,354,285,104,181,0,19,6,13,47,41,1,4,1,3
E33047726,425,334,74,260,3,35,6,29,47,41,0,6,0,6
E33047727,392,296,79,217,1,21,11,10,71,69,0,2,0,3
E33047728,625,447,97,350,6,24,9,15,146,137,1,8,0,2
E33047729,539,417,72,345,3,13,3,10,104,103,0,1,0,2
E33047730,531,313,57,256,6,35,18,17,171,167,1,3,0,6
E33047731,392,297,49,248,4,14,6,8,72,71,0,1,0,5
E33047732,1229,969,162,807,9,41,20,21,207,194,0,10,3,3
E33047733,456,386,100,286,3,5,0,5,61,59,0,1,1,1
E33047734,348,296,57,239,3,14,2,12,35,32,0,2,1,0
E33047735,449,403,116,287,2,8,0,8,34,26,1,7,0,2
E33047736,535,402,116,286,1,39,10,29,92,83,1,7,1,1
E33047737,275,216,52,164,3,22,5,17,33,31,0,2,0,1
E33047738,398,309,74,235,1,22,8,14,63,60,0,3,0,3
E33047739,370,285,68,217,1,38,13,25,42,40,0,1,1,4
E33047740,338,240,46,194,1,48,17,31,44,42,1,1,0,5
E33047741,535,334,101,233,3,42,18,24,151,139,2,9,1,5
E33047742,275,233,67,166,1,13,1,12,27,26,0,1,0,1
E33047743,309,219,46,173,1,51,13,38,37,34,0,3,0,1
E33047744,351,237,38,199,1,21,6,15,91,83,0,8,0,1
E33047745,565,369,60,309,2,70,19,51,121,113,1,5,2,3
E33047746,306,221,39,182,3,21,1,20,59,55,0,3,1,2
E33047747,344,259,59,200,0,14,7,7,71,67,0,4,0,0
E33047748,648,439,87,352,3,33,9,24,166,159,2,5,0,7
E33047749,306,255,64,191,0,30,5,25,18,17,0,1,0,3
E33047750,267,231,75,156,0,10,5,5,23,22,0,1,0,3
E33047751,449,382,129,253,1,17,6,11,45,38,2,4,1,4
E33047752,561,489,135,354,2,10,2,8,57,50,0,7,0,3
E33047753,332,270,67,203,0,7,0,7,54,46,0,7,1,1
E33047754,327,260,49,211,10,12,5,7,43,40,0,3,0,2
E33047755,350,262,69,193,1,39,11,28,45,43,0,0,2,3
E33047756,388,327,83,244,1,17,6,11,42,41,0,1,0,1
E33047757,306,258,77,181,0,23,12,11,24,20,0,4,0,1
E33047758,301,249,79,170,0,16,11,5,32,31,0,1,0,4
E33047759,312,239,69,170,2,20,6,14,50,46,0,4,0,1
E33047760,567,455,131,324,1,32,12,20,74,63,0,11,0,5
E33047761,408,318,90,228,2,34,17,17,54,49,0,4,1,0
E33047762,756,556,108,448,5,40,9,31,145,135,1,7,2,10
E33047763,2717,2012,554,1458,24,156,72,84,517,484,5,25,3,8
E33047764,498,287,53,234,2,68,41,27,137,131,1,3,2,4
E33047765,554,448,96,352,3,21,11,10,77,68,0,7,2,5
E33047766,275,211,58,153,2,24,15,9,38,33,1,4,0,0
E33047767,8937,6862,1472,5390,54,203,74,129,1723,1332,235,54,102,95
E33047768,595,456,103,353,3,30,7,23,99,93,0,4,2,7
E33047769,402,292,68,224,1,34,21,13,70,67,0,2,1,5
E33047770,353,210,51,159,3,36,18,18,103,92,1,7,3,1
E33047771,612,411,114,297,7,61,24,37,129,119,2,8,0,4
E33047772,292,208,63,145,4,13,5,8,66,60,0,4,2,1
E33047773,384,236,65,171,1,37,22,15,108,98,0,3,7,2
E33047774,659,475,126,349,4,55,24,31,125,120,0,3,2,0
E33047775,418,301,96,205,2,38,20,18,72,67,2,3,0,5
E33047776,249,208,64,144,0,21,12,9,20,19,0,1,0,0
E33047777,727,434,107,327,2,111,36,75,176,161,1,12,2,4
E33047778,249,204,68,136,1,14,5,9,27,27,0,0,0,3
E33047779,370,279,55,224,5,32,3,29,52,46,0,3,3,2
E33047780,322,251,63,188,2,22,8,14,45,40,3,1,1,2
E33047781,337,272,69,203,3,16,7,9,42,36,0,6,0,4
E33047782,271,224,61,163,1,14,2,12,30,30,0,0,0,2
E33047783,401,354,102,252,1,7,3,4,35,33,1,1,0,4
E33047784,283,231,63,168,0,19,6,13,31,27,0,4,0,2
E33047785,387,355,116,239,1,3,1,2,24,21,1,2,0,4
E33047786,487,402,78,324,0,24,12,12,61,54,2,4,1,0
E33047787,404,270,53,217,2,36,19,17,96,88,0,8,0,0
E33047788,571,430,95,335,2,37,22,15,102,82,2,10,8,0
E33047789,322,266,52,214,2,15,4,11,37,34,0,3,0,2
E33047790,486,350,63,287,1,15,3,12,118,92,14,6,6,2
E33047791,463,401,121,280,4,15,8,7,39,31,0,8,0,4
E33047792,275,236,67,169,2,9,5,4,27,20,0,7,0,1
E33047793,363,294,83,211,3,20,3,17,37,36,0,1,0,9
E33047794,283,221,67,154,0,20,5,15,37,34,0,3,0,5
E33047795,613,471,126,345,4,50,24,26,82,76,0,6,0,6
E33047796,286,210,61,149,4,20,9,11,50,46,0,4,0,2
E33047797,315,244,54,190,3,36,13,23,30,23,0,6,1,2
E33047798,378,287,77,210,0,51,18,33,37,30,3,4,0,3
E33047799,296,234,88,146,5,19,2,17,33,31,1,0,1,5
E33047800,488,397,132,265,0,42,16,26,44,36,2,4,2,5
E33047801,204,148,64,84,3,14,6,8,36,29,3,2,2,3
E33047802,294,243,82,161,2,13,4,9,28,23,2,3,0,8
E33047803,411,329,119,210,2,13,1,12,57,52,1,3,1,10
E33047804,353,265,110,155,0,24,12,12,47,40,3,3,1,17
E33047805,251,186,74,112,0,30,6,24,34,31,0,3,0,1
E33047806,574,443,134,309,10,29,9,20,82,73,3,5,1,10
E33047807,365,237,70,167,3,27,10,17,82,75,1,5,1,16
E33047808,279,152,77,75,1,11,0,11,79,61,9,6,3,36
E33047809,459,376,133,243,1,20,10,10,57,53,0,4,0,5
E33047810,475,408,99,309,5,15,5,10,46,43,1,2,0,1
E33047811,571,403,120,283,9,68,15,53,90,79,4,6,1,1
E33047812,284,229,75,154,0,27,16,11,27,25,0,2,0,1
E33047813,397,320,93,227,1,28,12,16,46,43,0,3,0,2
E33047814,539,388,110,278,0,67,34,33,77,70,3,2,2,7
E33047815,315,211,68,143,5,45,21,24,51,42,4,4,1,3
E33047816,463,374,103,271,5,32,12,20,47,43,0,4,0,5
E33047817,319,239,67,172,0,24,5,19,55,50,0,5,0,1
E33047818,588,479,139,340,2,30,8,22,73,67,0,6,0,4
E33047819,265,189,56,133,2,21,9,12,48,44,0,4,0,5
E33047820,681,446,123,323,4,86,37,49,140,134,1,4,1,5
E33047821,353,265,75,190,1,34,11,23,47,43,0,3,1,6
E33047822,378,268,67,201,2,43,15,28,64,57,0,4,3,1
E33047823,332,248,64,184,1,49,9,40,30,27,1,0,2,4
E33047824,349,276,71,205,0,47,5,42,26,26,0,0,0,0
E33047825,536,373,96,277,8,42,11,31,107,94,0,12,1,6
E33047826,270,193,55,138,1,37,18,19,38,35,0,3,0,1
E33047827,283,214,54,160,1,20,7,13,47,44,0,3,0,1
E33047828,359,290,85,205,1,29,6,23,38,32,0,4,2,1
E33047829,527,397,92,305,4,30,10,20,93,83,3,4,3,3
E33047830,320,253,79,174,1,31,14,17,34,30,1,3,0,1
E33047831,382,305,82,223,2,32,9,23,40,38,1,1,0,3
E33047832,338,262,50,212,0,23,12,11,49,42,0,7,0,4
E33047833,418,303,62,241,4,37,10,27,68,64,1,3,0,6
E33047834,351,303,60,243,1,9,1,8,38,32,0,4,2,0
E33047835,429,322,100,222,0,60,17,43,43,42,0,0,1,4
E33047836,404,294,77,217,1,55,14,41,51,46,0,4,1,3
E33047837,647,504,125,379,3,62,23,39,72,66,0,5,1,6
E33047838,252,192,65,127,1,9,6,3,48,47,0,0,1,2
E33047839,492,378,104,274,2,41,3,38,64,57,1,5,1,7
E33047840,599,452,147,305,2,47,19,28,93,86,2,4,1,5
E33047841,483,378,95,283,1,36,14,22,64,52,1,11,0,4
E33047842,502,379,99,280,1,36,11,25,82,76,0,6,0,4
E33047843,317,266,78,188,0,16,8,8,34,33,0,1,0,1
E33047844,486,406,116,290,1,18,10,8,61,52,2,7,0,0
E33047845,424,366,118,248,1,5,1,4,51,44,0,7,0,1
E33047846,371,300,81,219,3,16,5,11,50,45,0,5,0,2
E33047847,427,384,110,274,1,11,1,10,29,25,0,4,0,2
E33047848,437,364,107,257,1,29,9,20,40,35,3,2,0,3
E33047849,444,334,107,227,3,46,33,13,59,46,8,3,2,2
E33047850,1288,870,179,691,15,151,67,84,245,211,15,8,11,7
E33047851,261,209,66,143,1,20,12,8,28,25,2,0,1,3
E33047852,687,502,156,346,10,68,33,35,102,91,3,5,3,5
E33047853,529,391,108,283,2,74,44,30,61,56,1,3,1,1
E33047854,458,357,100,257,6,41,17,24,50,48,0,2,0,4
E33047855,358,239,62,177,1,77,50,27,41,35,1,5,0,0
E33047856,522,376,111,265,4,78,37,41,62,58,1,2,1,2
E33047857,714,467,114,353,5,151,92,59,87,73,1,9,4,4
E33047858,260,194,46,148,1,22,16,6,42,33,1,7,1,1
E33047859,366,250,70,180,2,94,63,31,19,15,0,4,0,1
E33047860,334,240,63,177,10,52,29,23,31,23,3,4,1,1
E33047861,544,383,107,276,4,48,14,34,106,91,2,10,3,3
E33047862,489,370,88,282,6,23,13,10,86,80,3,2,1,4
E33047863,408,312,66,246,3,15,8,7,78,69,3,6,0,0
E33047864,401,292,80,212,3,60,40,20,45,36,1,6,2,1
E33047865,825,624,156,468,6,46,21,25,143,128,1,10,4,6
E33047866,419,300,65,235,4,67,54,13,46,39,0,7,0,2
E33047867,553,417,119,298,1,77,45,32,54,46,1,5,2,4
E33047868,444,266,81,185,2,125,67,58,51,45,3,3,0,0
E33047869,257,168,49,119,4,52,28,24,33,30,0,3,0,0
E33047870,361,254,61,193,2,62,38,24,43,40,1,1,1,0
E33047871,339,193,39,154,9,73,53,20,63,57,0,5,1,1
E33047872,972,562,139,423,8,248,138,110,150,136,6,7,1,4
E33047873,327,239,62,177,2,28,12,16,55,45,6,2,2,3
E33047874,271,183,51,132,1,35,19,16,52,40,5,6,1,0
E33047875,227,177,46,131,2,17,5,12,30,22,4,3,1,1
E33047876,431,321,68,253,8,32,14,18,67,55,7,2,3,3
E33047877,370,280,78,202,2,23,9,14,60,28,19,4,9,5
E33047878,806,633,132,501,7,63,27,36,101,65,22,7,7,2
E33047879,411,291,63,228,3,67,36,31,48,41,1,5,1,2
E33047880,322,218,53,165,1,65,18,47,37,33,0,4,0,1
E33047881,500,333,70,263,5,83,35,48,73,64,0,9,0,6
E33047882,308,190,40,150,1,71,24,47,36,30,3,2,1,10
E33047883,381,262,65,197,4,55,34,21,58,52,1,2,3,2
E33047884,503,391,100,291,7,37,13,24,68,58,2,5,3,0
E33047885,466,330,89,241,4,63,24,39,67,59,1,7,0,2
E33047886,596,410,110,300,10,88,38,50,84,77,1,5,1,4
E33047887,369,236,56,180,4,68,38,30,60,53,0,6,1,1
E33047888,366,276,65,211,2,48,37,11,39,35,3,1,0,1
E33047889,457,356,85,271,4,35,16,19,61,55,0,6,0,1
E33047890,421,293,67,226,0,73,29,44,53,47,3,3,0,2
E33047891,669,529,163,366,5,47,19,28,86,74,0,10,2,2
E33047892,306,167,37,130,3,104,68,36,31,29,2,0,0,1
E33047893,367,258,55,203,3,38,22,16,65,61,1,2,1,3
E33047894,279,184,44,140,2,55,41,14,36,29,0,6,1,2
E33047895,532,357,80,277,9,91,52,39,72,62,0,10,0,3
E33047896,1570,1061,200,861,7,173,88,85,326,191,78,12,45,3
E33047897,286,179,48,131,1,68,13,55,38,33,1,3,1,0
E33047898,266,207,55,152,0,30,13,17,28,23,2,3,0,1
E33047899,468,375,104,271,6,36,19,17,48,43,0,3,2,3
E33047900,331,256,63,193,2,25,7,18,48,39,0,9,0,0
E33047901,405,323,89,234,1,26,13,13,53,47,2,3,1,2
E33047902,234,161,42,119,2,21,10,11,49,44,2,1,2,1
E33047903,229,159,33,126,8,24,5,19,37,30,1,4,2,1
E33047904,570,433,119,314,6,41,15,26,85,76,1,6,2,5
E33047905,349,291,72,219,2,10,5,5,46,40,3,2,1,0
E33047906,329,268,82,186,0,14,9,5,45,37,0,5,3,2
E33047907,266,208,77,131,1,20,11,9,36,34,0,1,1,1
E33047908,265,223,62,161,1,6,2,4,34,32,2,0,0,1
E33047909,385,290,91,199,1,35,19,16,55,51,0,2,2,4
E33047910,272,212,60,152,0,17,8,9,40,37,0,3,0,3
E33047911,291,191,45,146,3,39,21,18,54,44,1,7,2,4
E33047912,288,219,60,159,2,22,4,18,43,40,2,1,0,2
E33047913,382,279,73,206,4,7,2,5,92,86,1,5,0,0
E33047914,289,221,66,155,6,13,2,11,46,43,0,3,0,3
E33047915,586,467,101,366,8,24,3,21,87,74,3,10,0,0
E33047916,674,493,110,383,7,64,30,34,110,94,2,13,1,0
E33047917,661,491,122,369,5,70,30,40,95,79,2,13,1,0
E33047918,272,206,57,149,1,19,7,12,44,33,2,6,3,2
E33047919,563,422,119,303,9,48,14,34,82,68,0,11,3,2
E33047920,310,248,65,183,7,14,7,7,39,33,2,4,0,2
E33047921,408,283,56,227,5,25,12,13,88,77,1,10,0,7
E33047922,302,186,42,144,0,45,21,24,68,57,0,9,2,3
E33047923,353,222,56,166,0,59,27,32,69,64,0,4,1,3
E33047924,539,297,94,203,2,90,47,43,147,139,1,5,2,3
E33047925,342,217,51,166,4,78,34,44,42,35,1,4,2,1
E33047926,542,389,88,301,4,59,27,32,86,77,3,4,2,4
E33047927,1445,1124,300,824,18,115,46,69,183,163,6,9,5,5
E33047928,765,503,134,369,7,99,40,59,152,133,5,12,2,4
E33047929,468,375,108,267,5,31,8,23,57,47,5,3,2,0
E33047930,484,354,101,253,3,41,10,31,84,55,12,6,11,2
E33047931,219,141,29,112,1,28,20,8,47,43,0,4,0,2
E33047932,302,149,46,103,3,11,4,7,133,125,3,4,1,6
E33047933,374,200,56,144,1,55,27,28,115,108,0,6,1,3
E33047934,645,471,129,342,5,23,15,8,141,131,1,7,2,5
E33047935,265,170,37,133,2,10,5,5,79,71,2,3,3,4
E33047936,818,582,116,466,15,80,32,48,136,121,6,8,1,5
E33047937,439,306,81,225,4,56,24,32,70,63,1,6,0,3
E33047938,1084,567,160,407,16,147,53,94,344,311,0,32,1,10
E33047939,294,189,51,138,2,38,13,25,63,60,0,3,0,2
E33047940,260,168,59,109,5,25,11,14,56,48,2,5,1,6
E33047941,273,170,39,131,4,22,17,5,76,70,0,5,1,1
E33047942,299,176,41,135,3,21,10,11,98,94,1,3,0,1
E33047943,344,217,56,161,3,14,7,7,109,103,0,6,0,1
E33047944,597,391,97,294,9,56,30,26,132,114,4,12,2,9
E33047945,261,116,35,81,2,82,42,40,59,55,0,3,1,2
E33047946,4005,3183,885,2298,28,329,150,179,453,394,12,43,4,12
E33047947,305,146,39,107,7,75,37,38,74,64,0,6,4,3
E33047948,693,452,117,335,6,115,45,70,117,107,1,8,1,3
E33047949,281,159,42,117,2,55,21,34,63,56,2,4,1,2
E33047950,473,275,65,210,7,111,66,45,78,68,5,4,1,2
E33047951,405,245,59,186,4,40,20,20,115,103,3,8,1,1
E33047952,508,262,71,191,2,109,43,66,133,119,1,12,1,2
E33047953,377,216,43,173,3,27,9,18,129,116,0,5,8,2
E33047954,332,185,50,135,3,41,18,23,101,93,1,5,2,2
E33047955,574,409,109,300,9,42,16,26,112,92,4,13,3,2
E33047956,321,205,53,152,1,28,13,15,86,75,2,8,1,1
E33047957,408,257,60,197,3,30,8,22,118,102,6,9,1,0
E33047958,471,305,62,243,5,38,16,22,121,107,3,7,4,2
E33047959,451,226,52,174,2,96,52,44,127,118,2,6,1,0
E33047960,330,214,58,156,4,18,9,9,90,76,3,8,3,4
E33047961,328,154,43,111,4,34,10,24,135,132,0,3,0,1
E33047962,286,163,41,122,6,41,13,28,74,66,1,7,0,2
E33047963,673,346,84,262,5,71,25,46,247,216,6,23,2,4
E33047964,447,355,91,264,8,27,10,17,56,51,0,5,0,1
E33047965,266,130,49,81,0,24,8,16,107,97,3,5,2,5
E33047966,1122,714,162,552,12,140,54,86,250,227,2,16,5,6
E33047967,682,437,80,357,2,62,20,42,172,102,44,5,21,9
E33047968,641,396,109,287,8,89,40,49,139,132,1,6,0,9
E33047969,897,633,179,454,5,114,52,62,141,124,2,11,4,4
E33047970,568,369,88,281,5,41,12,29,151,124,10,7,10,2
E33047971,279,135,30,105,0,67,22,45,75,73,0,2,0,2
E33047972,449,312,75,237,2,33,11,22,101,98,1,2,0,1
E33047973,544,307,90,217,5,98,50,48,133,120,5,6,2,1
E33047974,377,213,49,164,3,28,9,19,130,114,1,11,4,3
E33047975,273,211,69,142,3,20,11,9,38,22,8,5,3,1
E33047976,525,395,124,271,8,33,16,17,82,71,3,8,0,7
E33047977,372,301,96,205,2,19,5,14,49,38,1,8,2,1
E33047978,319,276,79,197,3,6,4,2,31,28,0,3,0,3
E33047979,262,199,61,138,1,14,10,4,46,36,4,4,2,2
E33047980,554,411,107,304,7,39,13,26,88,77,7,2,2,9
E33047981,133,112,32,80,1,2,1,1,18,16,0,2,0,0
E33047982,282,224,49,175,2,12,6,6,43,37,2,2,2,1
E33047983,294,217,55,162,3,23,14,9,50,41,3,3,3,1
E33047984,521,350,99,251,0,29,8,21,139,76,38,9,16,3
E33047985,642,501,112,389,5,26,8,18,101,74,18,3,6,9
E33047986,424,339,92,247,0,10,2,8,72,59,2,6,5,3
E33047987,335,257,82,175,4,31,2,29,43,38,0,4,1,0
E33047988,420,324,90,234,4,29,5,24,61,51,1,9,0,2
E33047989,393,257,59,198,4,57,10,47,73,67,0,6,0,2
E33047990,250,185,51,134,5,13,4,9,46,42,0,3,1,1
E33047991,223,151,44,107,0,15,2,13,53,45,0,5,3,4
E33047992,377,288,74,214,6,10,2,8,70,66,0,4,0,3
E33047993,291,165,50,115,2,18,2,16,103,95,1,7,0,3
E33047994,256,204,67,137,3,4,1,3,38,33,0,5,0,7
E33047995,299,217,51,166,4,13,1,12,64,57,0,7,0,1
E33047996,511,338,87,251,6,42,5,37,123,111,2,10,0,2
E33047997,380,306,85,221,5,10,1,9,57,49,0,8,0,2
E33047998,377,308,105,203,1,22,2,20,42,36,3,1,2,4
E33047999,408,312,72,240,4,12,2,10,78,75,0,3,0,2
E33048000,430,298,96,202,5,19,2,17,104,91,0,13,0,4
E33048001,382,265,61,204,6,38,9,29,71,67,1,2,1,2
E33048002,276,214,58,156,5,9,1,8,48,44,0,4,0,0
E33048003,313,218,69,149,5,14,3,11,75,66,1,8,0,1
E33048004,737,534,161,373,18,49,7,42,134,121,2,10,1,2
E33048005,265,181,63,118,5,7,0,7,70,59,1,7,3,2
E33048006,458,321,87,234,3,32,3,29,101,95,1,5,0,1
E33048007,226,139,33,106,1,12,0,12,71,66,1,4,0,3
E33048008,370,282,67,215,1,17,0,17,69,63,0,6,0,1
E33048009,320,217,64,153,2,10,0,10,87,79,0,8,0,4
E33048010,265,193,64,129,3,12,1,11,56,54,0,2,0,1
E33048011,688,524,124,400,2,20,4,16,140,122,2,15,1,2
E33048012,371,272,49,223,7,19,0,19,67,57,3,5,2,6
E33048013,348,242,55,187,6,17,2,15,80,76,0,3,1,3
E33048014,458,288,81,207,3,30,2,28,133,126,0,6,1,4
E33048015,534,287,69,218,4,39,6,33,200,187,0,9,4,4
E33048016,327,201,67,134,3,16,6,10,103,98,1,2,2,4
E33048017,231,121,27,94,1,10,0,10,99,95,0,4,0,0
E33048018,220,149,42,107,0,6,2,4,60,59,0,1,0,5
E33048019,413,311,117,194,1,8,3,5,88,81,1,6,0,5
E33048020,276,210,56,154,1,11,6,5,51,43,1,7,0,3
E33048021,261,165,60,105,3,14,1,13,78,75,0,3,0,1
E33048022,269,191,75,116,1,7,0,7,68,63,1,3,1,2
E33048023,370,237,81,156,2,12,3,9,119,110,0,9,0,0
E33048024,476,286,85,201,2,22,2,20,160,142,3,12,3,6
E33048025,331,209,65,144,2,13,2,11,106,104,0,2,0,1
E33048026,487,342,88,254,5,21,3,18,115,103,2,9,1,4
E33048027,265,188,49,139,0,4,1,3,70,62,0,7,1,3
E33048028,399,324,95,229,2,10,1,9,61,54,0,7,0,2
E33048029,447,347,111,236,3,18,1,17,76,69,2,5,0,3
E33048030,335,259,80,179,4,10,2,8,58,48,3,7,0,4
E33048031,637,522,131,391,3,8,2,6,97,84,0,13,0,7
E33048032,457,314,69,245,7,23,3,20,112,101,1,8,2,1
E33048033,427,286,72,214,4,61,7,54,76,68,0,6,2,0
E33048034,292,187,41,146,10,32,4,28,62,58,0,4,0,1
E33048035,1127,821,251,570,20,60,4,56,219,197,6,15,1,7
E33048036,413,302,85,217,3,31,3,28,71,65,1,5,0,6
E33048037,467,358,98,260,8,18,0,18,78,72,0,6,0,5
E33048038,337,240,74,166,4,20,2,18,72,64,0,5,3,1
E33048039,314,187,58,129,5,21,2,19,97,88,1,6,2,4
E33048040,288,158,65,93,1,25,5,20,99,94,0,4,1,5
E33048041,514,389,117,272,6,19,5,14,98,87,0,9,2,2
E33048042,225,141,49,92,2,10,2,8,69,61,0,6,2,3
E33048043,278,181,76,105,3,12,1,11,81,76,1,4,0,1
E33048044,355,242,71,171,7,17,2,15,88,82,0,6,0,1
E33048045,271,195,61,134,2,13,1,12,60,55,0,5,0,1
E33048046,655,480,149,331,8,31,2,29,127,119,0,8,0,9
E33048047,350,284,82,202,11,6,0,6,47,42,0,5,0,2
E33048048,330,243,71,172,12,12,0,12,60,59,0,1,0,3
E33048049,332,240,69,171,1,10,1,9,77,63,1,13,0,4
E33048050,494,326,111,215,5,30,6,24,127,113,9,5,0,6
E33048051,385,323,112,211,1,13,1,12,46,39,0,5,2,2
E33048052,300,232,91,141,1,5,0,5,57,51,6,0,0,5
E33048053,233,185,81,104,0,8,0,8,39,35,1,3,0,1
E33048054,455,369,138,231,2,12,0,12,65,56,1,8,0,7
E33048055,242,173,50,123,4,14,2,12,51,45,0,6,0,0
E33048056,295,230,69,161,2,7,2,5,55,49,1,4,1,1
E33048057,253,161,57,104,3,11,3,8,76,68,1,5,2,2
E33048058,421,312,84,228,7,16,1,15,83,75,0,8,0,3
E33048059,395,300,101,199,3,14,3,11,70,59,1,10,0,8
E33048060,274,210,84,126,1,17,6,11,45,41,1,3,0,1
E33048061,306,229,91,138,3,13,1,12,57,48,2,7,0,4
E33048062,405,310,109,201,6,20,0,20,68,59,3,6,0,1
E33048063,235,179,61,118,0,8,1,7,46,45,0,1,0,2
E33048064,353,240,69,171,4,24,2,22,76,66,0,9,1,9
E33048065,484,378,119,259,4,22,2,20,75,65,0,10,0,5
E33048066,367,253,97,156,8,55,24,31,48,44,0,4,0,3
E33048067,339,257,75,182,1,40,26,14,39,34,0,2,3,2
E33048068,480,334,93,241,4,53,32,21,85,75,1,9,0,4
E33048069,868,553,122,431,3,166,100,66,143,131,0,9,3,3
E33048070,1423,998,270,728,12,116,71,45,292,270,3,17,2,5
E33048071,389,270,63,207,3,58,48,10,54,48,0,6,0,4
E33048072,331,264,83,181,1,30,24,6,35,27,1,7,0,1
E33048073,478,389,106,283,0,19,12,7,65,62,0,3,0,5
E33048074,317,221,61,160,3,51,41,10,41,38,0,2,1,1
E33048075,502,430,128,302,1,11,6,5,53,49,0,3,1,7
E33048076,401,253,76,177,4,47,31,16,97,86,5,6,0,0
E33048077,387,283,64,219,12,22,5,17,64,59,0,5,0,6
E33048078,503,406,80,326,1,13,9,4,81,74,0,6,1,2
E33048079,367,224,59,165,3,66,49,17,73,68,0,4,1,1
E33048080,274,180,47,133,3,26,19,7,62,57,0,4,1,3
E33048081,372,215,58,157,3,112,87,25,42,40,1,1,0,0
E33048082,445,294,63,231,8,78,55,23,64,53,4,5,2,1
E33048083,323,260,66,194,0,10,6,4,49,38,2,7,2,4
E33048084,386,290,85,205,4,21,10,11,70,63,0,6,1,1
E33048085,485,371,92,279,4,11,7,4,97,85,1,11,0,2
E33048086,323,245,55,190,1,11,5,6,60,55,0,5,0,6
E33048087,314,224,67,157,2,36,24,12,51,44,0,7,0,1
E33048088,326,227,70,157,1,23,14,9,72,67,1,3,1,3
E33048089,415,282,62,220,3,54,42,12,70,60,1,9,0,6
E33048090,603,428,119,309,1,67,45,22,106,99,1,6,0,1
E33048091,318,227,76,151,2,39,30,9,47,44,0,2,1,3
E33048092,508,305,73,232,10,98,51,47,91,83,0,7,1,4
E33048093,477,336,94,242,4,50,34,16,83,79,1,2,1,4
E33048094,289,162,43,119,1,36,22,14,89,82,1,6,0,1
E33048095,294,210,57,153,2,12,3,9,69,65,0,4,0,1
E33048096,372,282,57,225,3,18,11,7,65,58,0,7,0,4
E33048097,306,224,57,167,1,12,3,9,69,60,4,4,1,0
E33048098,295,148,36,112,1,17,7,10,128,124,2,2,0,1
E33048099,278,205,60,145,1,16,8,8,53,48,1,4,0,3
E33048100,376,274,69,205,0,15,6,9,78,72,1,4,1,9
E33048101,293,205,43,162,1,5,1,4,80,74,0,5,1,2
E33048102,529,439,129,310,4,22,9,13,61,56,1,4,0,3
E33048103,584,442,99,343,4,22,8,14,111,100,1,10,0,5
E33048104,267,191,53,138,1,12,7,5,58,55,0,2,1,5
E33048105,392,302,76,226,1,19,8,11,68,60,2,6,0,2
E33048106,4485,3126,810,2316,60,241,106,135,1039,923,45,53,18,19
E33048107,389,283,91,192,3,18,7,11,84,76,3,5,0,1
E33048108,729,484,147,337,7,50,19,31,185,170,0,13,2,3
E33048109,3628,2699,407,2292,27,61,20,41,831,786,6,34,5,10
E33048110,549,379,115,264,8,42,21,21,114,103,0,11,0,6
E33048111,301,213,64,149,1,21,7,14,62,60,0,2,0,4
E33048112,362,255,58,197,1,20,10,10,81,73,0,8,0,5
E33048113,298,198,39,159,1,12,4,8,84,79,2,3,0,3
E33048114,400,248,67,181,3,19,8,11,126,122,1,3,0,4
E33048115,246,143,42,101,0,14,6,8,89,83,3,3,0,0
E33048116,281,194,68,126,1,12,6,6,72,69,0,3,0,2
E33048117,281,238,88,150,1,10,4,6,31,28,0,3,0,1
E33048118,432,293,60,233,1,21,13,8,112,101,2,9,0,5
E33048119,308,174,43,131,1,23,11,12,105,96,2,7,0,5
E33048120,450,258,70,188,5,20,7,13,164,155,2,6,1,3
E33048121,310,198,67,131,0,15,7,8,92,86,2,4,0,5
E33048122,347,225,44,181,1,9,7,2,110,104,0,3,3,2
E33048123,304,208,43,165,0,56,25,31,39,37,1,1,0,1
E33048124,297,230,82,148,2,9,1,8,48,47,0,1,0,8
E33048125,330,239,74,165,1,33,22,11,54,50,0,4,0,3
E33048126,386,276,72,204,0,29,8,21,79,71,0,8,0,2
E33048127,313,193,43,150,1,20,4,16,97,88,0,8,1,2
E33048128,322,193,38,155,2,19,6,13,108,99,2,4,3,0
E33048129,469,296,70,226,2,42,12,30,127,120,1,6,0,2
E33048130,361,237,68,169,0,10,2,8,111,103,0,4,4,3
E33048131,375,237,66,171,2,11,6,5,123,116,0,7,0,2
E33048132,406,253,69,184,3,25,8,17,118,104,1,10,3,7
E33048133,259,182,70,112,1,9,1,8,62,55,0,7,0,5
E33048134,336,214,56,158,0,20,6,14,102,93,2,5,2,0
E33048135,350,230,64,166,4,20,6,14,93,86,1,5,1,3
E33048136,403,276,69,207,3,19,7,12,96,92,0,3,1,9
E33048137,506,361,104,257,3,19,5,14,122,115,0,7,0,1
E33048138,237,168,41,127,3,15,7,8,50,45,0,5,0,1
E33048139,263,141,29,112,3,15,7,8,102,98,0,4,0,2
E33048140,315,181,44,137,4,14,4,10,115,104,3,8,0,1
E33048141,699,429,94,335,10,22,7,15,236,224,0,9,3,2
E33048142,378,201,67,134,4,26,6,20,144,139,1,3,1,3
E33048143,415,270,64,206,0,28,10,18,113,101,2,9,1,4
E33048144,714,475,122,353,9,37,13,24,189,180,1,8,0,4
E33048145,279,131,35,96,4,21,4,17,119,111,0,6,2,4
E33048146,231,134,49,85,0,24,8,16,70,65,0,5,0,3
E33048147,537,347,94,253,3,21,11,10,159,144,3,11,1,7
E33048148,969,595,164,431,11,87,40,47,268,258,1,9,0,8
E33048149,1377,799,170,629,9,38,13,25,525,481,2,41,1,6
E33048150,360,257,66,191,1,12,4,8,88,84,1,3,0,2
E33048151,347,243,84,159,3,13,4,9,83,82,0,1,0,5
E33048152,303,161,46,115,5,17,5,12,117,112,2,3,0,3
E33048153,377,305,89,216,1,11,6,5,55,50,0,5,0,5
E33048154,504,334,87,247,5,23,8,15,139,133,0,6,0,3
E33048155,302,179,60,119,5,17,6,11,96,85,4,7,0,5
E33048156,234,126,41,85,1,9,3,6,97,90,1,4,2,1
E33048157,749,546,154,392,4,43,18,25,149,135,1,12,1,7
E33048158,356,170,49,121,2,28,8,20,151,145,0,5,1,5
E33048159,257,138,35,103,6,19,7,12,93,80,0,13,0,1
E33048160,314,112,33,79,2,30,9,21,167,155,1,10,1,3
E33048161,442,233,78,155,7,43,15,28,154,144,0,10,0,5
E33048162,461,191,57,134,2,40,17,23,220,214,2,2,2,8
E33048163,254,124,45,79,3,9,0,9,115,111,0,4,0,3
E33048164,459,305,91,214,2,21,6,15,127,110,1,11,5,4
E33048165,245,159,57,102,1,14,3,11,70,69,0,1,0,1
E33048166,336,260,83,177,2,20,4,16,53,47,0,6,0,1
E33048167,303,226,67,159,1,9,2,7,64,61,0,3,0,3
E33048168,511,345,101,244,3,30,10,20,129,118,2,9,0,4
E33048169,305,144,47,97,0,30,7,23,130,115,4,10,1,1
E33048170,331,179,40,139,6,19,3,16,125,114,2,9,0,2
E33048171,404,150,53,97,1,32,16,16,215,207,2,5,1,6
E33048172,323,186,46,140,5,18,6,12,111,99,2,8,2,3
E33048173,359,202,52,150,4,29,11,18,123,119,1,3,0,1
E33048174,479,281,59,222,3,21,11,10,174,149,8,14,3,0
E33048175,417,214,71,143,4,38,13,25,158,150,1,5,2,3
E33048176,221,85,32,53,2,12,3,9,119,116,1,2,0,3
E33048177,496,298,80,218,5,47,25,22,146,135,4,7,0,0
E33048178,337,263,95,168,3,21,9,12,46,36,0,4,6,4
E33048179,374,304,105,199,1,8,3,5,54,46,3,5,0,7
E33048180,327,267,99,168,3,8,2,6,44,41,2,1,0,5
E33048181,580,474,120,354,0,45,32,13,59,47,0,12,0,2
E33048182,518,447,181,266,3,22,9,13,43,38,0,5,0,3
E33048183,348,295,100,195,1,10,6,4,42,33,1,8,0,0
E33048184,458,405,133,272,2,5,2,3,38,36,2,0,0,8
E33048185,497,427,114,313,3,11,3,8,54,50,3,1,0,2
E33048186,445,290,91,199,3,74,36,38,75,72,1,2,0,3
E33048187,739,534,149,385,11,64,32,32,126,116,1,7,2,4
E33048188,440,393,127,266,0,7,4,3,40,37,0,1,2,0
E33048189,364,267,66,201,3,25,14,11,66,56,1,6,3,3
E33048190,327,253,64,189,5,31,14,17,36,32,0,3,1,2
E33048191,850,621,155,466,13,68,22,46,143,132,6,5,0,5
E33048192,294,204,44,160,3,49,38,11,37,31,0,6,0,1
E33048193,590,488,115,373,6,29,18,11,61,55,2,4,0,6
E33048194,406,294,68,226,4,36,15,21,68,57,0,11,0,4
E33048195,453,343,85,258,5,35,26,9,69,55,4,7,3,1
E33048196,221,135,26,109,2,45,32,13,38,31,0,6,1,1
E33048197,468,283,83,200,3,97,70,27,80,70,0,9,1,5
E33048198,530,382,102,280,5,54,34,20,88,77,1,8,2,1
E33048199,290,250,67,183,2,12,4,8,26,21,0,4,1,0
E33048200,343,232,67,165,10,43,29,14,54,48,1,4,1,4
E33048201,347,252,61,191,2,28,16,12,65,59,0,6,0,0
E33048202,285,203,57,146,3,17,11,6,62,58,1,3,0,0
E33048203,271,169,44,125,7,28,19,9,64,58,0,5,1,3
E33048204,274,145,38,107,2,38,6,32,89,81,0,4,4,0
E33048205,408,291,82,209,3,28,12,16,86,81,0,5,0,0
E33048206,1836,1216,373,843,22,53,19,34,533,507,0,20,6,12
E33048207,800,569,149,420,5,70,46,24,149,142,0,6,1,7
E33048208,575,392,103,289,4,33,14,19,142,130,0,11,1,4
E33048209,467,349,79,270,7,23,14,9,88,86,0,2,0,0
E33048210,536,373,88,285,3,41,21,20,112,101,1,8,2,7
E33048211,339,250,75,175,1,17,6,11,69,63,0,5,1,2
E33048212,309,234,62,172,1,24,12,12,48,48,0,0,0,2
E33048213,360,248,62,186,6,29,16,13,74,67,1,6,0,3
E33048214,405,295,84,211,4,27,8,19,73,65,2,4,2,6
E33048215,299,193,47,146,4,20,9,11,80,71,1,8,0,2
E33048216,336,235,93,142,0,40,28,12,58,51,2,2,3,3
E33048217,456,324,93,231,9,29,9,20,88,82,1,5,0,6
E33048218,702,498,136,362,4,56,29,27,138,122,1,12,3,6
E33048219,322,238,74,164,0,19,10,9,58,52,0,6,0,7
E33048220,447,365,104,261,5,20,13,7,54,48,6,0,0,3
E33048221,273,214,55,159,0,11,6,5,46,39,2,5,0,2
E33048222,372,293,71,222,2,23,17,6,51,47,0,4,0,3
E33048223,275,198,45,153,2,12,5,7,62,56,1,4,1,1
E33048224,283,214,79,135,0,5,1,4,62,56,2,3,1,2
E33048225,347,275,104,171,1,12,8,4,54,50,0,4,0,5
E33048226,367,262,68,194,3,16,4,12,84,74,1,9,0,2
E33048227,633,458,121,337,3,38,20,18,129,123,1,3,2,5
E33048228,464,311,88,223,4,38,18,20,106,91,5,10,0,5
E33048229,329,167,48,119,2,116,93,23,43,34,4,3,2,1
E33048230,383,293,93,200,5,29,15,14,55,36,13,2,4,1
E33048231,588,436,111,325,6,44,19,25,99,91,0,7,1,3
E33048232,4288,3154,840,2314,48,243,121,122,824,742,15,55,12,19
E33048233,385,244,69,175,0,29,16,13,103,92,4,7,0,9
E33048234,366,232,71,161,12,49,27,22,66,64,0,1,1,7
E33048235,261,161,48,113,1,18,8,10,77,73,2,2,0,4
E33048236,274,129,41,88,6,50,36,14,81,78,0,3,0,8
E33048237,591,421,107,314,3,64,21,43,99,89,4,4,2,4
E33048238,364,206,70,136,6,32,26,6,107,98,4,3,2,13
E33048239,400,318,89,229,1,16,10,6,64,56,2,4,2,1
E33048240,299,199,45,154,0,58,46,12,39,35,1,2,1,3
E33048241,480,319,81,238,11,44,22,22,103,86,3,11,3,3
E33048242,261,193,74,119,0,8,3,5,58,52,0,4,2,2
E33048243,577,403,104,299,4,30,10,20,136,119,1,14,2,4
E33048244,346,236,80,156,2,19,7,12,89,81,0,6,2,0
E33048245,272,199,59,140,1,7,2,5,61,59,1,1,0,4
E33048246,516,398,133,265,5,45,21,24,62,56,1,5,0,6
E33048247,235,182,60,122,0,6,0,6,41,37,0,1,3,6
E33048248,286,217,86,131,2,7,2,5,55,52,0,3,0,5
E33048249,301,220,76,144,2,12,9,3,66,63,1,2,0,1
E33048250,331,230,59,171,2,13,5,8,84,78,2,3,1,2
E33048251,439,303,118,185,4,11,5,6,116,105,1,8,2,5
E33048252,304,173,80,93,3,20,10,10,106,103,1,2,0,2
E33048253,224,179,69,110,0,10,7,3,32,29,1,2,0,3
E33048254,2483,1774,374,1400,18,83,46,37,597,556,4,35,2,11
E33048255,495,295,122,173,4,24,12,12,163,150,0,11,2,9
E33048256,642,443,127,316,5,38,20,18,148,142,0,5,1,8
E33048257,306,165,70,95,1,32,15,17,106,102,0,4,0,2
E33048258,513,376,129,247,5,30,11,19,94,89,0,5,0,8
E33048259,478,395,126,269,5,35,22,13,42,30,3,3,6,1
E33048260,344,258,60,198,3,36,27,9,46,36,6,3,1,1
E33048261,221,161,56,105,0,12,6,6,33,27,2,2,2,15
E33048262,663,513,150,363,5,50,30,20,91,77,0,8,6,4
E33048263,290,230,86,144,2,15,7,8,40,34,0,3,3,3
E33048264,573,318,65,253,5,198,181,17,48,40,3,3,2,4
E33048265,665,522,174,348,2,56,37,19,80,63,0,10,7,5
E33048266,423,349,67,282,1,23,16,7,44,37,1,4,2,6
E33048267,284,201,43,158,2,56,49,7,23,19,2,2,0,2
E33048268,532,399,121,278,5,66,54,12,60,50,1,8,1,2
E33048269,382,271,76,195,0,39,20,19,68,57,9,2,0,4
E33048270,248,176,36,140,1,40,29,11,30,26,1,3,0,1
E33048271,335,265,64,201,3,30,23,7,35,26,3,6,0,2
E33048272,261,210,61,149,1,17,13,4,30,22,2,6,0,3
E33048273,250,176,46,130,3,32,28,4,35,30,1,4,0,4
E33048274,449,322,54,268,3,70,57,13,50,46,0,4,0,4
E33048275,437,330,59,271,6,51,37,14,48,46,1,0,1,2
E33048276,488,315,75,240,5,96,88,8,65,59,2,2,2,7
E33048277,426,287,73,214,1,90,75,15,44,36,4,4,0,4
E33048278,365,255,63,192,1,51,32,19,56,41,5,6,4,2
E33048279,276,202,71,131,0,21,13,8,39,25,2,2,10,14
E33048280,500,352,104,248,4,54,30,24,84,80,0,4,0,6
E33048281,3619,2671,635,2036,42,261,146,115,623,544,29,35,15,22
E33048282,333,252,76,176,8,17,15,2,51,45,0,6,0,5
E33048283,360,229,63,166,1,31,26,5,87,75,6,5,1,12
E33048284,353,249,75,174,2,41,29,12,58,40,10,6,2,3
E33048285,266,196,62,134,0,25,16,9,45,31,3,10,1,0
E33048286,397,296,70,226,4,31,20,11,64,57,1,4,2,2
E33048287,239,180,48,132,2,28,22,6,26,23,0,3,0,3
E33048288,261,220,68,152,5,6,4,2,28,27,0,1,0,2
E33048289,383,287,63,224,2,19,15,4,70,65,1,2,2,5
E33048290,491,362,96,266,2,44,26,18,81,72,1,8,0,2
E33048291,607,425,123,302,6,41,31,10,124,111,4,8,1,11
E33048292,396,249,46,203,2,44,30,14,98,84,4,10,0,3
E33048293,577,410,87,323,4,92,66,26,65,59,1,5,0,6
E33048294,426,325,52,273,4,38,25,13,56,51,1,3,1,3
E33048295,268,200,36,164,4,24,8,16,35,31,0,3,1,5
E33048296,283,251,59,192,0,5,4,1,26,25,0,1,0,1
E33048297,194,142,32,110,1,16,13,3,35,35,0,0,0,0
E33048298,801,584,149,435,1,115,84,31,101,88,2,10,1,0
E33048299,827,636,183,453,10,46,22,24,133,121,1,8,3,2
E33048300,405,311,79,232,5,33,22,11,53,48,0,5,0,3
E33048301,929,617,140,477,9,87,58,29,213,191,4,15,3,3
E33048302,261,200,55,145,1,23,15,8,35,32,2,1,0,2
E33048303,623,470,118,352,2,49,30,19,100,92,1,5,2,2
E33048304,404,264,49,215,2,29,16,13,109,99,2,8,0,0
E33048305,678,539,150,389,4,47,28,19,86,77,1,7,1,2
E33048306,422,337,105,232,10,25,17,8,45,38,2,5,0,5
E33048307,423,363,101,262,3,17,12,5,39,36,2,1,0,1
E33048308,819,641,129,512,10,33,23,10,135,128,0,7,0,0
E33048309,276,231,64,167,1,8,5,3,36,30,1,5,0,0
E33048310,449,348,75,273,5,18,7,11,77,70,2,5,0,1
E33048311,269,182,41,141,1,21,16,5,65,58,1,5,1,0
E33048312,262,225,42,183,3,5,2,3,27,23,1,3,0,2
E33048313,515,397,86,311,4,28,16,12,84,80,2,0,2,2
E33048314,312,173,44,129,8,24,15,9,104,101,2,1,0,3
E33048315,281,168,34,134,4,16,10,6,93,91,0,2,0,0
E33048316,302,176,55,121,5,11,6,5,106,98,0,5,3,4
E33048317,544,364,101,263,7,54,38,16,117,105,2,8,2,2
E33048318,536,378,87,291,6,38,20,18,111,104,2,4,1,3
E33048319,827,591,185,406,18,124,96,28,89,79,0,9,1,5
E33048320,393,229,52,177,6,95,76,19,60,57,0,1,2,3
E33048321,297,213,49,164,1,24,12,12,57,49,4,4,0,2
E33048322,254,192,55,137,2,19,13,6,40,32,0,2,6,1
E33048323,335,232,58,174,2,31,20,11,63,58,1,4,0,7
E33048324,366,283,82,201,6,37,22,15,39,36,1,2,0,1
E33048325,642,479,124,355,11,41,23,18,108,97,2,9,0,3
E33048326,851,697,154,543,8,40,17,23,106,93,2,8,3,0
E33048327,842,497,81,416,10,70,40,30,259,245,1,12,1,6
E33048328,526,344,90,254,2,34,16,18,143,129,3,8,3,3
E33048329,277,194,45,149,4,13,9,4,66,61,0,5,0,0
E33048330,353,231,59,172,1,14,9,5,107,104,0,2,1,0
E33048331,340,212,54,158,4,79,62,17,42,38,0,3,1,3
E33048332,379,228,43,185,5,103,91,12,39,32,0,7,0,4
E33048333,363,232,54,178,7,79,71,8,42,32,3,5,2,3
E33048334,339,268,79,189,1,26,15,11,41,37,1,2,1,3
E33048335,665,436,107,329,16,55,26,29,156,139,1,13,3,2
E33048336,318,237,71,166,4,13,7,6,63,59,0,4,0,1
E33048337,737,551,167,384,7,48,34,14,129,118,1,8,2,2
E33048338,440,273,58,215,17,24,11,13,122,117,1,3,1,4
E33048339,300,232,54,178,5,38,17,21,21,16,0,3,2,4
E33048340,893,585,143,442,8,160,107,53,133,122,3,7,1,7
E33048341,737,539,116,423,12,76,53,23,101,95,2,2,2,9
E33048342,289,218,54,164,4,37,12,25,30,27,0,1,2,0
E33048343,364,296,93,203,4,28,17,11,33,28,1,4,0,3
E33048344,436,330,89,241,0,66,46,20,38,36,1,1,0,2
E33048345,378,270,80,190,1,33,23,10,73,70,0,3,0,1
E33048346,284,241,74,167,5,12,11,1,25,25,0,0,0,1
E33048347,205,168,50,118,0,7,6,1,30,26,1,3,0,0
E33048348,610,445,119,326,12,61,21,40,88,78,6,4,0,4
E33048349,728,568,184,384,9,65,43,22,78,69,4,4,1,8
E33048350,390,295,96,199,3,37,32,5,52,42,5,4,1,3
E33048351,282,209,63,146,4,32,24,8,31,30,0,1,0,6
E33048352,368,290,88,202,5,30,21,9,41,35,0,4,2,2
E33048353,298,202,63,139,2,36,15,21,49,38,7,3,1,9
E33048354,446,336,127,209,7,43,25,18,56,47,2,2,5,4
E33048355,274,189,21,168,8,16,9,7,59,52,2,3,2,2
E33048356,364,289,101,188,1,19,1,18,49,38,2,4,5,6
E33048357,390,287,125,162,5,29,18,11,63,54,0,9,0,6
E33048358,250,193,68,125,6,15,10,5,33,26,0,7,0,3
E33048359,513,381,147,234,7,42,27,15,72,63,1,5,3,11
E33048360,313,232,108,124,2,14,6,8,63,55,2,5,1,2
E33048361,308,244,82,162,1,16,14,2,45,39,0,5,1,2
E33048362,274,222,91,131,2,7,6,1,38,32,0,6,0,5
E33048363,540,426,201,225,4,25,18,7,75,60,3,8,4,10
E33048364,299,216,97,119,5,34,22,12,41,34,0,7,0,3
E33048365,702,516,161,355,6,42,19,23,125,111,0,11,3,13
E33048366,537,381,174,207,6,34,17,17,105,93,2,8,2,11
E33048367,559,407,148,259,9,45,26,19,92,81,1,9,1,6
E33048368,630,491,176,315,10,37,24,13,85,71,1,12,1,7
E33048369,232,159,72,87,4,13,10,3,55,45,5,4,1,1
E33048370,793,554,188,366,6,102,74,28,126,109,4,12,1,5
E33048371,502,322,124,198,3,72,38,34,102,92,1,9,0,3
E33048372,614,439,143,296,3,52,27,25,110,96,3,11,0,10
E33048373,487,321,135,186,2,61,37,24,98,85,0,13,0,5
E33048374,281,195,81,114,2,30,21,9,50,44,0,3,3,4
E33048375,565,436,122,314,5,46,32,14,76,61,1,13,1,2
E33048376,360,262,89,173,6,47,33,14,43,39,0,4,0,2
E33048377,688,522,183,339,4,58,44,14,100,92,0,8,0,4
E33048378,423,255,88,167,3,71,51,20,91,80,0,9,2,3
E33048379,431,346,107,239,3,12,8,4,65,58,3,2,2,5
E33048380,536,420,150,270,8,17,11,6,85,77,3,5,0,6
E33048381,292,225,88,137,2,18,11,7,41,35,0,4,2,6
E33048382,370,260,118,142,0,19,13,6,81,71,2,7,1,10
E33048383,281,209,95,114,3,15,9,6,47,41,0,5,1,7
E33048384,299,213,91,122,1,21,17,4,58,53,1,3,1,6
E33048385,253,170,92,78,2,32,29,3,48,38,3,7,0,1
E33048386,277,196,80,116,0,14,9,5,59,51,2,5,1,8
E33048387,243,164,49,115,2,30,14,16,39,31,3,4,1,8
E33048388,570,449,134,315,6,55,42,13,59,50,0,7,2,1
E33048389,396,290,92,198,10,37,25,12,56,46,3,7,0,3
E33048390,371,255,94,161,4,51,30,21,59,49,1,7,2,2
E33048391,315,220,62,158,3,31,19,12,60,58,0,1,1,1
E33048392,543,430,146,284,5,30,26,4,73,65,1,5,2,5
E33048393,329,257,49,208,8,25,13,12,37,32,0,4,1,2
E33048394,591,412,177,235,3,55,43,12,109,92,1,14,2,12
E33048395,274,209,91,118,2,14,9,5,45,37,2,5,1,4
E33048396,292,225,111,114,3,25,19,6,31,19,1,11,0,8
E33048397,367,274,94,180,0,35,31,4,54,45,4,4,1,4
E33048398,233,162,98,64,3,31,17,14,33,25,2,6,0,4
E33048399,275,173,85,88,2,20,14,6,70,62,3,5,0,10
E33048400,365,230,102,128,2,74,50,24,54,36,5,9,4,5
E33048401,382,257,83,174,1,46,21,25,73,56,1,8,8,5
E33048402,252,173,49,124,0,30,17,13,48,40,4,3,1,1
E33048403,524,372,103,269,4,55,34,21,87,82,1,3,1,6
E33048404,375,288,80,208,2,19,12,7,65,50,6,6,3,1
E33048405,330,232,73,159,1,30,21,9,59,46,5,3,5,8
E33048406,280,208,87,121,0,19,15,4,52,47,0,4,1,1
E33048407,640,416,174,242,11,76,42,34,120,105,4,9,2,17
E33048408,519,341,131,210,3,32,24,8,133,115,6,11,1,10
E33048409,278,206,92,114,3,16,9,7,49,39,0,8,2,4
E33048410,297,221,85,136,1,24,14,10,45,41,1,3,0,6
E33048411,373,275,117,158,1,24,17,7,71,66,1,4,0,2
E33048412,235,184,51,133,0,18,14,4,30,24,1,4,1,3
E33048413,216,148,75,73,1,11,7,4,52,44,0,8,0,4
E33048414,623,444,170,274,2,70,35,35,103,94,1,7,1,4
E33048415,321,225,75,150,10,14,5,9,69,62,0,7,0,3
E33048416,348,258,102,156,4,16,8,8,68,58,3,6,1,2
E33048417,378,279,103,176,4,29,17,12,57,45,5,5,2,9
E33048418,563,357,137,220,8,57,45,12,134,118,2,11,3,7
E33048419,273,199,85,114,1,17,6,11,47,37,2,8,0,9
E33048420,290,207,79,128,1,28,15,13,51,44,0,3,4,3
E33048421,334,225,108,117,1,36,17,19,65,47,7,8,3,7
E33048422,631,434,197,237,2,46,28,18,132,113,2,13,4,17
E33048423,492,339,130,209,6,48,33,15,94,86,0,4,4,5
E33048424,497,352,144,208,7,26,14,12,95,85,2,8,0,17
E33048425,376,258,105,153,3,11,5,6,96,79,3,14,0,8
E33048426,315,237,92,145,4,22,10,12,49,40,0,9,0,3
E33048427,469,333,117,216,7,27,8,19,97,86,2,9,0,5
E33048428,276,190,89,101,4,28,16,12,48,43,0,3,2,6
E33048429,486,343,114,229,7,34,14,20,96,80,0,10,6,6
E33048430,656,492,149,343,1,47,25,22,99,91,5,3,0,17
E33048431,334,243,79,164,2,37,21,16,48,46,0,2,0,4
E33048432,308,232,56,176,3,33,27,6,38,33,0,4,1,2
E33048433,371,247,91,156,7,36,24,12,79,68,2,9,0,2
E33048434,530,373,113,260,3,60,40,20,90,79,2,8,1,4
E33048435,253,176,68,108,3,19,10,9,53,48,0,5,0,2
E33048436,312,197,65,132,2,58,43,15,48,46,0,2,0,7
E33048437,232,164,57,107,0,25,17,8,42,37,1,4,0,1
E33048438,373,217,85,132,1,61,44,17,89,84,0,4,1,5
E33048439,323,268,78,190,4,12,5,7,38,36,0,2,0,1
E33048440,636,484,143,341,7,42,12,30,98,86,0,11,1,5
E33048441,295,211,72,139,4,19,10,9,57,44,0,9,4,4
E33048442,243,162,56,106,4,22,11,11,53,49,1,3,0,2
E33048443,304,190,58,132,2,34,16,18,77,70,2,4,1,1
E33048444,369,260,77,183,4,24,13,11,78,68,1,9,0,3
E33048445,247,190,67,123,0,20,9,11,36,32,1,3,0,1
E33048446,319,191,65,126,4,23,11,12,98,94,0,4,0,3
E33048447,484,367,160,207,2,21,15,6,84,71,3,8,2,10
E33048448,498,366,146,220,6,20,11,9,101,91,2,8,0,5
E33048449,361,289,117,172,3,19,12,7,49,42,0,7,0,1
E33048450,375,252,117,135,8,27,22,5,82,79,0,3,0,6
E33048451,540,381,138,243,4,36,17,19,112,104,0,7,1,7
E33048452,216,113,54,59,1,23,17,6,67,52,9,5,1,12
E33048453,701,483,159,324,5,57,41,16,145,133,2,5,5,11
E33048454,283,205,101,104,4,13,8,5,54,48,2,4,0,7
E33048455,372,233,118,115,8,53,33,20,67,52,8,6,1,11
E33048456,575,381,177,204,4,54,29,25,109,94,1,10,4,27
E33048457,331,189,98,91,5,60,32,28,77,54,19,4,0,0
E33048458,397,267,100,167,2,52,32,20,67,62,0,2,3,9
E33048459,536,408,152,256,6,44,20,24,73,64,2,7,0,5
E33048460,253,193,80,113,1,16,11,5,37,30,4,3,0,6
E33048461,283,223,87,136,1,14,9,5,40,36,1,3,0,5
E33048462,376,260,113,147,3,25,15,10,83,67,3,12,1,5
E33048463,349,269,137,132,2,21,20,1,57,42,0,8,7,0
E33048464,287,193,58,135,3,37,26,11,53,45,0,6,2,1
E33048465,349,232,60,172,2,46,34,12,69,59,0,10,0,0
E33048466,492,335,116,219,7,31,16,15,113,105,1,5,2,6
E33048467,460,312,111,201,13,44,22,22,88,79,3,5,1,3
E33048468,388,234,70,164,5,28,13,15,118,103,0,12,3,3
E33048469,342,257,86,171,4,34,27,7,42,37,3,1,1,5
E33048470,278,190,72,118,1,31,22,9,53,48,3,2,0,3
E33048471,256,186,57,129,2,34,25,9,30,26,0,4,0,4
E33048472,556,322,101,221,9,57,40,17,162,141,0,17,4,6
E33048473,361,238,90,148,2,56,50,6,61,55,0,6,0,4
E33048474,236,139,57,82,0,13,5,8,78,74,0,3,1,6
E33048475,417,251,56,195,3,73,61,12,89,82,0,7,0,1
E33048476,321,228,84,144,4,23,19,4,65,56,4,5,0,1
E33048477,237,152,55,97,1,20,11,9,62,56,2,4,0,2
E33048478,432,222,66,156,5,51,36,15,146,133,1,11,1,8
E33048479,1098,822,265,557,9,90,64,26,173,150,1,15,7,4
E33048480,243,160,52,108,1,16,10,6,65,60,2,1,2,1
E33048481,805,599,217,382,7,42,22,20,151,137,1,11,2,6
E33048482,322,234,82,152,1,18,11,7,64,57,0,6,1,5
E33048483,329,269,109,160,1,15,12,3,43,39,1,3,0,1
E33048484,419,322,103,219,6,30,15,15,58,48,2,5,3,3
E33048485,308,241,99,142,2,19,12,7,40,36,0,3,1,6
E33048486,614,465,190,275,2,17,5,12,120,90,6,17,7,10
E33048487,436,344,134,210,4,30,13,17,54,45,5,4,0,4
E33048488,314,234,69,165,9,14,3,11,53,49,0,4,0,4
E33048489,458,358,121,237,2,44,21,23,51,45,0,6,0,3
E33048490,590,443,155,288,3,35,9,26,103,96,0,5,2,6
E33048491,414,260,103,157,2,81,24,57,69,62,3,4,0,2
E33048492,600,430,153,277,7,48,21,27,109,95,0,11,3,6
E33048493,282,208,69,139,3,15,7,8,53,47,1,5,0,3
E33048494,295,234,84,150,3,9,4,5,45,43,0,2,0,4
E33048495,385,289,98,191,2,21,8,13,73,64,0,7,2,0
E33048496,435,319,106,213,7,20,5,15,81,68,5,8,0,8
E33048497,310,247,93,154,0,22,10,12,41,34,0,6,1,0
E33048498,613,454,173,281,1,49,12,37,100,78,6,10,6,9
E33048499,560,453,179,274,2,18,8,10,79,67,1,10,1,8
E33048500,952,703,230,473,5,77,26,51,160,141,2,16,1,7
E33048501,374,297,106,191,1,24,9,15,49,44,0,5,0,3
E33048502,325,251,77,174,1,18,3,15,54,48,0,6,0,1
E33048503,589,460,165,295,3,33,11,22,88,80,1,7,0,5
E33048504,437,297,110,187,1,31,12,19,106,93,2,10,1,2
E33048505,565,424,126,298,5,29,5,24,102,86,5,9,2,5
E33048506,708,494,170,324,0,69,22,47,142,130,1,10,1,3
E33048507,510,387,116,271,3,29,6,23,81,72,0,9,0,10
E33048508,349,233,77,156,3,38,14,24,72,62,0,9,1,3
E33048509,354,278,90,188,3,33,5,28,40,34,2,4,0,0
E33048510,617,478,155,323,3,39,10,29,93,82,2,9,0,4
E33048511,461,340,115,225,4,29,9,20,84,69,0,11,4,4
E33048512,325,240,69,171,3,12,4,8,60,53,0,6,1,10
E33048513,284,226,85,141,1,16,9,7,34,28,2,3,1,7
E33048514,297,224,87,137,2,28,12,16,39,34,1,4,0,4
E33048515,372,263,94,169,3,44,13,31,62,57,1,4,0,0
E33048516,344,264,96,168,1,28,9,19,43,39,0,4,0,8
E33048517,254,199,92,107,3,9,3,6,41,37,1,3,0,2
E33048518,449,353,158,195,2,24,6,18,60,48,3,8,1,10
E33048519,269,202,89,113,0,22,7,15,39,30,1,8,0,6
E33048520,407,333,134,199,6,11,3,8,49,42,2,5,0,8
E33048521,481,374,140,234,2,32,1,31,69,58,0,11,0,4
E33048522,235,193,75,118,1,12,6,6,27,23,0,4,0,2
E33048523,313,235,103,132,0,19,10,9,56,53,0,1,2,3
E33048524,237,175,77,98,3,15,8,7,43,40,1,2,0,1
E33048525,555,373,104,269,7,35,20,15,135,116,1,13,5,5
E33048526,393,296,155,141,1,26,13,13,57,46,1,6,4,13
E33048527,321,219,105,114,3,29,16,13,67,61,0,5,1,3
E33048528,342,267,112,155,4,22,16,6,45,30,6,7,2,4
E33048529,312,244,127,117,3,12,3,9,47,38,2,5,2,6
E33048530,283,219,87,132,0,22,14,8,39,33,0,4,2,3
E33048531,295,212,71,141,0,25,7,18,53,44,6,2,1,5
E33048532,303,225,64,161,2,12,3,9,57,50,3,3,1,7
E33048533,899,645,202,443,5,74,18,56,172,143,8,20,1,3
E33048534,359,293,110,183,2,14,3,11,47,36,3,8,0,3
E33048535,321,228,78,150,0,32,11,21,56,44,4,7,1,5
E33048536,609,448,154,294,7,54,17,37,94,87,2,4,1,6
E33048537,337,239,81,158,2,25,6,19,69,57,8,3,1,2
E33048538,537,350,118,232,1,42,8,34,138,111,10,6,11,6
E33048539,269,182,63,119,1,26,6,20,59,31,12,4,12,1
E33048540,290,216,93,123,2,17,4,13,50,39,5,6,0,5
E33048541,398,291,115,176,1,36,7,29,65,59,5,1,0,5
E33048542,284,199,80,119,4,29,6,23,49,43,1,4,1,3
E33048543,360,281,130,151,2,22,5,17,49,41,3,5,0,6
E33048544,319,245,122,123,4,17,2,15,49,40,3,5,1,4
E33048545,276,217,121,96,1,12,2,10,39,36,1,2,0,7
E33048546,322,234,113,121,0,32,5,27,48,36,5,3,4,8
E33048547,303,230,100,130,2,28,10,18,40,31,3,6,0,3
E33048548,218,181,89,92,0,7,1,6,23,17,1,5,0,7
E33048549,415,288,146,142,0,55,10,45,65,55,3,5,2,7
E33048550,252,179,94,85,0,25,9,16,42,29,3,8,2,6
E33048551,342,243,120,123,8,17,4,13,59,50,6,1,2,15
E33048552,3289,2404,614,1790,19,150,40,110,694,377,196,35,86,22
E33048553,418,305,155,150,1,43,11,32,63,53,3,6,1,6
E33048554,424,263,99,164,10,66,23,43,85,77,1,7,0,0
E33048555,501,354,137,217,9,59,36,23,76,68,0,8,0,3
E33048556,437,306,125,181,7,37,21,16,80,70,1,9,0,7
E33048557,364,278,102,176,2,22,17,5,57,48,1,7,1,5
E33048558,306,205,81,124,5,25,14,11,59,49,1,9,0,12
E33048559,251,185,89,96,0,21,15,6,42,40,0,2,0,3
E33048560,270,184,70,114,5,21,10,11,59,47,2,9,1,1
E33048561,315,221,85,136,6,35,13,22,46,39,0,7,0,7
E33048562,286,210,93,117,1,14,8,6,58,50,2,3,3,3
E33048563,363,276,112,164,3,15,7,8,57,49,2,6,0,12
E33048564,283,226,127,99,0,10,3,7,40,34,0,6,0,7
E33048565,341,273,140,133,6,15,5,10,38,30,1,7,0,9
E33048566,272,210,115,95,1,8,7,1,44,39,0,5,0,9
E33048567,681,505,238,267,4,51,28,23,92,76,7,9,0,29
E33048568,298,219,131,88,1,25,13,12,49,45,1,3,0,4
E33048569,313,237,111,126,1,21,13,8,51,40,4,4,3,3
E33048570,358,292,159,133,4,12,5,7,47,36,1,8,2,3
E33048571,279,191,81,110,0,31,14,17,53,44,0,8,1,4
E33048572,248,173,92,81,1,17,12,5,51,46,0,3,2,6
E33048573,349,268,128,140,3,24,15,9,49,42,2,4,1,5
E33048574,304,240,113,127,0,22,12,10,39,34,0,4,1,3
E33048575,327,251,113,138,1,16,9,7,52,50,0,2,0,7
E33048576,365,274,127,147,2,25,13,12,57,53,1,3,0,7
E33048577,576,399,166,233,3,56,32,24,106,91,2,12,1,12
E33048578,325,214,73,141,5,41,20,21,63,58,0,5,0,2
E33048579,267,214,117,97,1,12,9,3,31,21,2,6,2,9
E33048580,280,215,112,103,0,13,4,9,48,36,3,6,3,4
E33048581,284,218,108,110,0,9,5,4,50,36,1,12,1,7
E33048582,362,254,130,124,1,19,15,4,79,72,0,5,2,9
E33048583,219,156,38,118,3,10,6,4,47,40,1,4,2,3
E33048584,407,307,132,175,3,20,8,12,72,64,0,7,1,5
E33048585,285,218,51,167,1,18,9,9,48,43,1,4,0,0
E33048586,290,172,50,122,1,46,36,10,61,53,0,8,0,10
E33048587,373,242,76,166,5,29,18,11,94,82,2,10,0,3
E33048588,484,349,132,217,5,25,15,10,98,92,1,3,2,7
E33048589,320,206,68,138,4,26,18,8,83,77,3,3,0,1
E33048590,265,206,88,118,1,12,7,5,44,41,2,1,0,2
E33048591,348,288,163,125,3,5,4,1,47,38,1,6,2,5
E33048592,320,229,102,127,6,18,9,9,64,54,3,7,0,3
E33048593,471,382,158,224,5,11,9,2,63,51,0,11,1,10
E33048594,364,248,98,150,5,35,27,8,73,67,0,5,1,3
E33048595,260,188,95,93,2,8,4,4,58,55,0,3,0,4
E33048596,726,565,220,345,1,28,12,16,118,96,1,21,0,14
E33048597,250,155,69,86,2,43,29,14,45,37,2,6,0,5
E33048598,663,433,198,235,4,84,51,33,129,110,3,16,0,13
E33048599,265,172,86,86,1,33,22,11,50,43,1,6,0,9
E33048600,297,178,88,90,6,30,19,11,72,62,4,4,2,11
E33048601,336,232,123,109,1,28,16,12,55,48,4,3,0,20
E33048602,293,208,108,100,0,28,23,5,51,43,6,0,2,6
E33048603,307,229,90,139,3,24,8,16,51,42,1,6,2,0
E33048604,282,197,74,123,2,39,22,17,42,33,2,7,0,2
E33048605,257,182,84,98,3,18,12,6,50,39,0,6,5,4
E33048606,314,208,101,107,0,39,23,16,66,56,4,6,0,1
E33048607,363,256,131,125,1,18,11,7,81,65,6,6,4,7
E33048608,369,256,106,150,3,32,24,8,73,71,0,2,0,5
E33048609,340,216,84,132,5,71,53,18,43,40,0,3,0,5
E33048610,219,150,71,79,0,27,17,10,35,28,2,4,1,7
E33048611,317,230,91,139,1,41,35,6,44,31,3,8,2,1
E33048612,352,271,122,149,3,28,18,10,46,43,0,3,0,4
E33048613,338,231,87,144,6,39,26,13,56,43,2,10,1,6
E33048614,310,221,80,141,1,29,20,9,56,51,0,5,0,3
E33048615,309,231,79,152,1,30,8,22,44,36,3,5,0,3
E33048616,292,229,121,108,2,22,19,3,35,28,1,5,1,4
E33048617,451,318,155,163,2,31,21,10,84,70,3,10,1,16
E33048618,314,254,146,108,3,10,6,4,38,32,0,4,2,9
E33048619,444,331,128,203,2,41,29,12,67,55,3,8,1,3
E33048620,426,309,155,154,4,23,12,11,74,61,2,8,3,16
E33048621,561,384,123,261,3,47,32,15,126,103,9,14,0,1
E33048622,247,187,60,127,1,12,7,5,46,41,2,3,0,1
E33048623,506,336,107,229,2,55,38,17,108,93,1,14,0,5
E33048624,685,513,115,398,6,52,30,22,110,95,4,10,1,4
E33048625,293,234,73,161,2,9,4,5,47,34,8,5,0,1
E33048626,300,190,48,142,3,34,29,5,67,63,0,3,1,6
E33048627,330,225,80,145,3,29,20,9,66,58,1,4,3,7
E33048628,424,304,84,220,1,62,44,18,54,43,2,9,0,3
E33048629,377,235,83,152,2,71,52,19,68,61,1,6,0,1
E33048630,868,621,183,438,13,91,55,36,133,119,1,9,4,10
E33048631,338,232,73,159,3,55,40,15,48,41,0,7,0,0
E33048632,395,242,105,137,7,67,4,63,79,66,3,10,0,0
E33048633,297,201,73,128,1,41,4,37,51,46,1,4,0,3
E33048634,306,219,74,145,7,28,8,20,51,42,0,7,2,1
E33048635,279,207,85,122,2,19,7,12,49,43,1,5,0,2
E33048636,390,301,130,171,2,32,2,30,47,42,0,5,0,8
E33048637,405,257,99,158,5,48,16,32,85,67,7,9,2,10
E33048638,614,411,152,259,2,45,8,37,148,133,5,10,0,8
E33048639,323,231,71,160,2,15,1,14,63,52,0,7,4,12
E33048640,257,170,79,91,3,19,1,18,59,52,1,5,1,6
E33048641,456,316,100,216,7,46,9,37,81,63,1,15,2,6
E33048642,425,331,126,205,4,27,11,16,59,47,2,5,5,4
E33048643,316,218,81,137,4,42,9,33,46,36,1,9,0,6
E33048644,355,263,85,178,3,41,4,37,45,43,0,2,0,3
E33048645,264,205,69,136,6,10,2,8,43,41,0,2,0,0
E33048646,255,184,69,115,1,23,7,16,44,36,2,6,0,3
E33048647,509,336,116,220,9,57,11,46,102,90,0,8,4,5
E33048648,315,200,74,126,6,43,14,29,62,57,0,5,0,4
E33048649,295,198,71,127,1,32,4,28,61,48,7,5,1,3
E33048650,286,227,109,118,2,5,1,4,49,43,1,2,3,3
E33048651,719,545,209,336,6,63,12,51,96,81,1,13,1,9
E33048652,289,215,90,125,3,19,2,17,47,37,2,7,1,5
E33048653,296,214,113,101,1,13,2,11,63,56,0,6,1,5
E33048654,310,220,73,147,5,8,2,6,76,63,1,11,1,1
E33048655,265,189,73,116,5,9,0,9,53,46,1,6,0,9
E33048656,225,159,71,88,3,25,5,20,35,32,1,2,0,3
E33048657,427,273,115,158,1,35,8,27,98,83,3,8,4,20
E33048658,229,173,76,97,3,14,1,13,34,27,0,4,3,5
E33048659,390,280,117,163,3,22,4,18,78,67,0,9,2,7
E33048660,276,181,79,102,5,19,7,12,71,60,4,7,0,0
E33048661,350,223,111,112,2,27,7,20,95,89,0,5,1,3
E33048662,263,170,60,110,2,18,3,15,59,50,1,8,0,14
E33048663,366,223,110,113,1,30,5,25,99,82,6,9,2,13
E33048664,348,245,144,101,5,31,7,24,57,49,0,7,1,10
E33048665,590,395,161,234,4,57,5,52,126,109,5,11,1,8
E33048666,319,241,121,120,1,11,0,11,54,49,2,3,0,12
E33048667,268,177,75,102,9,35,4,31,45,40,1,4,0,2
E33048668,247,190,74,116,0,17,1,16,36,31,0,2,3,4
E33048669,505,378,132,246,7,52,8,44,62,54,1,7,0,6
E33048670,708,462,172,290,4,97,10,87,137,118,3,15,1,8
E33048671,241,175,69,106,1,12,2,10,49,36,9,4,0,4
E33048672,245,176,81,95,1,24,1,23,35,29,1,4,1,9
E33048673,309,197,67,130,4,58,9,49,48,43,0,5,0,2
E33048674,347,252,99,153,1,45,4,41,43,38,2,1,2,6
E33048675,336,226,80,146,4,37,7,30,64,59,0,5,0,5
E33048676,504,362,128,234,5,62,3,59,72,62,4,5,1,3
E33048677,310,185,64,121,0,35,3,32,84,78,2,4,0,6
E33048678,237,160,70,90,0,17,3,14,54,51,0,3,0,6
E33048679,261,186,59,127,0,19,3,16,52,48,1,1,2,4
E33048680,384,207,82,125,3,43,6,37,127,105,4,15,3,4
E33048681,345,205,75,130,2,26,5,21,89,73,1,13,2,23
E33048682,430,303,120,183,6,40,3,37,75,71,1,3,0,6
E33048683,390,283,142,141,2,26,6,20,69,62,0,7,0,10
E33048684,488,348,140,208,0,36,10,26,96,84,0,10,2,8
E33048685,430,319,158,161,2,21,2,19,75,61,1,8,5,13
E33048686,366,234,108,126,7,46,3,43,61,48,1,12,0,18
E33048687,289,193,84,109,1,49,13,36,44,37,0,5,2,2
E33048688,255,182,72,110,0,17,3,14,54,50,0,4,0,2
E33048689,435,314,136,178,2,28,4,24,75,70,1,2,2,16
E33048690,239,162,69,93,1,18,6,12,54,51,1,2,0,4
E33048691,478,351,141,210,1,46,7,39,75,65,0,7,3,5
E33048692,420,312,80,232,1,28,6,22,73,63,3,4,3,6
E33048693,267,168,62,106,1,10,3,7,84,67,12,3,2,4
E33048694,307,191,69,122,2,20,5,15,90,76,9,3,2,4
E33048695,546,350,118,232,4,20,6,14,162,132,8,20,2,10
E33048696,593,388,110,278,6,74,34,40,120,112,1,6,1,5
E33048697,554,388,135,253,9,38,18,20,111,100,0,10,1,8
E33048698,404,274,93,181,4,22,3,19,97,84,2,8,3,7
E33048699,420,257,90,167,2,17,5,12,135,116,2,11,6,9
E33048700,309,210,90,120,4,9,4,5,71,62,1,8,0,15
E33048701,809,558,178,380,11,77,28,49,157,136,2,18,1,6
E33048702,413,287,132,155,3,23,8,15,94,77,4,10,3,6
E33048703,400,286,99,187,3,26,8,18,81,74,0,7,0,4
E33048704,352,257,83,174,3,22,6,16,66,47,2,14,3,4
E33048705,466,306,81,225,6,50,13,37,97,83,1,13,0,7
E33048706,359,245,66,179,4,18,1,17,85,73,3,9,0,7
E33048707,231,159,64,95,3,7,1,6,60,48,4,4,4,2
E33048708,327,218,69,149,0,17,6,11,88,82,2,4,0,4
E33048709,310,171,53,118,2,18,6,12,116,104,1,6,5,3
E33048710,397,259,64,195,6,31,6,25,96,80,4,10,2,5
E33048711,289,193,53,140,2,16,2,14,75,67,3,5,0,3
E33048712,308,217,61,156,9,15,3,12,65,49,5,7,4,2
E33048713,513,332,101,231,7,33,6,27,137,120,10,6,1,4
E33048714,348,260,64,196,4,10,0,10,71,55,2,10,4,3
E33048715,302,232,61,171,2,21,6,15,45,35,3,7,0,2
E33048716,512,405,109,296,1,15,1,14,87,74,3,10,0,4
E33048717,371,285,79,206,3,23,10,13,59,51,1,5,2,1
E33048718,439,316,92,224,4,29,7,22,86,70,0,16,0,4
E33048719,312,233,101,132,0,12,3,9,63,53,2,7,1,4
E33048720,460,399,154,245,2,18,7,11,41,33,0,7,1,0
E33048721,353,231,86,145,6,59,19,40,54,48,1,5,0,3
E33048722,383,285,100,185,8,23,5,18,60,50,4,6,0,7
E33048723,625,489,163,326,4,44,16,28,83,78,1,2,2,5
E33048724,595,390,156,234,5,50,20,30,145,123,3,17,2,5
E33048725,598,438,158,280,3,41,15,26,109,96,1,10,2,7
E33048726,358,272,97,175,2,36,11,25,45,39,0,5,1,3
E33048727,398,312,95,217,2,15,7,8,66,59,0,6,1,3
E33048728,311,248,120,128,1,18,2,16,35,27,5,3,0,9
E33048729,207,160,67,93,0,10,5,5,34,29,0,3,2,3
E33048730,243,188,73,115,2,14,5,9,36,34,0,1,1,3
E33048731,295,240,85,155,1,10,2,8,42,25,5,9,3,2
E33048732,266,192,93,99,1,9,1,8,62,58,0,3,1,2
E33048733,337,267,89,178,5,17,6,11,46,43,1,2,0,2
E33048734,340,273,97,176,2,19,5,14,44,39,1,3,1,2
E33048735,313,241,80,161,4,19,5,14,46,44,0,2,0,3
E33048736,542,437,133,304,12,22,4,18,66,58,0,8,0,5
E33048737,294,213,93,120,4,40,14,26,34,31,0,3,0,3
E33048738,777,557,195,362,10,32,4,28,169,147,1,19,2,9
E33048739,341,233,66,167,2,38,11,27,66,60,0,5,1,2
E33048740,298,237,86,151,3,13,4,9,42,36,0,6,0,3
E33048741,321,235,77,158,0,15,4,11,71,60,2,8,1,0
E33048742,392,286,85,201,4,28,10,18,71,65,0,6,0,3
E33048743,299,197,78,119,1,15,5,10,82,72,0,10,0,4
E33048744,359,263,98,165,3,25,7,18,64,57,1,3,3,4
E33048745,364,267,98,169,2,23,9,14,70,60,0,9,1,2
E33048746,467,324,130,194,6,32,4,28,103,94,2,6,1,2
E33048747,339,264,85,179,1,17,5,12,52,47,0,5,0,5
E33048748,349,283,71,212,1,21,5,16,38,29,2,6,1,6
E33048749,392,303,74,229,4,21,4,17,61,55,0,6,0,3
E33048750,429,328,127,201,7,14,3,11,76,61,1,13,1,4
E33048751,873,702,226,476,8,46,6,40,116,99,4,11,2,1
E33048752,333,255,92,163,5,20,7,13,53,44,0,9,0,0
E33048753,706,557,188,369,9,31,6,25,104,83,0,17,4,5
E33048754,879,637,224,413,6,76,16,60,150,135,3,11,1,10
E33048755,321,243,75,168,4,22,3,19,50,42,1,7,0,2
E33048756,228,165,57,108,4,15,3,12,41,37,1,3,0,3
E33048757,420,286,85,201,4,39,14,25,89,78,1,10,0,2
E33048758,366,275,94,181,5,28,10,18,57,49,0,6,2,1
E33048759,731,517,143,374,17,54,18,36,140,126,0,12,2,3
E33048760,535,363,103,260,9,56,12,44,106,94,1,10,1,1
E33048761,408,289,104,185,2,44,18,26,67,59,3,5,0,6
E33048762,378,259,124,135,2,15,5,10,81,66,6,9,0,21
E33048763,283,181,78,103,0,9,2,7,89,72,2,15,0,4
E33048764,359,256,126,130,5,19,11,8,69,54,6,6,3,10
E33048765,429,329,142,187,1,25,14,11,67,57,0,8,2,7
E33048766,370,279,102,177,1,18,8,10,63,48,5,5,5,9
E33048767,359,258,109,149,3,24,8,16,68,59,1,6,2,6
E33048768,280,226,132,94,2,20,11,9,27,19,1,7,0,5
E33048769,457,354,212,142,3,32,14,18,63,51,2,10,0,5
E33048770,766,565,203,362,11,58,31,27,115,101,4,9,1,17
E33048771,407,295,140,155,0,24,21,3,77,64,1,12,0,11
E33048772,255,203,116,87,1,7,3,4,35,32,2,1,0,9
E33048773,267,189,70,119,2,33,22,11,38,35,1,1,1,5
E33048774,416,328,116,212,0,21,14,7,66,62,0,1,3,1
E33048775,425,288,85,203,2,25,19,6,102,95,0,6,1,8
E33048776,270,195,76,119,0,27,21,6,43,41,0,1,1,5
E33048777,272,200,70,130,4,22,16,6,43,40,0,3,0,3
E33048778,286,212,73,139,2,26,18,8,44,37,0,5,2,2
E33048779,265,204,64,140,0,24,11,13,35,31,0,3,1,2
E33048780,406,276,91,185,3,63,39,24,60,55,0,5,0,4
E33048781,886,623,159,464,5,71,43,28,182,168,1,12,1,5
E33048782,350,273,92,181,1,26,13,13,47,46,0,1,0,3
E33048783,520,388,173,215,3,47,42,5,76,69,0,7,0,6
E33048784,426,333,121,212,6,23,12,11,58,47,2,8,1,6
E33048785,323,255,93,162,1,19,10,9,44,38,2,4,0,4
E33048786,323,216,105,111,4,17,12,5,72,64,6,1,1,14
E33048787,423,279,110,169,3,24,18,6,99,86,2,8,3,18
E33048788,394,326,127,199,1,17,10,7,47,42,0,5,0,3
E33048789,315,249,117,132,1,22,18,4,39,30,7,2,0,4
E33048790,372,294,143,151,0,29,8,21,45,38,0,6,1,4
E33048791,359,288,114,174,2,28,17,11,38,36,0,2,0,3
E33048792,307,217,100,117,3,35,23,12,48,42,1,4,1,4
E33048793,306,218,91,127,0,29,21,8,54,41,1,12,0,5
E33048794,1146,783,262,521,9,182,128,54,162,141,9,11,1,10
E33048795,580,445,181,264,3,50,29,21,72,55,3,14,0,10
E33048796,287,223,103,120,1,20,14,6,42,40,0,2,0,1
E33048797,592,383,126,257,4,80,49,31,116,110,0,6,0,9
E33048798,343,248,106,142,1,28,16,12,59,45,6,5,3,7
E33048799,318,235,88,147,3,20,11,9,53,46,2,0,5,7
E33048800,223,155,42,113,5,23,15,8,38,36,0,2,0,2
E33048801,381,284,76,208,1,28,21,7,65,59,1,3,2,3
E33048802,356,292,144,148,1,21,13,8,36,35,0,1,0,6
E33048803,307,230,106,124,3,34,18,16,37,31,3,1,2,3
E33048804,306,208,97,111,0,55,40,15,41,39,2,0,0,2
E33048805,497,358,192,166,1,43,28,15,83,71,1,7,4,12
E33048806,390,311,136,175,5,29,18,11,39,24,3,9,3,6
E33048807,463,299,144,155,3,45,23,22,95,74,3,16,2,21
E33048808,469,379,178,201,6,22,18,4,54,38,2,8,6,8
E33048809,682,498,172,326,10,58,45,13,112,93,7,12,0,4
E33048810,627,451,169,282,2,51,41,10,114,102,0,11,1,9
E33048811,317,257,90,167,2,11,10,1,45,40,1,4,0,2
E33048812,241,170,77,93,4,22,19,3,41,35,1,4,1,4
E33048813,363,249,121,128,3,40,20,20,67,54,4,5,4,4
E33048814,309,224,102,122,0,28,14,14,48,40,1,7,0,9
E33048815,790,558,258,300,7,57,41,16,146,125,8,9,4,22
E33048816,266,216,102,114,2,15,13,2,29,24,2,3,0,4
E33048817,241,205,96,109,2,9,8,1,24,23,0,1,0,1
E33048818,266,199,77,122,2,24,14,10,40,36,0,2,2,1
E33048819,512,320,133,187,2,59,25,34,123,112,7,4,0,8
E33048820,465,288,121,167,3,47,25,22,123,108,2,12,1,4
E33048821,329,238,111,127,1,29,14,15,56,51,1,4,0,5
E33048822,459,336,145,191,2,39,27,12,80,73,1,5,1,2
E33048823,257,193,75,118,1,30,22,8,30,28,0,2,0,3
E33048824,379,306,110,196,0,29,24,5,41,39,0,2,0,3
E33048825,356,259,110,149,1,34,24,10,59,46,1,9,3,3
E33048826,394,273,99,174,10,59,28,31,47,44,0,3,0,5
E33048827,405,312,92,220,2,46,32,14,41,35,1,5,0,4
E33048828,231,142,59,83,3,26,18,8,54,48,1,2,3,6
E33048829,433,328,150,178,6,33,28,5,55,52,1,2,0,11
E33048830,301,198,66,132,0,30,20,10,71,58,4,6,3,2
E33048831,622,501,194,307,5,34,26,8,77,70,3,4,0,5
E33048832,442,299,140,159,10,32,25,7,97,85,1,9,2,4
E33048833,240,144,57,87,1,25,16,9,63,58,0,5,0,7
E33048834,317,245,90,155,2,24,20,4,43,41,0,1,1,3
E33048835,355,271,128,143,1,28,25,3,48,43,1,3,1,7
E33048836,719,472,136,336,5,82,48,34,152,136,6,8,2,8
E33048837,610,398,146,252,7,33,19,14,156,127,21,8,0,16
E33048838,976,713,191,522,12,41,24,17,205,180,5,15,5,5
E33048839,390,286,89,197,2,12,3,9,78,69,2,7,0,12
E33048840,1593,1120,247,873,13,98,57,41,356,212,72,19,53,6
E33048841,228,169,50,119,0,12,6,6,43,37,1,5,0,4
E33048842,325,209,77,132,7,30,19,11,78,52,10,4,12,1
E33048843,1248,924,249,675,16,78,48,30,226,212,2,12,0,4
E33048844,386,325,103,222,3,16,7,9,42,38,0,3,1,0
E33048845,379,302,97,205,2,18,7,11,56,53,0,3,0,1
E33048846,253,170,40,130,2,28,20,8,50,46,0,3,1,3
E33048847,440,328,98,230,0,26,5,21,75,61,7,4,3,11
E33048848,487,374,115,259,3,29,13,16,81,72,0,8,1,0
E33048849,278,212,71,141,1,19,13,6,42,36,2,2,2,4
E33048850,248,176,57,119,0,22,17,5,45,33,0,8,4,5
E33048851,404,287,117,170,2,31,13,18,72,61,1,8,2,12
E33048852,284,205,79,126,3,29,16,13,43,38,4,1,0,4
E33048853,571,417,166,251,4,35,28,7,106,104,1,1,0,9
E33048854,296,208,58,150,1,34,19,15,52,40,1,8,3,1
E33048855,370,285,76,209,2,42,27,15,41,38,0,1,2,0
E33048856,580,398,86,312,3,61,33,28,115,104,3,5,3,3
E33048857,293,205,64,141,3,46,26,20,33,27,4,2,0,6
E33048858,630,414,137,277,7,86,52,34,120,113,1,6,0,3
E33048859,331,215,57,158,2,25,14,11,87,77,2,6,2,2
E33048860,380,254,80,174,1,28,17,11,93,89,0,4,0,4
E33048861,340,226,73,153,6,22,11,11,80,74,0,6,0,6
E33048862,287,158,49,109,1,14,6,8,104,97,2,5,0,10
E33048863,338,229,76,153,3,21,12,9,82,70,0,10,2,3
E33048864,265,201,56,145,3,8,8,0,48,43,0,5,0,5
E33048865,310,184,62,122,2,62,55,7,60,56,0,4,0,2
E33048866,272,178,58,120,1,20,14,6,64,61,0,3,0,9
E33048867,671,389,134,255,1,97,58,39,176,159,6,11,0,8
E33048868,433,334,98,236,0,27,21,6,71,60,1,6,4,1
E33048869,380,244,82,162,5,49,24,25,81,77,2,1,1,1
E33048870,399,301,117,184,3,17,11,6,71,68,1,1,1,7
E33048871,351,205,74,131,3,16,6,10,125,117,1,6,1,2
E33048872,434,299,112,187,5,40,21,19,88,81,2,5,0,2
E33048873,317,177,68,109,2,33,16,17,102,94,1,5,2,3
E33048874,293,202,55,147,2,37,28,9,50,46,0,3,1,2
E33048875,393,270,82,188,2,74,63,11,46,40,3,2,1,1
E33048876,399,275,78,197,4,63,47,16,53,48,1,2,2,4
E33048877,512,373,85,288,4,63,31,32,71,65,0,4,2,1
E33048878,306,252,75,177,2,31,19,12,21,17,0,1,3,0
E33048879,333,210,62,148,2,67,32,35,53,49,1,3,0,1
E33048880,382,299,88,211,4,29,12,17,50,43,1,4,2,0
E33048881,284,133,59,74,6,27,14,13,114,107,0,6,1,4
E33048882,276,158,49,109,3,23,8,15,89,84,0,3,2,3
E33048883,410,212,58,154,2,37,21,16,156,145,1,6,4,3
E33048884,558,384,119,265,7,33,21,12,131,120,1,10,0,3
E33048885,385,198,64,134,3,36,18,18,146,136,2,6,2,2
E33048886,254,148,43,105,2,70,10,60,32,29,0,1,2,2
E33048887,355,236,59,177,2,43,11,32,73,62,3,6,2,1
E33048888,290,232,71,161,6,19,9,10,33,30,0,3,0,0
E33048889,498,352,128,224,7,44,30,14,92,85,2,5,0,3
E33048890,258,190,49,141,0,25,17,8,42,39,0,2,1,1
E33048891,298,166,42,124,6,32,12,20,93,91,0,2,0,1
E33048892,385,239,69,170,4,71,38,33,68,61,0,7,0,3
E33048893,246,155,38,117,2,32,24,8,53,48,1,4,0,4
E33048894,287,219,69,150,0,20,16,4,44,41,0,2,1,4
E33048895,576,390,123,267,4,124,93,31,54,45,4,4,1,4
E33048896,628,423,114,309,5,114,80,34,81,76,1,4,0,5
E33048897,284,172,51,121,8,26,6,20,77,70,2,4,1,1
E33048898,334,243,74,169,2,15,6,9,72,66,0,5,1,2
E33048899,823,595,203,392,10,44,20,24,167,151,3,13,0,7
E33048900,283,155,44,111,3,17,9,8,102,100,0,2,0,6
E33048901,457,277,69,208,6,62,25,37,108,98,4,3,3,4
E33048902,670,461,124,337,5,41,24,17,160,151,0,9,0,3
E33048903,539,371,107,264,5,40,26,14,118,104,7,5,2,5
E33048904,762,595,164,431,8,40,21,19,118,113,0,5,0,1
E33048905,483,324,73,251,11,44,20,24,103,93,4,6,0,1
E33048906,215,128,25,103,2,28,14,14,54,48,2,3,1,3
E33048907,390,242,65,177,2,26,15,11,116,106,1,9,0,4
E33048908,371,243,82,161,5,31,19,12,85,78,0,6,1,7
E33048909,275,203,63,140,0,18,11,7,54,52,0,2,0,0
E33048910,298,182,59,123,1,17,12,5,92,87,0,5,0,6
E33048911,471,364,135,229,0,30,15,15,74,67,0,5,2,3
E33048912,408,266,85,181,1,26,19,7,109,97,1,6,5,6
E33048913,265,204,63,141,1,15,6,9,43,41,0,2,0,2
E33048914,329,229,62,167,7,36,20,16,54,43,1,6,4,3
E33048915,334,234,73,161,2,33,18,15,62,55,1,4,2,3
E33048916,534,309,78,231,3,79,34,45,139,124,3,12,0,4
E33048917,526,330,108,222,10,74,34,40,106,96,0,9,1,6
E33048918,308,226,79,147,5,28,10,18,48,44,1,3,0,1
E33048919,1365,1021,261,760,20,56,20,36,259,229,2,28,0,9
E33048920,617,471,119,352,7,30,22,8,105,99,0,6,0,4
E33048921,456,309,94,215,4,30,24,6,108,105,0,3,0,5
E33048922,611,370,108,262,12,91,43,48,134,124,1,9,0,4
E33048923,556,412,111,301,7,36,24,12,96,87,1,8,0,5
E33048924,357,282,72,210,1,16,11,5,56,52,0,4,0,2
E33048925,327,245,70,175,4,28,23,5,48,46,0,2,0,2
E33048926,2265,1824,370,1454,22,98,58,40,306,270,6,26,4,15
E33048927,412,317,91,226,6,21,16,5,65,58,0,6,1,3
E33048928,545,397,119,278,4,51,25,26,91,81,8,2,0,2
E33048929,370,271,90,181,0,36,23,13,57,48,1,8,0,6
E33048930,349,278,76,202,0,19,7,12,51,45,1,5,0,1
E33048931,384,204,52,152,2,91,88,3,86,79,2,5,0,1
E33048932,408,228,74,154,1,69,50,19,108,94,3,4,7,2
E33048933,503,331,95,236,4,86,73,13,76,65,2,6,3,6
E33048934,456,267,72,195,8,75,43,32,100,89,1,10,0,6
E33048935,337,226,63,163,4,26,15,11,80,78,1,1,0,1
E33048936,262,206,65,141,4,24,16,8,27,26,0,1,0,1
E33048937,404,277,73,204,3,39,18,21,83,76,0,7,0,2
E33048938,345,226,64,162,6,20,9,11,91,84,0,7,0,2
E33048939,295,194,45,149,0,47,31,16,52,48,0,4,0,2
E33048940,295,215,82,133,2,40,29,11,37,33,3,1,0,1
E33048941,239,165,63,102,3,18,14,4,53,48,0,5,0,0
E33048942,348,249,111,138,1,27,22,5,66,64,0,2,0,5
E33048943,244,168,51,117,2,27,13,14,45,39,2,4,0,2
E33048944,361,272,98,174,3,31,21,10,47,44,0,3,0,8
E33048945,281,210,107,103,0,9,5,4,50,41,2,6,1,12
E33048946,359,228,96,132,4,42,26,16,81,75,1,5,0,4
E33048947,315,241,122,119,1,9,4,5,52,50,0,2,0,12
E33048948,243,191,90,101,0,7,6,1,41,34,5,2,0,4
E33048949,276,245,124,121,0,6,5,1,21,18,0,2,1,4
E33048950,397,305,109,196,1,22,15,7,64,59,1,4,0,5
E33048951,395,303,162,141,5,13,11,2,63,51,3,8,1,11
E33048952,497,345,150,195,4,16,6,10,117,100,2,9,6,15
E33048953,549,404,129,275,10,33,10,23,98,92,3,3,0,4
E33048954,386,258,78,180,3,29,17,12,90,82,1,5,2,6
E33048955,481,370,159,211,9,34,21,13,52,41,0,9,2,16
E33048956,253,207,97,110,0,6,4,2,30,28,1,1,0,10
E33048957,332,231,80,151,9,24,10,14,66,60,0,6,0,2
E33048958,295,221,89,132,3,16,6,10,44,30,12,2,0,11
E33048959,590,415,137,278,9,73,35,38,84,77,0,6,1,9
E33048960,593,383,120,263,12,72,46,26,119,106,2,11,0,7
E33048961,637,405,109,296,12,78,68,10,135,119,3,13,0,7
E33048962,251,160,72,88,0,31,21,10,58,52,4,0,2,2
E33048963,305,202,54,148,6,42,28,14,52,46,0,4,2,3
E33048964,516,353,133,220,6,43,24,19,101,92,1,4,4,13
E33048965,315,228,63,165,6,37,23,14,42,35,5,2,0,2
E33048966,661,411,129,282,8,68,42,26,163,132,17,11,3,11
E33048967,449,338,85,253,1,29,23,6,77,69,1,5,2,4
E33048968,487,335,125,210,6,43,25,18,96,79,9,6,2,7
E33048969,666,522,247,275,6,29,23,6,92,83,1,7,1,17
E33048970,276,202,108,94,1,25,16,9,43,38,1,4,0,5
E33048971,412,311,109,202,6,35,23,12,54,46,0,5,3,6
E33048972,275,192,62,130,1,36,10,26,43,40,0,2,1,3
E33048973,244,156,43,113,5,26,18,8,56,48,3,4,1,1
E33048974,609,436,119,317,6,53,24,29,109,99,0,9,1,5
E33048975,328,269,81,188,2,18,13,5,35,34,1,0,0,4
E33048976,348,223,89,134,0,52,25,27,73,66,1,5,1,0
E33048977,341,257,104,153,0,30,20,10,45,36,2,2,5,9
E33048978,506,356,151,205,3,38,21,17,101,87,5,5,4,8
E33048979,509,389,143,246,3,40,23,17,68,65,1,1,1,9
E33048980,281,214,113,101,0,8,4,4,50,44,1,5,0,9
E33048981,383,274,110,164,2,34,21,13,56,47,4,4,1,17
E33048982,433,346,152,194,9,23,16,7,51,43,4,2,2,4
E33048983,383,301,162,139,5,16,8,8,52,41,1,10,0,9
E33048984,302,213,78,135,1,23,19,4,54,50,3,1,0,11
E33048985,318,243,139,104,2,14,5,9,48,43,3,2,0,11
E33048986,246,189,97,92,0,10,4,6,43,36,2,5,0,4
E33048987,313,236,88,148,1,19,11,8,54,44,0,10,0,3
E33048988,457,317,116,201,6,32,15,17,96,87,1,8,0,6
E33048989,411,310,148,162,4,29,20,9,58,53,1,4,0,10
E33048990,292,236,125,111,0,12,12,0,42,35,2,3,2,2
E33048991,306,240,77,163,1,20,13,7,44,42,0,2,0,1
E33048992,242,206,106,100,1,3,3,0,24,21,0,3,0,8
E33048993,349,231,100,131,0,21,14,7,84,53,24,7,0,13
E33048994,255,179,76,103,0,23,13,10,45,27,11,3,4,8
E33048995,570,454,134,320,5,32,16,16,76,73,0,3,0,3
E33048996,506,342,111,231,12,49,31,18,97,89,2,6,0,6
E33048997,321,252,100,152,1,22,13,9,45,40,1,3,1,1
E33048998,426,318,103,215,3,35,23,12,69,62,0,7,0,1
E33048999,642,447,152,295,13,51,33,18,126,116,5,5,0,5
E33049000,267,197,48,149,0,26,20,6,43,39,0,4,0,1
E33049001,356,230,77,153,0,18,8,10,103,92,4,6,1,5
E33049002,391,232,76,156,2,15,6,9,139,124,4,6,5,3
E33049003,367,238,75,163,3,32,7,25,88,82,1,5,0,6
E33049004,431,307,94,213,0,18,4,14,104,91,0,12,1,2
E33049005,422,304,95,209,1,21,3,18,92,83,1,8,0,4
E33049006,219,159,63,96,0,12,3,9,47,39,0,6,2,1
E33049007,499,384,171,213,2,15,5,10,87,72,3,11,1,11
E33049008,256,186,70,116,0,20,2,18,46,37,5,4,0,4
E33049009,170,113,49,64,0,7,2,5,34,29,4,0,1,16
E33049010,229,181,92,89,1,11,2,9,34,24,5,4,1,2
E33049011,469,337,150,187,1,22,6,16,101,92,2,7,0,8
E33049012,269,205,68,137,1,12,3,9,46,39,2,4,1,5
E33049013,321,243,98,145,2,14,2,12,53,49,1,3,0,9
E33049014,1077,737,192,545,24,62,15,47,248,229,0,17,2,6
E33049015,247,191,57,134,1,8,0,8,47,43,1,3,0,0
E33049016,246,162,61,101,0,14,5,9,69,65,0,3,1,1
E33049017,391,255,95,160,3,22,3,19,103,82,13,6,2,8
E33049018,476,315,144,171,1,15,1,14,132,95,30,6,1,13
E33049019,293,217,82,135,1,9,4,5,58,46,2,6,4,8
E33049020,619,460,154,306,6,17,3,14,123,108,3,10,2,13
E33049021,287,213,95,118,0,17,6,11,49,42,3,2,2,8
E33049022,273,205,83,122,2,11,1,10,48,36,3,8,1,7
E33049023,1372,890,221,669,7,107,31,76,357,155,102,17,83,11
E33049024,333,248,89,159,2,21,5,16,59,52,0,7,0,3
E33049025,274,201,92,109,1,10,0,10,59,46,3,6,4,3
E33049026,382,292,125,167,5,22,6,16,61,55,1,3,2,2
E33049027,420,326,108,218,5,24,2,22,60,44,3,3,10,5
E33049028,606,451,158,293,8,30,6,24,115,92,6,12,5,2
E33049029,347,228,93,135,2,19,4,15,93,59,15,6,13,5
E33049030,267,199,90,109,0,10,3,7,55,32,15,7,1,3
E33049031,220,167,76,91,0,12,2,10,37,34,0,3,0,4
E33049032,261,203,92,111,6,8,5,3,40,34,1,5,0,4
E33049033,226,184,87,97,1,12,5,7,24,23,0,0,1,5
E33049034,234,189,73,116,4,14,3,11,22,18,1,2,1,5
E33049035,402,320,145,175,2,21,9,12,53,49,0,4,0,6
E33049036,257,172,75,97,3,25,3,22,46,33,2,8,3,11
E33049037,517,355,115,240,4,29,4,25,124,111,3,8,2,5
E33049038,285,210,65,145,6,27,11,16,39,34,1,3,1,3
E33049039,655,547,186,361,1,25,7,18,71,60,2,7,2,11
E33049040,348,256,70,186,2,26,9,17,64,51,4,8,1,0
E33049041,518,344,99,245,0,72,28,44,101,89,1,10,1,1
E33049042,268,195,63,132,2,21,10,11,46,39,0,4,3,4
E33049043,327,247,86,161,3,19,8,11,55,50,3,1,1,3
E33049044,435,317,119,198,2,42,16,26,71,63,2,6,0,3
E33049045,613,454,147,307,2,34,9,25,116,99,3,12,2,7
E33049046,512,368,113,255,8,34,7,27,98,88,2,6,2,4
E33049047,1003,783,259,524,9,37,9,28,170,155,0,14,1,4
E33049048,441,324,80,244,4,24,5,19,87,80,2,5,0,2
E33049049,277,170,37,133,2,25,4,21,80,74,2,4,0,0
E33049050,512,316,99,217,3,75,34,41,114,99,1,11,3,4
E33049051,303,248,87,161,0,7,3,4,44,39,0,3,2,4
E33049052,450,334,92,242,4,39,10,29,71,61,1,8,1,2
E33049053,438,312,113,199,8,28,12,16,87,76,1,8,2,3
E33049054,295,221,89,132,2,18,8,10,47,43,2,2,0,7
E33049055,315,249,82,167,2,21,2,19,40,34,2,1,3,3
E33049056,247,207,67,140,1,13,4,9,25,19,0,2,4,1
E33049057,250,170,54,116,2,14,3,11,62,52,2,4,4,2
E33049058,387,279,113,166,1,16,5,11,85,70,6,7,2,6
E33049059,377,299,102,197,1,25,8,17,49,35,0,12,2,3
E33049060,308,225,74,151,6,12,1,11,62,56,0,5,1,3
E33049061,277,206,84,122,5,15,2,13,46,41,0,5,0,5
E33049062,467,310,93,217,5,18,5,13,113,94,8,8,3,21
E33049063,407,292,158,134,4,17,2,15,77,60,8,8,1,17
E33049064,577,408,155,253,9,48,21,27,102,76,9,16,1,10
E33049065,274,223,96,127,2,9,4,5,34,31,0,2,1,6
E33049066,336,237,78,159,6,24,4,20,65,61,1,2,1,4
E33049067,269,220,127,93,4,8,3,5,34,30,2,2,0,3
E33049068,335,258,108,150,4,23,7,16,45,39,0,6,0,5
E33049069,386,245,116,129,2,13,3,10,107,95,4,6,2,19
E33049070,358,269,93,176,6,14,7,7,64,57,4,3,0,5
E33049071,304,227,92,135,0,30,11,19,42,35,3,4,0,5
E33049072,216,176,93,83,1,10,2,8,25,22,1,2,0,4
E33049073,311,251,153,98,2,4,2,2,41,35,2,4,0,13
E33049074,322,240,132,108,1,9,4,5,57,41,6,9,1,15
E33049075,242,196,118,78,0,10,3,7,33,25,2,6,0,3
E33049076,238,200,98,102,3,8,3,5,19,17,0,2,0,8
E33049077,298,235,129,106,3,10,6,4,39,31,1,7,0,11
E33049078,503,344,80,264,6,50,24,26,103,87,4,10,2,0
E33049079,458,323,64,259,2,28,10,18,97,87,1,9,0,8
E33049080,353,271,76,195,0,23,13,10,55,40,2,9,4,4
E33049081,1517,1152,255,897,16,97,38,59,246,186,25,17,18,6
E33049082,1420,1129,312,817,9,116,45,71,162,140,7,7,8,4
E33049083,394,306,99,207,2,26,4,22,60,54,2,4,0,0
E33049084,224,151,73,78,1,9,3,6,52,46,2,4,0,11
E33049085,423,313,122,191,6,24,8,16,70,59,4,5,2,10
E33049086,608,414,171,243,5,36,12,24,150,118,7,14,11,3
E33049087,592,430,166,264,12,50,7,43,93,87,2,2,2,7
E33049088,267,203,96,107,2,16,3,13,43,43,0,0,0,3
E33049089,257,194,57,137,3,18,4,14,39,33,0,4,2,3
E33049090,279,185,78,107,6,37,6,31,47,37,6,4,0,4
E33049091,501,330,116,214,5,39,5,34,118,109,1,8,0,9
E33049092,558,410,154,256,19,31,1,30,97,87,2,8,0,1
E33049093,284,183,85,98,2,22,2,20,75,70,1,4,0,2
E33049094,389,262,104,158,2,63,5,58,60,55,0,4,1,2
E33049095,128,82,39,43,4,9,1,8,33,30,0,2,1,0
E33049096,491,313,132,181,6,48,10,38,119,116,0,3,0,5
E33049097,332,242,137,105,2,36,12,24,48,36,0,11,1,4
E33049098,440,310,130,180,3,12,0,12,95,74,5,10,6,20
E33049099,333,235,100,135,3,20,8,12,73,69,1,3,0,2
E33049100,390,292,139,153,2,11,2,9,72,64,0,7,1,13
E33049101,496,423,174,249,5,16,3,13,44,39,1,4,0,8
E33049102,346,266,136,130,1,19,2,17,48,40,2,4,2,12
E33049103,534,397,109,288,13,34,7,27,90,82,4,2,2,0
E33049104,537,457,125,332,3,22,2,20,50,44,2,3,1,5
E33049105,385,298,94,204,2,34,6,28,51,48,2,1,0,0
E33049106,360,282,82,200,8,12,0,12,56,54,0,2,0,2
E33049107,685,542,152,390,9,39,4,35,86,76,1,9,0,9
E33049108,293,237,62,175,1,9,1,8,41,38,1,2,0,5
E33049109,398,291,101,190,5,38,2,36,57,50,1,5,1,7
E33049110,335,241,99,142,5,16,1,15,70,66,1,3,0,3
E33049111,257,179,100,79,0,14,6,8,58,51,0,7,0,6
E33049112,369,267,104,163,4,18,0,18,78,69,0,6,3,2
E33049113,240,174,81,93,5,11,0,11,46,37,1,8,0,4
E33049114,276,207,110,97,1,13,3,10,48,42,0,6,0,7
E33049115,273,199,68,131,10,23,6,17,36,30,0,5,1,5
E33049116,285,176,67,109,4,29,4,25,71,66,1,2,2,5
E33049117,513,299,83,216,9,109,33,76,94,80,7,4,3,2
E33049118,777,531,183,348,4,80,15,65,154,112,20,5,17,8
E33049119,380,278,92,186,6,29,6,23,66,54,6,5,1,1
E33049120,312,227,101,126,3,28,1,27,52,45,2,2,3,2
E33049121,374,274,113,161,0,40,11,29,53,44,2,5,2,7
E33049122,435,327,121,206,11,28,3,25,65,55,1,6,3,4
E33049123,258,186,59,127,5,18,6,12,45,42,0,2,1,4
E33049124,271,200,97,103,1,23,3,20,38,32,1,5,0,9
E33049125,288,191,98,93,1,20,1,19,65,53,5,4,3,11
E33049126,325,223,97,126,2,21,5,16,66,64,0,2,0,13
E33049127,289,200,105,95,2,21,6,15,63,54,0,3,6,3
E33049128,551,400,158,242,6,32,11,21,105,93,6,4,2,8
E33049129,281,191,71,120,6,32,13,19,51,41,8,1,1,1
E33049130,242,186,86,100,2,10,2,8,43,33,2,4,4,1
E33049131,280,224,70,154,1,16,6,10,38,28,4,6,0,1
E33049132,410,297,117,180,6,41,10,31,66,61,2,3,0,0
E33049133,276,194,94,100,2,24,7,17,52,47,1,4,0,4
E33049134,520,349,119,230,18,79,19,60,69,65,0,4,0,5
E33049135,393,251,99,152,2,42,11,31,95,84,2,7,2,3
E33049136,332,247,94,153,5,29,8,21,47,41,0,6,0,4
E33049137,361,268,83,185,2,29,2,27,60,47,1,10,2,2
E33049138,285,221,122,99,2,20,5,15,39,31,1,3,4,3
E33049139,362,254,138,116,4,37,5,32,65,61,0,4,0,2
E33049140,323,240,98,142,2,23,4,19,49,46,2,1,0,9
E33049141,342,254,117,137,4,21,2,19,58,54,0,2,2,5
E33049142,259,188,85,103,2,25,5,20,40,32,4,4,0,4
E33049143,247,187,92,95,2,15,5,10,34,32,0,1,1,9
E33049144,274,189,85,104,6,22,3,19,55,41,0,12,2,2
E33049145,583,384,168,216,16,64,9,55,112,97,2,13,0,7
E33049146,505,329,118,211,15,44,10,34,113,93,2,18,0,4
E33049147,282,195,86,109,1,24,5,19,57,49,3,5,0,5
E33049148,427,296,135,161,3,28,7,21,93,81,4,7,1,7
E33049149,249,197,95,102,1,8,2,6,39,29,3,7,0,4
E33049150,327,241,110,131,0,19,11,8,64,55,7,1,1,3
E33049151,271,207,118,89,3,3,0,3,54,50,1,3,0,4
E33049152,340,237,80,157,5,25,12,13,71,66,4,0,1,2
E33049153,337,265,134,131,2,17,7,10,50,47,2,1,0,3
E33049154,307,213,67,146,1,24,8,16,68,60,2,5,1,1
E33049155,392,261,99,162,7,35,13,22,78,66,5,4,3,11
E33049156,275,202,73,129,2,24,16,8,39,37,0,1,1,8
E33049157,330,225,58,167,6,43,26,17,54,51,0,3,0,2
E33049158,324,224,93,131,2,12,2,10,72,62,5,5,0,14
E33049159,463,306,103,203,5,57,30,27,93,81,2,8,2,2
E33049160,273,202,60,142,0,15,4,11,52,47,0,5,0,4
E33049161,455,360,90,270,6,16,5,11,68,60,1,6,1,5
E33049162,280,215,106,109,0,13,4,9,45,40,0,5,0,7
E33049163,387,266,123,143,1,11,3,8,98,74,9,13,2,11
E33049164,420,292,110,182,1,42,13,29,82,71,2,9,0,3
E33049165,308,235,109,126,2,13,3,10,55,45,4,5,1,3
E33049166,330,258,105,153,3,31,5,26,35,25,0,6,4,3
E33049167,369,267,142,125,7,13,1,12,75,60,9,6,0,7
E33049168,382,287,84,203,5,33,9,24,55,46,3,4,2,2
E33049169,266,213,75,138,1,13,2,11,38,34,0,3,1,1
E33049170,247,196,58,138,1,20,3,17,26,22,1,2,1,4
E33049171,455,357,118,239,1,19,4,15,75,63,0,7,5,3
E33049172,236,200,64,136,0,14,7,7,21,19,0,2,0,1
E33049173,292,223,67,156,3,20,8,12,45,38,2,4,1,1
E33049174,429,297,88,209,9,35,9,26,83,75,1,5,2,5
E33049175,261,201,51,150,3,12,5,7,43,38,4,1,0,2
E33049176,319,253,90,163,1,20,6,14,44,39,1,4,0,1
E33049177,511,368,94,274,5,21,3,18,114,107,1,6,0,3
E33049178,714,481,172,309,9,56,17,39,156,140,6,9,1,12
E33049179,295,192,62,130,5,17,3,14,79,72,6,1,0,2
E33049180,329,229,76,153,9,39,14,25,52,50,0,2,0,0
E33049181,319,232,79,153,5,16,2,14,64,57,2,5,0,2
E33049182,283,198,71,127,3,7,0,7,67,62,2,3,0,8
E33049183,614,375,126,249,8,41,11,30,176,161,2,12,1,14
E33049184,252,190,76,114,3,9,1,8,48,46,0,2,0,2
E33049185,426,335,125,210,4,25,5,20,52,45,0,7,0,10
E33049186,910,651,229,422,13,59,14,45,179,159,2,18,0,8
E33049187,863,604,151,453,14,64,16,48,178,157,1,19,1,3
E33049188,270,205,85,120,1,21,6,15,35,33,0,2,0,8
E33049189,573,475,146,329,0,18,6,12,76,68,0,8,0,4
E33049190,414,286,104,182,1,31,5,26,94,85,1,7,1,2
E33049191,365,316,103,213,3,4,0,4,36,29,1,5,1,6
E33049192,274,208,69,139,3,17,2,15,41,39,1,1,0,5
E33049193,300,263,90,173,3,4,1,3,29,23,1,4,1,1
E33049194,770,567,181,386,13,64,13,51,123,114,1,5,3,3
E33049195,646,463,131,332,10,44,10,34,127,118,1,8,0,2
E33049196,303,239,83,156,0,15,2,13,45,44,0,1,0,4
E33049197,338,272,72,200,6,11,1,10,44,39,0,5,0,5
E33049198,357,257,109,148,0,21,3,18,77,72,0,5,0,2
E33049199,362,274,67,207,6,29,11,18,53,46,0,7,0,0
E33049200,427,291,109,182,3,35,5,30,89,77,3,7,2,9
E33049201,274,182,57,125,1,20,2,18,66,57,1,7,1,5
E33049202,423,280,94,186,4,26,5,21,112,98,2,12,0,1
E33049203,363,267,63,204,8,40,15,25,45,36,0,7,2,3
E33049204,223,144,45,99,3,9,4,5,66,61,2,1,2,1
E33049205,249,190,74,116,1,20,9,11,35,31,0,3,1,3
E33049206,410,315,123,192,7,21,6,15,63,54,3,6,0,4
E33049207,270,218,72,146,2,11,2,9,36,31,0,5,0,3
E33049208,359,284,118,166,1,9,2,7,57,51,3,3,0,8
E33049209,446,333,128,205,3,30,15,15,75,69,0,5,1,5
E33049210,400,292,88,204,3,30,9,21,68,61,0,7,0,7
E33049211,394,305,82,223,10,16,3,13,60,56,0,4,0,3
E33049212,473,370,90,280,2,23,3,20,77,72,0,3,2,1
E33049213,645,536,147,389,6,17,6,11,83,78,0,3,2,3
E33049214,392,309,95,214,1,13,3,10,69,63,3,3,0,0
E33049215,413,280,99,181,3,18,5,13,108,98,1,6,3,4
E33049216,339,285,92,193,2,7,4,3,44,41,1,1,1,1
E33049217,403,309,92,217,4,15,4,11,74,63,1,9,1,1
E33049218,916,655,168,487,16,70,16,54,169,154,1,13,1,6
E33049219,291,200,55,145,5,20,8,12,62,55,1,6,0,4
E33049220,864,596,173,423,15,76,35,41,170,148,0,21,1,7
E33049221,317,233,81,152,2,22,4,18,58,51,0,5,2,2
E33049222,681,424,126,298,15,64,18,46,174,154,0,19,1,4
E33049223,409,330,74,256,2,15,5,10,58,55,0,2,1,4
E33049224,625,434,127,307,11,73,18,55,106,94,1,9,2,1
E33049225,257,154,57,97,1,27,4,23,74,66,0,7,1,1
E33049226,715,494,147,347,3,55,8,47,154,138,4,12,0,9
E33049227,614,485,134,351,4,28,9,19,96,82,2,12,0,1
E33049228,211,151,39,112,1,16,2,14,43,36,0,3,4,0
E33049229,296,252,82,170,0,14,4,10,28,21,3,3,1,2
E33049230,1386,1043,308,735,24,104,30,74,209,190,2,14,3,6
E33049231,389,307,111,196,1,23,5,18,55,53,0,2,0,3
E33049232,330,217,73,144,7,32,7,25,67,57,1,9,0,7
E33049233,414,286,96,190,6,45,13,32,75,57,12,4,2,2
E33049234,280,208,95,113,0,7,1,6,59,51,0,6,2,6
E33049235,244,182,67,115,2,26,7,19,34,30,0,2,2,0
E33049236,287,195,49,146,4,46,8,38,41,37,1,2,1,1
E33049237,262,162,50,112,3,35,9,26,57,54,0,3,0,5
E33049238,286,208,67,141,5,34,5,29,39,35,2,2,0,0
E33049239,357,227,91,136,2,35,6,29,88,83,3,2,0,5
E33049240,319,248,69,179,3,17,5,12,48,41,1,6,0,3
E33049241,449,349,133,216,3,19,1,18,72,61,6,5,0,6
E33049242,235,186,87,99,5,15,5,10,27,21,2,4,0,2
E33049243,292,238,66,172,6,19,5,14,25,18,2,4,1,4
E33049244,239,179,85,94,5,13,7,6,37,26,5,4,2,5
E33049245,340,278,110,168,2,19,5,14,39,35,0,4,0,2
E33049246,256,207,70,137,6,10,2,8,32,31,0,1,0,1
E33049247,485,388,117,271,4,23,6,17,68,61,0,7,0,2
E33049248,400,291,109,182,7,17,4,13,74,67,1,6,0,11
E33049249,648,492,182,310,6,49,8,41,91,81,0,10,0,10
E33049250,339,250,105,145,3,24,5,19,59,52,0,7,0,3
E33049251,407,255,113,142,5,19,5,14,126,111,5,6,4,2
E33049252,303,249,96,153,3,8,5,3,43,31,6,6,0,0
E33049253,587,446,190,256,8,32,7,25,96,89,1,6,0,5
E33049254,240,186,76,110,3,16,3,13,30,28,0,1,1,5
E33049255,317,250,78,172,1,10,1,9,38,34,0,4,0,18
E33049256,457,310,114,196,5,35,8,27,103,90,1,10,2,4
E33049257,439,304,127,177,5,43,6,37,83,78,2,3,0,4
E33049258,376,293,90,203,3,20,6,14,55,54,0,1,0,5
E33049259,250,175,56,119,1,10,4,6,62,53,1,5,3,2
E33049260,721,572,173,399,13,46,14,32,86,76,4,6,0,4
E33049261,743,517,162,355,10,82,20,62,127,116,2,6,3,7
E33049262,269,183,44,139,6,31,14,17,49,45,1,3,0,0
E33049263,298,216,61,155,0,30,5,25,49,46,0,2,1,3
E33049264,321,235,78,157,4,28,7,21,52,48,0,3,1,2
E33049265,514,376,110,266,8,42,11,31,85,77,0,7,1,3
E33049266,265,205,107,98,2,8,2,6,46,40,3,3,0,4
E33049267,235,109,55,54,2,6,3,3,92,85,4,2,1,26
E33049268,424,342,138,204,6,8,2,6,63,53,1,9,0,5
E33049269,375,267,111,156,3,21,10,11,72,49,4,14,5,12
E33049270,287,187,90,97,3,24,4,20,64,51,5,6,2,9
E33049271,225,142,65,77,2,10,4,6,65,54,6,4,1,6
E33049272,364,292,140,152,1,11,4,7,53,35,8,10,0,7
E33049273,337,231,80,151,0,29,7,22,73,66,0,5,2,4
E33049274,303,227,85,142,0,25,6,19,50,43,0,7,0,1
E33049275,450,330,112,218,4,39,14,25,76,67,0,9,0,1
E33049276,378,296,105,191,4,19,4,15,54,47,0,7,0,5
E33049277,329,274,79,195,0,12,2,10,41,40,0,1,0,2
E33049278,335,265,130,135,4,8,2,6,51,39,4,8,0,7
E33049279,626,454,212,242,8,43,18,25,111,102,4,5,0,10
E33049280,428,289,140,149,4,16,4,12,103,82,7,11,3,16
E33049281,340,292,137,155,2,11,5,6,23,18,2,3,0,12
E33049282,243,172,91,81,3,7,0,7,40,39,0,0,1,21
E33049283,288,199,78,121,5,29,8,21,52,45,1,6,0,3
E33049284,246,211,119,92,2,6,3,3,23,19,0,4,0,4
E33049285,247,185,95,90,1,14,1,13,42,39,0,3,0,5
E33049286,305,259,114,145,1,7,0,7,33,31,1,1,0,5
E33049287,241,182,84,98,2,11,4,7,36,28,5,3,0,10
E33049288,332,271,144,127,3,13,3,10,41,28,3,9,1,4
E33049289,383,290,156,134,3,12,2,10,55,39,5,10,1,23
E33049290,417,319,137,182,4,39,10,29,53,46,3,4,0,2
E33049291,280,225,108,117,3,17,7,10,30,26,1,3,0,5
E33049292,283,239,104,135,2,9,1,8,33,30,0,3,0,0
E33049293,509,382,142,240,4,36,9,27,81,71,0,10,0,6
E33049294,320,261,145,116,0,13,6,7,33,28,0,5,0,13
E33049295,244,201,84,117,2,8,3,5,29,27,0,2,0,4
E33049296,392,322,182,140,1,18,10,8,45,40,3,2,0,6
E33049297,527,435,213,222,3,23,8,15,58,54,1,2,1,8
E33049298,432,307,158,149,2,11,4,7,101,88,4,8,1,11
E33049299,505,400,177,223,3,12,1,11,66,58,0,8,0,24
E33049300,275,215,89,126,1,10,1,9,44,33,1,10,0,5
E33049301,357,308,175,133,2,12,1,11,29,23,2,4,0,6
E33049302,587,428,171,257,8,42,9,33,103,82,8,12,1,6
E33049303,643,502,195,307,0,40,14,26,95,77,3,15,0,6
E33049304,235,185,116,69,3,10,2,8,28,23,2,3,0,9
E33049305,267,205,127,78,3,5,0,5,47,39,1,7,0,7
E33049306,296,248,111,137,2,6,0,6,36,29,0,4,3,4
E33049307,425,311,140,171,4,32,16,16,72,63,0,9,0,6
E33049308,227,167,75,92,3,10,2,8,45,40,1,4,0,2
E33049309,512,368,121,247,3,31,4,27,101,88,2,10,1,9
E33049310,374,289,91,198,3,12,1,11,68,64,0,4,0,2
E33049311,349,251,89,162,3,33,9,24,61,55,0,5,1,1
E33049312,367,261,102,159,3,30,10,20,64,55,2,7,0,9
E33049313,375,265,104,161,3,29,13,16,72,65,2,5,0,6
E33049314,313,241,88,153,5,26,8,18,40,39,1,0,0,1
E33049315,479,367,147,220,4,39,8,31,63,57,1,5,0,6
E33049316,399,252,118,134,7,18,9,9,115,100,2,7,6,7
E33049317,669,504,166,338,4,61,23,38,98,81,2,12,3,2
E33049318,323,248,127,121,3,14,5,9,39,29,5,2,3,19
E33049319,360,249,132,117,4,20,6,14,74,63,2,8,1,13
E33049320,319,208,108,100,4,18,7,11,83,75,2,3,3,6
E33049321,344,248,120,128,0,18,10,8,68,56,2,8,2,10
E33049322,398,315,122,193,2,22,4,18,56,53,0,3,0,3
E33049323,236,178,80,98,0,13,6,7,44,42,0,2,0,1
E33049324,306,233,139,94,2,8,2,6,41,37,1,3,0,22
E33049325,278,198,77,121,1,18,7,11,55,48,6,0,1,6
E33049326,341,231,111,120,2,13,6,7,81,76,1,3,1,14
E33049327,234,174,48,126,1,17,3,14,37,30,2,5,0,5
E33049328,328,238,127,111,2,22,13,9,61,51,7,3,0,5
E33049329,631,479,199,280,1,26,15,11,119,102,4,12,1,6
E33049330,350,271,137,134,1,24,10,14,52,45,3,4,0,2
E33049331,479,379,145,234,1,38,11,27,42,34,3,3,2,19
E33049332,352,265,103,162,6,23,3,20,49,45,0,4,0,9
E33049333,332,262,67,195,2,13,2,11,54,49,0,5,0,1
E33049334,595,435,156,279,2,60,13,47,96,90,0,6,0,2
E33049335,575,396,125,271,4,43,19,24,117,108,2,6,1,15
E33049336,630,442,148,294,13,68,12,56,102,89,2,9,2,5
E33049337,570,436,149,287,5,36,14,22,90,77,2,9,2,3
E33049338,294,218,83,135,4,17,3,14,55,53,1,1,0,0
E33049339,283,221,113,108,3,19,8,11,37,36,0,1,0,3
E33049340,343,246,109,137,4,29,4,25,60,53,3,4,0,4
E33049341,380,299,148,151,3,21,9,12,49,40,0,9,0,8
E33049342,388,287,112,175,0,55,22,33,41,31,1,7,2,5
E33049343,380,288,122,166,2,26,8,18,52,38,5,6,3,12
E33049344,373,294,105,189,3,28,8,20,45,40,0,4,1,3
E33049345,276,217,86,131,1,17,7,10,40,30,5,3,2,1
E33049346,280,194,77,117,1,30,11,19,54,47,1,6,0,1
E33049347,453,328,117,211,3,47,14,33,69,64,4,1,0,6
E33049348,308,255,84,171,4,24,4,20,24,23,1,0,0,1
E33049349,498,368,124,244,6,36,6,30,75,62,1,11,1,13
E33049350,343,268,75,193,3,20,3,17,45,37,1,7,0,7
E33049351,777,562,164,398,9,73,14,59,130,127,0,3,0,3
E33049352,324,281,103,178,2,8,3,5,27,25,0,2,0,6
E33049353,367,265,55,210,7,33,2,31,58,57,0,1,0,4
E33049354,597,444,175,269,4,32,11,21,109,99,3,5,2,8
E33049355,239,213,70,143,1,6,2,4,18,17,0,1,0,1
E33049356,303,220,81,139,1,12,2,10,69,61,0,8,0,1
E33049357,287,217,75,142,4,25,10,15,38,33,2,2,1,3
E33049358,333,237,80,157,2,24,9,15,66,65,0,1,0,4
E33049359,402,349,117,232,2,7,4,3,39,36,1,2,0,5
E33049360,232,168,57,111,0,20,6,14,39,35,0,4,0,5
E33049361,1357,1094,342,752,10,65,17,48,181,177,0,4,0,7
E33049362,295,165,31,134,2,99,11,88,27,23,0,4,0,2
E33049363,234,144,42,102,2,30,8,22,56,49,0,7,0,2
E33049364,293,173,52,121,5,75,5,70,39,33,1,4,1,1
E33049365,320,215,56,159,10,61,3,58,32,29,0,3,0,2
E33049366,581,434,119,315,6,50,5,45,88,82,1,4,1,3
E33049367,266,179,61,118,0,34,4,30,52,46,1,5,0,1
E33049368,397,271,92,179,4,31,7,24,87,81,0,6,0,4
E33049369,412,264,84,180,3,45,10,35,96,88,1,5,2,4
E33049370,440,285,82,203,10,33,8,25,109,100,5,4,0,3
E33049371,277,210,56,154,3,10,1,9,52,49,0,3,0,2
E33049372,260,166,63,103,5,20,4,16,65,61,0,4,0,4
E33049373,303,235,83,152,1,28,1,27,37,33,0,3,1,2
E33049374,309,260,115,145,2,9,3,6,37,36,0,1,0,1
E33049375,402,280,110,170,4,33,2,31,81,78,2,1,0,4
E33049376,326,229,76,153,0,29,3,26,62,50,1,4,7,6
E33049377,260,193,82,111,0,10,1,9,48,33,11,3,1,9
E33049378,376,204,72,132,1,46,4,42,97,82,8,3,4,28
E33049379,317,265,76,189,0,18,0,18,31,25,0,3,3,3
E33049380,780,499,161,338,2,93,50,43,153,131,12,9,1,33
E33049381,426,340,102,238,1,26,5,21,59,56,1,2,0,0
E33049382,722,578,154,424,0,48,13,35,92,76,0,15,1,4
E33049383,606,471,122,349,4,41,6,35,80,72,0,6,2,10
E33049384,457,368,110,258,0,31,9,22,58,50,2,4,2,0
E33049385,562,413,151,262,1,71,10,61,74,69,0,4,1,3
E33049386,284,228,61,167,0,18,0,18,32,28,0,4,0,6
E33049387,321,273,83,190,1,12,6,6,32,24,1,2,5,3
E33049388,333,292,114,178,2,10,1,9,25,24,0,1,0,4
E33049389,439,317,109,208,1,29,7,22,86,77,2,6,1,6
E33049390,434,373,144,229,0,23,8,15,37,35,0,1,1,1
E33049391,757,605,215,390,4,40,6,34,96,82,2,11,1,12
E33049392,575,415,135,280,4,39,5,34,97,87,2,2,6,20
E33049393,287,225,99,126,0,23,2,21,32,25,0,5,2,7
E33049394,226,149,58,91,0,13,0,13,57,47,7,2,1,7
E33049395,481,349,103,246,4,46,9,37,74,65,5,3,1,8
E33049396,303,231,93,138,2,15,6,9,48,45,1,2,0,7
E33049397,231,111,58,53,0,15,1,14,74,55,16,1,2,31
E33049398,311,203,82,121,1,29,2,27,65,54,4,4,3,13
E33049399,278,206,92,114,3,17,2,15,44,40,0,2,2,8
E33049400,313,261,108,153,1,25,1,24,24,22,1,1,0,2
E33049401,797,605,201,404,3,62,5,57,122,88,17,8,9,5
E33049402,260,207,69,138,3,15,3,12,33,30,0,2,1,2
E33049403,379,280,100,180,1,42,4,38,49,43,3,3,0,7
E33049404,648,561,190,371,3,20,5,15,58,56,0,2,0,6
E33049405,403,337,109,228,1,28,2,26,37,31,1,2,3,0
E33049406,534,450,154,296,2,26,5,21,53,46,3,2,2,3
E33049407,521,402,150,252,4,22,6,16,90,76,1,10,3,3
E33049408,829,579,194,385,4,112,23,89,128,107,4,7,10,6
E33049409,393,332,104,228,1,13,2,11,43,39,2,2,0,4
E33049410,312,239,80,159,2,12,2,10,56,50,3,3,0,3
E33049411,798,669,191,478,8,39,7,32,79,77,0,2,0,3
E33049412,301,217,69,148,0,31,6,25,47,42,3,1,1,6
E33049413,323,273,87,186,0,23,7,16,23,21,0,2,0,4
E33049414,846,632,158,474,4,68,12,56,136,124,3,7,2,6
E33049415,388,277,80,197,1,41,9,32,68,60,2,6,0,1
E33049416,332,264,102,162,2,26,3,23,36,31,0,5,0,4
E33049417,449,348,93,255,1,33,5,28,58,53,1,4,0,9
E33049418,296,223,79,144,5,10,0,10,55,45,3,7,0,3
E33049419,502,366,136,230,1,46,4,42,83,77,1,2,3,6
E33049420,513,382,137,245,3,49,7,42,74,68,2,3,1,5
E33049421,322,273,63,210,0,13,6,7,36,31,3,1,1,0
E33049422,334,252,79,173,4,18,1,17,56,53,1,2,0,4
E33049423,262,227,78,149,2,9,4,5,22,22,0,0,0,2
E33049424,397,322,105,217,3,22,10,12,47,43,0,3,1,3
E33049425,563,419,132,287,5,46,19,27,88,75,4,4,5,5
E33049426,507,421,136,285,1,24,5,19,55,50,1,3,1,6
E33049427,354,282,101,181,2,23,3,20,46,38,1,5,2,1
E33049428,309,270,97,173,2,4,1,3,31,28,0,3,0,2
E33049429,382,305,89,216,4,29,4,25,41,36,1,4,0,3
E33049430,313,244,71,173,2,17,2,15,42,35,1,4,2,8
E33049431,287,242,63,179,0,11,2,9,32,26,1,3,2,2
E33049432,350,261,79,182,1,29,6,23,55,47,3,5,0,4
E33049433,377,293,100,193,5,24,2,22,51,44,0,7,0,4
E33049434,366,279,82,197,2,25,5,20,57,51,2,4,0,3
E33049435,558,420,122,298,4,55,11,44,72,61,1,8,2,7
E33049436,320,228,86,142,3,30,2,28,56,50,0,6,0,3
E33049437,346,267,125,142,2,26,9,17,46,37,0,8,1,5
E33049438,497,370,136,234,4,34,5,29,80,75,3,2,0,9
E33049439,248,184,71,113,0,21,3,18,31,23,7,1,0,12
E33049440,408,302,107,195,6,22,7,15,71,57,8,4,2,7
E33049441,323,251,122,129,2,29,2,27,39,35,2,2,0,2
E33049442,408,277,67,210,8,32,6,26,88,78,3,7,0,3
E33049443,298,204,47,157,3,39,1,38,52,49,0,3,0,0
E33049444,307,222,84,138,3,26,5,21,55,45,6,3,1,1
E33049445,565,406,127,279,6,52,10,42,97,92,3,2,0,4
E33049446,257,201,76,125,2,16,2,14,27,19,4,4,0,11
E33049447,436,286,86,200,4,66,13,53,76,67,1,5,3,4
E33049448,420,299,89,210,3,51,5,46,64,59,2,3,0,3
E33049449,247,191,74,117,5,25,2,23,26,21,1,4,0,0
E33049450,421,271,121,150,4,60,7,53,82,76,3,2,1,4
E33049451,339,251,114,137,2,42,7,35,41,40,0,1,0,3
E33049452,515,377,119,258,7,51,4,47,73,65,2,4,2,7
E33049453,343,226,67,159,0,33,1,32,81,62,19,0,0,3
E33049454,445,329,123,206,2,19,3,16,87,66,12,9,0,8
E33049455,264,189,62,127,4,39,2,37,32,28,1,1,2,0
E33049456,342,227,79,148,4,44,8,36,62,53,4,5,0,5
E33049457,312,245,89,156,2,31,2,29,34,31,0,3,0,0
E33049458,242,171,65,106,0,8,0,8,50,42,3,3,2,13
E33049459,305,210,75,135,6,47,8,39,38,34,1,1,2,4
E33049460,437,268,88,180,11,66,8,58,89,82,1,4,2,3
E33049461,362,243,121,122,2,43,3,40,51,39,4,8,0,23
E33049462,608,431,130,301,2,69,9,60,97,83,5,7,2,9
E33049463,553,407,144,263,10,47,5,42,81,69,6,4,2,8
E33049464,277,207,86,121,1,31,6,25,33,23,7,3,0,5
E33049465,261,166,60,106,3,43,6,37,40,25,2,6,7,9
E33049466,480,355,133,222,3,24,6,18,72,55,9,5,3,26
E33049467,394,264,105,159,3,44,9,35,71,60,5,4,2,12
E33049468,1822,935,257,678,6,134,24,110,733,225,333,5,170,14
E33049469,655,396,139,257,4,97,8,89,99,69,16,5,9,59
E33049470,284,191,64,127,1,40,6,34,51,43,3,4,1,1
E33049471,374,230,105,125,0,14,2,12,111,100,8,2,1,19
E33049472,285,173,76,97,3,28,6,22,58,41,11,4,2,23
E33049473,339,252,79,173,4,30,5,25,46,38,3,3,2,7
E33049474,360,244,77,167,6,37,3,34,67,57,2,4,4,6
E33049475,339,268,81,187,4,40,2,38,26,22,0,3,1,1
E33049476,342,228,49,179,3,43,9,34,63,52,7,2,2,5
E33049477,293,199,56,143,1,42,7,35,49,40,6,2,1,2
E33049478,426,310,80,230,2,44,5,39,63,55,2,5,1,7
E33049479,370,262,111,151,2,30,0,30,68,57,6,3,2,8
E33049480,323,221,86,135,3,44,3,41,47,39,2,1,5,8
E33049481,289,201,84,117,0,35,3,32,37,30,0,2,5,16
E33049482,385,270,116,154,2,43,12,31,61,54,3,3,1,9
E33049483,320,234,130,104,2,28,3,25,46,40,2,0,4,10
E33049484,321,212,86,126,4,26,2,24,62,47,10,5,0,17
E33049485,269,215,69,146,1,24,11,13,27,23,2,2,0,2
E33049486,272,219,57,162,3,20,7,13,29,27,1,1,0,1
E33049487,270,161,67,94,1,21,4,17,66,56,7,0,3,21
E33049488,271,191,81,110,0,33,13,20,36,29,1,2,4,11
E33049489,391,298,89,209,3,20,7,13,62,57,2,3,0,8
E33049490,317,272,80,192,1,9,0,9,31,23,2,4,2,4
E33049491,403,267,60,207,12,29,9,20,93,88,1,4,0,2
E33049492,595,432,103,329,8,36,10,26,106,85,8,11,2,13
E33049493,294,200,78,122,1,47,8,39,46,41,2,2,1,0
E33049494,288,208,78,130,2,31,7,24,44,36,5,1,2,3
E33049495,259,177,74,103,3,21,3,18,53,43,6,3,1,5
E33049496,306,228,69,159,5,38,10,28,34,30,1,3,0,1
E33049497,595,342,129,213,6,78,17,61,156,140,9,4,3,13
E33049498,1060,760,247,513,10,90,29,61,192,159,10,20,3,8
E33049499,405,274,98,176,7,57,17,40,64,59,3,2,0,3
E33049500,327,215,67,148,3,47,11,36,54,39,11,2,2,8
E33049501,569,351,139,212,8,65,22,43,138,101,29,4,4,7
E33049502,622,437,137,300,11,60,11,49,109,66,26,4,13,5
E33049503,333,178,62,116,8,35,4,31,100,57,35,1,7,12
E33049504,542,389,149,240,2,36,7,29,90,71,13,3,3,25
E33049505,275,166,60,106,1,24,3,21,70,48,11,6,5,14
E33049506,370,192,67,125,4,42,7,35,127,52,47,7,21,5
E33049507,232,165,86,79,6,24,5,19,31,26,2,3,0,6
E33049508,323,196,87,109,5,29,6,23,71,53,13,2,3,22
E33049509,317,185,84,101,4,45,6,39,77,70,1,1,5,6
E33049510,314,194,78,116,5,23,5,18,76,62,7,4,3,16
E33049511,274,199,93,106,6,12,8,4,54,43,7,1,3,3
E33049512,274,184,77,107,1,29,4,25,55,46,0,5,4,5
E33049513,283,193,79,114,1,21,5,16,66,59,0,4,3,2
E33049514,452,311,141,170,5,43,5,38,89,78,1,8,2,4
E33049515,359,251,122,129,2,29,2,27,73,64,1,6,2,4
E33049516,432,289,119,170,5,41,10,31,88,81,1,6,0,9
E33049517,518,361,119,242,6,79,10,69,63,51,0,12,0,9
E33049518,373,261,114,147,4,29,5,24,77,71,2,4,0,2
E33049519,375,225,85,140,5,41,8,33,96,89,0,5,2,8
E33049520,426,292,115,177,5,42,11,31,84,78,2,2,2,3
E33049521,398,296,100,196,5,28,4,24,62,57,0,5,0,7
E33049522,544,367,142,225,5,75,8,67,83,78,2,3,0,14
E33049523,235,159,48,111,2,27,4,23,40,35,1,4,0,7
E33049524,579,408,156,252,7,74,10,64,75,69,3,2,1,15
E33049525,431,300,110,190,3,40,12,28,73,64,5,2,2,15
E33049526,464,311,126,185,5,49,5,44,83,71,6,5,1,16
E33049527,628,394,136,258,12,72,17,55,140,121,5,12,2,10
E33049528,426,322,128,194,2,34,5,29,66,58,1,4,3,2
E33049529,498,325,100,225,6,86,20,66,73,57,8,7,1,8
E33049530,320,191,80,111,2,34,7,27,78,62,4,8,4,15
E33049531,263,191,73,118,2,22,3,19,43,35,5,2,1,5
E33049532,258,161,72,89,2,11,1,10,69,59,8,2,0,15
E33049533,234,131,75,56,4,35,5,30,55,49,3,1,2,9
E33049534,508,232,102,130,4,40,9,31,224,221,0,2,1,8
E33049535,306,217,101,116,3,39,2,37,37,33,3,1,0,10
E33049536,298,208,72,136,3,37,3,34,47,38,2,7,0,3
E33049537,312,244,127,117,1,18,3,15,38,30,2,5,1,11
E33049538,311,220,110,110,3,33,1,32,50,44,4,2,0,5
E33049539,340,222,82,140,3,41,2,39,66,58,2,6,0,8
E33049540,242,180,75,105,4,24,5,19,28,20,4,3,1,6
E33049541,398,263,105,158,3,52,2,50,65,52,5,8,0,15
E33049542,233,149,59,90,1,14,1,13,49,41,4,2,2,20
E33049543,432,292,140,152,3,25,4,21,83,69,7,7,0,29
E33049544,227,141,79,62,0,12,3,9,68,62,6,0,0,6
E33049545,571,396,133,263,11,56,0,56,106,90,5,6,5,2
E33049546,305,230,81,149,6,19,1,18,44,34,6,1,3,6
E33049547,349,227,116,111,2,23,0,23,79,73,2,4,0,18
E33049548,284,192,70,122,2,21,2,19,57,47,5,5,0,12
E33049549,545,369,107,262,0,82,7,75,87,77,3,6,1,7
E33049550,216,145,65,80,4,11,0,11,50,45,1,3,1,6
E33049551,424,271,107,164,5,31,2,29,106,78,15,11,2,11
E33049552,247,179,94,85,5,19,4,15,34,31,1,2,0,10
E33049553,326,205,92,113,1,37,13,24,61,46,5,9,1,22
E33049554,260,167,72,95,3,19,2,17,49,41,6,0,2,22
E33049555,246,177,84,93,1,17,1,16,45,38,6,1,0,6
E33049556,293,182,79,103,4,53,2,51,49,44,0,3,2,5
E33049557,290,189,78,111,2,28,5,23,71,66,2,3,0,0
E33049558,285,209,94,115,1,26,1,25,41,40,0,1,0,8
E33049559,262,194,99,95,4,18,2,16,40,29,4,3,4,6
E33049560,405,292,138,154,8,40,4,36,60,46,5,6,3,5
E33049561,375,281,163,118,8,20,2,18,53,42,1,6,4,13
E33049562,662,427,173,254,9,83,11,72,134,121,1,11,1,9
E33049563,415,262,102,160,0,96,7,89,54,41,2,10,1,3
E33049564,436,310,127,183,3,57,2,55,59,51,3,3,2,7
E33049565,503,372,156,216,1,54,6,48,66,59,0,6,1,10
E33049566,383,263,121,142,2,41,3,38,70,65,0,4,1,7
E33049567,381,255,141,114,3,51,17,34,67,52,4,10,1,5
E33049568,393,258,121,137,5,31,1,30,82,68,6,8,0,17
E33049569,291,220,111,109,2,23,1,22,42,31,3,4,4,4
E33049570,432,301,144,157,7,28,1,27,78,66,4,6,2,18
E33049571,524,354,203,151,8,39,2,37,103,69,17,12,5,20
E33049572,358,255,118,137,4,36,3,33,58,50,1,4,3,5
E33049573,315,227,82,145,4,32,3,29,47,43,2,2,0,5
E33049574,700,457,215,242,9,106,8,98,119,104,3,9,3,9
E33049575,297,203,88,115,2,49,1,48,36,33,0,3,0,7
E33049576,371,240,120,120,5,51,6,45,71,62,2,6,1,4
E33049577,239,170,66,104,1,28,4,24,38,36,1,1,0,2
E33049578,309,220,72,148,2,40,5,35,47,43,2,1,1,0
E33049579,446,320,75,245,8,32,1,31,83,77,1,4,1,3
E33049580,364,249,84,165,4,46,4,42,58,56,1,1,0,7
E33049581,645,471,152,319,2,74,7,67,90,83,1,5,1,8
E33049582,326,203,78,125,5,35,2,33,78,67,4,7,0,5
E33049583,380,264,75,189,3,51,7,44,61,57,1,2,1,1
E33049584,398,247,75,172,8,66,7,59,74,65,0,9,0,3
E33049585,479,327,95,232,8,51,3,48,92,89,0,3,0,1
E33049586,882,644,202,442,9,87,6,81,133,120,5,8,0,9
E33049587,339,217,58,159,7,33,5,28,80,78,0,2,0,2
E33049588,380,276,92,184,6,32,1,31,64,59,4,0,1,2
E33049589,397,267,106,161,2,64,5,59,57,47,0,8,2,7
E33049590,552,388,151,237,7,81,12,69,72,62,2,6,2,4
E33049591,381,285,98,187,6,32,4,28,52,46,1,5,0,6
E33049592,387,299,110,189,2,28,4,24,53,47,0,4,2,5
E33049593,254,173,67,106,7,24,10,14,39,34,3,2,0,11
E33049594,324,205,75,130,3,53,5,48,56,44,7,4,1,7
E33049595,428,278,94,184,3,18,1,17,100,82,6,9,3,29
E33049596,406,259,107,152,7,39,7,32,83,76,6,1,0,18
E33049597,341,258,103,155,1,31,4,27,42,31,2,7,2,9
E33049598,239,176,71,105,1,16,3,13,35,24,6,1,4,11
E33049599,304,222,77,145,2,31,3,28,44,39,4,0,1,5
E33049600,1225,928,243,685,11,75,17,58,204,185,3,15,1,7
E33049601,237,158,70,88,2,10,4,6,56,50,3,2,1,11
E33049602,702,491,148,343,4,50,14,36,152,132,7,11,2,5
E33049603,324,263,79,184,7,13,6,7,35,27,3,5,0,6
E33049604,285,215,76,139,3,30,5,25,36,32,1,3,0,1
E33049605,252,149,74,75,2,24,9,15,68,56,10,1,1,9
E33049606,257,168,73,95,2,25,11,14,54,50,2,1,1,8
E33049607,826,638,188,450,3,58,10,48,119,107,0,9,3,8
E33049608,1057,746,221,525,6,85,19,66,214,192,3,18,1,6
E33049609,539,395,137,258,3,45,17,28,81,69,2,8,2,15
E33049610,375,224,66,158,2,93,41,52,52,47,1,4,0,4
E33049611,233,183,89,94,1,10,3,7,36,32,0,4,0,3
E33049612,400,274,89,185,2,39,9,30,79,71,1,7,0,6
E33049613,413,321,132,189,1,33,11,22,50,44,1,4,1,8
E33049614,319,224,68,156,3,23,9,14,67,60,0,4,3,2
E33049615,320,207,52,155,2,23,8,15,78,72,2,4,0,10
E33049616,343,223,78,145,5,42,22,20,70,63,3,3,1,3
E33049617,376,275,72,203,1,54,20,34,41,38,0,3,0,5
E33049618,955,617,181,436,10,104,37,67,218,200,2,14,2,6
E33049619,429,332,98,234,2,34,8,26,56,45,2,9,0,5
E33049620,444,343,119,224,2,34,10,24,57,52,1,4,0,8
E33049621,270,194,53,141,1,28,7,21,43,38,4,1,0,4
E33049622,312,225,60,165,1,15,3,12,67,58,1,6,2,4
E33049623,294,213,72,141,0,24,9,15,56,52,0,4,0,1
E33049624,513,310,106,204,6,58,18,40,133,124,2,6,1,6
E33049625,415,230,67,163,6,58,27,31,111,102,1,6,2,10
E33049626,377,222,73,149,2,54,31,23,92,84,2,5,1,7
E33049627,534,392,122,270,1,36,14,22,103,87,5,6,5,2
E33049628,344,236,91,145,4,31,14,17,71,67,0,1,3,2
E33049629,316,244,64,180,3,25,8,17,42,39,0,3,0,2
E33049630,266,207,62,145,2,17,5,12,37,33,2,2,0,3
E33049631,363,249,67,182,3,36,6,30,72,64,1,5,2,3
E33049632,507,360,113,247,3,68,28,40,75,70,1,4,0,1
E33049633,620,405,114,291,1,75,25,50,136,129,0,6,1,3
E33049634,330,245,69,176,5,28,16,12,50,47,2,0,1,2
E33049635,372,269,96,173,1,45,11,34,53,47,0,6,0,4
E33049636,282,194,67,127,3,37,15,22,45,38,1,6,0,3
E33049637,315,212,65,147,2,35,10,25,64,61,0,3,0,2
E33049638,495,391,116,275,0,25,9,16,75,66,3,5,1,4
E33049639,798,614,170,444,10,65,15,50,109,95,2,9,3,0
E33049640,290,177,54,123,1,34,14,20,76,64,0,10,2,2
E33049641,331,219,81,138,1,51,24,27,56,49,3,4,0,4
E33049642,480,366,105,261,3,36,11,25,70,60,0,4,6,5
E33049643,249,190,54,136,2,17,6,11,39,33,1,5,0,1
E33049644,492,343,94,249,0,56,21,35,87,77,0,5,5,6
E33049645,273,207,71,136,1,16,7,9,47,41,0,1,5,2
E33049646,423,324,96,228,2,31,11,20,65,59,0,3,3,1
E33049647,405,288,81,207,7,41,12,29,68,59,1,6,2,1
E33049648,385,216,65,151,1,78,60,18,88,78,0,8,2,2
E33049649,314,248,81,167,3,23,10,13,37,32,1,3,1,3
E33049650,771,536,153,383,12,78,45,33,143,134,1,8,0,2
E33049651,1155,848,278,570,16,112,64,48,172,162,0,9,1,7
E33049652,1148,727,215,512,8,157,83,74,247,235,0,9,3,9
E33049653,246,203,56,147,2,14,4,10,27,26,1,0,0,0
E33049654,882,608,160,448,9,40,22,18,216,200,5,10,1,9
E33049655,462,361,122,239,3,29,19,10,61,54,0,4,3,8
E33049656,319,246,102,144,1,25,12,13,44,42,0,1,1,3
E33049657,508,343,86,257,6,76,51,25,82,68,3,8,3,1
E33049658,454,305,72,233,5,72,48,24,71,65,0,5,1,1
E33049659,549,321,91,230,4,39,22,17,180,172,1,7,0,5
E33049660,421,256,79,177,8,60,32,28,96,93,0,2,1,1
E33049661,428,333,107,226,2,13,7,6,80,74,4,2,0,0
E33049662,501,330,112,218,7,39,21,18,123,115,3,5,0,2
E33049663,228,104,24,80,2,40,27,13,81,79,0,2,0,1
E33049664,487,273,68,205,8,115,90,25,84,75,0,7,2,7
E33049665,572,422,128,294,7,62,35,27,78,68,1,8,1,3
E33049666,456,353,109,244,3,43,36,7,57,53,1,3,0,0
E33049667,275,136,42,94,3,79,53,26,55,50,0,4,1,2
E33049668,300,187,57,130,11,42,37,5,55,53,0,2,0,5
E33049669,1013,702,168,534,11,118,80,38,178,166,0,10,2,4
E33049670,426,297,92,205,8,76,51,25,42,39,0,3,0,3
E33049671,512,364,90,274,1,59,40,19,82,78,1,3,0,6
E33049672,351,225,52,173,1,31,19,12,94,85,0,8,1,0
E33049673,373,284,76,208,1,24,15,9,59,53,0,6,0,5
E33049674,759,519,128,391,15,59,34,25,160,141,0,16,3,6
E33049675,354,227,59,168,2,54,35,19,67,64,1,2,0,4
E33049676,317,206,61,145,3,25,15,10,80,76,1,3,0,3
E33049677,450,286,92,194,3,34,15,19,125,120,0,4,1,2
E33049678,258,179,51,128,1,29,15,14,48,44,1,0,3,1
E33049679,516,318,100,218,7,48,31,17,137,131,0,6,0,6
E33049680,271,198,69,129,0,8,2,6,62,54,1,7,0,3
E33049681,488,340,86,254,0,20,8,12,123,116,0,7,0,5
E33049682,295,205,51,154,0,18,7,11,70,65,1,4,0,2
E33049683,252,160,51,109,0,23,10,13,67,67,0,0,0,2
E33049684,239,154,53,101,4,13,9,4,64,62,0,0,2,4
E33049685,257,178,58,120,0,16,10,6,62,55,0,7,0,1
E33049686,302,191,60,131,2,32,21,11,75,72,1,2,0,2
E33049687,254,151,57,94,0,36,17,19,62,56,0,5,1,5
E33049688,417,290,101,189,5,29,13,16,88,76,3,8,1,5
E33049689,3380,2506,721,1785,34,191,88,103,622,572,12,30,8,27
E33049690,327,184,60,124,3,23,14,9,111,108,0,2,1,6
E33049691,306,180,45,135,7,35,8,27,81,79,0,2,0,3
E33049692,1117,769,168,601,11,34,15,19,298,284,2,12,0,5
E33049693,819,575,146,429,5,60,27,33,175,163,1,8,3,4
E33049694,263,170,49,121,1,21,9,12,68,63,0,4,1,3
E33049695,5983,4549,1068,3481,57,122,57,65,1223,1125,36,45,17,32
E33049696,313,199,60,139,1,30,18,12,83,74,3,6,0,0
E33049697,451,338,99,239,2,26,18,8,85,74,2,5,4,0
E33049698,535,427,129,298,8,24,12,12,74,67,1,5,1,2
E33049699,236,168,39,129,10,11,5,6,44,41,0,2,1,3
E33049700,611,486,108,378,8,18,8,10,90,80,2,8,0,9
E33049701,574,391,113,278,3,26,8,18,148,136,3,9,0,6
E33049702,580,476,135,341,5,18,7,11,79,70,3,6,0,2
E33049703,255,190,61,129,2,9,5,4,50,45,1,3,1,4
E33049704,473,344,93,251,2,22,11,11,97,88,1,8,0,8
E33049705,512,381,121,260,5,15,5,10,109,102,0,7,0,2
E33049706,382,280,85,195,3,12,5,7,84,74,0,7,3,3
E33049707,277,213,54,159,2,12,7,5,47,45,0,2,0,3
E33049708,477,379,120,259,1,23,15,8,73,70,0,3,0,1
E33049709,263,185,56,129,0,18,8,10,56,52,0,4,0,4
E33049710,430,331,100,231,3,23,13,10,70,66,1,3,0,3
E33049711,428,327,74,253,1,32,21,11,66,61,1,3,1,2
E33049712,331,211,48,163,5,31,17,14,82,75,0,5,2,2
E33049713,271,223,87,136,5,10,6,4,27,20,0,4,3,6
E33049714,356,284,90,194,8,9,6,3,49,40,0,9,0,6
E33049715,335,285,91,194,0,7,5,2,41,37,3,0,1,2
E33049716,486,359,109,250,5,53,25,28,66,62,1,3,0,3
E33049717,442,262,76,186,2,55,40,15,122,114,4,4,0,1
E33049718,349,296,92,204,3,12,8,4,31,25,0,5,1,7
E33049719,420,339,87,252,7,17,9,8,55,50,3,2,0,2
E33049720,526,427,138,289,0,21,10,11,75,71,1,3,0,3
E33049721,293,216,57,159,2,15,4,11,59,56,1,2,0,1
E33049722,417,258,93,165,3,21,14,7,133,125,2,6,0,2
E33049723,332,272,77,195,2,10,3,7,48,48,0,0,0,0
E33049724,284,249,87,162,0,5,2,3,25,25,0,0,0,5
E33049725,241,185,54,131,1,4,2,2,46,44,0,2,0,5
E33049726,261,226,58,168,0,3,0,3,29,26,0,2,1,3
E33049727,327,254,82,172,4,11,7,4,57,52,2,3,0,1
E33049728,275,230,91,139,0,18,12,6,24,22,0,0,2,3
E33049729,358,212,83,129,15,59,8,51,68,62,5,1,0,4
E33049730,313,225,99,126,6,32,2,30,39,32,3,2,2,11
E33049731,365,247,83,164,3,47,10,37,60,56,1,3,0,8
E33049732,357,252,84,168,15,30,6,24,57,46,7,3,1,3
E33049733,284,203,77,126,1,40,10,30,37,26,5,4,2,3
E33049734,249,173,76,97,2,12,1,11,49,41,4,4,0,13
E33049735,327,225,80,145,5,60,9,51,33,30,3,0,0,4
E33049736,276,192,78,114,4,35,11,24,40,38,2,0,0,5
E33049737,306,219,73,146,4,33,6,27,41,37,1,3,0,9
E33049738,462,307,104,203,7,43,6,37,91,83,1,3,4,14
E33049739,566,369,105,264,6,60,6,54,118,99,9,8,2,13
E33049740,371,222,83,139,4,67,2,65,66,51,12,2,1,12
E33049741,320,210,72,138,2,22,3,19,70,58,9,3,0,16
E33049742,548,340,124,216,6,64,12,52,125,112,10,3,0,13
E33049743,477,321,114,207,12,52,9,43,84,77,3,2,2,8
E33049744,258,116,49,67,5,22,4,18,82,61,18,1,2,33
E33049745,277,175,57,118,0,27,5,22,58,44,7,2,5,17
E33049746,313,169,91,78,9,16,2,14,86,72,8,6,0,33
E33049747,283,191,77,114,1,44,4,40,40,38,1,1,0,7
E33049748,295,189,74,115,8,46,7,39,42,39,1,0,2,10
E33049749,791,485,145,340,26,130,22,108,131,117,4,10,0,19
E33049750,351,256,84,172,4,47,7,40,38,33,2,3,0,6
E33049751,339,227,85,142,4,41,6,35,56,52,0,3,1,11
E33049752,441,257,111,146,6,35,3,32,97,87,5,3,2,46
E33049753,325,200,93,107,4,26,7,19,66,61,5,0,0,29
E33049754,271,205,87,118,0,20,5,15,44,39,1,4,0,2
E33049755,355,193,88,105,0,46,3,43,90,61,23,3,3,26
E33049756,340,233,59,174,9,35,4,31,60,51,0,6,3,3
E33049757,304,182,66,116,1,26,6,20,70,61,7,2,0,25
E33049758,278,161,66,95,1,12,3,9,60,53,4,3,0,44
E33049759,328,202,97,105,0,21,9,12,83,76,5,2,0,22
E33049760,612,405,153,252,5,58,23,35,122,98,17,4,3,22
E33049761,242,152,58,94,0,18,4,14,42,37,2,3,0,30
E33049762,356,247,97,150,2,25,9,16,70,59,5,5,1,12
E33049763,305,186,73,113,2,13,4,9,81,65,13,2,1,23
E33049764,286,188,64,124,3,21,9,12,62,56,1,5,0,12
E33049765,378,265,77,188,2,29,9,20,69,62,1,4,2,13
E33049766,412,279,97,182,2,51,12,39,71,63,3,3,2,9
E33049767,232,117,49,68,1,16,0,16,69,54,7,2,6,29
E33049768,303,205,84,121,1,23,4,19,59,52,5,1,1,15
E33049769,295,172,90,82,1,27,0,27,76,63,3,3,7,19
E33049770,280,212,62,150,0,12,3,9,50,47,1,2,0,6
E33049771,298,173,74,99,1,26,3,23,71,57,9,4,1,27
E33049772,350,177,74,103,2,57,8,49,85,60,15,4,6,29
E33049773,296,190,58,132,1,27,8,19,50,40,5,5,0,28
E33049774,404,239,79,160,2,38,14,24,96,84,4,4,4,29
E33049775,417,315,102,213,4,57,8,49,39,36,0,2,1,2
E33049776,437,352,128,224,2,24,5,19,53,50,0,3,0,6
E33049777,384,290,81,209,0,41,10,31,50,44,1,2,3,3
E33049778,446,294,92,202,7,61,11,50,79,71,1,6,1,5
E33049779,244,164,55,109,2,40,9,31,36,32,3,1,0,2
E33049780,665,440,127,313,14,103,14,89,104,94,4,4,2,4
E33049781,552,390,134,256,4,61,14,47,93,90,0,0,3,4
E33049782,234,154,53,101,3,32,6,26,43,40,1,2,0,2
E33049783,370,261,87,174,2,51,11,40,55,46,3,6,0,1
E33049784,1662,1145,300,845,34,200,41,159,272,239,0,27,6,11
E33049785,1164,602,198,404,22,213,36,177,313,166,87,11,49,14
E33049786,342,206,68,138,6,77,11,66,52,46,2,2,2,1
E33049787,399,276,64,212,4,31,1,30,79,71,3,3,2,9
E33049788,296,205,60,145,4,35,8,27,50,43,0,6,1,2
E33049789,465,344,127,217,6,46,9,37,57,50,2,3,2,12
E33049790,369,295,83,212,2,14,1,13,48,36,6,3,3,10
E33049791,413,265,95,170,6,54,11,43,79,67,0,7,5,9
E33049792,745,490,167,323,5,111,14,97,121,100,9,7,5,18
E33049793,679,478,154,324,10,93,17,76,80,72,3,5,0,18
E33049794,340,240,94,146,12,34,6,28,45,31,5,7,2,9
E33049795,494,337,126,211,6,47,10,37,94,86,7,1,0,10
E33049796,430,283,84,199,24,44,11,33,77,66,4,4,3,2
E33049797,519,361,108,253,6,45,7,38,97,83,3,6,5,10
E33049798,277,223,78,145,2,16,4,12,33,28,0,2,3,3
E33049799,696,507,137,370,8,70,11,59,107,97,2,6,2,4
E33049800,288,163,54,109,2,36,12,24,83,68,6,4,5,4
E33049801,330,187,67,120,3,18,4,14,106,97,2,5,2,16
E33049802,292,192,67,125,2,48,9,39,50,39,3,5,3,0
E33049803,495,306,131,175,3,40,16,24,124,105,13,2,4,22
E33049804,390,245,104,141,2,18,6,12,85,63,18,4,0,40
E33049805,473,320,119,201,2,48,15,33,92,80,10,1,1,11
E33049806,658,449,183,266,11,90,15,75,95,84,7,4,0,13
E33049807,269,216,67,149,3,27,3,24,19,16,1,2,0,4
E33049808,558,402,139,263,5,56,11,45,87,83,1,0,3,8
E33049809,616,375,125,250,10,61,15,46,140,124,8,5,3,30
E33049810,336,226,75,151,6,64,7,57,37,35,0,2,0,3
E33049811,276,216,97,119,5,20,5,15,29,26,0,2,1,6
E33049812,234,161,50,111,0,19,5,14,52,49,0,1,2,2
E33049813,708,489,164,325,11,26,7,19,163,144,5,10,4,19
E33049814,419,333,178,155,2,19,3,16,50,41,2,5,2,15
E33049815,419,320,134,186,2,17,4,13,75,63,2,8,2,5
E33049816,373,288,115,173,2,25,11,14,55,46,1,7,1,3
E33049817,293,216,91,125,5,18,5,13,52,44,1,5,2,2
E33049818,537,423,161,262,2,37,15,22,73,58,1,13,1,2
E33049819,329,252,105,147,7,27,5,22,32,29,0,3,0,11
E33049820,465,289,90,199,1,43,14,29,130,119,1,8,2,2
E33049821,435,346,90,256,5,27,6,21,55,48,0,7,0,2
E33049822,285,203,93,110,6,23,4,19,50,39,2,6,3,3
E33049823,312,264,125,139,1,8,3,5,33,25,5,2,1,6
E33049824,578,411,161,250,2,55,10,45,100,95,2,3,0,10
E33049825,489,371,113,258,11,34,9,25,70,60,0,8,2,3
E33049826,294,259,101,158,0,16,5,11,18,16,0,2,0,1
E33049827,359,269,89,180,1,35,7,28,49,43,0,4,2,5
E33049828,522,432,151,281,8,33,8,25,47,37,1,7,2,2
E33049829,316,265,98,167,0,19,7,12,30,24,4,2,0,2
E33049830,369,280,86,194,3,32,7,25,51,46,2,3,0,3
E33049831,355,267,78,189,0,32,10,22,50,48,0,2,0,6
E33049832,251,192,70,122,2,27,6,21,27,22,0,3,2,3
E33049833,536,384,120,264,3,65,24,41,83,76,0,6,1,1
E33049834,246,183,82,101,4,27,4,23,31,24,4,2,1,1
E33049835,443,377,134,243,1,39,9,30,24,23,0,1,0,2
E33049836,562,417,155,262,0,55,12,43,87,80,0,7,0,3
E33049837,508,379,124,255,4,45,13,32,77,74,0,2,1,3
E33049838,431,346,134,212,4,38,6,32,38,33,0,5,0,5
E33049839,365,251,101,150,2,30,8,22,74,64,0,8,2,8
E33049840,253,194,79,115,2,12,3,9,43,37,1,5,0,2
E33049841,444,359,125,234,4,22,7,15,44,39,1,4,0,15
E33049842,336,280,104,176,2,18,4,14,35,34,0,1,0,1
E33049843,303,229,94,135,0,19,5,14,44,36,6,1,1,11
E33049844,493,298,124,174,0,34,15,19,150,125,15,10,0,11
E33049845,448,363,133,230,3,30,11,19,44,35,1,8,0,8
E33049846,444,355,163,192,3,25,2,23,58,51,1,3,3,3
E33049847,254,213,81,132,0,21,7,14,17,11,0,5,1,3
E33049848,254,205,91,114,2,15,4,11,24,17,2,4,1,8
E33049849,544,429,137,292,1,47,8,39,63,58,0,4,1,4
E33049850,596,456,156,300,0,49,9,40,84,78,1,4,1,7
E33049851,298,235,69,166,1,25,5,20,33,31,0,2,0,4
E33049852,627,522,176,346,3,52,10,42,49,42,0,7,0,1
E33049853,327,254,80,174,1,34,3,31,35,27,3,3,2,3
E33049854,340,268,96,172,1,32,4,28,34,31,0,2,1,5
E33049855,502,363,102,261,4,62,17,45,70,67,0,0,3,3
E33049856,398,319,114,205,3,35,1,34,37,33,1,3,0,4
E33049857,274,230,87,143,0,26,11,15,17,14,3,0,0,1
E33049858,364,276,86,190,3,29,8,21,50,47,0,2,1,6
E33049859,332,257,99,158,4,29,4,25,38,33,1,3,1,4
E33049860,352,283,106,177,2,31,4,27,31,26,0,3,2,5
E33049861,308,267,101,166,0,17,1,16,23,20,0,3,0,1
E33049862,384,293,102,191,1,56,14,42,34,26,0,7,1,0
E33049863,705,574,224,350,3,64,8,56,61,56,1,4,0,3
E33049864,741,568,178,390,1,38,7,31,113,102,1,10,0,21
E33049865,255,206,62,144,0,18,7,11,30,27,0,3,0,1
E33049866,302,277,102,175,0,2,0,2,22,18,0,3,1,1
E33049867,613,482,184,298,1,44,13,31,73,70,1,1,1,13
E33049868,330,263,134,129,2,11,0,11,48,46,0,2,0,6
E33049869,299,249,101,148,2,24,3,21,23,19,2,2,0,1
E33049870,325,240,84,156,2,25,7,18,51,44,3,2,2,7
E33049871,301,224,96,128,0,20,8,12,49,33,7,7,2,8
E33049872,675,336,74,262,2,64,23,41,270,107,89,7,67,3
E33049873,564,442,128,314,3,52,20,32,63,52,5,5,1,4
E33049874,333,277,85,192,1,9,4,5,42,34,0,7,1,4
E33049875,880,710,205,505,1,52,21,31,111,102,2,5,2,6
E33049876,327,260,67,193,1,10,4,6,49,47,1,1,0,7
E33049877,335,255,68,187,1,8,2,6,67,60,1,5,1,4
E33049878,263,201,60,141,4,16,8,8,42,38,0,3,1,0
E33049879,487,367,94,273,4,36,11,25,78,69,2,5,2,2
E33049880,702,489,139,350,5,73,28,45,133,124,1,7,1,2
E33049881,381,255,72,183,2,36,24,12,88,85,0,3,0,0
E33049882,455,342,107,235,2,27,16,11,73,69,2,1,1,11
E33049883,264,221,79,142,2,7,5,2,31,30,1,0,0,3
E33049884,351,260,84,176,5,23,14,9,59,53,1,3,2,4
E33049885,327,216,62,154,1,31,21,10,76,66,1,5,4,3
E33049886,364,256,73,183,4,30,16,14,71,66,2,3,0,3
E33049887,280,226,77,149,1,11,5,6,40,35,2,3,0,2
E33049888,340,273,90,183,1,25,16,9,40,36,0,3,1,1
E33049889,322,267,91,176,1,7,3,4,46,42,0,4,0,1
E33049890,330,243,78,165,1,17,8,9,67,66,0,1,0,2
E33049891,478,329,120,209,5,54,29,25,88,81,0,7,0,2
E33049892,897,635,153,482,10,76,39,37,174,164,0,10,0,2
E33049893,382,224,64,160,9,40,16,24,103,94,3,5,1,6
E33049894,607,455,111,344,5,31,10,21,105,94,4,2,5,11
E33049895,247,176,49,127,2,27,17,10,38,35,0,2,1,4
E33049896,573,454,163,291,7,42,20,22,67,56,3,5,3,3
E33049897,294,199,52,147,1,26,11,15,64,60,1,3,0,4
E33049898,464,333,113,220,4,35,14,21,80,72,6,2,0,12
E33049899,692,485,144,341,15,74,31,43,114,107,0,5,2,4
E33049900,640,464,130,334,11,35,14,21,125,111,2,10,2,5
E33049901,288,195,72,123,2,22,4,18,66,63,1,2,0,3
E33049902,350,247,69,178,4,36,22,14,59,53,1,4,1,4
E33049903,483,352,124,228,4,33,18,15,93,80,2,9,2,1
E33049904,248,162,73,89,4,22,13,9,56,52,0,2,2,4
E33049905,322,269,81,188,2,12,9,3,36,34,0,2,0,3
E33049906,215,167,48,119,1,18,9,9,27,24,0,3,0,2
E33049907,402,349,113,236,1,12,4,8,40,32,2,5,1,0
E33049908,417,349,126,223,2,20,12,8,43,37,1,5,0,3
E33049909,360,303,84,219,3,11,5,6,41,38,0,3,0,2
E33049910,223,164,42,122,1,38,29,9,20,16,0,2,2,0
E33049911,770,542,137,405,9,90,55,35,129,123,1,4,1,0
E33049912,532,444,95,349,10,15,7,8,60,54,2,4,0,3
E33049913,392,341,102,239,1,22,11,11,24,20,1,3,0,4
E33049914,329,252,72,180,2,19,10,9,52,49,0,3,0,4
E33049915,492,302,92,210,9,48,24,24,128,118,1,6,3,5
E33049916,497,326,68,258,6,101,63,38,61,53,1,6,1,3
E33049917,361,271,73,198,1,28,20,8,57,50,0,7,0,4
E33049918,323,248,84,164,1,30,22,8,43,38,1,4,0,1
E33049919,249,189,55,134,5,15,9,6,34,31,1,2,0,6
E33049920,357,265,80,185,4,23,14,9,62,58,0,4,0,3
E33049921,337,247,59,188,2,20,7,13,65,58,1,5,1,3
E33049922,864,710,213,497,5,40,17,23,103,87,1,12,3,6
E33049923,580,468,92,376,6,20,5,15,84,76,0,7,1,2
E33049924,417,293,83,210,2,77,60,17,40,36,0,4,0,5
E33049925,413,311,83,228,2,49,40,9,48,44,1,3,0,3
E33049926,472,304,75,229,4,87,71,16,68,61,0,4,3,9
E33049927,320,250,80,170,2,28,16,12,38,37,0,1,0,2
E33049928,599,468,141,327,11,59,39,20,56,45,2,8,1,5
E33049929,226,169,49,120,0,26,16,10,28,25,1,2,0,3
E33049930,465,366,99,267,8,28,14,14,60,55,0,4,1,3
E33049931,400,342,115,227,5,12,8,4,41,31,1,6,3,0
E33049932,546,393,108,285,4,45,22,23,101,91,1,8,1,3
E33049933,1419,1038,248,790,17,90,31,59,268,233,5,29,1,6
E33049934,537,420,110,310,13,25,13,12,75,60,0,13,2,4
E33049935,602,495,87,408,0,14,2,12,90,86,0,4,0,3
E33049936,318,196,27,169,12,35,3,32,75,65,5,1,4,0
E33049937,486,407,85,322,3,22,4,18,52,46,1,4,1,2
E33049938,338,211,36,175,8,39,12,27,79,69,5,0,5,1
E33049939,228,155,40,115,0,18,10,8,53,48,2,1,2,2
E33049940,495,366,63,303,11,28,10,18,89,82,1,3,3,1
E33049941,261,179,48,131,3,17,9,8,54,48,3,3,0,8
E33049942,501,388,126,262,5,21,9,12,80,73,1,4,2,7
E33049943,406,329,72,257,2,13,8,5,59,53,1,5,0,3
E33049944,242,177,89,88,0,10,6,4,54,35,13,2,4,1
E33049945,609,465,170,295,6,51,31,20,74,65,1,4,4,13
E33049946,368,243,96,147,3,34,26,8,84,76,5,2,1,4
E33049947,267,194,86,108,3,12,5,7,49,42,3,3,1,9
E33049948,424,309,151,158,1,16,10,6,87,80,2,1,4,11
E33049949,289,199,87,112,0,23,18,5,61,52,1,3,5,6
E33049950,284,207,63,144,1,25,20,5,43,37,1,5,0,8
E33049951,418,306,93,213,3,30,21,9,71,64,5,2,0,8
E33049952,374,275,89,186,7,33,26,7,49,41,2,3,3,10
E33049953,303,234,71,163,2,36,29,7,30,23,2,5,0,1
E33049954,456,321,114,207,3,36,25,11,92,84,2,2,4,4
E33049955,316,223,61,162,1,45,38,7,46,41,0,5,0,1
E33049956,322,239,83,156,6,43,28,15,31,27,0,4,0,3
E33049957,679,499,178,321,7,70,51,19,89,73,5,11,0,14
E33049958,365,297,116,181,1,19,18,1,47,43,1,3,0,1
E33049959,478,334,99,235,6,69,59,10,66,61,1,4,0,3
E33049960,490,373,111,262,0,29,25,4,84,78,1,4,1,4
E33049961,417,293,111,182,2,69,53,16,52,46,2,4,0,1
E33049962,352,251,83,168,5,32,18,14,60,54,0,6,0,4
E33049963,280,210,55,155,0,29,24,5,37,31,4,2,0,4
E33049964,300,223,66,157,2,28,22,6,45,42,0,2,1,2
E33049965,483,356,104,252,5,74,63,11,45,41,1,2,1,3
E33049966,504,409,133,276,2,49,38,11,42,39,1,2,0,2
E33049967,614,443,156,287,5,59,45,14,84,79,0,5,0,23
E33049968,314,249,86,163,1,20,12,8,44,40,0,4,0,0
E33049969,541,421,158,263,2,52,41,11,62,58,0,4,0,4
E33049970,446,291,91,200,6,73,48,25,74,69,0,5,0,2
E33049971,301,220,83,137,3,30,17,13,43,39,0,4,0,5
E33049972,639,491,146,345,0,46,31,15,98,93,0,5,0,4
E33049973,749,585,178,407,8,72,45,27,80,72,2,5,1,4
E33049974,367,272,89,183,1,27,13,14,62,55,0,3,4,5
E33049975,419,356,104,252,1,13,5,8,45,41,0,4,0,4
E33049976,872,694,240,454,4,64,39,25,107,101,0,6,0,3
E33049977,360,232,64,168,2,51,36,15,73,64,1,8,0,2
E33049978,311,263,90,173,2,12,8,4,34,30,0,2,2,0
E33049979,683,500,164,336,7,61,43,18,111,103,1,7,0,4
E33049980,567,410,114,296,4,53,29,24,96,89,0,5,2,4
E33049981,305,254,67,187,2,19,16,3,29,26,0,1,2,1
E33049982,318,280,92,188,4,11,9,2,21,21,0,0,0,2
E33049983,278,220,60,160,0,9,1,8,46,44,1,1,0,3
E33049984,659,523,172,351,4,38,24,14,89,86,0,2,1,5
E33049985,263,220,89,131,1,10,6,4,27,23,1,3,0,5
E33049986,241,195,61,134,0,27,22,5,17,16,0,1,0,2
E33049987,685,506,181,325,4,79,62,17,87,73,4,7,3,9
E33049988,356,255,105,150,1,43,33,10,53,47,3,3,0,4
E33049989,231,174,43,131,2,17,14,3,35,30,0,3,2,3
E33049990,418,324,126,198,1,27,15,12,62,56,1,5,0,4
E33049991,457,327,119,208,1,44,32,12,81,73,4,4,0,4
E33049992,352,260,97,163,4,34,26,8,50,44,1,5,0,4
E33049993,388,322,131,191,2,20,7,13,35,29,0,4,2,9
E33049994,264,192,64,128,2,36,23,13,25,25,0,0,0,9
E33049995,321,257,91,166,2,13,11,2,47,43,1,3,0,2
E33049996,370,288,93,195,4,38,31,7,39,36,0,3,0,1
E33049997,309,250,94,156,0,33,15,18,26,23,1,2,0,0
E33049998,254,194,70,124,2,24,24,0,33,27,3,3,0,1
E33049999,742,551,165,386,10,90,75,15,86,79,2,3,2,5
E33050000,302,225,66,159,1,49,40,9,22,17,0,5,0,5
E33050001,564,406,138,268,2,61,42,19,86,73,3,10,0,9
E33050002,296,221,61,160,1,16,10,6,52,46,0,4,2,6
E33050003,359,262,89,173,3,38,24,14,54,51,0,2,1,2
E33050004,261,197,64,133,3,21,18,3,34,33,1,0,0,6
E33050005,367,258,86,172,5,46,29,17,54,42,7,4,1,4
E33050006,313,229,84,145,5,28,19,9,47,44,2,1,0,4
E33050007,241,175,68,107,1,20,14,6,39,36,0,3,0,6
E33050008,317,209,73,136,8,36,25,11,64,56,1,7,0,0
E33050009,338,276,110,166,2,13,9,4,43,35,5,2,1,4
E33050010,296,218,80,138,4,17,14,3,55,48,0,5,2,2
E33050011,517,378,108,270,2,52,32,20,81,74,0,7,0,4
E33050012,394,308,109,199,1,36,20,16,48,44,0,4,0,1
E33050013,321,247,70,177,4,31,28,3,38,33,0,3,2,1
E33050014,402,297,100,197,4,51,35,16,49,45,1,3,0,1
E33050015,490,370,93,277,3,76,65,11,37,33,1,3,0,4
E33050016,317,226,87,139,5,36,26,10,48,47,0,1,0,2
E33050017,658,507,183,324,2,37,26,11,102,95,2,3,2,10
E33050018,350,296,99,197,3,20,17,3,29,25,0,2,2,2
E33050019,508,424,177,247,1,22,15,7,55,48,2,5,0,6
E33050020,327,221,78,143,1,30,20,10,74,69,1,4,0,1
E33050021,1470,1165,344,821,10,90,62,28,189,178,0,11,0,16
E33050022,441,353,124,229,0,49,47,2,37,32,0,5,0,2
E33050023,336,248,30,218,3,23,1,22,60,50,5,2,3,2
E33050024,495,335,113,222,7,65,12,53,88,80,2,6,0,0
E33050025,550,377,103,274,3,78,16,62,89,80,2,4,3,3
E33050026,365,284,69,215,6,29,5,24,45,42,0,3,0,1
E33050027,744,548,166,382,8,64,14,50,119,87,14,5,13,5
E33050028,374,277,77,200,7,35,7,28,51,44,1,6,0,4
E33050029,416,300,88,212,3,53,12,41,54,48,2,4,0,6
E33050030,354,251,91,160,4,26,6,20,70,65,1,4,0,3
E33050031,327,201,61,140,1,66,11,55,53,48,1,2,2,6
E33050032,225,174,63,111,2,19,2,17,27,25,1,1,0,3
E33050033,278,225,89,136,3,16,5,11,32,31,1,0,0,2
E33050034,581,432,123,309,6,51,12,39,88,75,5,5,3,4
E33050035,659,442,139,303,5,76,14,62,130,107,4,17,2,6
E33050036,344,283,93,190,1,22,5,17,37,33,0,2,2,1
E33050037,271,179,62,117,4,54,5,49,33,29,1,3,0,1
E33050038,336,222,78,144,9,17,0,17,82,74,4,2,2,6
E33050039,339,240,97,143,4,31,3,28,61,58,0,2,1,3
E33050040,285,185,86,99,5,16,3,13,63,53,3,7,0,16
E33050041,383,284,86,198,1,29,2,27,63,56,2,3,2,6
E33050042,269,201,69,132,8,24,7,17,33,31,0,2,0,3
E33050043,284,210,106,104,0,18,3,15,47,41,0,1,5,9
E33050044,372,300,110,190,2,28,7,21,34,31,1,0,2,8
E33050045,528,403,131,272,8,40,11,29,75,66,3,6,0,2
E33050046,328,227,75,152,6,45,9,36,44,40,0,3,1,6
E33050047,366,310,110,200,1,11,3,8,35,31,0,4,0,9
E33050048,1208,920,243,677,8,52,16,36,225,196,11,16,2,3
E33050049,335,179,73,106,5,21,8,13,126,111,12,2,1,4
E33050050,510,349,125,224,4,38,23,15,110,98,2,7,3,9
E33050051,361,247,107,140,3,19,4,15,76,70,1,4,1,16
E33050052,243,194,83,111,2,10,5,5,28,23,1,2,2,9
E33050053,434,326,93,233,1,38,8,30,62,60,1,1,0,7
E33050054,348,261,66,195,7,32,3,29,45,43,0,2,0,3
E33050055,626,459,120,339,2,45,18,27,116,105,0,11,0,4
E33050056,822,608,213,395,6,103,24,79,103,87,0,7,9,2
E33050057,268,192,45,147,4,19,5,14,50,43,2,3,2,3
E33050058,257,216,56,160,0,11,6,5,28,27,0,1,0,2
E33050059,379,312,128,184,3,29,3,26,33,31,1,1,0,2
E33050060,494,417,149,268,4,10,4,6,61,52,2,6,1,2
E33050061,262,206,82,124,1,24,12,12,22,17,3,1,1,9
E33050062,241,188,69,119,3,20,16,4,22,17,2,3,0,8
E33050063,373,277,80,197,2,24,6,18,64,56,0,6,2,6
E33050064,369,267,86,181,5,17,7,10,73,64,1,4,4,7
E33050065,640,542,179,363,3,30,13,17,61,54,0,4,3,4
E33050066,453,304,75,229,4,41,10,31,99,55,19,6,19,5
E33050067,277,218,54,164,1,18,7,11,36,30,2,4,0,4
E33050068,316,241,83,158,2,27,12,15,39,32,2,2,3,7
E33050069,292,226,84,142,1,30,24,6,32,24,2,5,1,3
E33050070,265,221,59,162,1,15,7,8,23,18,2,2,1,5
E33050071,304,221,44,177,3,22,10,12,56,48,3,4,1,2
E33050072,447,345,104,241,1,40,13,27,60,56,3,1,0,1
E33050073,950,719,195,524,7,89,23,66,128,106,4,17,1,7
E33050074,349,272,93,179,2,28,12,16,46,40,1,4,1,1
E33050075,310,235,83,152,1,21,13,8,43,40,0,2,1,10
E33050076,308,227,74,153,1,15,8,7,59,49,2,7,1,6
E33050077,307,234,68,166,1,28,16,12,44,40,3,1,0,0
E33050078,350,226,59,167,3,56,23,33,65,57,0,7,1,0
E33050079,296,194,54,140,2,54,15,39,43,39,1,3,0,3
E33050080,292,214,54,160,1,27,6,21,48,44,0,3,1,2
E33050081,373,275,79,196,6,26,11,15,63,55,3,5,0,3
E33050082,359,263,72,191,3,46,21,25,44,42,0,2,0,3
E33050083,268,208,72,136,0,14,6,8,41,38,1,2,0,5
E33050084,330,222,94,128,7,25,6,19,74,69,1,3,1,2
E33050085,306,248,86,162,1,9,1,8,46,43,0,2,1,2
E33050086,501,361,112,249,3,38,17,21,92,82,8,2,0,7
E33050087,320,218,73,145,0,14,3,11,72,59,1,10,2,16
E33050088,254,194,70,124,0,20,6,14,38,34,0,4,0,2
E33050089,277,210,74,136,1,10,4,6,42,36,2,2,2,14
E33050090,278,216,92,124,3,9,0,9,45,40,3,2,0,5
E33050091,232,171,71,100,0,20,7,13,29,29,0,0,0,12
E33050092,301,232,56,176,2,24,5,19,40,32,2,6,0,3
E33050093,256,207,78,129,0,21,6,15,23,20,0,3,0,5
E33050094,555,431,166,265,4,47,7,40,68,60,0,7,1,5
E33050095,392,319,95,224,3,27,9,18,43,41,0,2,0,0
E33050096,440,282,100,182,4,38,7,31,108,95,8,5,0,8
E33050097,313,202,75,127,0,34,13,21,58,44,11,2,1,19
E33050098,484,387,135,252,1,25,8,17,69,61,1,6,1,2
E33050099,274,206,76,130,1,17,7,10,49,42,0,5,2,1
E33050100,329,282,77,205,4,8,3,5,35,32,0,3,0,0
E33050101,402,326,110,216,0,11,3,8,64,60,3,1,0,1
E33050102,533,441,134,307,1,26,12,14,64,55,4,5,0,1
E33050103,424,306,92,214,5,29,7,22,84,76,2,4,2,0
E33050104,303,214,74,140,1,32,12,20,54,50,0,4,0,2
E33050105,421,310,86,224,3,40,11,29,64,60,0,4,0,4
E33050106,560,373,125,248,4,73,21,52,108,102,2,4,0,2
E33050107,372,283,76,207,2,35,10,25,50,43,1,5,1,2
E33050108,628,470,156,314,3,67,18,49,76,70,1,5,0,12
E33050109,389,292,140,152,1,41,10,31,49,45,2,1,1,6
E33050110,619,507,143,364,3,34,8,26,70,63,0,6,1,5
E33050111,292,225,99,126,3,9,2,7,46,43,3,0,0,9
E33050112,305,228,82,146,3,15,1,14,49,42,2,4,1,10
E33050113,430,326,130,196,4,20,4,16,49,45,1,3,0,31
E33050114,288,232,97,135,0,13,8,5,36,33,0,3,0,7
E33050115,291,235,97,138,4,21,7,14,28,26,0,1,1,3
E33050116,312,228,90,138,2,29,6,23,51,44,0,4,3,2
E33050117,342,220,91,129,1,17,5,12,95,87,2,5,1,9
E33050118,477,372,110,262,2,31,5,26,70,68,0,2,0,2
E33050119,342,265,90,175,0,13,3,10,52,44,4,2,2,12
E33050120,361,276,109,167,2,21,8,13,59,47,6,6,0,3
E33050121,286,226,81,145,1,25,4,21,29,26,0,2,1,5
E33050122,421,303,126,177,1,20,5,15,89,81,2,5,1,8
E33050123,429,323,97,226,7,31,14,17,66,56,0,6,4,2
E33050124,574,396,98,298,7,65,23,42,101,94,1,5,1,5
E33050125,369,270,81,189,3,30,11,19,65,64,0,0,1,1
E33050126,768,560,165,395,3,87,19,68,115,106,1,8,0,3
E33050127,401,315,123,192,5,20,8,12,59,55,0,4,0,2
E33050128,304,228,89,139,6,22,6,16,44,38,1,5,0,4
E33050129,369,289,92,197,4,22,9,13,52,45,2,5,0,2
E33050130,540,398,128,270,4,25,7,18,106,99,2,5,0,7
E33050131,329,238,85,153,4,31,5,26,53,50,0,3,0,3
E33050132,460,330,121,209,6,34,9,25,85,73,0,10,2,5
E33050133,458,337,173,164,1,22,6,16,75,62,5,8,0,23
E33050134,502,387,135,252,8,42,11,31,62,60,1,1,0,3
E33050135,293,202,55,147,4,31,7,24,52,46,1,5,0,4
E33050136,724,508,136,372,11,63,17,46,134,124,1,9,0,8
E33050137,604,401,126,275,10,57,13,44,133,123,0,9,1,3
E33050138,548,382,114,268,9,64,24,40,84,72,2,10,0,9
E33050139,391,296,94,202,10,28,7,21,56,53,0,3,0,1
E33050140,346,245,89,156,4,37,14,23,56,50,1,5,0,4
E33050141,419,311,104,207,4,20,2,18,83,79,0,4,0,1
E33050142,586,360,99,261,3,61,15,46,154,140,8,6,0,8
E33050143,517,393,137,256,4,48,8,40,64,50,5,7,2,8
E33050144,264,214,86,128,0,20,6,14,29,25,0,2,2,1
E33050145,329,269,114,155,2,17,5,12,35,31,1,3,0,6
E33050146,241,168,61,107,2,21,10,11,47,44,2,1,0,3
E33050147,253,185,68,117,2,30,11,19,30,27,2,1,0,6
E33050148,373,310,124,186,1,20,7,13,35,25,2,8,0,7
E33050149,230,169,81,88,3,12,1,11,34,32,2,0,0,12
E33050150,383,225,88,137,4,42,12,30,105,96,2,6,1,7
E33050151,372,262,106,156,4,29,7,22,75,66,0,9,0,2
E33050152,249,204,76,128,1,8,5,3,34,31,1,2,0,2
E33050153,279,175,79,96,3,40,13,27,58,55,2,1,0,3
E33050154,449,355,139,216,6,24,6,18,50,33,1,10,6,14
E33050155,308,228,71,157,3,31,6,25,45,38,1,6,0,1
E33050156,379,292,107,185,4,14,1,13,60,52,2,5,1,9
E33050157,459,375,140,235,3,9,3,6,69,58,1,10,0,3
E33050158,394,309,122,187,4,22,3,19,52,45,1,6,0,7
E33050159,890,702,272,430,8,42,18,24,117,112,1,3,1,21
E33050160,308,237,94,143,2,20,7,13,49,45,0,4,0,0
E33050161,374,306,106,200,5,16,5,11,42,34,1,7,0,5
E33050162,473,300,117,183,5,32,9,23,95,74,14,7,0,41
E33050163,398,322,140,182,1,20,7,13,44,39,1,4,0,11
E33050164,302,214,83,131,1,23,4,19,49,46,0,3,0,15
E33050165,324,251,112,139,3,21,6,15,45,40,3,2,0,4
E33050166,334,261,119,142,1,12,4,8,50,45,3,1,1,10
E33050167,492,372,165,207,1,30,8,22,75,66,4,5,0,14
E33050168,258,191,59,132,2,15,4,11,45,41,0,4,0,5
E33050169,511,375,143,232,8,35,9,26,87,75,0,10,2,6
E33050170,549,393,151,242,5,63,9,54,84,76,2,6,0,4
E33050171,290,191,56,135,4,29,4,25,64,61,0,3,0,2
E33050172,280,213,73,140,1,19,5,14,42,39,1,1,1,5
E33050173,683,545,184,361,10,30,6,24,90,81,0,8,1,8
E33050174,425,305,100,205,3,33,20,13,79,70,0,6,3,5
E33050175,370,301,109,192,1,19,8,11,44,39,0,5,0,5
E33050176,296,237,63,174,1,15,4,11,38,35,0,3,0,5
E33050177,296,250,92,158,3,19,9,10,23,23,0,0,0,1
E33050178,811,608,176,432,10,45,22,23,138,125,2,10,1,10
E33050179,530,399,129,270,0,48,25,23,78,73,1,3,1,5
E33050180,275,224,65,159,1,9,1,8,37,36,0,1,0,4
E33050181,330,245,93,152,3,27,8,19,44,41,1,1,1,11
E33050182,291,223,58,165,3,19,11,8,40,33,2,3,2,6
E33050183,307,236,85,151,2,27,8,19,39,35,0,4,0,3
E33050184,362,291,96,195,4,16,11,5,45,41,0,4,0,6
E33050185,417,274,102,172,2,33,21,12,94,75,12,4,3,14
E33050186,233,192,68,124,1,12,11,1,28,26,1,1,0,0
E33050187,428,357,136,221,4,14,9,5,50,40,4,3,3,3
E33050188,252,204,64,140,0,17,9,8,31,31,0,0,0,0
E33050189,341,279,113,166,2,14,10,4,40,32,2,4,2,6
E33050190,373,311,119,192,1,19,13,6,35,27,0,8,0,7
E33050191,252,214,72,142,1,9,6,3,28,26,0,0,2,0
E33050192,413,369,155,214,2,8,4,4,34,27,2,4,1,0
E33050193,368,317,137,180,3,10,4,6,33,27,0,6,0,5
E33050194,379,270,92,178,3,24,12,12,78,69,3,4,2,4
E33050195,558,426,139,287,7,21,10,11,96,84,0,12,0,8
E33050196,283,226,58,168,1,5,4,1,51,45,0,5,1,0
E33050197,244,146,57,89,0,22,12,10,74,67,2,5,0,2
E33050198,302,246,66,180,0,10,6,4,42,34,5,3,0,4
E33050199,580,434,120,314,2,28,17,11,110,100,0,10,0,6
E33050200,445,332,98,234,3,25,13,12,82,72,2,8,0,3
E33050201,407,300,92,208,8,47,19,28,50,44,3,3,0,2
E33050202,347,260,68,192,4,48,30,18,34,31,0,3,0,1
E33050203,299,203,66,137,7,31,14,17,56,45,0,8,3,2
E33050204,245,194,75,119,5,27,22,5,16,13,3,0,0,3
E33050205,349,284,99,185,1,22,15,7,37,33,0,4,0,5
E33050206,290,219,95,124,1,29,20,9,37,25,3,9,0,4
E33050207,679,545,167,378,6,38,21,17,82,69,1,9,3,8
E33050208,297,233,84,149,1,36,24,12,27,21,1,4,1,0
E33050209,305,222,104,118,5,13,8,5,61,52,5,4,0,4
E33050210,352,272,115,157,2,12,7,5,46,35,3,7,1,20
E33050211,275,218,108,110,2,29,22,7,25,16,1,6,2,1
E33050212,270,208,72,136,1,13,7,6,45,32,3,2,8,3
E33050213,509,333,129,204,3,58,41,17,102,81,10,10,1,13
E33050214,267,182,67,115,0,30,15,15,49,40,1,7,1,6
E33050215,294,205,69,136,1,27,14,13,53,45,0,8,0,8
E33050216,511,341,96,245,2,66,37,29,98,81,1,12,4,4
E33050217,317,218,70,148,2,43,38,5,50,46,0,4,0,4
E33050218,1152,896,236,660,5,94,51,43,143,133,0,9,1,14
E33050219,306,201,57,144,0,56,45,11,44,38,0,5,1,5
E33050220,389,275,75,200,0,29,13,16,78,55,9,11,3,7
E33050221,287,205,64,141,1,32,23,9,49,46,0,3,0,0
E33050222,766,564,179,385,3,69,28,41,122,106,2,14,0,8
E33050223,414,299,83,216,2,37,19,18,74,68,0,5,1,2
E33050224,457,361,89,272,2,14,8,6,74,63,8,3,0,6
E33050225,305,234,71,163,4,23,14,9,44,38,1,5,0,0
E33050226,311,258,72,186,1,13,4,9,37,36,0,1,0,2
E33050227,448,351,90,261,1,11,7,4,83,76,0,7,0,2
E33050228,568,427,137,290,1,40,18,22,93,88,0,4,1,7
E33050229,252,208,80,128,0,16,8,8,26,21,0,4,1,2
E33050230,316,267,76,191,1,11,6,5,35,32,0,1,2,2
E33050231,367,310,134,176,4,10,8,2,36,29,0,5,2,7
E33050232,389,321,108,213,3,16,7,9,42,37,1,4,0,7
E33050233,350,287,120,167,2,21,5,16,33,29,0,0,4,7
E33050234,253,209,92,117,0,11,5,6,25,23,1,0,1,8
E33050235,344,288,116,172,3,17,9,8,28,25,0,3,0,8
E33050236,371,312,134,178,2,16,9,7,37,31,1,4,1,4
E33050237,354,228,66,162,2,68,38,30,56,49,0,7,0,0
E33050238,298,203,47,156,0,31,23,8,59,54,2,3,0,5
E33050239,375,240,79,161,0,80,50,30,52,41,3,8,0,3
E33050240,640,437,115,322,4,86,48,38,111,96,1,13,1,2
E33050241,256,176,46,130,1,26,19,7,52,51,0,1,0,1
E33050242,370,278,77,201,0,25,14,11,60,53,0,5,2,7
E33050243,327,206,47,159,3,40,16,24,74,68,0,5,1,4
E33050244,435,349,144,205,1,16,8,8,61,45,3,4,9,8
E33050245,728,503,149,354,11,70,31,39,138,122,1,10,5,6
E33050246,402,305,121,184,3,19,6,13,51,42,6,2,1,24
E33050247,331,233,91,142,0,16,3,13,72,59,6,6,1,10
E33050248,553,388,124,264,7,48,9,39,86,74,8,4,0,24
E33050249,368,275,138,137,2,20,6,14,49,39,4,6,0,22
E33050250,484,305,142,163,8,31,16,15,115,109,3,3,0,25
E33050251,372,247,98,149,5,33,16,17,67,51,10,4,2,20
E33050252,546,369,152,217,11,53,15,38,102,90,2,7,3,11
E33050253,291,223,87,136,2,23,4,19,32,25,2,3,2,11
E33050254,270,192,84,108,2,14,0,14,59,38,5,14,2,3
E33050255,297,227,105,122,0,13,2,11,49,42,0,6,1,8
E33050256,296,219,89,130,1,16,5,11,46,36,3,6,1,14
E33050257,467,320,118,202,6,54,19,35,83,71,1,11,0,4
E33050258,418,303,106,197,6,35,10,25,69,62,3,4,0,5
E33050259,902,692,225,467,6,64,20,44,132,116,1,15,0,8
E33050260,596,428,160,268,4,66,27,39,89,79,4,6,0,9
E33050261,344,275,122,153,3,23,6,17,39,35,0,2,2,4
E33050262,256,187,69,118,3,27,6,21,36,30,0,6,0,3
E33050263,324,227,79,148,3,40,12,28,51,48,0,3,0,3
E33050264,640,412,124,288,7,62,20,42,155,147,5,3,0,4
E33050265,230,179,74,105,1,15,2,13,29,22,0,2,5,6
E33050266,575,461,186,275,10,34,6,28,55,46,1,7,1,15
E33050267,251,174,65,109,0,29,10,19,45,41,0,4,0,3
E33050268,481,333,112,221,1,53,15,38,77,64,3,9,1,17
E33050269,474,338,94,244,1,25,9,16,107,100,2,4,1,3
E33050270,699,433,129,304,3,87,29,58,173,157,0,15,1,3
E33050271,382,284,113,171,1,32,7,25,59,52,4,3,0,6
E33050272,263,183,93,90,2,16,0,16,42,39,1,2,0,20
E33050273,264,178,41,137,3,30,2,28,51,33,11,4,3,2
E33050274,308,224,83,141,1,31,9,22,46,36,3,7,0,6
E33050275,230,160,77,83,1,24,9,15,37,33,2,1,1,8
E33050276,476,346,125,221,3,43,12,31,74,64,3,5,2,10
E33050277,411,276,78,198,4,36,10,26,90,52,19,2,17,5
E33050278,325,171,45,126,1,24,8,16,126,79,28,4,15,3
E33050279,334,221,77,144,3,28,8,20,56,35,13,4,4,26
E33050280,270,210,77,133,3,15,2,13,39,34,0,5,0,3
E33050281,255,189,85,104,3,23,8,15,35,30,1,4,0,5
E33050282,287,213,68,145,2,22,9,13,46,39,2,3,2,4
E33050283,370,266,88,178,5,40,15,25,55,50,1,3,1,4
E33050284,336,241,97,144,0,29,6,23,54,48,4,1,1,12
E33050285,307,198,91,107,3,33,10,23,59,53,1,1,4,14
E33050286,854,681,285,396,5,51,11,40,106,88,4,13,1,11
E33050287,616,427,158,269,5,87,21,66,87,79,0,8,0,10
E33050288,590,403,153,250,5,70,15,55,101,82,5,9,5,11
E33050289,278,232,85,147,4,16,2,14,25,22,2,0,1,1
E33050290,251,182,70,112,1,30,13,17,33,28,2,2,1,5
E33050291,646,469,137,332,10,86,37,49,78,66,0,10,2,3
E33050292,431,322,118,204,3,46,22,24,56,49,0,7,0,4
E33050293,373,278,99,179,9,49,10,39,30,24,3,3,0,7
E33050294,456,376,154,222,2,24,5,19,45,36,4,3,2,9
E33050295,365,279,127,152,3,32,9,23,46,42,2,0,2,5
E33050296,324,251,105,146,0,24,7,17,38,33,2,0,3,11
E33050297,499,341,115,226,3,39,15,24,110,95,4,10,1,6
E33050298,377,315,108,207,1,14,6,8,45,32,8,4,1,2
E33050299,1059,750,209,541,16,141,62,79,145,125,4,14,2,7
E33050300,408,314,84,230,6,33,13,20,53,47,1,3,2,2
E33050301,559,412,132,280,9,42,13,29,94,85,1,8,0,2
E33050302,422,301,83,218,2,63,21,42,52,47,1,4,0,4
E33050303,281,176,44,132,2,58,20,38,42,31,2,1,8,3
E33050304,518,328,81,247,9,69,17,52,109,89,7,11,2,3
E33050305,333,196,69,127,2,88,30,58,46,36,1,6,3,1
E33050306,498,345,80,265,5,75,37,38,68,53,7,7,1,5
E33050307,327,236,71,165,4,21,8,13,56,53,0,3,0,10
E33050308,237,146,36,110,2,46,16,30,41,39,2,0,0,2
E33050309,273,202,53,149,2,15,7,8,51,43,0,6,2,3
E33050310,296,219,66,153,2,35,13,22,40,34,2,3,1,0
E33050311,261,146,36,110,2,43,20,23,66,57,7,2,0,4
E33050312,599,429,134,295,11,77,28,49,75,68,4,3,0,7
E33050313,225,140,41,99,3,29,9,20,48,41,3,3,1,5
E33050314,529,404,89,315,7,40,6,34,77,65,3,7,2,1
E33050315,865,591,149,442,10,114,39,75,143,124,4,12,3,7
E33050316,299,240,71,169,1,19,8,11,37,30,1,5,1,2
E33050317,270,186,40,146,3,27,7,20,51,43,4,4,0,3
E33050318,510,369,99,270,6,52,22,30,79,68,3,4,4,4
E33050319,460,314,104,210,1,55,21,34,88,82,1,2,3,2
E33050320,329,235,99,136,2,43,17,26,43,38,0,5,0,6
E33050321,319,236,77,159,2,36,10,26,36,32,3,1,0,9
E33050322,309,225,78,147,2,27,12,15,41,30,6,3,2,14
E33050323,439,341,127,214,4,41,10,31,44,34,4,2,4,9
E33050324,260,201,78,123,0,22,4,18,36,31,0,4,1,1
E33050325,246,178,61,117,2,23,10,13,34,31,0,3,0,9
E33050326,250,187,76,111,0,15,5,10,40,31,1,4,4,8
E33050327,244,176,67,109,7,19,11,8,33,29,1,1,2,9
E33050328,366,266,70,196,3,30,8,22,62,53,0,8,1,5
E33050329,310,258,88,170,0,10,7,3,41,35,0,6,0,1
E33050330,890,685,136,549,14,61,17,44,127,113,4,7,3,3
E33050331,340,226,81,145,2,61,46,15,49,46,0,3,0,2
E33050332,468,340,94,246,2,53,20,33,65,56,1,5,3,8
E33050333,438,309,85,224,2,34,13,21,78,70,1,6,1,15
E33050334,460,353,113,240,1,44,12,32,57,47,1,6,3,5
E33050335,360,254,99,155,3,43,19,24,53,50,0,3,0,7
E33050336,230,179,85,94,0,12,5,7,38,32,3,2,1,1
E33050337,336,267,98,169,1,22,6,16,45,41,1,3,0,1
E33050338,287,228,69,159,4,20,5,15,29,26,1,2,0,6
E33050339,359,259,73,186,5,35,8,27,56,50,1,5,0,4
E33050340,464,352,140,212,1,45,16,29,59,47,4,5,3,7
E33050341,651,500,221,279,5,56,23,33,74,59,5,8,2,16
E33050342,539,377,101,276,11,37,11,26,107,99,2,5,1,7
E33050343,295,230,92,138,3,18,6,12,41,37,1,2,1,3
E33050344,267,207,84,123,2,26,5,21,31,28,1,2,0,1
E33050345,399,289,91,198,0,60,20,40,45,40,1,4,0,5
E33050346,433,332,104,228,4,20,9,11,74,71,0,3,0,3
E33050347,294,236,81,155,0,31,16,15,23,21,0,2,0,4
E33050348,654,462,142,320,6,58,21,37,121,113,0,8,0,7
E33050349,506,360,91,269,6,74,19,55,62,56,2,4,0,4
E33050350,980,659,200,459,9,100,31,69,208,197,0,8,3,4
E33050351,1206,838,219,619,25,160,62,98,177,161,2,14,0,6
E33050352,345,254,82,172,2,36,13,23,49,46,0,1,2,4
E33050353,282,203,59,144,1,36,14,22,39,34,1,3,1,3
E33050354,587,329,97,232,9,104,37,67,142,138,0,4,0,3
E33050355,330,275,86,189,2,17,8,9,34,31,2,1,0,2
E33050356,729,502,170,332,6,108,35,73,105,93,2,9,1,8
E33050357,461,327,130,197,7,41,21,20,75,59,9,7,0,11
E33050358,279,237,89,148,0,22,12,10,19,17,0,1,1,1
E33050359,250,178,89,89,0,24,12,12,33,28,2,3,0,15
E33050360,470,365,133,232,2,21,9,12,71,63,0,8,0,11
E33050361,280,215,79,136,0,20,2,18,39,29,4,6,0,6
E33050362,391,264,129,135,2,38,16,22,67,58,6,3,0,20
E33050363,258,214,117,97,0,6,2,4,29,25,0,4,0,9
E33050364,447,348,125,223,2,31,21,10,61,55,2,3,1,5
E33050365,294,230,90,140,0,13,7,6,43,37,1,5,0,8
E33050366,326,212,84,128,3,42,27,15,64,58,1,5,0,5
E33050367,446,322,90,232,2,33,22,11,80,72,2,6,0,9
E33050368,380,254,81,173,1,59,47,12,62,54,1,5,2,4
E33050369,705,517,171,346,0,37,21,16,134,114,5,6,9,17
E33050370,318,218,59,159,1,38,29,9,54,49,3,2,0,7
E33050371,567,411,119,292,2,39,26,13,100,93,1,6,0,15
E33050372,513,374,132,242,11,60,37,23,62,52,3,7,0,6
E33050373,531,339,128,211,6,58,31,27,122,111,5,5,1,6
E33050374,320,236,99,137,5,26,18,8,47,41,2,4,0,6
E33050375,340,240,98,142,3,31,22,9,61,53,3,4,1,5
E33050376,381,278,127,151,7,36,22,14,49,47,0,2,0,11
E33050377,274,161,46,115,2,67,51,16,36,33,0,3,0,8
E33050378,616,435,117,318,4,102,83,19,73,63,0,9,1,2
E33050379,341,261,72,189,2,34,31,3,43,41,0,2,0,1
E33050380,470,331,101,230,2,71,47,24,63,54,2,6,1,3
E33050381,243,166,61,105,1,35,27,8,41,34,1,3,3,0
E33050382,395,305,98,207,1,19,11,8,67,60,2,4,1,3
E33050383,341,248,99,149,7,30,18,12,53,46,2,5,0,3
E33050384,297,238,86,152,7,16,14,2,33,31,0,1,1,3
E33050385,365,278,104,174,3,38,26,12,45,36,0,7,2,1
E33050386,269,208,94,114,6,19,15,4,31,29,1,0,1,5
E33050387,248,180,57,123,2,24,13,11,41,36,2,1,2,1
E33050388,411,280,83,197,4,35,22,13,83,72,1,3,7,9
E33050389,314,223,61,162,0,28,22,6,61,54,1,6,0,2
E33050390,312,240,79,161,1,27,23,4,42,41,0,1,0,2
E33050391,352,247,56,191,2,33,25,8,69,64,0,5,0,1
E33050392,493,359,71,288,5,54,40,14,74,64,1,9,0,1
E33050393,479,296,75,221,4,58,39,19,119,100,8,10,1,2
E33050394,297,223,77,146,4,25,16,9,41,35,1,5,0,4
E33050395,413,297,97,200,1,29,19,10,82,71,0,9,2,4
E33050396,285,207,54,153,1,12,6,6,61,59,2,0,0,4
E33050397,359,249,72,177,1,34,23,11,74,71,0,1,2,1
E33050398,302,216,71,145,3,28,15,13,51,49,1,1,0,4
E33050399,251,151,38,113,0,21,10,11,78,70,1,7,0,1
E33050400,251,179,72,107,1,21,14,7,44,38,5,1,0,6
E33050401,533,378,137,241,4,67,45,22,83,76,0,7,0,1
E33050402,728,494,127,367,4,64,31,33,161,109,29,8,15,5
E33050403,285,185,63,122,2,28,18,10,69,62,2,2,3,1
E33050404,264,165,48,117,5,40,31,9,51,46,0,5,0,3
E33050405,304,191,57,134,1,52,42,10,58,51,1,5,1,2
E33050406,742,462,147,315,6,89,63,26,181,172,4,5,0,4
E33050407,680,460,127,333,7,66,55,11,132,108,4,14,6,15
E33050408,667,442,120,322,8,107,81,26,104,94,1,7,2,6
E33050409,344,239,76,163,5,66,54,12,32,27,0,5,0,2
E33050410,1363,1050,301,749,7,124,109,15,175,158,3,10,4,7
E33050411,400,231,72,159,4,99,75,24,58,49,0,8,1,8
E33050412,378,288,100,188,0,26,17,9,59,54,2,2,1,5
E33050413,434,299,84,215,5,35,24,11,93,79,3,9,2,2
E33050414,320,208,55,153,3,51,25,26,57,49,1,5,2,1
E33050415,599,418,99,319,8,57,35,22,110,100,1,6,3,6
E33050416,557,403,135,268,7,44,32,12,85,75,2,6,2,18
E33050417,257,174,76,98,3,18,15,3,59,47,5,0,7,3
E33050418,271,190,65,125,1,16,10,6,63,56,1,5,1,1
E33050419,356,294,85,209,1,6,1,5,51,47,1,3,0,4
E33050420,241,179,56,123,4,22,16,6,35,33,1,0,1,1
E33050421,391,311,115,196,2,21,12,9,51,46,2,2,1,6
E33050422,575,405,119,286,1,84,62,22,75,72,1,1,1,10
E33050423,486,326,90,236,2,89,59,30,63,59,0,2,2,6
E33050424,261,186,47,139,0,44,34,10,30,26,0,4,0,1
E33050425,383,278,84,194,3,39,25,14,60,51,0,6,3,3
E33050426,631,401,111,290,6,87,55,32,126,112,1,9,4,11
E33050427,1097,716,208,508,13,178,135,43,183,171,0,11,1,7
E33050428,278,231,60,171,0,15,11,4,29,27,1,1,0,3
E33050429,257,186,90,96,4,20,12,8,42,35,3,3,1,5
E33050430,323,239,85,154,1,42,20,22,40,38,0,2,0,1
E33050431,450,311,88,223,1,59,44,15,67,64,0,2,1,12
E33050432,387,289,90,199,3,17,12,5,71,64,0,7,0,7
E33050433,500,384,125,259,2,33,23,10,74,66,1,6,1,7
E33050434,478,378,119,259,1,35,20,15,50,43,1,6,0,14
E33050435,431,329,119,210,3,22,11,11,66,52,5,8,1,11
E33050436,643,465,145,320,2,54,38,16,110,105,0,3,2,12
E33050437,268,209,71,138,0,11,10,1,43,36,0,1,6,5
E33050438,217,167,80,87,1,10,9,1,37,32,0,5,0,2
E33050439,256,183,70,113,2,23,16,7,44,39,3,1,1,4
E33050440,363,233,92,141,1,26,15,11,98,87,3,3,5,5
E33050441,245,183,77,106,2,19,9,10,37,29,1,2,5,4
E33050442,376,285,124,161,2,33,26,7,52,45,2,4,1,4
E33050443,325,221,74,147,4,23,8,15,70,62,0,1,7,7
E33050444,394,262,110,152,2,42,5,37,84,79,1,4,0,4
E33050445,309,193,65,128,2,29,4,25,78,63,3,11,1,7
E33050446,272,199,70,129,1,20,3,17,43,38,0,5,0,9
E33050447,365,264,96,168,3,31,2,29,65,59,0,4,2,2
E33050448,299,151,56,95,1,51,6,45,93,90,1,1,1,3
E33050449,309,195,70,125,1,37,7,30,67,64,0,3,0,9
E33050450,258,186,70,116,1,19,3,16,43,36,2,4,1,9
E33050451,280,144,56,88,4,66,5,61,56,46,3,3,4,10
E33050452,271,161,75,86,1,33,4,29,74,51,16,6,1,2
E33050453,216,113,64,49,2,22,0,22,60,39,5,4,12,19
E33050454,260,172,82,90,1,24,3,21,57,50,0,3,4,6
E33050455,1027,610,209,401,13,124,26,98,266,249,5,11,1,14
E33050456,415,286,88,198,1,49,4,45,70,62,1,4,3,9
E33050457,394,278,102,176,4,50,3,47,58,54,0,0,4,4
E33050458,267,138,73,65,2,28,6,22,85,50,17,5,13,14
E33050459,476,319,117,202,0,95,8,87,56,51,1,4,0,6
E33050460,340,215,93,122,1,27,6,21,84,73,4,5,2,13
E33050461,265,216,103,113,1,15,7,8,30,20,4,5,1,3
E33050462,332,227,119,108,0,22,3,19,72,55,7,6,4,11
E33050463,555,362,136,226,3,69,10,59,113,101,3,9,0,8
E33050464,252,171,84,87,1,11,3,8,60,51,3,6,0,9
E33050465,260,193,95,98,3,12,3,9,47,38,3,4,2,5
E33050466,370,283,156,127,2,23,3,20,51,47,0,3,1,11
E33050467,582,411,159,252,3,58,8,50,105,90,3,11,1,5
E33050468,461,308,118,190,2,54,10,44,87,74,6,4,3,10
E33050469,356,223,131,92,1,42,1,41,68,56,6,4,2,22
E33050470,269,191,101,90,1,30,1,29,39,31,2,4,2,8
E33050471,552,400,155,245,1,55,22,33,86,70,5,10,1,10
E33050472,321,244,133,111,0,19,2,17,40,27,9,4,0,18
E33050473,227,150,61,89,3,25,3,22,42,34,4,3,1,7
E33050474,365,215,85,130,7,40,6,34,74,69,3,0,2,29
E33050475,259,158,63,95,1,10,2,8,48,32,10,5,1,42
E33050476,643,379,147,232,4,77,7,70,127,111,12,3,1,56
E33050477,358,261,99,162,3,36,4,32,42,37,3,2,0,16
E33050478,244,173,56,117,9,35,9,26,24,19,4,1,0,3
E33050479,244,141,72,69,4,22,4,18,57,39,13,2,3,20
E33050480,429,296,120,176,5,58,9,49,56,49,3,1,3,14
E33050481,322,227,97,130,0,18,6,12,67,40,23,3,1,10
E33050482,245,177,75,102,2,13,0,13,43,34,7,2,0,10
E33050483,367,262,89,173,4,42,11,31,57,47,5,4,1,2
E33050484,711,536,156,380,8,76,10,66,81,65,9,4,3,10
E33050485,760,447,158,289,5,89,9,80,141,80,48,8,5,78
E33050486,298,201,67,134,2,40,5,35,49,43,1,5,0,6
E33050487,341,190,74,116,1,63,8,55,70,56,10,3,1,17
E33050488,671,416,124,292,7,130,20,110,108,95,3,7,3,10
E33050489,366,244,79,165,3,36,5,31,65,58,5,2,0,18
E33050490,329,227,73,154,1,39,5,34,57,50,3,3,1,5
E33050491,309,173,46,127,9,83,16,67,37,29,4,3,1,7
E33050492,241,173,73,100,1,17,0,17,28,22,1,3,2,22
E33050493,292,213,70,143,4,32,4,28,28,25,2,1,0,15
E33050494,304,205,63,142,6,46,8,38,35,32,0,1,2,12
E33050495,517,319,122,197,6,73,19,54,104,79,10,8,7,15
E33050496,302,201,81,120,1,27,6,21,51,38,10,0,3,22
E33050497,290,183,53,130,9,55,8,47,41,39,1,1,0,2
E33050498,294,180,41,139,5,62,5,57,46,41,1,4,0,1
E33050499,1176,976,163,813,11,55,9,46,132,114,4,10,4,2
E33050500,364,274,75,199,5,35,2,33,42,35,3,4,0,8
E33050501,625,391,99,292,6,128,22,106,87,75,3,5,4,13
E33050502,665,452,129,323,11,116,16,100,83,66,5,10,2,3
E33050503,545,381,92,289,10,70,4,66,80,60,4,6,10,4
E33050504,529,414,115,299,6,41,2,39,63,51,2,7,3,5
E33050505,372,288,88,200,1,26,3,23,53,46,4,2,1,4
E33050506,345,237,69,168,2,45,3,42,60,43,9,4,4,1
E33050507,401,256,74,182,3,93,10,83,47,37,6,2,2,2
E33050508,412,328,99,229,5,35,3,32,38,35,1,0,2,6
E33050509,385,256,64,192,5,70,6,64,53,45,4,3,1,1
E33050510,289,190,57,133,1,62,10,52,33,28,2,3,0,3
E33050511,401,299,109,190,2,49,4,45,45,38,0,4,3,6
E33050512,367,283,113,170,2,29,1,28,40,24,5,7,4,13
E33050513,259,179,78,101,1,28,5,23,49,46,1,2,0,2
E33050514,498,373,115,258,1,56,7,49,60,48,3,7,2,8
E33050515,322,227,81,146,6,43,5,38,39,26,4,6,3,7
E33050516,538,397,150,247,3,54,14,40,74,50,3,7,14,10
E33050517,271,193,62,131,1,42,7,35,31,22,5,2,2,4
E33050518,498,329,125,204,8,51,9,42,80,66,5,5,4,30
E33050519,444,276,94,182,9,58,7,51,85,70,5,3,7,16
E33050520,354,220,108,112,7,26,3,23,77,61,9,4,3,24
E33050521,379,240,76,164,7,43,11,32,71,46,13,3,9,18
E33050522,494,338,111,227,8,50,5,45,78,58,5,3,12,20
E33050523,332,261,121,140,2,27,1,26,34,22,3,2,7,8
E33050524,347,262,99,163,3,39,4,35,38,34,2,2,0,5
E33050525,548,413,123,290,4,41,4,37,59,44,6,7,2,31
E33050526,478,289,116,173,1,79,9,70,101,75,4,4,18,8
E33050527,232,149,43,106,2,27,5,22,41,28,6,4,3,13
E33050528,379,269,79,190,1,56,8,48,51,39,1,6,5,2
E33050529,598,455,100,355,14,47,5,42,77,66,2,7,2,5
E33050530,284,223,79,144,5,24,3,21,26,21,3,0,2,6
E33050531,283,174,58,116,4,44,4,40,54,37,8,0,9,7
E33050532,329,233,89,144,1,29,6,23,59,44,6,5,4,7
E33050533,1036,622,155,467,6,120,32,88,287,94,116,2,75,1
E33050534,305,206,71,135,0,31,8,23,59,46,8,5,0,9
E33050535,419,175,43,132,7,82,7,75,153,50,55,1,47,2
E33050536,245,142,39,103,6,50,9,41,41,32,2,3,4,6
E33050537,560,225,48,177,3,74,20,54,250,81,71,16,82,8
E33050538,304,184,37,147,11,47,13,34,62,24,25,5,8,0
E33050539,345,199,59,140,5,80,13,67,53,27,16,1,9,8
E33050540,332,246,78,168,1,19,6,13,58,50,2,5,1,8
E33050541,307,214,72,142,2,47,7,40,41,33,0,3,5,3
E33050542,434,354,112,242,3,36,14,22,40,38,0,1,1,1
E33050543,665,530,181,349,13,49,7,42,70,58,7,3,2,3
E33050544,552,399,110,289,5,79,17,62,67,58,4,3,2,2
E33050545,330,222,85,137,7,28,2,26,62,56,2,2,2,11
E33050546,359,274,86,188,2,22,5,17,59,52,3,4,0,2
E33050547,1392,973,156,817,16,62,7,55,338,322,2,12,2,3
E33050548,346,245,89,156,7,35,2,33,54,50,1,3,0,5
E33050549,522,373,125,248,1,40,10,30,107,91,7,6,3,1
E33050550,280,208,70,138,8,18,8,10,38,27,1,4,6,8
E33050551,313,202,85,117,4,35,9,26,68,63,0,5,0,4
E33050552,330,275,82,193,0,22,7,15,32,28,3,1,0,1
E33050553,306,246,60,186,4,21,2,19,33,27,1,5,0,2
E33050554,316,254,67,187,2,19,10,9,40,35,1,4,0,1
E33050555,304,249,65,184,1,15,7,8,34,28,0,6,0,5
E33050556,276,224,84,140,4,16,5,11,27,20,6,1,0,5
E33050557,398,310,121,189,3,27,6,21,56,51,1,4,0,2
E33050558,334,266,96,170,4,18,4,14,46,42,0,4,0,0
E33050559,251,177,73,104,0,13,3,10,56,43,5,7,1,5
E33050560,310,238,108,130,1,21,1,20,43,34,0,5,4,7
E33050561,395,335,129,206,1,10,3,7,40,35,1,2,2,9
E33050562,327,233,88,145,6,21,1,20,58,27,10,7,14,9
E33050563,437,320,100,220,3,26,1,25,82,73,5,3,1,6
E33050564,335,247,92,155,3,21,3,18,49,47,0,2,0,15
E33050565,559,410,152,258,6,30,0,30,100,83,7,7,3,13
E33050566,270,197,74,123,4,27,1,26,36,32,0,0,4,6
E33050567,331,269,77,192,1,13,4,9,47,44,1,2,0,1
E33050568,304,212,55,157,1,35,9,26,54,49,1,0,4,2
E33050569,554,423,123,300,3,57,5,52,69,61,6,1,1,2
E33050570,240,139,40,99,0,45,7,38,56,41,6,6,3,0
E33050571,1054,754,207,547,7,102,63,39,181,162,2,15,2,10
E33050572,612,467,117,350,7,55,11,44,81,72,1,4,4,2
E33050573,273,199,89,110,1,24,8,16,43,36,3,4,0,6
E33050574,269,229,90,139,1,15,5,10,19,12,6,1,0,5
E33050575,433,331,113,218,2,44,22,22,52,36,6,6,4,4
E33050576,408,314,63,251,3,25,11,14,64,54,2,7,1,2
E33050577,302,177,22,155,0,13,4,9,111,45,47,0,19,1
E33050578,2458,1554,327,1227,22,139,14,125,730,250,307,11,162,13
E33050579,523,356,129,227,2,54,6,48,100,76,15,6,3,11
E33050580,710,326,93,233,8,81,13,68,281,51,114,2,114,14
E33050581,446,327,98,229,2,25,7,18,75,62,3,6,4,17
E33050582,271,222,68,154,1,16,5,11,29,23,2,3,1,3
E33050583,357,256,120,136,4,23,5,18,61,50,6,3,2,13
E33050584,425,307,92,215,3,29,8,21,78,68,2,8,0,8
E33050585,586,435,135,300,5,52,4,48,84,64,9,3,8,10
E33050586,595,443,112,331,3,53,5,48,95,91,1,2,1,1
E33050587,316,223,37,186,1,26,4,22,64,55,2,4,3,2
E33050588,738,595,165,430,6,45,6,39,89,82,3,3,1,3
E33050589,282,213,55,158,0,30,1,29,39,35,1,3,0,0
E33050590,961,667,147,520,9,111,23,88,169,137,19,6,7,5
E33050591,359,283,85,198,2,24,4,20,49,42,3,2,2,1
E33050592,1258,931,230,701,17,123,17,106,184,167,2,8,7,3
E33050593,809,595,169,426,2,89,16,73,120,97,4,13,6,3
E33050594,274,223,76,147,1,23,2,21,25,21,2,1,1,2
E33050595,282,187,38,149,5,36,1,35,54,47,2,4,1,0
E33050596,358,269,61,208,2,20,1,19,66,60,0,6,0,1
E33050597,619,446,109,337,8,48,7,41,115,99,8,6,2,2
E33050598,330,230,53,177,4,63,10,53,32,29,0,3,0,1
E33050599,653,435,127,308,6,92,11,81,117,105,1,6,5,3
E33050600,257,209,79,130,0,24,5,19,24,17,0,7,0,0
E33050601,408,283,85,198,1,70,8,62,54,46,3,1,4,0
E33050602,396,308,88,220,4,21,1,20,59,58,0,1,0,4
E33050603,618,430,117,313,3,100,11,89,82,72,1,5,4,3
E33050604,658,480,108,372,7,73,8,65,93,77,4,11,1,5
E33050605,542,418,145,273,4,49,8,41,66,50,7,4,5,5
E33050606,364,264,98,166,3,31,4,27,51,42,5,3,1,15
E33050607,315,236,92,144,2,21,3,18,52,46,4,2,0,4
E33050608,260,180,63,117,9,22,3,19,43,36,2,1,4,6
E33050609,325,204,59,145,3,25,8,17,78,68,5,4,1,15
E33050610,351,244,73,171,3,34,6,28,61,52,1,4,4,9
E33050611,412,325,156,169,2,37,4,33,43,31,5,5,2,5
E33050612,372,276,92,184,1,45,6,39,45,40,4,0,1,5
E33050613,375,302,70,232,3,25,0,25,45,36,1,7,1,0
E33050614,287,216,49,167,3,32,4,28,35,30,2,3,0,1
E33050615,426,358,75,283,1,22,4,18,45,40,0,5,0,0
E33050616,282,199,46,153,4,44,4,40,30,27,1,0,2,5
E33050617,313,215,32,183,6,33,5,28,55,51,1,1,2,4
E33050618,694,516,132,384,6,67,14,53,72,59,6,1,6,33
E33050619,399,293,56,237,4,42,5,37,57,52,0,5,0,3
E33050620,441,308,67,241,3,77,10,67,50,46,0,2,2,3
E33050621,382,283,74,209,4,30,3,27,61,54,1,4,2,4
E33050622,246,182,46,136,3,25,3,22,36,29,2,2,3,0
E33050623,523,437,107,330,2,20,3,17,61,52,3,5,1,3
E33050624,356,282,80,202,2,25,6,19,46,39,2,1,4,1
E33050625,492,392,152,240,0,30,3,27,61,48,6,3,4,9
E33050626,286,213,82,131,2,15,2,13,53,34,7,5,7,3
E33050627,408,314,106,208,2,31,8,23,59,45,5,6,3,2
E33050628,286,204,34,170,3,32,5,27,45,37,2,2,4,2
E33050629,714,376,78,298,8,55,9,46,272,94,109,7,62,3
E33050630,261,193,60,133,0,20,2,18,43,36,3,1,3,5
E33050631,310,212,66,146,2,41,6,35,48,35,5,5,3,7
E33050632,484,352,109,243,5,61,15,46,66,61,2,2,1,0
E33050633,347,209,77,132,1,54,4,50,61,44,9,4,4,22
E33050634,369,278,68,210,0,29,2,27,60,48,5,6,1,2
E33050635,363,260,54,206,1,24,3,21,63,57,1,3,2,15
E33050636,325,246,56,190,10,26,1,25,41,35,0,5,1,2
E33050637,360,233,70,163,1,41,5,36,75,67,1,4,3,10
E33050638,261,182,60,122,0,39,4,35,38,29,7,1,1,2
E33050639,276,192,56,136,5,28,3,25,50,37,7,3,3,1
E33050640,285,188,69,119,3,35,26,9,50,38,0,2,10,9
E33050641,568,274,60,214,6,50,21,29,234,81,100,2,51,4
E33050642,352,168,51,117,1,35,10,25,144,34,57,1,52,4
E33050643,345,150,49,101,5,37,20,17,148,36,67,2,43,5
E33050644,255,172,66,106,6,42,28,14,30,21,7,0,2,5
E33050645,446,326,101,225,5,48,29,19,61,46,10,3,2,6
E33050646,434,313,77,236,1,52,31,21,67,49,10,5,3,1
E33050647,372,181,33,148,3,57,36,21,125,53,44,0,28,6
E33050648,324,180,30,150,2,46,12,34,95,55,20,3,17,1
E33050649,653,474,118,356,15,44,20,24,114,81,16,6,11,6
E33050650,348,204,48,156,5,57,17,40,81,67,9,2,3,1
E33050651,390,230,48,182,4,80,57,23,73,56,7,4,6,3
E33050652,581,379,74,305,11,80,46,34,108,79,13,4,12,3
E33050653,304,245,98,147,0,19,12,7,33,30,0,3,0,7
E33050654,695,393,115,278,5,109,62,47,169,142,16,4,7,19
E33050655,282,196,69,127,7,29,19,10,45,36,8,0,1,5
E33050656,2666,2018,462,1556,21,142,75,67,464,379,38,27,20,21
E33050657,495,334,135,199,4,70,41,29,81,51,16,3,11,6
E33050658,872,495,153,342,6,97,54,43,238,190,27,12,9,36
E33050659,498,319,133,186,5,41,23,18,115,91,15,8,1,18
E33050660,347,219,95,124,1,38,12,26,65,56,4,3,2,24
E33050661,581,354,153,201,5,78,30,48,129,112,3,5,9,15
E33050662,552,351,127,224,9,91,57,34,94,81,0,6,7,7
E33050663,437,312,102,210,8,45,13,32,62,49,10,3,0,10
E33050664,271,188,78,110,3,37,18,19,42,36,5,1,0,1
E33050665,857,563,135,428,7,132,62,70,141,112,13,8,8,14
E33050666,335,250,75,175,1,42,28,14,38,33,4,0,1,4
E33050667,452,251,72,179,2,129,92,37,67,57,1,7,2,3
E33050668,295,163,54,109,2,100,73,27,26,22,1,1,2,4
E33050669,271,195,62,133,3,38,20,18,31,28,1,1,1,4
E33050670,342,257,100,157,2,40,30,10,41,33,0,5,3,2
E33050671,221,134,37,97,1,43,26,17,41,31,5,4,1,2
E33050672,263,190,87,103,3,30,23,7,38,29,1,8,0,2
E33050673,384,244,84,160,0,73,52,21,65,58,6,1,0,2
E33050674,348,224,111,113,0,36,15,21,66,55,9,0,2,22
E33050675,332,218,82,136,3,30,15,15,63,57,5,1,0,18
E33050676,383,252,82,170,1,50,30,20,73,47,11,5,10,7
E33050677,473,293,103,190,2,46,36,10,107,81,15,5,6,25
E33050678,358,209,78,131,5,27,15,12,102,83,12,4,3,15
E33050679,398,244,82,162,0,28,26,2,105,85,13,1,6,21
E33050680,631,379,128,251,4,108,74,34,134,119,6,3,6,6
E33050681,422,266,89,177,4,55,32,23,90,76,6,6,2,7
E33050682,248,161,51,110,1,23,15,8,55,45,6,2,2,8
E33050683,558,335,76,259,16,57,33,24,147,133,1,9,4,3
E33050684,508,337,88,249,10,46,33,13,108,89,9,5,5,7
E33050685,265,152,54,98,2,40,30,10,59,43,3,11,2,12
E33050686,374,225,63,162,7,50,28,22,85,69,2,7,7,7
E33050687,333,225,74,151,0,36,23,13,68,59,1,5,3,4
E33050688,477,329,115,214,6,37,21,16,101,81,5,7,8,4
E33050689,254,176,56,120,2,37,27,10,32,31,1,0,0,7
E33050690,255,136,47,89,0,31,16,15,78,66,7,5,0,10
E33050691,296,198,71,127,5,18,10,8,73,56,6,7,4,2
E33050692,531,322,114,208,6,64,38,26,123,104,9,4,6,16
E33050693,554,364,133,231,1,43,27,16,118,90,17,6,5,28
E33050694,294,206,82,124,3,14,8,6,59,45,4,10,0,12
E33050695,472,363,126,237,10,30,19,11,66,58,5,2,1,3
E33050696,445,272,66,206,13,59,19,40,100,76,12,6,6,1
E33050697,360,257,102,155,7,49,33,16,42,30,2,4,6,5
E33050698,424,287,106,181,2,37,25,12,76,55,13,4,4,22
E33050699,247,159,59,100,0,31,17,14,55,47,4,1,3,2
E33050700,234,149,39,110,2,32,20,12,50,42,4,2,2,1
E33050701,535,358,112,246,3,57,33,24,111,93,6,8,4,6
E33050702,291,198,66,132,5,34,13,21,49,42,0,2,5,5
E33050703,453,290,95,195,8,82,49,33,69,55,7,2,5,4
E33050704,316,251,91,160,0,21,10,11,41,34,4,2,1,3
E33050705,291,228,76,152,2,22,15,7,35,30,0,2,3,4
E33050706,631,466,191,275,1,66,38,28,86,75,2,5,4,12
E33050707,337,226,85,141,6,20,9,11,75,66,5,3,1,10
E33050708,381,303,101,202,6,16,8,8,40,31,4,4,1,16
E33050709,274,179,78,101,2,15,10,5,66,58,5,3,0,12
E33050710,307,207,83,124,3,49,23,26,43,37,4,0,2,5
E33050711,254,174,67,107,1,18,14,4,55,44,4,4,3,6
E33050712,341,233,96,137,7,40,25,15,57,50,1,6,0,4
E33050713,240,162,83,79,1,22,21,1,35,26,4,3,2,20
E33050714,285,173,70,103,0,17,4,13,70,63,4,2,1,25
E33050715,330,242,95,147,1,18,3,15,45,30,8,6,1,24
E33050716,243,162,57,105,0,25,21,4,52,40,6,1,5,4
E33050717,267,198,65,133,2,17,12,5,45,40,1,3,1,5
E33050718,257,193,72,121,0,4,3,1,47,39,5,2,1,13
E33050719,323,244,94,150,5,26,14,12,47,39,2,1,5,1
E33050720,297,213,71,142,1,32,27,5,43,34,3,4,2,8
E33050721,458,347,149,198,6,27,14,13,75,65,3,6,1,3
E33050722,614,424,125,299,6,70,41,29,109,95,4,6,4,5
E33050723,415,314,78,236,2,36,2,34,59,51,1,7,0,4
E33050724,509,367,116,251,0,66,9,57,71,61,2,7,1,5
E33050725,340,281,62,219,2,15,4,11,37,34,1,2,0,5
E33050726,284,217,76,141,3,13,1,12,46,38,7,1,0,5
E33050727,424,318,79,239,5,41,6,35,55,52,1,1,1,5
E33050728,394,297,96,201,2,38,5,33,52,45,3,4,0,5
E33050729,315,248,67,181,3,26,3,23,35,30,2,1,2,3
E33050730,374,286,106,180,0,36,7,29,44,35,3,6,0,8
E33050731,284,204,57,147,0,23,4,19,43,28,5,2,8,14
E33050732,435,357,101,256,1,28,3,25,48,46,1,1,0,1
E33050733,533,388,89,299,2,68,2,66,74,70,1,3,0,1
E33050734,276,185,42,143,3,46,8,38,42,37,0,5,0,0
E33050735,435,338,89,249,3,40,5,35,51,42,0,8,1,3
E33050736,312,231,68,163,2,30,2,28,42,37,0,5,0,7
E33050737,257,194,73,121,2,14,5,9,43,40,1,0,2,4
E33050738,252,199,83,116,1,26,4,22,21,20,0,1,0,5
E33050739,446,372,143,229,0,19,2,17,48,45,2,1,0,7
E33050740,607,447,184,263,1,37,10,27,108,93,6,5,4,14
E33050741,349,275,93,182,1,30,5,25,41,38,1,2,0,2
E33050742,379,303,103,200,0,25,7,18,50,46,1,2,1,1
E33050743,299,228,85,143,0,34,1,33,36,29,1,6,0,1
E33050744,296,235,98,137,2,12,3,9,46,42,1,3,0,1
E33050745,477,368,101,267,0,51,7,44,55,53,0,2,0,3
E33050746,289,235,97,138,1,22,0,22,27,27,0,0,0,4
E33050747,604,439,159,280,2,42,3,39,113,108,1,4,0,8
E33050748,588,455,145,310,1,46,11,35,84,74,3,5,2,2
E33050749,241,202,75,127,1,12,1,11,24,21,2,0,1,2
E33050750,344,275,44,231,0,16,4,12,53,47,1,3,2,0
E33050751,329,220,50,170,2,41,2,39,56,48,1,4,3,10
E33050752,462,374,66,308,7,28,2,26,52,50,1,1,0,1
E33050753,300,249,72,177,0,18,1,17,24,18,1,4,1,9
E33050754,499,393,109,284,4,27,3,24,72,61,1,8,2,3
E33050755,784,540,150,390,5,104,8,96,134,126,1,4,3,1
E33050756,986,667,186,481,3,96,10,86,218,208,2,6,2,2
E33050757,533,320,81,239,1,50,6,44,157,146,1,8,2,5
E33050758,541,385,104,281,6,53,10,43,94,89,0,3,2,3
E33050759,384,279,90,189,2,40,5,35,60,52,1,6,1,3
E33050760,435,326,88,238,0,23,3,20,84,75,3,5,1,2
E33050761,719,519,134,385,9,62,18,44,127,114,1,11,1,2
E33050762,726,503,153,350,3,82,9,73,132,124,2,5,1,6
E33050763,367,294,80,214,3,23,2,21,47,41,1,5,0,0
E33050764,361,272,63,209,1,20,1,19,65,55,3,5,2,3
E33050765,376,301,89,212,4,18,5,13,50,44,1,5,0,3
E33050766,237,191,46,145,4,16,1,15,26,24,0,2,0,0
E33050767,289,246,90,156,0,16,1,15,26,25,0,1,0,1
E33050768,526,376,90,286,4,73,4,69,71,62,0,8,1,2
E33050769,957,650,176,474,10,99,16,83,193,177,2,11,3,5
E33050770,447,356,100,256,2,42,6,36,41,39,0,2,0,6
E33050771,492,405,108,297,5,28,6,22,51,46,1,4,0,3
E33050772,717,556,163,393,6,50,3,47,98,88,3,7,0,7
E33050773,295,219,72,147,1,16,3,13,56,53,2,1,0,3
E33050774,354,293,101,192,2,19,2,17,38,23,8,3,4,2
E33050775,249,213,95,118,0,7,2,5,22,20,0,1,1,7
E33050776,355,294,102,192,0,15,2,13,45,34,4,6,1,1
E33050777,423,329,119,210,1,28,6,22,59,49,1,7,2,6
E33050778,231,167,65,102,0,12,6,6,45,32,5,3,5,7
E33050779,443,366,99,267,0,24,3,21,43,31,1,8,3,10
E33050780,273,217,87,130,3,16,3,13,27,26,1,0,0,10
E33050781,452,351,112,239,0,36,2,34,57,37,9,10,1,8
E33050782,254,207,54,153,1,15,1,14,30,26,0,4,0,1
E33050783,266,199,68,131,2,23,2,21,41,28,3,4,6,1
E33050784,315,224,59,165,0,24,2,22,64,62,0,2,0,3
E33050785,352,253,47,206,1,34,6,28,62,56,0,6,0,2
E33050786,518,366,94,272,0,43,7,36,105,93,2,8,2,4
E33050787,303,253,57,196,0,22,2,20,25,20,1,3,1,3
E33050788,498,388,102,286,4,43,5,38,57,47,3,2,5,6
E33050789,510,358,71,287,6,78,5,73,67,60,0,5,2,1
E33050790,410,302,70,232,3,49,8,41,56,51,1,3,1,0
E33050791,256,163,40,123,1,25,2,23,64,30,18,1,15,3
E33050792,264,184,54,130,3,28,5,23,48,35,7,2,4,1
E33050793,2015,1157,279,878,16,173,32,141,655,233,239,17,166,14
E33050794,235,162,51,111,2,30,4,26,41,30,1,3,7,0
E33050795,391,306,92,214,1,17,4,13,63,55,5,3,0,4
E33050796,299,224,56,168,1,17,5,12,55,45,2,7,1,2
E33050797,326,236,70,166,2,39,9,30,46,36,3,4,3,3
E33050798,523,338,87,251,9,57,11,46,112,101,3,4,4,7
E33050799,239,172,44,128,1,29,5,24,36,33,1,2,0,1
E33050800,326,229,79,150,1,26,7,19,49,44,4,1,0,21
E33050801,325,223,56,167,1,44,4,40,56,48,0,5,3,1
E33050802,437,276,78,198,6,46,8,38,109,102,2,3,2,0
E33050803,404,276,109,167,2,44,5,39,71,57,4,4,6,11
E33050804,632,444,134,310,6,55,9,46,123,110,3,6,4,4
E33050805,283,236,80,156,2,9,0,9,34,30,1,3,0,2
E33050806,394,272,96,176,2,21,1,20,88,72,6,3,7,11
E33050807,546,360,123,237,8,41,7,34,118,96,12,4,6,19
E33050808,281,194,65,129,5,19,1,18,48,38,3,4,3,15
E33050809,1779,1136,354,782,10,211,42,169,385,328,21,21,15,37
E33050810,373,211,86,125,3,32,9,23,111,73,23,1,14,16
E33050811,248,102,51,51,2,60,46,14,75,46,19,4,6,9
E33050812,181,58,36,22,0,37,26,11,68,54,6,4,4,18
E33050813,290,124,83,41,0,55,41,14,89,62,11,9,7,22
E33050814,277,105,68,37,0,54,26,28,108,85,3,3,17,10
E33050815,238,31,19,12,8,8,0,8,106,52,27,0,27,85
E33050816,484,312,96,216,3,22,4,18,141,136,0,5,0,6
E33050817,500,344,96,248,6,13,4,9,134,117,1,15,1,3
E33050818,294,224,66,158,2,16,3,13,50,46,0,4,0,2
E33050819,428,343,107,236,1,7,1,6,75,68,1,6,0,2
E33050820,233,178,80,98,1,7,1,6,43,38,0,5,0,4
E33050821,363,297,91,206,3,15,2,13,47,43,2,2,0,1
E33050822,396,316,77,239,3,15,2,13,60,56,1,3,0,2
E33050823,262,209,62,147,1,10,3,7,38,32,3,3,0,4
E33050824,973,700,143,557,5,48,23,25,218,193,2,21,2,2
E33050825,398,305,67,238,3,14,4,10,72,58,1,13,0,4
E33050826,474,361,72,289,8,21,4,17,81,74,0,7,0,3
E33050827,576,427,89,338,0,26,13,13,117,108,1,7,1,6
E33050828,692,461,55,406,5,28,6,22,195,183,0,12,0,3
E33050829,513,374,57,317,22,35,20,15,80,72,3,4,1,2
E33050830,367,295,27,268,9,11,6,5,52,50,0,2,0,0
E33050831,394,332,37,295,1,6,3,3,51,48,0,2,1,4
E33050832,279,164,18,146,5,32,12,20,77,71,0,6,0,1
E33050833,335,236,24,212,11,7,3,4,80,75,1,4,0,1
E33050834,488,339,54,285,10,29,10,19,108,102,0,6,0,2
E33050835,642,438,96,342,13,55,31,24,135,122,0,11,2,1
E33050836,1198,833,169,664,19,113,69,44,228,204,7,14,3,5
E33050837,448,375,60,315,4,12,9,3,57,55,1,1,0,0
E33050838,377,289,29,260,7,23,8,15,54,46,3,3,2,4
E33050839,343,184,47,137,4,14,4,10,139,133,2,3,1,2
E33050840,422,266,85,181,0,21,9,12,135,128,2,4,1,0
E33050841,292,190,51,139,2,15,7,8,82,72,0,5,5,3
E33050842,251,155,42,113,1,19,12,7,75,70,2,3,0,1
E33050843,321,165,45,120,2,36,18,18,115,109,1,3,2,3
E33050844,563,353,77,276,5,35,17,18,167,160,0,6,1,3
E33050845,295,152,56,96,2,6,3,3,128,120,2,5,1,7
E33050846,255,159,54,105,1,5,2,3,85,80,1,4,0,5
E33050847,255,168,52,116,5,12,7,5,70,64,2,3,1,0
E33050848,311,130,25,105,14,15,4,11,144,136,2,6,0,8
E33050849,268,169,50,119,3,6,1,5,86,77,2,7,0,4
E33050850,451,253,62,191,2,84,64,20,107,98,0,9,0,5
E33050851,449,322,79,243,3,55,48,7,63,60,0,3,0,6
E33050852,969,649,144,505,15,59,40,19,233,221,1,9,2,13
E33050853,460,275,69,206,5,53,37,16,121,115,1,4,1,6
E33050854,368,256,60,196,2,10,4,6,97,89,2,6,0,3
E33050855,493,334,60,274,9,36,16,20,109,109,0,0,0,5
E33050856,591,396,129,267,12,56,31,25,125,117,1,6,1,2
E33050857,412,205,58,147,2,90,66,24,111,102,1,8,0,4
E33050858,347,201,56,145,6,32,18,14,105,96,0,9,0,3
E33050859,282,170,58,112,0,51,29,22,60,55,1,2,2,1
E33050860,475,205,46,159,4,147,117,30,116,110,3,2,1,3
E33050861,710,415,112,303,4,127,103,24,153,138,0,12,3,11
E33050862,270,125,33,92,3,63,43,20,74,65,4,3,2,5
E33050863,262,190,57,133,4,19,11,8,47,45,0,2,0,2
E33050864,279,173,51,122,2,32,19,13,67,64,1,2,0,5
E33050865,416,208,51,157,2,47,31,16,158,147,0,9,2,1
E33050866,301,208,73,135,1,24,9,15,68,63,0,5,0,0
E33050867,315,162,41,121,3,31,19,12,116,104,0,9,3,3
E33050868,443,292,80,212,1,25,19,6,121,108,0,13,0,4
W35000001,296,194,85,109,2,33,26,7,62,52,1,7,2,5
W35000002,297,203,71,132,2,17,12,5,72,65,0,7,0,3
W35000003,356,264,96,168,1,27,21,6,60,57,0,3,0,4
W35000004,864,641,237,404,1,88,65,23,129,109,0,19,1,5
W35000005,266,205,58,147,0,29,25,4,31,27,0,4,0,1
W35000006,1179,927,332,595,3,111,86,25,124,108,4,8,4,14
W35000007,749,570,159,411,1,69,56,13,100,92,1,4,3,9
W35000008,301,239,81,158,0,32,28,4,26,23,0,2,1,4
W35000009,283,188,73,115,1,28,14,14,54,47,0,4,3,12
W35000010,723,527,159,368,2,80,44,36,104,87,1,13,3,10
W35000011,194,139,43,96,2,10,4,6,43,41,1,1,0,0
W35000012,294,203,63,140,0,27,18,9,56,50,0,4,2,8
W35000013,313,190,61,129,0,38,24,14,83,78,1,4,0,2
W35000014,288,158,62,96,2,38,23,15,88,83,1,3,1,2
W35000015,293,161,42,119,1,52,29,23,77,74,0,3,0,2
W35000016,990,596,197,399,4,150,90,60,225,207,0,14,4,15
W35000017,373,282,118,164,5,33,10,23,47,41,1,4,1,6
W35000018,263,173,87,86,1,36,26,10,47,38,5,4,0,6
W35000019,307,215,84,131,1,38,16,22,48,34,1,8,5,5
W35000020,238,179,83,96,1,24,11,13,30,28,0,1,1,4
W35000021,269,173,53,120,1,16,5,11,76,73,0,3,0,3
W35000022,842,588,210,378,2,67,47,20,178,171,0,6,1,7
W35000023,443,318,125,193,0,56,25,31,64,50,1,9,4,5
W35000024,213,153,45,108,0,21,9,12,35,35,0,0,0,4
W35000025,578,487,179,308,0,35,17,18,50,41,3,5,1,6
W35000026,376,263,99,164,2,66,37,29,42,39,1,2,0,3
W35000027,924,631,233,398,3,144,94,50,138,122,1,12,3,8
W35000028,3151,2516,776,1740,7,201,116,85,375,291,30,45,9,52
W35000029,430,327,98,229,3,32,15,17,66,58,2,6,0,2
W35000030,363,247,82,165,1,20,9,11,90,80,1,8,1,5
W35000031,410,319,89,230,1,32,21,11,53,51,0,2,0,5
W35000032,208,140,75,65,0,12,3,9,54,43,2,9,0,2
W35000033,514,369,156,213,0,55,24,31,77,71,0,5,1,13
W35000034,283,206,83,123,0,26,16,10,48,43,1,4,0,3
W35000035,329,183,71,112,0,67,34,33,76,71,3,1,1,3
W35000036,230,153,69,84,3,31,14,17,35,32,3,0,0,8
W35000037,283,179,65,114,1,52,28,24,45,41,2,2,0,6
W35000038,254,188,74,114,0,29,20,9,33,29,1,2,1,4
W35000039,359,249,96,153,0,39,19,20,59,46,3,7,3,12
W35000040,1248,1047,377,670,1,105,63,42,80,70,1,9,0,15
W35000041,323,256,80,176,1,25,13,12,33,25,3,5,0,8
W35000042,312,252,97,155,0,15,10,5,39,31,2,5,1,6
W35000043,742,572,181,391,3,46,18,28,115,103,2,6,4,6
W35000044,212,158,50,108,0,13,7,6,40,39,0,1,0,1
W35000045,598,381,121,260,5,76,42,34,134,124,0,7,3,2
W35000046,1005,871,185,686,5,28,10,18,92,83,1,7,1,9
W35000047,313,262,63,199,1,18,6,12,31,26,2,3,0,1
W35000048,364,227,84,143,3,26,11,15,107,97,0,7,3,1
W35000049,220,156,52,104,2,11,3,8,49,42,0,7,0,2
W35000050,392,247,71,176,3,38,15,23,98,79,1,13,5,6
W35000051,225,119,42,77,1,25,8,17,75,70,0,4,1,5
W35000052,636,520,154,366,2,35,23,12,74,65,2,7,0,5
W35000053,273,205,79,126,3,14,7,7,50,49,0,1,0,1
W35000054,751,549,166,383,5,49,16,33,144,131,1,11,1,4
W35000055,224,146,43,103,3,20,5,15,53,51,1,1,0,2
W35000056,231,168,48,120,5,14,5,9,39,31,0,8,0,5
W35000057,295,191,63,128,2,32,15,17,65,60,0,4,1,5
W35000058,225,128,40,88,2,14,4,10,77,66,5,5,1,4
W35000059,253,147,48,99,1,32,15,17,68,62,1,4,1,5
W35000060,196,97,22,75,0,21,7,14,74,73,0,1,0,4
W35000061,793,669,195,474,8,33,13,20,81,71,0,9,1,2
W35000062,525,392,113,279,4,42,23,19,86,80,0,6,0,1
W35000063,276,184,61,123,3,22,14,8,65,56,1,8,0,2
W35000064,382,276,83,193,5,28,12,16,69,64,2,3,0,4
W35000065,439,335,106,229,2,21,12,9,60,50,0,6,4,21
W35000066,551,424,115,309,1,42,23,19,80,73,1,5,1,4
W35000067,300,230,90,140,2,16,8,8,50,33,11,6,0,2
W35000068,359,297,87,210,2,15,5,10,39,36,0,2,1,6
W35000069,422,269,78,191,4,38,18,20,106,90,4,11,1,5
W35000070,229,153,50,103,0,33,16,17,42,40,0,1,1,1
W35000071,549,362,95,267,3,49,21,28,129,119,2,8,0,6
W35000072,873,626,183,443,3,101,38,63,133,126,1,5,1,10
W35000073,343,244,56,188,4,28,17,11,65,60,0,5,0,2
W35000074,365,308,78,230,5,19,11,8,33,27,0,4,2,0
W35000075,614,510,113,397,6,23,17,6,72,68,0,4,0,3
W35000076,706,585,129,456,11,21,11,10,83,73,1,8,1,6
W35000077,272,206,70,136,6,26,15,11,33,25,3,4,1,1
W35000078,669,525,126,399,8,43,25,18,91,81,0,10,0,2
W35000079,226,174,59,115,0,11,9,2,36,36,0,0,0,5
W35000080,770,539,198,341,6,76,42,34,134,118,2,13,1,15
W35000081,343,251,85,166,4,39,28,11,43,39,1,3,0,6
W35000082,500,385,94,291,8,37,21,16,65,60,0,4,1,5
W35000083,647,490,111,379,12,43,22,21,96,87,1,6,2,6
W35000084,642,462,140,322,5,67,45,22,106,98,0,6,2,2
W35000085,200,144,40,104,2,13,7,6,39,35,0,4,0,2
W35000086,243,180,55,125,2,25,8,17,34,33,0,1,0,2
W35000087,205,138,45,93,2,14,10,4,45,37,1,6,1,6
W35000088,255,186,46,140,4,24,16,8,39,32,2,4,1,2
W35000089,297,218,73,145,3,26,15,11,49,48,1,0,0,1
W35000090,272,204,44,160,2,18,12,6,47,43,0,3,1,1
W35000091,480,308,81,227,7,54,24,30,108,96,3,7,2,3
W35000092,302,224,72,152,1,14,8,6,61,53,3,5,0,2
W35000093,688,561,163,398,3,46,30,16,69,64,1,4,0,9
W35000094,621,447,163,284,3,70,37,33,86,78,1,4,3,15
W35000095,447,334,126,208,1,47,23,24,59,50,4,5,0,6
W35000096,715,523,170,353,1,78,47,31,107,95,0,12,0,6
W35000097,450,324,90,234,6,29,19,10,89,86,0,3,0,2
W35000098,514,422,75,347,0,18,15,3,72,69,0,3,0,2
W35000099,4609,3923,784,3139,24,260,161,99,381,322,0,57,2,21
W35000100,284,204,45,159,3,27,13,14,47,40,0,7,0,3
W35000101,1055,882,215,667,7,62,37,25,96,82,0,12,2,8
W35000102,594,429,118,311,6,57,36,21,95,89,0,4,2,7
W35000103,321,234,55,179,2,31,20,11,53,45,1,6,1,1
W35000104,1013,796,202,594,12,100,65,35,96,85,3,8,0,9
W35000105,1201,1014,258,756,5,71,45,26,108,98,0,10,0,3
W35000106,1015,865,246,619,6,62,40,22,74,68,1,5,0,8
W35000107,801,646,158,488,3,86,50,36,61,56,0,4,1,5
W35000108,1353,1051,197,854,21,38,21,17,233,216,0,15,2,10
W35000109,344,221,53,168,0,33,23,10,89,81,2,5,1,1
W35000110,266,203,53,150,1,28,21,7,34,29,0,5,0,0
W35000111,575,444,113,331,6,45,32,13,78,67,0,10,1,2
W35000112,585,396,116,280,6,67,51,16,109,99,0,10,0,7
W35000113,867,694,180,514,8,59,40,19,102,93,2,6,1,4
W35000114,252,220,65,155,4,7,6,1,21,16,0,4,1,0
W35000115,763,582,178,404,5,79,53,26,91,74,2,11,4,6
W35000116,2002,1751,513,1238,7,109,73,36,126,109,3,13,1,9
W35000117,227,174,63,111,2,12,9,3,35,29,0,6,0,4
W35000118,737,559,163,396,3,69,51,18,102,86,3,12,1,4
W35000119,420,304,91,213,3,32,18,14,79,74,2,3,0,2
W35000120,1239,538,147,391,10,98,63,35,584,569,1,13,1,9
W35000121,297,237,57,180,5,18,9,9,37,30,1,6,0,0
W35000122,246,172,54,118,1,25,17,8,48,45,0,3,0,0
W35000123,468,338,111,227,3,57,31,26,64,53,7,3,1,6
W35000124,255,203,56,147,3,20,13,7,26,25,0,1,0,3
W35000125,313,254,57,197,1,20,7,13,38,35,0,3,0,0
W35000126,887,678,192,486,6,71,48,23,131,119,0,12,0,1
W35000127,239,170,49,121,2,38,16,22,28,27,1,0,0,1
W35000128,210,152,41,111,2,32,20,12,23,19,0,3,1,1
W35000129,531,373,106,267,1,77,53,24,74,66,1,7,0,6
W35000130,2594,1931,402,1529,11,253,147,106,385,356,0,24,5,14
W35000131,610,468,113,355,3,38,21,17,100,85,1,14,0,1
W35000132,1130,922,229,693,2,94,62,32,111,101,0,9,1,1
W35000133,576,511,140,371,1,25,15,10,36,33,0,3,0,3
W35000134,1156,801,192,609,10,119,72,47,223,202,2,18,1,3
W35000135,1183,903,220,683,8,133,83,50,135,121,1,11,2,4
W35000136,1147,859,175,684,4,122,66,56,155,140,3,11,1,7
W35000137,757,552,162,390,6,97,65,32,101,89,0,12,0,1
W35000138,232,130,35,95,1,49,41,8,52,50,1,1,0,0
W35000139,610,421,100,321,2,92,71,21,86,79,0,6,1,9
W35000140,204,152,54,98,0,24,16,8,18,15,2,1,0,10
W35000141,970,734,186,548,2,122,98,24,103,92,1,8,2,9
W35000142,683,568,176,392,2,35,30,5,63,51,0,11,1,15
W35000143,220,161,45,116,0,27,25,2,30,24,4,2,0,2
W35000144,294,199,59,140,0,51,42,9,41,37,3,1,0,3
W35000145,869,733,206,527,3,59,48,11,70,64,0,6,0,4
W35000146,337,268,81,187,1,32,24,8,32,32,0,0,0,4
W35000147,370,261,65,196,2,56,45,11,45,38,0,5,2,6
W35000148,381,246,66,180,2,47,37,10,81,80,0,1,0,5
W35000149,208,131,32,99,3,39,32,7,34,33,0,1,0,1
W35000150,225,157,32,125,1,41,34,7,25,21,0,4,0,1
W35000151,244,196,69,127,2,19,17,2,27,26,1,0,0,0
W35000152,352,281,95,186,2,24,13,11,40,36,0,4,0,5
W35000153,407,302,78,224,1,56,47,9,48,40,0,8,0,0
W35000154,888,694,203,491,3,100,79,21,86,79,0,7,0,5
W35000155,1180,760,211,549,1,199,143,56,211,181,1,29,0,9
W35000156,879,683,201,482,4,49,39,10,138,119,2,14,3,5
W35000157,448,349,110,239,2,36,27,9,58,54,1,3,0,3
W35000158,864,607,145,462,2,122,93,29,126,113,2,11,0,7
W35000159,1803,1081,241,840,15,198,164,34,492,469,5,11,7,17
W35000160,1123,931,209,722,3,72,54,18,109,98,2,8,1,8
W35000161,527,372,123,249,3,63,51,12,86,80,1,5,0,3
W35000162,447,350,99,251,2,35,27,8,54,49,0,5,0,6
W35000163,581,421,109,312,1,66,50,16,90,79,2,7,2,3
W35000164,1889,1402,338,1064,11,185,148,37,280,264,0,15,1,11
W35000165,402,281,86,195,5,74,65,9,40,35,2,3,0,2
W35000166,775,505,132,373,2,143,119,24,120,114,1,5,0,5
W35000167,1924,1263,351,912,10,217,173,44,417,396,1,17,3,17
W35000168,656,407,135,272,2,161,128,33,84,82,0,2,0,2
W35000169,532,412,78,334,0,51,40,11,65,56,0,9,0,4
W35000170,786,647,159,488,1,72,55,17,62,57,1,3,1,4
W35000171,1176,782,179,603,6,165,133,32,218,208,2,8,0,5
W35000172,188,95,25,70,2,42,31,11,48,42,0,6,0,1
W35000173,515,263,70,193,5,69,57,12,174,166,1,7,0,4
W35000174,330,235,132,103,1,17,12,5,73,65,2,6,0,4
W35000175,549,343,142,201,0,65,41,24,138,128,2,8,0,3
W35000176,240,186,63,123,1,6,4,2,45,39,1,5,0,2
W35000177,1052,822,361,461,6,65,44,21,137,118,0,19,0,22
W35000178,365,237,117,120,0,53,34,19,70,62,0,7,1,5
W35000179,207,135,55,80,1,30,20,10,40,35,1,3,1,1
W35000180,214,153,68,85,0,25,18,7,35,32,1,1,1,1
W35000181,360,295,109,186,3,16,11,5,42,38,0,4,0,4
W35000182,245,169,71,98,2,31,18,13,37,32,1,4,0,6
W35000183,227,159,59,100,0,31,22,9,36,31,2,3,0,1
W35000184,217,144,52,92,0,29,18,11,42,35,2,4,1,2
W35000185,232,171,80,91,1,18,8,10,42,34,3,3,2,0
W35000186,468,340,134,206,1,47,31,16,72,67,1,3,1,8
W35000187,296,149,51,98,0,60,44,16,83,78,1,4,0,4
W35000188,323,198,100,98,0,62,41,21,58,45,2,10,1,5
W35000189,929,606,274,332,5,154,99,55,156,139,0,16,1,8
W35000190,1806,1223,467,756,5,226,141,85,339,303,2,33,1,13
W35000191,789,507,195,312,2,85,45,40,184,163,5,15,1,11
W35000192,359,201,80,121,0,63,38,25,87,75,4,4,4,8
W35000193,213,136,51,85,0,36,24,12,40,31,2,6,1,1
W35000194,292,194,79,115,3,38,22,16,54,39,0,8,7,3
W35000195,209,121,62,59,0,17,11,6,64,49,3,9,3,7
W35000196,529,421,170,251,5,38,20,18,57,51,0,5,1,8
W35000197,282,185,81,104,1,28,12,16,60,54,1,5,0,8
W35000198,767,547,161,386,6,68,33,35,139,126,1,9,3,7
W35000199,222,142,58,84,1,22,13,9,55,44,2,4,5,2
W35000200,496,323,134,189,2,63,23,40,103,92,2,9,0,5
W35000201,1124,678,237,441,1,104,50,54,332,307,9,16,0,9
W35000202,530,383,140,243,1,63,27,36,77,70,0,6,1,6
W35000203,704,431,127,304,2,92,49,43,168,151,4,10,3,11
W35000204,420,292,119,173,2,46,20,26,75,68,3,4,0,5
W35000205,330,275,103,172,0,25,22,3,28,26,0,2,0,2
W35000206,570,472,180,292,2,17,7,10,67,62,0,4,1,12
W35000207,300,234,91,143,1,19,7,12,43,39,0,2,2,3
W35000208,297,239,112,127,2,26,11,15,29,26,0,2,1,1
W35000209,324,233,85,148,0,26,8,18,61,58,1,1,1,4
W35000210,617,461,179,282,2,14,5,9,135,119,0,15,1,5
W35000211,226,133,56,77,0,17,4,13,73,72,0,1,0,3
W35000212,375,213,91,122,0,24,6,18,132,123,2,5,2,6
W35000213,394,221,71,150,3,26,8,18,137,130,0,5,2,7
W35000214,331,164,59,105,0,40,14,26,122,114,1,3,4,5
W35000215,519,331,132,199,0,17,4,13,165,147,1,10,7,6
W35000216,910,621,246,375,3,62,19,43,208,193,2,10,3,16
W35000217,406,302,96,206,3,44,17,27,51,45,0,5,1,6
W35000218,420,306,123,183,1,49,33,16,60,54,0,6,0,4
W35000219,706,473,162,311,0,105,74,31,118,93,3,17,5,10
W35000220,380,268,92,176,0,32,17,15,73,64,1,8,0,7
W35000221,1569,1261,456,805,4,90,59,31,200,161,3,31,5,14
W35000222,237,196,66,130,0,12,4,8,27,25,1,1,0,2
W35000223,296,228,68,160,1,37,19,18,28,21,1,6,0,2
W35000224,2667,2023,649,1374,3,226,125,101,398,347,15,32,4,17
W35000225,866,678,230,448,0,73,42,31,106,87,4,13,2,9
W35000226,1666,1202,398,804,0,168,121,47,278,241,15,20,2,18
W35000227,586,392,140,252,0,85,67,18,103,93,2,7,1,6
W35000228,325,207,64,143,1,54,34,20,60,54,0,6,0,3
W35000229,669,473,155,318,2,82,50,32,106,93,3,10,0,6
W35000230,227,172,47,125,2,18,11,7,34,27,0,6,1,1
W35000231,508,380,140,240,1,61,38,23,62,57,1,3,1,4
W35000232,376,250,67,183,0,43,30,13,82,78,0,4,0,1
W35000233,245,194,91,103,0,18,16,2,32,30,0,2,0,1
W35000234,293,221,72,149,2,33,19,14,36,32,0,2,2,1
W35000235,204,159,57,102,0,16,9,7,28,25,0,3,0,1
W35000236,886,672,178,494,2,65,43,22,140,121,3,16,0,7
W35000237,589,427,141,286,2,74,49,25,81,69,3,9,0,5
W35000238,285,226,86,140,0,27,17,10,31,27,0,3,1,1
W35000239,231,156,78,78,2,16,7,9,37,28,2,4,3,20
W35000240,251,201,123,78,3,16,11,5,29,29,0,0,0,2
W35000241,255,200,55,145,0,23,18,5,30,25,0,4,1,2
W35000242,300,191,74,117,0,29,13,16,71,63,3,5,0,9
W35000243,247,156,59,97,0,14,8,6,69,54,3,10,2,8
W35000244,256,204,91,113,1,20,11,9,30,28,0,2,0,1
W35000245,700,561,191,370,0,66,41,25,63,52,0,10,1,10
W35000246,107,85,23,62,0,9,6,3,11,10,0,1,0,2
W35000247,522,395,149,246,2,61,38,23,61,54,1,6,0,3
W35000248,1708,1251,395,856,5,208,156,52,232,197,1,31,3,12
W35000249,1493,1253,402,851,2,109,77,32,120,103,2,14,1,9
W35000250,2012,1668,562,1106,2,112,76,36,203,173,7,21,2,27
W35000251,405,342,123,219,2,17,7,10,38,35,0,3,0,6
W35000252,259,195,85,110,0,12,6,6,49,44,0,5,0,3
W35000253,532,363,142,221,3,47,34,13,111,95,1,13,2,8
W35000254,809,705,234,471,6,39,30,9,54,46,1,7,0,5
W35000255,344,252,91,161,0,34,24,10,53,46,2,5,0,5
W35000256,201,147,42,105,1,21,13,8,29,25,2,1,1,3
W35000257,302,222,88,134,0,27,17,10,47,38,0,9,0,6
W35000258,355,255,95,160,2,26,15,11,69,63,1,5,0,3
W35000259,287,212,72,140,0,22,13,9,50,43,5,2,0,3
W35000260,440,285,101,184,2,50,38,12,97,85,2,10,0,6
W35000261,603,448,174,274,2,54,39,15,94,84,0,10,0,5
W35000262,292,226,70,156,0,23,12,11,41,34,0,7,0,2
W35000263,204,168,63,105,0,3,3,0,28,21,3,4,0,5
W35000264,487,354,122,232,3,46,31,15,80,70,2,4,4,4
W35000265,622,443,198,245,1,44,23,21,116,95,1,20,0,18
W35000266,884,572,216,356,3,85,65,20,219,209,0,7,3,5
W35000267,465,368,126,242,0,37,25,12,53,48,0,5,0,7
W35000268,318,254,75,179,0,32,21,11,31,29,1,1,0,1
W35000269,285,238,83,155,0,15,11,4,29,25,1,3,0,3
W35000270,758,673,162,511,0,16,12,4,60,51,0,9,0,9
W35000271,202,159,49,110,0,19,11,8,24,20,0,3,1,0
W35000272,342,306,111,195,0,14,8,6,20,17,0,1,2,2
W35000273,226,181,54,127,0,25,20,5,20,20,0,0,0,0
W35000274,426,311,98,213,1,63,51,12,49,47,0,2,0,2
W35000275,274,193,60,133,0,32,18,14,45,41,0,2,2,4
W35000276,805,677,213,464,0,54,33,21,72,63,0,8,1,2
W35000277,348,271,98,173,0,34,26,8,40,37,0,3,0,3
W35000278,239,173,55,118,0,30,20,10,36,29,0,6,1,0
W35000279,239,197,76,121,0,15,10,5,27,25,0,2,0,0
W35000280,245,187,87,100,0,18,6,12,37,32,1,2,2,3
W35000281,263,194,93,101,0,22,18,4,34,30,1,3,0,13
W35000282,217,158,59,99,0,31,24,7,26,22,0,4,0,2
W35000283,585,429,139,290,0,57,44,13,91,77,0,11,3,8
W35000284,990,768,297,471,2,97,79,18,114,100,1,13,0,9
W35000285,281,227,65,162,0,6,4,2,45,40,1,3,1,3
W35000286,1539,1098,288,810,3,149,102,47,279,259,0,19,1,10
W35000287,1065,830,206,624,1,77,45,32,153,136,0,16,1,4
W35000288,1028,905,246,659,2,42,22,20,74,67,0,7,0,5
W35000289,818,573,161,412,1,109,74,35,126,121,0,5,0,9
W35000290,1277,974,271,703,3,159,98,61,124,108,2,14,0,17
W35000291,408,324,73,251,1,42,33,9,40,31,0,9,0,1
W35000292,534,427,140,287,4,54,33,21,42,39,0,3,0,7
W35000293,336,144,30,114,6,48,26,22,135,120,2,13,0,3
W35000294,294,188,67,121,2,38,24,14,62,54,2,3,3,4
W35000295,390,268,100,168,0,59,34,25,54,47,1,6,0,9
W35000296,257,161,46,115,0,53,32,21,38,37,1,0,0,5
W35000297,1025,705,243,462,3,135,86,49,175,159,0,16,0,7
W35000298,355,275,80,195,1,23,13,10,56,50,0,6,0,0
W35000299,246,187,42,145,1,22,13,9,34,30,0,4,0,2
W35000300,491,318,97,221,0,37,18,19,132,112,0,20,0,4
W35000301,240,159,43,116,0,29,23,6,50,48,0,2,0,2
W35000302,265,183,57,126,0,30,14,16,50,44,0,6,0,2
W35000303,452,390,90,300,2,15,9,6,43,36,0,7,0,2
W35000304,528,392,119,273,1,47,30,17,80,73,1,6,0,8
W35000305,745,525,149,376,3,104,62,42,106,98,0,7,1,7
W35000306,233,148,57,91,1,41,25,16,39,30,5,4,0,4
W35000307,232,146,43,103,0,37,24,13,48,40,0,7,1,1
W35000308,506,276,58,218,2,77,53,24,145,139,0,6,0,6
W35000309,375,256,59,197,0,42,30,12,74,66,0,6,2,3
W35000310,284,189,58,131,0,52,31,21,43,40,0,3,0,0
W35000311,233,149,38,111,0,46,30,16,37,35,0,2,0,1
W35000312,220,144,40,104,0,37,27,10,38,37,0,1,0,1
W35000313,494,342,82,260,2,55,34,21,92,86,0,6,0,3
W35000314,201,148,57,91,0,24,10,14,24,21,0,3,0,5
W35000315,195,139,33,106,0,23,10,13,32,31,0,1,0,1
W35000316,363,247,72,175,0,71,51,20,45,40,0,5,0,0
W35000317,532,342,119,223,0,119,84,35,68,57,1,9,1,3
W35000318,793,548,153,395,0,121,80,41,114,107,0,7,0,10
W35000319,435,351,106,245,1,50,36,14,33,28,0,5,0,0
W35000320,208,171,44,127,0,23,17,6,9,6,0,3,0,5
W35000321,534,376,123,253,2,90,60,30,64,61,0,2,1,2
W35000322,392,311,70,241,0,38,24,14,40,39,1,0,0,3
W35000323,250,194,86,108,3,19,11,8,29,27,0,2,0,5
W35000324,220,183,73,110,0,4,2,2,25,20,0,5,0,8
W35000325,853,593,162,431,3,76,43,33,172,154,0,17,1,9
W35000326,691,533,159,374,0,91,61,30,65,59,0,6,0,2
W35000327,441,330,86,244,4,55,37,18,49,47,0,2,0,3
W35000328,775,615,163,452,2,66,41,25,91,82,1,8,0,1
W35000329,683,566,169,397,0,54,33,21,60,51,0,9,0,3
W35000330,213,175,58,117,0,22,15,7,14,13,0,1,0,2
W35000331,479,403,108,295,2,22,15,7,50,45,0,5,0,2
W35000332,304,219,70,149,2,41,26,15,40,38,0,2,0,2
W35000333,472,381,111,270,0,34,23,11,56,46,0,10,0,1
W35000334,289,223,60,163,3,36,24,12,27,26,0,1,0,0
W35000335,408,328,72,256,1,27,18,9,49,44,0,5,0,3
W35000336,210,160,55,105,1,16,8,8,29,29,0,0,0,4
W35000337,284,193,51,142,0,43,34,9,44,35,0,8,1,4
W35000338,381,250,78,172,2,76,50,26,51,45,0,4,2,2
W35000339,247,204,52,152,0,22,7,15,21,18,0,1,2,0
W35000340,3886,3319,1020,2299,9,242,150,92,299,258,1,39,1,17
W35000341,439,280,95,185,1,67,50,17,89,82,0,5,2,2
W35000342,264,210,57,153,0,31,20,11,22,22,0,0,0,1
W35000343,716,564,171,393,2,70,49,21,76,70,0,6,0,4
W35000344,710,597,199,398,2,43,25,18,65,60,0,4,1,3
W35000345,692,580,162,418,1,42,26,16,62,52,0,10,0,7
W35000346,284,181,59,122,0,21,11,10,73,66,2,4,1,9
W35000347,980,735,197,538,0,141,111,30,100,87,1,12,0,4
W35000348,1731,1411,423,988,2,168,116,52,145,126,4,15,0,5
W35000349,2145,1750,567,1183,1,235,159,76,145,121,1,20,3,14
W35000350,1378,1152,342,810,3,111,67,44,110,97,2,11,0,2
W35000351,1239,1023,349,674,4,105,64,41,103,96,2,5,0,4
W35000352,906,783,277,506,5,51,32,19,61,53,0,8,0,6
W35000353,926,746,207,539,2,88,54,34,85,75,2,8,0,5
W35000354,376,302,102,200,2,35,24,11,36,32,0,3,1,1
W35000355,372,296,101,195,0,33,26,7,41,33,1,7,0,2
W35000356,418,362,103,259,0,15,11,4,36,32,0,4,0,5
W35000357,1103,650,211,439,3,237,185,52,205,190,3,9,3,8
W35000358,1413,1093,370,723,4,182,112,70,127,117,0,9,1,7
W35000359,209,170,61,109,0,16,11,5,22,11,0,5,6,1
W35000360,5315,4525,1155,3370,8,295,175,120,466,421,0,42,3,21
W35000361,247,197,87,110,0,19,7,12,28,22,1,5,0,3
W35000362,794,634,223,411,4,84,60,24,69,62,0,5,2,3
W35000363,278,222,58,164,2,25,14,11,28,24,0,4,0,1
W35000364,287,203,57,146,0,47,30,17,34,26,1,5,2,3
W35000365,624,514,189,325,0,66,47,19,39,28,0,8,3,5
W35000366,215,169,67,102,0,18,9,9,27,22,0,4,1,1
W35000367,395,284,81,203,0,67,46,21,40,33,0,7,0,4
W35000368,302,230,74,156,0,52,30,22,18,14,0,4,0,2
W35000369,231,210,63,147,1,8,4,4,10,9,0,1,0,2
W35000370,248,197,64,133,0,32,18,14,18,13,0,3,2,1
W35000371,327,240,57,183,1,45,22,23,39,35,0,4,0,2
W35000372,250,161,46,115,0,52,31,21,37,34,0,3,0,0
W35000373,755,660,208,452,1,63,38,25,26,23,0,3,0,5
W35000374,515,428,134,294,1,41,28,13,39,32,0,7,0,6
W35000375,277,195,65,130,1,39,30,9,38,33,1,4,0,4
W35000376,441,350,110,240,1,37,24,13,50,45,0,5,0,3
W35000377,301,245,64,181,1,25,18,7,24,21,0,3,0,6
W35000378,299,230,63,167,0,31,16,15,36,33,1,2,0,2
W35000379,225,174,64,110,0,26,17,9,25,21,2,2,0,0
W35000380,399,320,92,228,1,31,16,15,46,40,0,6,0,1
W35000381,333,262,75,187,1,27,11,16,43,35,1,6,1,0
W35000382,429,329,80,249,3,31,9,22,64,58,0,6,0,2
W35000383,368,280,90,190,1,32,18,14,46,41,1,4,0,9
W35000384,2512,2293,353,1940,2,62,35,27,149,132,0,13,4,6
W35000385,345,275,71,204,2,19,9,10,47,42,0,5,0,2
W35000386,818,673,165,508,1,54,22,32,87,73,1,13,0,3
W35000387,251,212,73,139,0,19,5,14,19,17,0,1,1,1
W35000388,392,326,68,258,1,16,9,7,47,44,0,3,0,2
W35000389,468,400,100,300,2,22,2,20,41,38,0,2,1,3
W35000390,533,385,105,280,0,42,16,26,103,96,0,5,2,3
W35000391,436,358,95,263,0,24,7,17,54,46,2,6,0,0
W35000392,3688,3224,800,2424,7,169,64,105,270,241,2,26,1,18
W35000393,314,246,55,191,0,26,12,14,42,37,0,5,0,0
W35000394,296,245,65,180,2,17,6,11,30,28,1,1,0,2
W35000395,939,742,183,559,3,59,18,41,127,113,1,12,1,8
W35000396,428,349,92,257,1,19,7,12,54,51,1,2,0,5
W35000397,264,216,76,140,0,15,4,11,28,24,0,2,2,5
W35000398,229,187,43,144,0,16,5,11,24,22,0,2,0,2
W35000399,293,247,65,182,0,23,10,13,22,20,0,2,0,1
W35000400,338,252,84,168,1,29,13,16,54,48,0,6,0,2
W35000401,300,246,54,192,0,19,7,12,33,32,0,1,0,2
W35000402,219,169,39,130,1,13,1,12,36,33,0,3,0,0
W35000403,292,233,60,173,0,15,5,10,41,31,1,7,2,3
W35000404,896,708,208,500,1,79,23,56,100,88,0,11,1,8
W35000405,512,380,68,312,0,53,15,38,76,65,0,9,2,3
W35000406,257,175,41,134,0,26,2,24,55,51,0,4,0,1
W35000407,1908,1564,451,1113,6,139,40,99,185,162,4,16,3,14
W35000408,1102,915,239,676,5,63,18,45,112,92,2,15,3,7
W35000409,710,599,137,462,2,28,11,17,78,73,1,3,1,3
W35000410,756,546,126,420,0,90,22,68,118,103,0,13,2,2
W35000411,866,674,165,509,3,73,29,44,116,107,0,8,1,0
W35000412,931,722,182,540,5,91,24,67,109,95,1,10,3,4
W35000413,224,175,55,120,1,9,2,7,35,32,0,2,1,4
W35000414,335,256,70,186,0,18,4,14,58,55,1,2,0,3
W35000415,352,279,115,164,1,12,1,11,58,54,0,3,1,2
W35000416,1057,844,212,632,2,96,45,51,108,92,0,14,2,7
W35000417,340,276,84,192,0,28,15,13,34,31,0,3,0,2
W35000418,244,156,39,117,3,31,17,14,54,45,0,7,2,0
W35000419,463,364,104,260,0,32,16,16,66,60,1,4,1,1
W35000420,690,521,134,387,2,57,30,27,108,92,1,15,0,2
W35000421,932,774,165,609,3,59,32,27,95,85,2,7,1,1
W35000422,569,408,93,315,0,63,31,32,94,82,1,11,0,4
W35000423,605,456,175,281,1,29,20,9,110,98,1,11,0,9
W35000424,2477,1909,464,1445,4,161,88,73,395,357,12,22,4,8
W35000425,793,624,192,432,1,45,34,11,114,97,2,14,1,9
W35000426,1055,866,213,653,1,62,28,34,117,110,0,6,1,9
W35000427,1022,760,210,550,0,141,86,55,116,108,1,5,2,5
W35000428,257,178,45,133,0,31,20,11,47,43,0,4,0,1
W35000429,227,158,49,109,0,17,6,11,49,47,0,2,0,3
W35000430,264,212,60,152,0,12,8,4,39,34,1,3,1,1
W35000431,345,237,51,186,0,36,18,18,68,64,0,4,0,4
W35000432,543,420,117,303,3,48,30,18,70,67,2,1,0,2
W35000433,629,503,146,357,3,25,11,14,96,85,2,7,2,2
W35000434,777,587,197,390,0,74,33,41,111,102,0,9,0,5
W35000435,1130,989,254,735,1,30,18,12,103,90,1,11,1,7
W35000436,266,205,58,147,0,18,12,6,43,42,0,1,0,0
W35000437,606,493,138,355,0,25,9,16,87,76,4,7,0,1
W35000438,685,487,185,302,1,88,47,41,104,97,0,7,0,5
W35000439,433,382,113,269,0,17,11,6,31,21,3,5,2,3
W35000440,318,217,70,147,2,23,10,13,74,71,1,2,0,2
W35000441,463,382,127,255,2,20,6,14,55,48,0,7,0,4
W35000442,367,292,105,187,2,25,10,15,46,40,0,6,0,2
W35000443,1176,978,263,715,1,64,33,31,128,110,0,18,0,5
W35000444,2339,1972,561,1411,2,147,75,72,206,187,1,18,0,12
W35000445,219,178,47,131,0,14,6,8,26,21,0,5,0,1
W35000446,719,634,144,490,1,28,20,8,54,51,0,3,0,2
W35000447,270,233,68,165,1,14,3,11,19,16,0,3,0,3
W35000448,290,252,64,188,0,17,8,9,21,16,1,3,1,0
W35000449,420,356,96,260,1,16,4,12,42,36,0,5,1,5
W35000450,307,236,66,170,0,31,15,16,38,35,0,2,1,2
W35000451,409,318,98,220,0,24,8,16,63,56,0,7,0,4
W35000452,330,280,82,198,0,20,13,7,22,18,0,4,0,8
W35000453,276,200,58,142,1,27,10,17,46,43,0,1,2,2
W35000454,414,356,93,263,0,22,10,12,33,32,0,1,0,3
W35000455,399,327,91,236,0,12,8,4,54,48,0,6,0,6
W35000456,630,478,139,339,0,57,27,30,94,85,0,7,2,1
W35000457,247,192,57,135,0,14,7,7,38,35,1,2,0,3
W35000458,616,461,129,332,3,36,22,14,115,108,0,7,0,1
W35000459,968,731,210,521,2,97,52,45,133,124,0,8,1,5
W35000460,1219,1073,278,795,5,29,16,13,106,90,0,15,1,6
W35000461,638,501,144,357,1,60,33,27,73,65,0,8,0,3
W35000462,3365,2886,769,2117,7,134,61,73,323,280,6,36,1,15
W35000463,264,213,47,166,0,20,10,10,31,27,0,4,0,0
W35000464,236,192,48,144,0,8,5,3,36,32,1,3,0,0
W35000465,894,710,158,552,1,72,30,42,109,100,1,7,1,2
W35000466,369,281,69,212,0,38,21,17,48,43,0,4,1,2
W35000467,434,344,109,235,1,41,19,22,47,44,0,3,0,1
W35000468,323,229,65,164,1,16,7,9,77,67,0,10,0,0
W35000469,220,182,58,124,0,17,9,8,20,19,0,1,0,1
W35000470,275,231,68,163,0,9,7,2,34,30,0,4,0,1
W35000471,223,171,62,109,1,10,8,2,40,36,0,3,1,1
W35000472,1220,1058,297,761,3,46,22,24,111,99,0,10,2,2
W35000473,378,294,92,202,1,21,11,10,60,55,0,5,0,2
W35000474,1104,789,253,536,2,168,97,71,142,134,0,7,1,3
W35000475,940,748,196,552,0,97,50,47,91,78,3,10,0,4
W35000476,991,739,207,532,3,118,66,52,124,116,0,8,0,7
W35000477,1142,916,266,650,3,123,57,66,95,88,0,7,0,5
W35000478,434,352,127,225,0,58,20,38,18,17,0,0,1,6
W35000479,828,648,209,439,1,102,51,51,76,67,0,6,3,1
W35000480,201,170,52,118,0,16,6,10,15,13,0,2,0,0
W35000481,256,180,56,124,0,35,18,17,40,37,1,2,0,1
W35000482,590,497,138,359,2,36,16,20,51,41,1,7,2,4
W35000483,590,413,148,265,0,97,39,58,72,69,0,3,0,8
W35000484,296,207,62,145,1,41,16,25,46,40,0,6,0,1
W35000485,420,288,91,197,0,77,42,35,53,47,0,6,0,2
W35000486,936,789,229,560,1,73,40,33,68,61,0,6,1,5
W35000487,216,161,45,116,1,25,11,14,29,24,3,2,0,0
W35000488,322,257,56,201,0,31,11,20,33,33,0,0,0,1
W35000489,210,164,51,113,0,15,10,5,31,30,1,0,0,0
W35000490,1358,1030,261,769,10,155,105,50,156,144,0,10,2,7
W35000491,511,408,104,304,3,39,29,10,59,50,1,8,0,2
W35000492,300,240,60,180,0,27,21,6,33,30,0,3,0,0
W35000493,293,204,58,146,1,46,30,16,42,41,0,1,0,0
W35000494,747,580,158,422,3,76,45,31,83,76,0,7,0,5
W35000495,165,141,38,103,0,7,4,3,16,13,0,2,1,1
W35000496,681,470,141,329,4,111,68,43,95,88,1,6,0,1
W35000497,283,228,66,162,1,27,19,8,27,25,0,2,0,0
W35000498,268,217,45,172,0,30,21,9,21,16,0,5,0,0
W35000499,246,207,61,146,1,15,7,8,21,18,0,3,0,2
W35000500,470,356,105,251,0,48,34,14,63,58,0,5,0,3
W35000501,341,276,84,192,2,26,16,10,35,32,0,3,0,2
W35000502,414,331,72,259,1,39,21,18,42,37,0,5,0,1
W35000503,913,716,239,477,1,93,56,37,100,88,1,10,1,3
W35000504,780,655,171,484,1,51,38,13,70,62,0,8,0,3
W35000505,247,185,46,139,1,20,11,9,39,32,0,7,0,2
W35000506,938,753,198,555,4,78,45,33,97,85,0,10,2,6
W35000507,790,549,144,405,4,110,74,36,122,109,0,12,1,5
W35000508,375,313,77,236,0,24,15,9,36,33,0,3,0,2
W35000509,275,230,54,176,0,15,13,2,30,27,0,2,1,0
W35000510,494,388,108,280,0,63,39,24,43,39,0,4,0,0
W35000511,342,280,74,206,0,22,13,9,39,34,0,5,0,1
W35000512,719,604,177,427,0,63,41,22,50,47,0,3,0,2
W35000513,497,371,116,255,2,47,27,20,72,64,2,6,0,5
W35000514,787,649,206,443,2,64,43,21,70,69,0,0,1,2
W35000515,612,478,117,361,3,45,27,18,85,80,0,5,0,1
W35000516,694,514,105,409,3,51,32,19,121,104,1,16,0,5
W35000517,884,703,139,564,1,57,39,18,122,112,0,10,0,1
W35000518,205,182,42,140,0,11,7,4,11,10,0,1,0,1
W35000519,298,218,60,158,1,34,25,9,42,38,0,3,1,3
W35000520,298,227,55,172,1,31,18,13,39,33,0,5,1,0
W35000521,734,565,160,405,3,76,44,32,88,78,0,7,3,2
W35000522,1473,1245,330,915,3,83,55,28,133,123,1,9,0,9
W35000523,414,318,93,225,0,41,26,15,52,50,0,2,0,3
W35000524,793,679,199,480,1,39,23,16,69,65,3,1,0,5
W35000525,727,540,159,381,4,113,53,60,69,62,0,6,1,1
W35000526,827,667,181,486,1,97,51,46,60,55,0,4,1,2
W35000527,302,259,76,183,1,18,16,2,22,20,0,1,1,2
W35000528,363,282,72,210,3,37,22,15,41,36,1,3,1,0
W35000529,339,267,80,187,1,31,20,11,40,34,1,4,1,0
W35000530,517,380,120,260,1,55,26,29,81,71,1,8,1,0
W35000531,420,347,122,225,1,33,7,26,37,34,1,2,0,2
W35000532,863,684,183,501,2,92,41,51,83,74,0,9,0,2
W35000533,554,446,115,331,1,44,18,26,57,56,0,1,0,6
W35000534,682,479,142,337,4,112,68,44,85,77,0,8,0,2
W35000535,466,364,87,277,0,44,17,27,56,51,1,3,1,2
W35000536,411,283,71,212,5,82,40,42,41,40,1,0,0,0
W35000537,707,505,145,360,6,107,59,48,87,78,0,8,1,2
W35000538,699,509,166,343,1,112,52,60,71,61,0,9,1,6
W35000539,254,180,43,137,1,33,16,17,38,34,0,3,1,2
W35000540,266,168,34,134,2,59,33,26,37,34,0,2,1,0
W35000541,470,394,95,299,3,34,12,22,34,29,0,4,1,5
W35000542,293,229,60,169,0,16,5,11,48,47,0,1,0,0
W35000543,1702,1317,304,1013,8,151,67,84,218,192,2,23,1,8
W35000544,699,572,119,453,2,61,23,38,62,54,0,7,1,2
W35000545,435,340,98,242,4,37,24,13,49,42,0,4,3,5
W35000546,200,165,45,120,1,13,8,5,21,20,0,1,0,0
W35000547,464,345,103,242,3,66,26,40,48,41,0,7,0,2
W35000548,1505,1107,285,822,10,163,57,106,218,199,0,17,2,7
W35000549,1063,816,242,574,2,146,70,76,93,83,0,8,2,6
W35000550,2537,2195,517,1678,10,133,59,74,189,164,0,23,2,10
W35000551,640,503,132,371,2,45,21,24,88,78,1,7,2,2
W35000552,552,469,118,351,3,27,12,15,50,47,0,3,0,3
W35000553,372,280,69,211,2,44,16,28,44,38,0,5,1,2
W35000554,236,185,74,111,0,23,8,15,28,22,2,3,1,0
W35000555,448,288,99,189,1,95,36,59,63,59,0,4,0,1
W35000556,1010,848,223,625,3,97,46,51,62,54,1,6,1,0
W35000557,352,271,68,203,3,48,19,29,29,28,0,1,0,1
W35000558,253,199,66,133,0,29,14,15,24,22,2,0,0,1
W35000559,296,211,59,152,1,49,24,25,33,29,0,4,0,2
W35000560,338,253,73,180,1,51,24,27,32,27,2,2,1,1
W35000561,403,277,70,207,0,74,34,40,52,45,1,6,0,0
W35000562,217,162,46,116,1,26,13,13,28,22,0,4,2,0
W35000563,587,454,173,281,6,47,7,40,74,68,1,5,0,6
W35000564,310,224,86,138,3,29,8,21,50,43,1,5,1,4
W35000565,272,205,62,143,2,21,6,15,41,37,2,1,1,3
W35000566,536,411,109,302,1,53,21,32,67,59,4,4,0,4
W35000567,674,505,166,339,0,68,39,29,89,82,1,6,0,12
W35000568,310,229,92,137,2,15,5,10,57,52,0,5,0,7
W35000569,220,171,64,107,4,17,6,11,25,24,0,1,0,3
W35000570,1085,921,285,636,1,66,34,32,92,86,1,5,0,5
W35000571,774,563,185,378,4,98,29,69,106,101,0,4,1,3
W35000572,643,534,147,387,2,42,19,23,63,54,0,8,1,2
W35000573,246,170,51,119,0,35,16,19,40,34,2,4,0,1
W35000574,653,473,166,307,0,92,37,55,82,71,2,8,1,6
W35000575,239,173,44,129,2,28,9,19,34,30,1,3,0,2
W35000576,316,263,84,179,2,17,3,14,32,28,1,2,1,2
W35000577,321,243,73,170,2,28,9,19,45,37,0,5,3,3
W35000578,273,202,44,158,1,22,8,14,46,40,1,4,1,2
W35000579,694,512,151,361,0,65,14,51,113,99,1,11,2,4
W35000580,1197,877,215,662,11,169,65,104,132,123,1,8,0,8
W35000581,221,178,60,118,0,20,2,18,19,16,0,3,0,4
W35000582,560,431,132,299,7,51,20,31,70,63,0,6,1,1
W35000583,294,224,66,158,1,33,13,20,35,32,0,2,1,1
W35000584,345,267,74,193,4,26,12,14,47,42,1,4,0,1
W35000585,817,533,137,396,11,72,34,38,189,171,2,12,4,12
W35000586,713,534,125,409,1,45,32,13,129,119,0,9,1,4
W35000587,530,443,145,298,2,41,23,18,42,38,0,3,1,2
W35000588,1078,817,211,606,6,130,70,60,118,101,3,13,1,7
W35000589,418,339,90,249,0,37,21,16,37,27,1,8,1,5
W35000590,339,270,61,209,2,38,20,18,27,23,0,4,0,2
W35000591,801,579,119,460,2,103,58,45,114,106,0,6,2,3
W35000592,242,179,36,143,3,35,22,13,22,22,0,0,0,3
W35000593,335,276,76,200,3,29,6,23,27,22,0,5,0,0
W35000594,363,288,97,191,3,27,12,15,44,39,0,4,1,1
W35000595,1506,1173,301,872,7,160,93,67,162,147,0,12,3,4
W35000596,540,461,131,330,3,35,13,22,37,34,0,3,0,4
W35000597,290,217,56,161,1,31,16,15,39,37,0,2,0,2
W35000598,367,312,71,241,1,11,4,7,38,35,0,3,0,5
W35000599,696,519,170,349,5,65,27,38,101,92,0,7,2,6
W35000600,423,319,100,219,3,39,21,18,58,48,1,8,1,4
W35000601,296,206,46,160,1,39,24,15,49,44,0,5,0,1
W35000602,643,455,117,338,7,86,38,48,92,87,0,4,1,3
W35000603,1565,1211,276,935,7,160,84,76,180,166,2,10,2,7
W35000604,439,316,76,240,1,52,19,33,69,63,0,6,0,1
W35000605,273,206,62,144,1,26,11,15,40,37,0,3,0,0
W35000606,430,323,77,246,0,46,23,23,58,49,0,9,0,3
W35000607,369,244,54,190,5,45,26,19,72,71,0,0,1,3
W35000608,209,150,40,110,0,24,14,10,35,30,0,4,1,0
W35000609,324,252,56,196,2,31,15,16,35,33,0,2,0,4
W35000610,313,198,58,140,3,53,29,24,56,55,0,1,0,3
W35000611,251,180,67,113,0,37,16,21,34,31,0,2,1,0
W35000612,209,150,45,105,0,25,12,13,33,29,0,3,1,1
W35000613,229,167,31,136,1,20,5,15,40,36,1,3,0,1
W35000614,455,299,63,236,6,48,20,28,97,87,1,8,1,5
W35000615,244,202,69,133,0,17,6,11,23,17,2,2,2,2
W35000616,292,194,66,128,1,41,20,21,52,47,0,5,0,4
W35000617,430,331,79,252,4,35,13,22,58,53,0,5,0,2
W35000618,484,422,134,288,2,30,16,14,27,24,0,3,0,3
W35000619,249,195,47,148,1,22,15,7,31,28,0,3,0,0
W35000620,364,239,47,192,2,35,21,14,88,82,1,5,0,0
W35000621,408,323,89,234,4,36,18,18,43,38,0,5,0,2
W35000622,211,132,38,94,1,26,14,12,46,43,0,3,0,6
W35000623,317,224,54,170,5,39,15,24,48,42,0,6,0,1
W35000624,219,166,38,128,2,22,12,10,27,23,1,3,0,2
W35000625,1357,1059,306,753,9,131,64,67,148,136,2,7,3,10
W35000626,667,485,135,350,3,108,60,48,67,59,0,8,0,4
W35000627,252,163,49,114,2,22,6,16,64,61,1,2,0,1
W35000628,281,187,50,137,0,13,6,7,78,73,1,3,1,3
W35000629,362,272,67,205,1,21,7,14,65,59,1,5,0,3
W35000630,734,543,106,437,2,40,25,15,145,130,1,12,2,4
W35000631,708,493,115,378,4,50,29,21,156,147,0,9,0,5
W35000632,365,249,55,194,0,21,9,12,93,88,0,4,1,2
W35000633,222,127,33,94,0,8,2,6,85,83,0,2,0,2
W35000634,2999,2036,393,1643,18,188,75,113,732,662,1,64,5,25
W35000635,693,498,127,371,4,68,36,32,115,101,0,13,1,8
W35000636,323,171,32,139,2,31,14,17,116,108,0,8,0,3
W35000637,337,253,47,206,4,21,12,9,56,51,0,5,0,3
W35000638,2016,1400,277,1123,12,136,57,79,458,409,5,41,3,10
W35000639,736,574,107,467,1,44,25,19,116,113,0,3,0,1
W35000640,323,221,55,166,2,25,13,12,69,62,1,5,1,6
W35000641,334,229,56,173,3,35,16,19,65,61,0,3,1,2
W35000642,308,201,55,146,1,50,30,20,54,49,0,5,0,2
W35000643,284,215,45,170,0,28,16,12,39,34,0,3,2,2
W35000644,1273,740,188,552,3,179,89,90,339,319,1,17,2,12
W35000645,361,255,72,183,2,29,20,9,74,68,0,6,0,1
W35000646,314,206,68,138,2,26,12,14,72,65,2,4,1,8
W35000647,1659,1410,373,1037,4,80,46,34,159,149,0,9,1,6
W35000648,852,601,158,443,2,107,68,39,133,120,0,13,0,9
W35000649,353,264,71,193,1,39,21,18,48,45,0,3,0,1
W35000650,318,249,69,180,0,16,7,9,52,47,0,5,0,1
W35000651,314,234,58,176,1,27,16,11,48,43,1,4,0,4
W35000652,313,228,67,161,2,38,26,12,45,39,1,4,1,0
W35000653,279,197,66,131,1,40,19,21,40,39,1,0,0,1
W35000654,1170,917,246,671,3,117,58,59,125,115,0,8,2,8
W35000655,217,163,44,119,2,20,10,10,32,30,0,2,0,0
W35000656,270,200,58,142,2,31,18,13,35,34,0,1,0,2
W35000657,809,676,149,527,9,25,10,15,96,83,1,11,1,3
W35000658,633,510,105,405,1,15,6,9,104,96,3,4,1,3
W35000659,7485,5789,1298,4491,31,321,157,164,1306,1188,10,101,7,38
W35000660,1284,735,248,487,7,152,84,68,378,373,1,4,0,12
W35000661,1472,1000,262,738,6,157,81,76,303,281,1,19,2,6
W35000662,1062,875,253,622,3,25,14,11,149,134,1,14,0,10
W35000663,1674,1158,271,887,7,134,49,85,367,348,1,16,2,8
W35000664,205,157,36,121,1,17,8,9,29,26,0,3,0,1
W35000665,730,525,126,399,6,42,15,27,156,140,3,12,1,1
W35000666,553,459,114,345,2,31,20,11,58,52,0,5,1,3
W35000667,402,289,72,217,1,70,51,19,40,37,0,3,0,2
W35000668,475,386,107,279,0,43,26,17,45,38,1,5,1,1
W35000669,618,463,123,340,3,61,37,24,89,78,0,8,3,2
W35000670,365,267,92,175,1,50,26,24,46,41,0,5,0,1
W35000671,235,155,37,118,2,36,13,23,40,35,0,5,0,2
W35000672,1049,658,156,502,2,166,81,85,218,202,0,16,0,5
W35000673,357,232,67,165,0,19,10,9,102,94,1,6,1,4
W35000674,483,390,77,313,6,7,2,5,76,65,0,10,1,4
W35000675,781,551,174,377,4,22,10,12,198,190,0,5,3,6
W35000676,436,290,56,234,0,31,16,15,114,105,0,9,0,1
W35000677,729,521,137,384,5,33,14,19,166,144,1,20,1,4
W35000678,607,404,118,286,3,108,53,55,90,83,0,5,2,2
W35000679,231,141,38,103,1,21,13,8,68,63,0,5,0,0
W35000680,991,781,152,629,5,66,23,43,135,124,3,8,0,4
W35000681,409,301,71,230,1,21,8,13,83,80,0,3,0,3
W35000682,1198,829,157,672,6,85,38,47,274,259,0,14,1,4
W35000683,551,426,96,330,0,33,23,10,91,77,0,14,0,1
W35000684,246,208,33,175,1,2,0,2,34,32,1,1,0,1
W35000685,248,185,32,153,0,14,7,7,45,41,0,4,0,4
W35000686,564,457,101,356,2,21,8,13,75,69,0,6,0,9
W35000687,1353,837,192,645,7,168,88,80,335,310,1,21,3,6
W35000688,423,321,65,256,2,11,6,5,88,84,0,4,0,1
W35000689,296,224,54,170,2,16,6,10,51,47,1,3,0,3
W35000690,303,226,59,167,0,15,9,6,58,51,0,7,0,4
W35000691,1304,1019,239,780,2,49,21,28,231,197,1,31,2,3
W35000692,1154,833,197,636,2,98,49,49,213,200,0,12,1,8
W35000693,883,639,159,480,5,135,71,64,103,91,0,11,1,1
W35000694,993,758,177,581,5,91,42,49,132,105,3,24,0,7
W35000695,413,303,79,224,2,24,3,21,82,77,0,4,1,2
W35000696,430,360,86,274,0,27,14,13,41,37,0,4,0,2
W35000697,764,623,142,481,4,43,20,23,92,82,0,10,0,2
W35000698,683,519,123,396,1,57,30,27,100,94,0,4,2,6
W35000699,352,277,73,204,0,13,7,6,54,49,0,5,0,8
W35000700,215,142,35,107,2,30,3,27,40,35,1,4,0,1
W35000701,405,304,83,221,0,35,16,19,64,61,1,2,0,2
W35000702,588,459,103,356,0,35,16,19,91,88,0,3,0,3
W35000703,328,237,55,182,0,21,9,12,68,67,0,1,0,2
W35000704,1084,801,218,583,6,140,72,68,135,123,2,9,1,2
W35000705,499,364,89,275,1,42,18,24,91,78,0,12,1,1
W35000706,368,265,64,201,1,34,11,23,63,60,1,1,1,5
W35000707,571,445,105,340,1,49,22,27,71,67,0,4,0,5
W35000708,410,311,92,219,1,39,15,24,57,48,1,7,1,2
W35000709,248,131,39,92,2,30,14,16,82,75,0,7,0,3
W35000710,2676,2103,475,1628,7,152,71,81,397,359,4,34,0,17
W35000711,720,613,139,474,1,27,19,8,77,68,0,9,0,2
W35000712,327,253,68,185,1,24,14,10,49,47,0,2,0,0
W35000713,591,411,120,291,0,89,33,56,90,82,0,8,0,1
W35000714,390,323,94,229,0,16,4,12,51,51,0,0,0,0
W35000715,1424,1067,250,817,1,161,93,68,191,172,2,16,1,4
W35000716,483,358,97,261,1,66,36,30,54,46,0,7,1,4
W35000717,798,527,168,359,3,121,76,45,146,135,1,10,0,1
W35000718,407,303,67,236,2,54,32,22,47,42,0,5,0,1
W35000719,389,276,63,213,1,29,12,17,83,77,0,6,0,0
W35000720,2768,2069,412,1657,19,126,64,62,545,511,2,25,7,9
W35000721,2302,1745,304,1441,16,162,79,83,372,334,2,33,3,7
W35000722,474,301,71,230,3,79,25,54,87,80,1,6,0,4
W35000723,715,562,133,429,10,57,30,27,81,71,0,10,0,5
W35000724,606,424,83,341,6,26,11,15,148,138,0,10,0,2
W35000725,391,240,67,173,3,66,33,33,78,72,0,5,1,4
W35000726,705,449,107,342,6,113,55,58,134,123,1,7,3,3
W35000727,697,565,163,402,2,45,27,18,80,72,0,8,0,5
W35000728,2146,1679,403,1276,7,154,60,94,303,263,3,35,2,3
W35000729,1247,913,203,710,8,50,26,24,265,246,0,18,1,11
W35000730,279,193,47,146,1,11,7,4,72,62,0,2,8,2
W35000731,484,359,77,282,5,12,7,5,106,102,0,4,0,2
W35000732,584,502,106,396,3,36,22,14,42,37,0,5,0,1
W35000733,1104,795,135,660,7,73,40,33,223,203,1,19,0,6
W35000734,1527,1300,438,862,4,53,39,14,158,141,3,12,2,12
W35000735,4258,3409,906,2503,30,340,259,81,461,397,21,38,5,18
W35000736,234,169,57,112,2,42,37,5,21,21,0,0,0,0
W35000737,290,200,38,162,3,35,23,12,50,46,1,3,0,2
W35000738,1129,861,210,651,5,95,71,24,163,141,2,20,0,5
W35000739,1214,890,329,561,2,49,28,21,256,234,5,15,2,17
W35000740,395,283,117,166,0,24,16,8,81,72,0,9,0,7
W35000741,1594,1146,396,750,5,89,31,58,334,318,0,12,4,20
W35000742,543,356,140,216,1,7,1,6,176,169,1,6,0,3
W35000743,231,141,47,94,0,8,2,6,80,70,0,8,2,2
W35000744,1046,684,232,452,4,63,14,49,288,246,8,26,8,7
W35000745,2468,2007,570,1437,5,190,126,64,254,231,0,22,1,12
W35000746,311,224,65,159,0,26,22,4,54,52,0,2,0,7
W35000747,5342,4117,1262,2855,6,269,177,92,911,821,10,71,9,39
W35000748,207,138,42,96,2,29,15,14,37,33,0,3,1,1
W35000749,226,153,42,111,1,26,11,15,43,40,0,3,0,3
W35000750,327,228,76,152,1,36,25,11,57,52,0,4,1,5
W35000751,433,317,67,250,0,43,22,21,67,60,1,2,4,6
W35000752,307,222,67,155,0,39,21,18,42,37,0,5,0,4
W35000753,784,540,162,378,0,127,72,55,108,93,1,14,0,9
W35000754,378,304,91,213,0,33,18,15,39,30,4,4,1,2
W35000755,171,98,19,79,0,23,15,8,47,43,0,4,0,3
W35000756,245,154,61,93,0,25,21,4,64,57,0,7,0,2
W35000757,466,324,88,236,1,41,17,24,97,85,1,11,0,3
W35000758,314,202,52,150,2,32,8,24,75,68,1,5,1,3
W35000759,220,122,42,80,2,37,24,13,56,51,0,4,1,3
W35000760,228,133,33,100,1,15,6,9,79,74,0,4,1,0
W35000761,252,96,19,77,2,23,12,11,129,116,5,5,3,2
W35000762,966,748,206,542,7,33,14,19,173,164,1,8,0,5
W35000763,382,206,49,157,2,32,17,15,138,126,0,9,3,4
W35000764,252,188,49,139,0,15,10,5,46,46,0,0,0,3
W35000765,2169,1459,288,1171,14,137,66,71,544,501,1,42,0,15
W35000766,298,226,47,179,1,10,3,7,60,56,0,3,1,1
W35000767,921,651,189,462,6,20,8,12,242,229,2,11,0,2
W35000768,329,185,57,128,1,34,16,18,106,100,1,3,2,3
W35000769,624,477,90,387,3,11,5,6,130,114,0,14,2,3
W35000770,496,335,93,242,6,43,21,22,109,98,1,7,3,3
W35000771,211,154,29,125,1,6,5,1,49,44,0,5,0,1
W35000772,330,226,48,178,2,18,11,7,82,76,0,4,2,2
W35000773,899,586,160,426,4,91,40,51,213,198,0,14,1,5
W35000774,262,180,45,135,2,6,4,2,71,67,0,3,1,3
W35000775,324,156,39,117,5,22,13,9,140,126,2,11,1,1
W35000776,633,516,137,379,1,20,7,13,93,86,0,6,1,3
W35000777,518,286,71,215,3,27,10,17,196,182,1,13,0,6
W35000778,355,255,58,197,3,12,5,7,81,75,0,5,1,4
W35000779,782,449,108,341,3,90,43,47,233,217,0,16,0,7
W35000780,589,396,122,274,2,43,28,15,145,132,2,10,1,3
W35000781,589,441,93,348,2,13,6,7,125,117,0,6,2,8
W35000782,626,370,85,285,4,86,48,38,161,152,0,7,2,5
W35000783,1020,722,176,546,4,15,5,10,274,262,3,8,1,5
W35000784,348,248,72,176,2,17,9,8,78,72,1,5,0,3
W35000785,619,518,127,391,2,29,16,13,66,62,0,3,1,4
W35000786,255,115,28,87,0,33,24,9,106,95,0,9,2,1
W35000787,229,132,43,89,1,13,7,6,78,71,1,6,0,5
W35000788,383,259,72,187,3,27,16,11,93,87,0,6,0,1
W35000789,242,173,61,112,1,10,5,5,58,54,0,3,1,0
W35000790,552,418,90,328,3,25,12,13,104,99,0,5,0,2
W35000791,497,353,72,281,4,16,10,6,122,116,0,6,0,2
W35000792,521,389,44,345,6,9,5,4,117,113,0,4,0,0
W35000793,415,257,84,173,2,33,13,20,119,106,0,12,1,4
W35000794,615,320,70,250,4,43,20,23,245,232,1,11,1,3
W35000795,329,204,47,157,3,30,15,15,90,82,1,7,0,2
W35000796,1037,690,154,536,6,57,22,35,277,250,2,25,0,7
W35000797,790,549,124,425,3,39,18,21,194,178,0,16,0,5
W35000798,228,121,32,89,3,16,10,6,85,80,0,5,0,3
W35000799,819,525,126,399,1,95,45,50,195,182,0,13,0,3
W35000800,659,465,90,375,5,28,13,15,154,141,0,12,1,7
W35000801,268,185,38,147,1,11,4,7,71,69,0,2,0,0
W35000802,739,333,81,252,1,58,37,21,339,322,0,14,3,8
W35000803,932,617,151,466,1,54,29,25,256,240,1,15,0,4
W35000804,305,206,45,161,0,29,14,15,65,60,0,4,1,5
W35000805,393,289,53,236,3,7,4,3,90,81,1,8,0,4
W35000806,282,86,21,65,1,16,8,8,179,172,0,7,0,0
W35000807,389,246,69,177,0,35,24,11,107,101,0,2,4,1
W35000808,282,213,52,161,1,10,4,6,57,54,0,3,0,1
W35000809,373,285,58,227,0,14,5,9,71,69,0,2,0,3
W35000810,311,258,60,198,0,11,6,5,38,34,0,3,1,4
W35000811,929,673,162,511,5,46,26,20,200,185,0,15,0,5
W35000812,485,296,60,236,2,47,22,25,138,126,0,10,2,2
W35000813,783,551,117,434,3,41,16,25,184,173,3,8,0,4
W35000814,551,390,105,285,3,19,8,11,137,128,1,8,0,2
W35000815,585,316,65,251,5,54,25,29,208,202,0,6,0,2
W35000816,783,606,129,477,3,39,22,17,126,115,1,9,1,9
W35000817,1037,772,204,568,3,46,24,22,211,192,1,14,4,5
W35000818,434,228,73,155,1,35,18,17,167,159,0,8,0,3
W35000819,250,128,28,100,4,27,10,17,87,81,0,6,0,4
W35000820,1004,587,114,473,9,56,21,35,334,310,2,20,2,18
W35000821,1594,780,215,565,8,118,53,65,673,648,0,22,3,15
W35000822,1017,727,161,566,7,71,26,45,210,197,0,11,2,2
W35000823,2330,1884,458,1426,6,157,83,74,277,249,0,28,0,6
W35000824,956,760,241,519,2,107,61,46,82,69,2,10,1,5
W35000825,859,507,127,380,3,131,47,84,211,204,0,7,0,7
W35000826,489,328,87,241,4,44,18,26,109,105,1,3,0,4
W35000827,520,401,101,300,5,42,23,19,67,59,1,6,1,5
W35000828,1320,1138,305,833,2,41,19,22,137,129,0,7,1,2
W35000829,314,151,46,105,4,33,14,19,119,113,2,3,1,7
W35000830,405,277,55,222,1,32,18,14,94,82,2,10,0,1
W35000831,322,183,36,147,3,35,16,19,99,96,0,3,0,2
W35000832,308,137,32,105,2,28,13,15,135,130,0,5,0,6
W35000833,220,71,12,59,2,20,10,10,125,123,1,0,1,2
W35000834,334,224,61,163,1,15,8,7,92,79,6,6,1,2
W35000835,256,162,47,115,2,16,8,8,76,68,0,8,0,0
W35000836,323,239,53,186,1,32,18,14,50,42,1,7,0,1
W35000837,410,326,93,233,3,34,13,21,46,44,0,2,0,1
W35000838,882,656,147,509,5,45,23,22,174,161,1,12,0,2
W35000839,466,325,59,266,1,35,12,23,101,98,1,2,0,4
W35000840,505,377,89,288,4,43,27,16,80,75,0,5,0,1
W35000841,997,758,195,563,2,91,55,36,137,116,1,20,0,9
W35000842,1130,842,238,604,8,102,57,45,174,156,0,16,2,4
W35000843,312,248,68,180,1,30,26,4,32,30,0,2,0,1
W35000844,1101,722,187,535,6,194,117,77,170,154,1,14,1,9
W35000845,363,290,94,196,0,35,24,11,35,31,0,4,0,3
W35000846,589,417,133,284,4,87,61,26,78,73,0,5,0,3
W35000847,253,193,48,145,1,24,18,6,32,28,0,3,1,3
W35000848,565,460,97,363,1,42,24,18,58,51,0,5,2,4
W35000849,381,312,99,213,1,34,20,14,32,23,2,6,1,2
W35000850,235,172,58,114,0,34,25,9,28,25,0,3,0,1
W35000851,277,212,43,169,1,25,17,8,33,28,0,5,0,6
W35000852,468,345,121,224,2,49,39,10,57,51,0,6,0,15
W35000853,1250,1029,378,651,0,79,70,9,129,109,0,10,10,13
W35000854,356,282,123,159,0,28,26,2,42,32,1,9,0,4
W35000855,325,241,102,139,0,38,33,5,39,30,0,9,0,7
W35000856,338,259,133,126,1,45,45,0,23,21,0,2,0,10
W35000857,268,206,107,99,0,26,17,9,31,26,0,4,1,5
W35000858,373,283,134,149,2,22,21,1,59,52,0,5,2,7
W35000859,318,237,128,109,4,20,16,4,44,36,0,6,2,13
W35000860,324,260,116,144,1,8,7,1,50,39,2,6,3,5
W35000861,257,199,92,107,2,28,25,3,21,16,1,2,2,7
W35000862,485,308,86,222,1,84,74,10,84,71,0,10,3,8
W35000863,254,179,67,112,1,38,32,6,32,26,2,3,1,4
W35000864,333,238,78,160,2,36,30,6,57,49,0,7,1,0
W35000865,342,256,88,168,0,39,33,6,42,32,3,5,2,5
W35000866,277,209,59,150,0,27,18,9,31,26,1,4,0,10
W35000867,401,284,108,176,0,57,50,7,59,49,1,9,0,1
W35000868,636,430,150,280,0,79,65,14,120,105,3,11,1,7
W35000869,295,223,84,139,0,20,18,2,47,38,1,7,1,5
W35000870,349,241,106,135,0,38,30,8,63,55,0,3,5,7
W35000871,292,227,110,117,4,19,16,3,28,22,2,4,0,14
W35000872,568,370,130,240,1,86,70,16,99,91,2,4,2,12
W35000873,305,254,97,157,1,14,12,2,33,25,0,7,1,3
W35000874,291,234,95,139,0,28,21,7,25,21,2,2,0,4
W35000875,253,172,56,116,2,34,28,6,42,38,0,2,2,3
W35000876,380,293,126,167,2,14,12,2,61,51,3,6,1,10
W35000877,293,229,92,137,1,26,19,7,36,31,0,4,1,1
W35000878,410,308,168,140,1,34,25,9,52,45,0,7,0,15
W35000879,223,152,74,78,1,16,14,2,47,40,0,7,0,7
W35000880,319,211,85,126,1,41,29,12,54,50,0,3,1,12
W35000881,256,189,89,100,0,21,20,1,37,30,4,3,0,9
W35000882,297,224,87,137,1,43,29,14,20,19,0,1,0,9
W35000883,414,332,135,197,0,45,28,17,33,26,1,5,1,4
W35000884,367,278,102,176,3,43,32,11,36,32,0,4,0,7
W35000885,646,458,181,277,1,78,62,16,100,85,1,11,3,9
W35000886,295,230,105,125,2,29,22,7,30,22,2,5,1,4
W35000887,415,291,137,154,1,25,22,3,87,73,2,10,2,11
W35000888,355,257,108,149,3,41,36,5,48,41,2,3,2,6
W35000889,339,248,108,140,1,42,35,7,43,34,3,5,1,5
W35000890,1502,1043,284,759,2,83,54,29,365,208,83,19,55,9
W35000891,514,393,137,256,1,50,40,10,60,53,0,7,0,10
W35000892,277,188,62,126,0,27,24,3,53,43,2,4,4,9
W35000893,288,215,77,138,0,25,21,4,35,33,0,2,0,13
W35000894,360,260,110,150,1,27,23,4,70,55,8,2,5,2
W35000895,315,243,104,139,0,16,15,1,49,42,4,3,0,7
W35000896,375,275,102,173,1,38,31,7,53,45,0,8,0,8
W35000897,1145,804,276,528,1,142,111,31,185,168,1,14,2,13
W35000898,350,265,113,152,2,31,28,3,43,37,1,5,0,9
W35000899,381,273,97,176,1,45,42,3,53,48,0,5,0,9
W35000900,330,194,80,114,1,40,20,20,92,88,2,2,0,3
W35000901,348,237,83,154,0,38,24,14,69,65,0,4,0,4
W35000902,653,424,159,265,2,71,36,35,145,130,0,12,3,11
W35000903,256,132,42,90,2,24,11,13,90,79,4,4,3,8
W35000904,288,175,51,124,5,62,31,31,43,39,0,4,0,3
W35000905,219,148,54,94,0,12,6,6,54,47,1,6,0,5
W35000906,405,264,84,180,5,80,48,32,42,36,0,2,4,14
W35000907,337,247,97,150,0,61,39,22,24,22,0,2,0,5
W35000908,401,284,92,192,1,49,27,22,65,60,0,5,0,2
W35000909,738,599,212,387,1,51,27,24,77,69,2,6,0,10
W35000910,418,309,117,192,0,56,27,29,51,41,2,7,1,2
W35000911,253,173,80,93,0,10,5,5,61,52,3,5,1,9
W35000912,297,204,81,123,0,51,24,27,38,31,1,1,5,4
W35000913,299,215,81,134,1,32,24,8,49,46,0,2,1,2
W35000914,274,219,85,134,0,23,12,11,32,27,0,5,0,0
W35000915,398,317,114,203,1,36,21,15,36,32,1,3,0,8
W35000916,234,192,72,120,1,13,8,5,25,22,0,2,1,3
W35000917,429,345,129,216,0,34,19,15,46,35,3,7,1,4
W35000918,341,253,107,146,0,26,11,15,61,49,0,12,0,1
W35000919,278,209,76,133,0,16,7,9,51,41,2,5,3,2
W35000920,420,310,100,210,2,47,26,21,58,48,1,8,1,3
W35000921,978,699,202,497,5,112,68,44,156,130,2,20,4,6
W35000922,700,475,175,300,0,86,55,31,131,124,0,4,3,8
W35000923,944,696,259,437,5,95,53,42,140,123,1,14,2,8
W35000924,335,263,99,164,4,33,21,12,28,25,0,3,0,7
W35000925,483,376,151,225,0,57,45,12,43,32,2,6,3,7
W35000926,385,285,132,153,2,43,26,17,49,41,2,4,2,6
W35000927,288,223,68,155,2,28,13,15,35,28,3,4,0,0
W35000928,339,258,88,170,1,61,32,29,15,12,0,2,1,4
W35000929,446,315,109,206,1,68,38,30,56,51,2,2,1,6
W35000930,231,182,63,119,1,32,11,21,14,13,0,0,1,2
W35000931,362,298,114,184,1,27,15,12,36,28,0,8,0,0
W35000932,286,212,66,146,1,50,33,17,21,19,1,1,0,2
W35000933,395,246,91,155,2,71,41,30,69,60,1,5,3,7
W35000934,353,288,133,155,1,26,15,11,33,29,1,1,2,5
W35000935,321,243,92,151,1,38,17,21,33,27,1,4,1,6
W35000936,551,392,147,245,0,94,45,49,61,50,2,7,2,4
W35000937,271,221,88,133,0,26,17,9,20,19,0,1,0,4
W35000938,428,299,115,184,1,71,44,27,55,43,2,9,1,2
W35000939,239,186,65,121,1,27,12,15,20,18,0,1,1,5
W35000940,331,260,108,152,0,45,29,16,20,19,0,1,0,6
W35000941,400,308,156,152,2,32,14,18,50,47,1,2,0,8
W35000942,381,312,137,175,0,33,19,14,28,24,2,2,0,8
W35000943,433,319,147,172,2,47,27,20,59,51,0,4,4,6
W35000944,290,231,110,121,0,29,16,13,27,21,1,3,2,3
W35000945,318,239,68,171,0,35,21,14,39,34,0,3,2,5
W35000946,405,277,134,143,0,56,25,31,68,58,0,7,3,4
W35000947,839,655,337,318,5,69,37,32,100,86,2,12,0,10
W35000948,445,297,128,169,1,55,22,33,82,72,1,9,0,10
W35000949,242,170,73,97,0,19,6,13,50,45,0,5,0,3
W35000950,541,380,179,201,1,54,26,28,85,63,7,12,3,21
W35000951,229,172,75,97,0,19,6,13,29,29,0,0,0,9
W35000952,344,234,124,110,1,34,13,21,69,56,2,4,7,6
W35000953,322,239,107,132,1,39,15,24,35,25,0,8,2,8
W35000954,574,410,177,233,4,88,42,46,68,57,0,9,2,4
W35000955,293,223,122,101,3,20,14,6,33,28,1,3,1,14
W35000956,422,305,143,162,2,58,24,34,52,47,0,5,0,5
W35000957,330,270,171,99,0,21,11,10,35,30,0,5,0,4
W35000958,295,186,81,105,2,49,21,28,51,40,2,8,1,7
W35000959,352,255,120,135,2,32,13,19,55,38,6,7,4,8
W35000960,578,331,139,192,3,90,53,37,146,122,5,16,3,8
W35000961,252,182,87,95,1,41,20,21,23,19,0,4,0,5
W35000962,241,162,94,68,2,24,18,6,46,39,1,6,0,7
W35000963,462,322,138,184,2,51,26,25,75,63,0,11,1,12
W35000964,582,422,164,258,3,60,26,34,90,74,0,11,5,7
W35000965,375,277,138,139,2,45,30,15,40,32,2,3,3,11
W35000966,399,290,128,162,3,49,24,25,54,46,0,7,1,3
W35000967,446,300,130,170,3,76,38,38,57,47,1,7,2,10
W35000968,258,186,91,95,0,28,18,10,37,29,0,5,3,7
W35000969,254,204,90,114,2,15,4,11,25,24,0,1,0,8
W35000970,520,370,169,201,3,47,21,26,81,64,0,16,1,19
W35000971,254,206,84,122,0,16,5,11,31,25,0,6,0,1
W35000972,239,180,95,85,0,23,10,13,29,24,0,5,0,7
W35000973,427,285,137,148,2,51,35,16,80,68,7,5,0,9
W35000974,234,180,81,99,0,15,7,8,36,34,1,1,0,3
W35000975,293,222,132,90,1,15,7,8,43,36,0,6,1,12
W35000976,290,176,105,71,0,19,9,10,87,81,4,0,2,8
W35000977,315,226,140,86,3,24,10,14,50,39,0,5,6,12
W35000978,301,193,122,71,0,45,20,25,55,47,3,4,1,8
W35000979,482,327,159,168,2,52,17,35,91,75,5,9,2,10
W35000980,275,186,85,101,0,18,10,8,63,57,0,3,3,8
W35000981,417,311,178,133,0,33,15,18,64,51,7,6,0,9
W35000982,223,159,87,72,1,15,10,5,40,33,3,2,2,8
W35000983,373,293,198,95,1,20,11,9,39,22,5,11,1,20
W35000984,327,216,104,112,3,56,24,32,52,43,1,8,0,0
W35000985,272,173,103,70,0,28,18,10,60,47,1,7,5,11
W35000986,439,329,211,118,1,35,19,16,68,53,3,12,0,6
W35000987,275,181,88,93,0,40,22,18,47,36,2,9,0,7
W35000988,287,211,108,103,0,26,11,15,40,29,0,10,1,10
W35000989,473,363,167,196,2,30,12,18,63,55,0,6,2,15
W35000990,313,212,122,90,1,41,31,10,49,44,0,5,0,10
W35000991,263,175,70,105,1,36,17,19,44,38,1,5,0,7
W35000992,308,206,74,132,1,31,15,16,68,60,2,6,0,2
W35000993,339,224,91,133,1,43,14,29,66,62,0,4,0,5
W35000994,223,164,81,83,0,23,12,11,30,28,0,2,0,6
W35000995,356,214,87,127,0,56,38,18,77,69,1,7,0,9
W35000996,255,199,105,94,0,20,13,7,28,27,1,0,0,8
W35000997,458,333,156,177,2,59,32,27,60,56,2,2,0,4
W35000998,645,460,164,296,0,81,34,47,94,84,3,7,0,10
W35000999,327,237,123,114,3,11,2,9,70,60,3,2,5,6
W35001000,252,140,79,61,2,19,8,11,85,65,15,4,1,6
W35001001,242,180,105,75,1,22,14,8,36,33,0,3,0,3
W35001002,256,169,85,84,0,29,13,16,51,41,4,5,1,7
W35001003,307,205,96,109,1,32,15,17,63,60,2,1,0,6
W35001004,676,409,122,287,6,87,25,62,170,156,2,10,2,4
W35001005,263,184,62,122,1,34,16,18,43,35,2,4,2,1
W35001006,455,290,93,197,3,34,12,22,125,115,0,8,2,3
W35001007,385,291,107,184,2,25,10,15,63,56,0,6,1,4
W35001008,264,168,65,103,3,27,10,17,62,60,0,2,0,4
W35001009,243,162,63,99,1,22,6,16,53,51,0,2,0,5
W35001010,495,365,116,249,3,44,14,30,83,68,1,12,2,0
W35001011,319,245,79,166,3,24,7,17,45,44,0,1,0,2
W35001012,267,209,63,146,3,18,4,14,34,32,0,1,1,3
W35001013,291,207,65,142,3,22,5,17,58,51,1,6,0,1
W35001014,519,383,136,247,1,62,27,35,72,65,0,5,2,1
W35001015,495,364,104,260,5,56,33,23,70,64,0,5,1,0
W35001016,467,383,126,257,2,17,8,9,51,48,0,2,1,14
W35001017,427,339,126,213,2,21,11,10,60,55,1,4,0,5
W35001018,515,379,146,233,2,31,18,13,103,98,0,4,1,0
W35001019,421,289,99,190,3,34,17,17,92,86,0,5,1,3
W35001020,1289,1072,319,753,10,63,29,34,132,117,0,11,4,12
W35001021,381,282,99,183,2,28,9,19,62,60,0,2,0,7
W35001022,601,407,140,267,5,51,21,30,133,114,9,9,1,5
W35001023,415,336,81,255,6,20,12,8,46,42,0,4,0,7
W35001024,590,405,126,279,20,39,17,22,118,107,0,11,0,8
W35001025,280,199,55,144,2,28,17,11,49,44,1,3,1,2
W35001026,277,224,96,128,2,13,5,8,34,30,0,4,0,4
W35001027,428,303,117,186,2,12,6,6,107,103,0,4,0,4
W35001028,493,351,111,240,4,38,18,20,96,90,0,6,0,4
W35001029,248,194,69,125,1,11,3,8,38,33,0,5,0,4
W35001030,272,194,65,129,2,30,6,24,40,34,0,5,1,6
W35001031,417,299,98,201,5,34,15,19,73,66,3,4,0,6
W35001032,472,381,114,267,4,27,10,17,58,54,0,4,0,2
W35001033,394,279,75,204,1,27,7,20,82,74,3,5,0,5
W35001034,389,310,93,217,1,21,13,8,53,48,1,3,1,4
W35001035,301,186,61,125,4,32,16,16,75,67,2,6,0,4
W35001036,379,272,72,200,3,34,20,14,65,55,0,6,4,5
W35001037,440,337,94,243,4,16,4,12,76,66,3,6,1,7
W35001038,285,225,58,167,2,7,4,3,44,38,0,2,4,7
W35001039,262,207,67,140,1,13,9,4,39,36,0,3,0,2
W35001040,305,233,78,155,3,25,13,12,40,34,0,6,0,4
W35001041,272,227,83,144,2,12,8,4,29,26,1,1,1,2
W35001042,460,385,102,283,3,23,11,12,44,39,0,5,0,5
W35001043,291,232,75,157,4,13,7,6,34,31,0,2,1,8
W35001044,367,256,90,166,3,44,23,21,62,54,1,7,0,2
W35001045,359,274,89,185,2,47,29,18,36,27,0,8,1,0
W35001046,331,254,75,179,4,14,7,7,57,51,2,4,0,2
W35001047,253,191,67,124,2,12,5,7,47,41,1,4,1,1
W35001048,505,396,122,274,1,26,14,12,77,73,2,2,0,5
W35001049,792,575,164,411,9,81,42,39,122,116,1,4,1,5
W35001050,330,266,85,181,2,9,5,4,50,47,0,2,1,3
W35001051,407,286,86,200,7,38,20,18,74,65,0,7,2,2
W35001052,398,310,93,217,4,39,17,22,43,36,1,5,1,2
W35001053,323,242,74,168,3,22,17,5,55,54,0,1,0,1
W35001054,320,252,73,179,2,13,8,5,50,47,0,1,2,3
W35001055,662,511,143,368,2,51,23,28,92,82,0,10,0,6
W35001056,290,214,93,121,5,24,11,13,45,42,1,1,1,2
W35001057,597,483,158,325,3,41,19,22,67,63,0,4,0,3
W35001058,680,490,136,354,3,52,24,28,127,121,0,6,0,8
W35001059,271,224,120,104,2,17,9,8,25,24,0,1,0,3
W35001060,224,177,84,93,1,14,9,5,28,20,0,8,0,4
W35001061,399,314,99,215,3,16,6,10,60,53,1,6,0,6
W35001062,400,304,109,195,0,25,12,13,63,53,2,8,0,8
W35001063,254,201,67,134,2,20,7,13,29,27,0,2,0,2
W35001064,384,254,90,164,3,47,15,32,75,61,0,13,1,5
W35001065,985,784,236,548,7,59,29,30,127,116,0,11,0,8
W35001066,384,290,155,135,4,21,14,7,59,52,0,7,0,10
W35001067,348,240,167,73,0,9,2,7,82,72,0,8,2,17
W35001068,391,312,164,148,0,30,15,15,41,36,0,5,0,8
W35001069,339,258,128,130,3,10,3,7,59,54,1,3,1,9
W35001070,475,329,182,147,0,26,11,15,104,93,1,5,5,16
W35001071,473,334,165,169,6,11,5,6,102,80,6,9,7,20
W35001072,340,240,102,138,3,34,14,20,56,50,0,2,4,7
W35001073,234,166,90,76,2,21,3,18,37,23,9,5,0,8
W35001074,485,345,127,218,0,40,9,31,91,74,0,6,11,9
W35001075,652,464,183,281,7,79,29,50,92,77,3,10,2,10
W35001076,237,139,73,66,2,46,3,43,48,39,0,0,9,2
W35001077,315,224,91,133,1,30,16,14,55,50,2,3,0,5
W35001078,429,326,115,211,3,34,17,17,60,50,2,5,3,6
W35001079,335,273,116,157,1,25,3,22,32,28,0,4,0,4
W35001080,519,392,95,297,5,12,3,9,97,83,2,11,1,13
W35001081,224,180,61,119,5,9,4,5,28,21,2,5,0,2
W35001082,559,422,125,297,7,42,20,22,83,79,0,4,0,5
W35001083,273,198,60,138,1,19,10,9,49,45,0,4,0,6
W35001084,340,222,78,144,5,32,25,7,79,69,2,8,0,2
W35001085,321,244,62,182,4,32,23,9,36,29,0,7,0,5
W35001086,417,306,78,228,5,25,13,12,77,70,0,6,1,4
W35001087,863,711,233,478,3,22,10,12,121,107,2,10,2,6
W35001088,258,159,37,122,3,30,8,22,62,58,1,2,1,4
W35001089,443,317,91,226,4,45,23,22,70,66,0,4,0,7
W35001090,685,572,167,405,7,33,20,13,71,58,0,11,2,2
W35001091,516,336,92,244,3,48,28,20,126,115,1,9,1,3
W35001092,267,208,65,143,1,17,10,7,33,32,0,1,0,8
W35001093,227,161,50,111,2,20,14,6,42,41,0,1,0,2
W35001094,270,193,44,149,5,23,13,10,47,43,0,4,0,2
W35001095,244,185,48,137,2,23,16,7,34,27,0,7,0,0
W35001096,580,448,120,328,5,49,32,17,71,67,0,4,0,7
W35001097,382,258,66,192,6,64,34,30,51,44,0,7,0,3
W35001098,358,259,64,195,6,30,19,11,57,52,1,4,0,6
W35001099,274,210,100,110,2,17,11,6,42,39,0,3,0,3
W35001100,344,251,71,180,1,37,32,5,50,41,0,9,0,5
W35001101,376,302,122,180,0,18,17,1,53,39,10,4,0,3
W35001102,365,266,98,168,2,34,24,10,57,50,3,1,3,6
W35001103,691,506,136,370,7,32,19,13,139,124,5,8,2,7
W35001104,342,256,75,181,3,25,20,5,57,55,1,1,0,1
W35001105,348,266,92,174,4,21,14,7,56,45,2,8,1,1
W35001106,266,179,56,123,7,28,18,10,52,42,1,7,2,0
W35001107,3388,2769,740,2029,27,168,107,61,398,351,11,35,1,26
W35001108,444,330,95,235,3,19,14,5,80,71,1,6,2,12
W35001109,400,296,97,199,7,31,23,8,60,49,1,8,2,6
W35001110,249,157,63,94,4,26,13,13,56,52,3,1,0,6
W35001111,537,417,125,292,4,14,10,4,93,80,4,9,0,9
W35001112,905,727,221,506,10,43,29,14,117,96,5,14,2,8
W35001113,679,558,199,359,6,44,30,14,66,51,8,6,1,5
W35001114,614,456,158,298,5,45,25,20,102,93,0,7,2,6
W35001115,631,434,149,285,4,91,67,24,95,80,1,13,1,7
W35001116,295,187,71,116,1,53,38,15,41,37,0,2,2,13
W35001117,659,472,157,315,2,82,46,36,95,80,6,7,2,8
W35001118,290,250,132,118,0,9,5,4,21,16,0,5,0,10
W35001119,330,236,111,125,1,29,19,10,56,51,1,4,0,8
W35001120,372,293,89,204,3,22,11,11,45,39,0,6,0,9
W35001121,621,495,184,311,5,48,27,21,69,58,1,10,0,4
W35001122,258,204,91,113,1,11,10,1,36,30,0,6,0,6
W35001123,225,180,64,116,0,19,12,7,23,14,2,5,2,3
W35001124,366,286,116,170,0,24,17,7,52,38,4,10,0,4
W35001125,485,280,99,181,6,72,41,31,120,114,2,4,0,7
W35001126,278,210,58,152,1,16,9,7,41,34,1,4,2,10
W35001127,331,234,98,136,0,44,23,21,50,42,2,6,0,3
W35001128,301,242,92,150,2,19,9,10,34,26,0,6,2,4
W35001129,346,245,73,172,1,48,24,24,48,43,0,4,1,4
W35001130,556,454,172,282,2,40,23,17,47,45,0,2,0,13
W35001131,321,229,104,125,1,18,13,5,64,57,1,4,2,9
W35001132,357,279,138,141,4,16,14,2,50,36,6,4,4,8
W35001133,286,214,75,139,0,42,27,15,28,25,0,3,0,2
W35001134,405,361,183,178,0,15,10,5,26,22,2,2,0,3
W35001135,441,274,117,157,1,74,50,24,82,75,0,4,3,10
W35001136,272,167,79,88,1,49,40,9,53,50,1,2,0,2
W35001137,392,304,102,202,5,43,28,15,39,34,1,3,1,1
W35001138,516,333,116,217,5,63,46,17,107,98,3,6,0,8
W35001139,279,200,109,91,0,29,24,5,42,41,0,1,0,8
W35001140,326,224,94,130,5,42,32,10,47,42,0,3,2,8
W35001141,750,538,226,312,3,103,73,30,94,80,1,9,4,12
W35001142,328,242,82,160,5,32,21,11,47,38,1,6,2,2
W35001143,366,289,94,195,2,13,10,3,57,46,1,7,3,5
W35001144,635,460,122,338,2,61,40,21,103,96,2,4,1,9
W35001145,295,246,93,153,2,18,9,9,28,24,0,4,0,1
W35001146,280,229,69,160,3,18,12,6,26,23,0,3,0,4
W35001147,339,265,106,159,0,27,16,11,39,33,0,1,5,8
W35001148,404,305,90,215,0,51,37,14,47,35,4,6,2,1
W35001149,431,344,97,247,1,30,21,9,55,48,1,6,0,1
W35001150,593,438,141,297,3,61,44,17,86,70,2,10,4,5
W35001151,490,400,137,263,6,42,36,6,39,33,1,4,1,3
W35001152,746,553,168,385,5,100,74,26,86,74,0,8,4,2
W35001153,542,443,129,314,4,41,33,8,49,42,1,6,0,5
W35001154,403,295,88,207,3,50,36,14,48,43,0,5,0,7
W35001155,243,190,50,140,1,11,7,4,40,29,0,11,0,1
W35001156,314,257,72,185,1,25,20,5,27,22,1,4,0,4
W35001157,435,344,113,231,1,56,41,15,32,23,1,7,1,2
W35001158,307,232,68,164,1,37,27,10,37,33,0,2,2,0
W35001159,2534,1819,461,1358,10,303,210,93,395,380,1,12,2,7
W35001160,781,487,141,346,2,83,62,21,199,178,1,15,5,10
W35001161,424,367,133,234,3,22,13,9,30,28,1,1,0,2
W35001162,401,322,92,230,2,34,18,16,42,40,0,1,1,1
W35001163,258,198,61,137,0,25,15,10,31,27,0,4,0,4
W35001164,328,254,113,141,1,28,22,6,42,38,0,4,0,3
W35001165,541,453,168,285,5,31,22,9,38,31,0,4,3,14
W35001166,336,253,87,166,1,20,12,8,54,52,1,1,0,8
W35001167,255,196,65,131,2,30,22,8,23,18,2,3,0,4
W35001168,349,287,127,160,3,20,10,10,34,26,2,5,1,5
W35001169,388,321,102,219,8,26,24,2,30,22,0,8,0,3
W35001170,316,223,64,159,1,51,34,17,37,35,0,2,0,4
W35001171,355,255,69,186,4,60,40,20,33,30,0,3,0,3
W35001172,851,729,217,512,3,53,39,14,61,58,1,1,1,5
W35001173,507,395,98,297,4,44,23,21,61,52,0,9,0,3
W35001174,334,242,78,164,7,45,36,9,37,32,1,4,0,3
W35001175,258,211,70,141,1,19,10,9,26,26,0,0,0,1
W35001176,250,172,48,124,1,46,29,17,31,29,1,1,0,0
W35001177,623,471,141,330,6,60,32,28,81,78,1,2,0,5
W35001178,412,305,76,229,2,50,29,21,53,50,0,3,0,2
W35001179,324,237,57,180,4,31,15,16,50,45,4,1,0,2
W35001180,352,292,78,214,2,18,13,5,36,29,0,6,1,4
W35001181,248,204,70,134,0,13,9,4,31,24,0,6,1,0
W35001182,530,431,112,319,0,33,24,9,62,53,0,9,0,4
W35001183,269,196,59,137,1,39,23,16,30,27,0,3,0,3
W35001184,323,246,87,159,2,30,11,19,44,42,0,0,2,1
W35001185,502,378,103,275,5,65,46,19,48,43,0,5,0,6
W35001186,936,754,208,546,6,66,46,20,108,93,0,11,4,2
W35001187,511,402,123,279,5,39,20,19,63,56,0,7,0,2
W35001188,845,669,229,440,7,50,39,11,112,97,3,10,2,7
W35001189,654,540,123,417,5,21,9,12,87,75,2,9,1,1
W35001190,298,272,95,177,0,5,4,1,19,16,0,3,0,2
W35001191,477,362,118,244,2,23,9,14,76,64,3,8,1,14
W35001192,374,325,95,230,1,9,8,1,35,29,0,6,0,4
W35001193,428,347,96,251,1,30,25,5,44,37,0,6,1,6
W35001194,401,327,105,222,1,32,25,7,38,34,0,4,0,3
W35001195,338,275,101,174,1,25,23,2,35,30,0,4,1,2
W35001196,299,228,66,162,1,19,14,5,49,40,0,6,3,2
W35001197,420,375,120,255,1,9,5,4,31,26,0,4,1,4
W35001198,419,339,115,224,2,29,20,9,45,40,0,4,1,4
W35001199,337,270,88,182,0,23,19,4,39,34,0,5,0,5
W35001200,421,338,76,262,3,24,19,5,52,48,0,4,0,4
W35001201,369,271,74,197,1,65,45,20,31,29,1,1,0,1
W35001202,292,214,62,152,2,29,20,9,45,43,1,1,0,2
W35001203,289,250,79,171,1,12,9,3,26,24,0,2,0,0
W35001204,388,325,99,226,1,20,14,6,39,37,0,2,0,3
W35001205,716,556,169,387,3,55,37,18,101,91,0,10,0,1
W35001206,602,484,135,349,3,54,39,15,54,49,0,5,0,7
W35001207,319,248,75,173,2,40,29,11,28,24,0,3,1,1
W35001208,253,214,65,149,2,11,9,2,25,24,0,1,0,1
W35001209,345,273,93,180,4,22,14,8,40,35,0,3,2,6
W35001210,362,246,74,172,2,60,41,19,49,42,0,7,0,5
W35001211,491,383,124,259,0,46,35,11,59,56,0,3,0,3
W35001212,872,724,140,584,4,56,39,17,83,73,1,8,1,5
W35001213,393,291,88,203,3,35,25,10,53,51,0,2,0,11
W35001214,413,343,96,247,1,18,9,9,50,39,1,8,2,1
W35001215,543,401,136,265,4,69,51,18,53,49,0,4,0,16
W35001216,366,293,99,194,4,17,10,7,45,40,2,3,0,7
W35001217,330,275,115,160,1,16,13,3,38,30,2,5,1,0
W35001218,292,258,96,162,1,10,7,3,19,18,0,1,0,4
W35001219,287,216,73,143,0,18,14,4,48,44,1,2,1,5
W35001220,477,406,142,264,2,21,18,3,43,33,2,6,2,5
W35001221,246,171,60,111,0,17,14,3,52,45,1,6,0,6
W35001222,347,295,115,180,2,29,22,7,18,18,0,0,0,3
W35001223,288,215,59,156,1,28,27,1,44,33,0,8,3,0
W35001224,292,229,71,158,2,25,21,4,31,26,0,4,1,5
W35001225,396,333,103,230,2,21,13,8,33,29,1,2,1,7
W35001226,506,388,163,225,3,45,36,9,60,50,4,6,0,10
W35001227,353,286,81,205,2,40,29,11,20,16,0,4,0,5
W35001228,359,251,90,161,1,74,68,6,29,27,0,2,0,4
W35001229,1033,794,223,571,5,120,97,23,107,93,0,12,2,7
W35001230,385,297,97,200,0,51,41,10,37,33,1,1,2,0
W35001231,454,261,74,187,1,78,73,5,113,108,0,4,1,1
W35001232,309,223,57,166,0,54,41,13,30,26,0,4,0,2
W35001233,311,235,74,161,3,37,26,11,31,26,0,5,0,5
W35001234,310,209,52,157,0,55,50,5,42,37,2,2,1,4
W35001235,513,374,84,290,0,92,76,16,43,34,3,6,0,4
W35001236,288,201,73,128,1,48,39,9,36,34,0,2,0,2
W35001237,584,413,111,302,0,93,74,19,76,59,0,10,7,2
W35001238,460,353,108,245,2,55,46,9,45,41,0,2,2,5
W35001239,411,304,83,221,2,57,46,11,47,39,1,6,1,1
W35001240,491,410,133,277,0,33,26,7,44,32,0,8,4,4
W35001241,372,303,114,189,0,21,19,2,45,36,0,9,0,3
W35001242,530,384,117,267,2,60,46,14,76,72,0,4,0,8
W35001243,351,266,101,165,1,46,40,6,33,29,0,3,1,5
W35001244,508,360,108,252,1,74,61,13,68,61,1,6,0,5
W35001245,485,284,96,188,0,130,120,10,64,55,2,5,2,7
W35001246,397,208,55,153,3,140,130,10,40,39,0,1,0,6
W35001247,405,234,67,167,4,91,71,20,72,63,3,6,0,4
W35001248,779,621,162,459,8,75,48,27,72,66,0,6,0,3
W35001249,348,263,80,183,1,36,30,6,41,36,0,5,0,7
W35001250,598,403,124,279,5,85,70,15,97,82,1,14,0,8
W35001251,441,309,111,198,3,39,34,5,85,77,2,6,0,5
W35001252,717,543,138,405,10,80,68,12,80,73,1,6,0,4
W35001253,788,510,148,362,5,139,127,12,129,113,1,15,0,5
W35001254,277,172,73,99,1,44,32,12,56,49,2,3,2,4
W35001255,338,224,71,153,1,60,32,28,51,45,4,1,1,2
W35001256,799,528,149,379,1,144,129,15,122,110,1,9,2,4
W35001257,286,214,75,139,4,51,39,12,14,11,0,1,2,3
W35001258,841,667,232,435,3,76,69,7,90,83,0,6,1,5
W35001259,393,269,72,197,2,63,52,11,56,50,0,4,2,3
W35001260,332,259,65,194,3,44,37,7,26,22,1,3,0,0
W35001261,310,241,80,161,1,29,23,6,37,31,2,4,0,2
W35001262,255,181,64,117,0,37,31,6,36,32,0,4,0,1
W35001263,323,214,52,162,1,48,43,5,58,56,0,2,0,2
W35001264,301,218,65,153,0,47,40,7,34,30,1,3,0,2
W35001265,245,183,63,120,0,34,28,6,26,21,2,3,0,2
W35001266,290,190,62,128,1,67,58,9,26,22,0,4,0,6
W35001267,352,215,83,132,0,44,38,6,86,75,3,7,1,7
W35001268,308,214,67,147,2,53,43,10,38,35,0,3,0,1
W35001269,811,612,180,432,4,84,73,11,108,101,0,4,3,3
W35001270,220,180,58,122,0,24,21,3,14,13,0,1,0,2
W35001271,310,233,78,155,1,47,36,11,28,26,0,2,0,1
W35001272,332,264,89,175,1,36,20,16,27,25,0,2,0,4
W35001273,272,209,64,145,2,37,32,5,22,18,0,2,2,2
W35001274,606,402,128,274,1,145,135,10,52,45,0,5,2,6
W35001275,306,183,48,135,1,96,90,6,24,24,0,0,0,2
W35001276,294,237,65,172,0,24,17,7,30,29,0,0,1,3
W35001277,234,170,68,102,0,14,11,3,46,44,1,0,1,4
W35001278,243,189,78,111,2,13,9,4,37,27,1,4,5,2
W35001279,312,253,117,136,0,19,16,3,32,28,0,4,0,8
W35001280,409,289,121,168,0,35,16,19,81,72,5,3,1,4
W35001281,764,533,198,335,6,101,89,12,117,109,0,5,3,7
W35001282,386,305,118,187,4,34,25,9,37,33,1,2,1,6
W35001283,279,217,120,97,1,24,16,8,33,32,0,1,0,4
W35001284,337,255,79,176,2,37,28,9,39,36,0,3,0,4
W35001285,413,290,107,183,1,59,34,25,55,48,1,6,0,8
W35001286,241,169,72,97,2,33,25,8,31,26,0,4,1,6
W35001287,296,228,93,135,0,15,11,4,43,37,2,4,0,10
W35001288,371,297,174,123,0,15,11,4,56,52,0,4,0,3
W35001289,226,177,91,86,0,10,6,4,36,31,1,4,0,3
W35001290,365,284,167,117,1,24,13,11,45,39,0,4,2,11
W35001291,491,360,172,188,3,27,16,11,95,84,2,7,2,6
W35001292,630,478,237,241,4,46,29,17,95,87,1,7,0,7
W35001293,291,197,114,83,0,15,11,4,70,66,0,4,0,9
W35001294,333,266,149,117,0,18,12,6,44,41,1,1,1,5
W35001295,346,293,201,92,1,6,4,2,34,32,0,2,0,12
W35001296,317,231,119,112,0,14,10,4,60,39,5,7,9,12
W35001297,282,227,80,147,1,10,5,5,40,34,0,5,1,4
W35001298,289,233,78,155,1,18,10,8,35,31,2,2,0,2
W35001299,270,234,136,98,1,3,3,0,27,23,1,2,1,5
W35001300,361,280,127,153,1,15,14,1,61,53,4,4,0,4
W35001301,318,237,115,122,4,14,7,7,56,52,0,3,1,7
W35001302,371,253,81,172,4,38,17,21,69,61,3,5,0,7
W35001303,234,159,66,93,3,28,20,8,41,39,0,2,0,3
W35001304,343,273,108,165,1,26,9,17,39,34,0,5,0,4
W35001305,266,200,103,97,5,29,12,17,30,25,0,3,2,2
W35001306,293,178,81,97,0,34,7,27,70,65,1,2,2,11
W35001307,345,245,132,113,0,34,16,18,61,46,4,8,3,5
W35001308,423,258,110,148,0,94,73,21,65,57,1,7,0,6
W35001309,279,211,128,83,7,7,7,0,41,37,0,4,0,13
W35001310,510,345,120,225,1,59,32,27,100,89,0,9,2,5
W35001311,258,215,147,68,3,10,8,2,24,19,3,1,1,6
W35001312,331,274,166,108,0,17,15,2,25,22,0,3,0,15
W35001313,461,330,128,202,1,38,28,10,86,70,6,7,3,6
W35001314,417,306,167,139,0,19,17,2,88,80,1,5,2,4
W35001315,290,226,99,127,0,16,7,9,45,42,0,2,1,3
W35001316,443,321,115,206,2,39,23,16,73,64,1,7,1,8
W35001317,260,180,80,100,0,23,14,9,49,40,6,3,0,8
W35001318,333,271,148,123,3,16,14,2,37,31,0,5,1,6
W35001319,291,231,145,86,0,14,9,5,41,37,0,4,0,5
W35001320,409,351,207,144,4,22,12,10,30,24,0,6,0,2
W35001321,318,254,127,127,1,16,12,4,41,38,1,2,0,6
W35001322,411,329,187,142,1,21,20,1,59,50,2,6,1,1
W35001323,339,252,133,119,0,41,33,8,44,34,1,9,0,2
W35001324,396,299,181,118,0,48,42,6,44,39,1,4,0,5
W35001325,272,187,112,75,0,35,27,8,41,38,1,2,0,9
W35001326,351,278,130,148,1,24,20,4,35,28,0,5,2,13
W35001327,343,290,176,114,0,11,3,8,36,28,0,7,1,6
W35001328,362,262,139,123,2,30,17,13,60,48,4,6,2,8
W35001329,370,276,113,163,2,35,15,20,50,39,1,10,0,7
W35001330,471,323,121,202,0,61,43,18,84,77,2,4,1,3
W35001331,358,270,113,157,0,33,19,14,52,43,0,7,2,3
W35001332,250,194,83,111,0,14,8,6,38,33,0,5,0,4
W35001333,548,337,110,227,1,120,73,47,79,71,0,7,1,11
W35001334,473,326,119,207,1,80,64,16,64,55,1,7,1,2
W35001335,557,358,179,179,2,68,51,17,121,111,2,8,0,8
W35001336,235,168,78,90,1,17,9,8,43,41,0,2,0,6
W35001337,452,392,253,139,1,3,2,1,49,42,0,5,2,7
W35001338,500,362,156,206,2,47,39,8,83,77,1,5,0,6
W35001339,231,185,132,53,0,10,6,4,28,24,1,3,0,8
W35001340,550,391,215,176,4,18,9,9,127,116,2,9,0,10
W35001341,350,235,133,102,5,23,15,8,76,68,7,1,0,11
W35001342,439,309,162,147,0,41,29,12,78,66,1,10,1,11
W35001343,297,241,151,90,2,9,5,4,36,32,0,4,0,9
W35001344,373,256,123,133,1,28,12,16,81,66,8,7,0,7
W35001345,316,205,108,97,0,35,18,17,71,66,3,2,0,5
W35001346,451,373,255,118,1,14,14,0,46,33,2,10,1,17
W35001347,340,247,155,92,0,16,14,2,56,47,1,5,3,21
W35001348,382,285,152,133,2,33,25,8,55,42,2,10,1,7
W35001349,636,440,189,251,0,76,30,46,113,106,1,5,1,7
W35001350,394,292,174,118,0,45,36,9,42,35,1,6,0,15
W35001351,455,283,145,138,1,53,28,25,109,92,0,15,2,9
W35001352,282,241,154,87,0,10,9,1,26,25,0,1,0,5
W35001353,273,199,110,89,0,16,9,7,54,47,0,7,0,4
W35001354,333,269,149,120,0,21,13,8,34,32,0,1,1,9
W35001355,316,209,106,103,1,45,27,18,54,47,2,1,4,7
W35001356,275,232,147,85,1,9,7,2,28,24,0,3,1,5
W35001357,284,205,96,109,3,27,16,11,47,42,1,4,0,2
W35001358,256,180,72,108,0,27,15,12,46,45,0,1,0,3
W35001359,245,189,77,112,0,9,5,4,43,40,0,3,0,4
W35001360,586,401,173,228,2,41,27,14,125,114,2,9,0,17
W35001361,450,327,132,195,1,31,15,16,88,79,0,7,2,3
W35001362,587,406,143,263,0,56,34,22,120,110,1,9,0,5
W35001363,273,210,80,130,1,9,5,4,44,41,1,2,0,9
W35001364,363,288,130,158,0,19,11,8,53,47,1,5,0,3
W35001365,365,262,135,127,0,25,15,10,72,63,4,5,0,6
W35001366,273,203,112,91,1,14,10,4,41,37,0,2,2,14
W35001367,323,235,116,119,1,29,9,20,52,50,1,1,0,6
W35001368,232,174,119,55,2,5,3,2,45,39,1,1,4,6
W35001369,343,272,159,113,0,13,11,2,52,41,6,4,1,6
W35001370,317,268,162,106,0,8,5,3,34,31,0,3,0,7
W35001371,672,459,245,214,4,46,26,20,144,118,9,13,4,19
W35001372,370,252,103,149,1,30,21,9,71,59,3,8,1,16
W35001373,449,307,134,173,0,39,18,21,94,78,5,11,0,9
W35001374,226,171,101,70,0,13,10,3,32,27,1,4,0,10
W35001375,536,392,166,226,0,54,34,20,86,76,0,9,1,4
W35001376,542,415,231,184,4,21,13,8,87,70,0,17,0,15
W35001377,749,574,237,337,2,65,40,25,98,82,0,16,0,10
W35001378,320,256,174,82,0,17,14,3,40,34,1,5,0,7
W35001379,438,302,163,139,3,34,19,15,84,64,6,13,1,15
W35001380,533,374,152,222,1,49,32,17,90,71,3,10,6,19
W35001381,1137,745,273,472,7,126,64,62,242,126,58,14,44,17
W35001382,445,290,124,166,0,82,48,34,63,45,2,9,7,10
W35001383,519,364,127,237,2,46,27,19,96,67,17,6,6,11
W35001384,375,271,101,170,2,36,11,25,64,51,2,5,6,2
W35001385,278,205,113,92,3,8,3,5,50,43,2,5,0,12
W35001386,371,269,132,137,2,19,14,5,57,53,0,4,0,24
W35001387,286,233,99,134,1,22,9,13,27,21,1,4,1,3
W35001388,461,326,134,192,0,44,16,28,79,68,2,3,6,12
W35001389,328,253,129,124,1,24,7,17,39,32,0,7,0,11
W35001390,343,271,118,153,1,28,14,14,37,32,0,4,1,6
W35001391,329,264,129,135,2,7,3,4,54,48,1,5,0,2
W35001392,315,214,97,117,0,19,7,12,76,67,0,8,1,6
W35001393,596,477,195,282,3,16,2,14,89,79,3,6,1,11
W35001394,376,291,184,107,0,14,4,10,64,57,1,6,0,7
W35001395,359,235,106,129,2,27,8,19,90,78,8,1,3,5
W35001396,663,391,156,235,1,40,14,26,224,217,0,4,3,7
W35001397,632,361,169,192,1,49,10,39,211,201,1,7,2,10
W35001398,341,221,87,134,2,29,8,21,82,74,1,5,2,7
W35001399,252,157,66,91,3,11,5,6,71,69,0,0,2,10
W35001400,298,186,85,101,2,34,13,21,72,68,1,2,1,4
W35001401,450,227,95,132,2,26,11,15,186,177,5,4,0,9
W35001402,337,233,82,151,2,56,18,38,43,35,2,5,1,3
W35001403,639,495,199,296,2,35,13,22,98,86,1,6,5,9
W35001404,427,299,129,170,0,28,9,19,92,84,4,4,0,8
W35001405,281,186,66,120,0,54,14,40,38,37,0,1,0,3
W35001406,268,174,62,112,2,21,9,12,65,54,0,11,0,6
W35001407,270,226,126,100,1,8,0,8,34,30,0,3,1,1
W35001408,352,256,114,142,3,15,6,9,73,66,2,4,1,5
W35001409,440,355,186,169,1,16,11,5,61,48,2,7,4,7
W35001410,283,217,116,101,1,10,3,7,43,42,0,1,0,12
W35001411,348,271,135,136,2,9,3,6,56,51,0,5,0,10
W35001412,234,196,117,79,0,4,3,1,31,25,0,5,1,3
W35001413,359,260,102,158,1,22,8,14,71,63,0,7,1,5
W35001414,344,274,140,134,1,10,3,7,49,38,3,5,3,10
W35001415,311,258,136,122,1,4,3,1,29,20,2,7,0,19
W35001416,293,236,117,119,1,16,4,12,35,29,2,4,0,5
W35001417,402,279,127,152,0,23,4,19,90,82,0,8,0,10
W35001418,392,324,170,154,2,12,5,7,45,37,0,8,0,9
W35001419,276,217,114,103,3,19,9,10,30,26,0,3,1,7
W35001420,335,279,176,103,3,10,5,5,37,33,0,1,3,6
W35001421,537,363,178,185,0,46,14,32,120,107,2,6,5,8
W35001422,323,243,143,100,2,18,14,4,52,35,0,10,7,8
W35001423,400,328,134,194,1,19,3,16,44,39,1,3,1,8
W35001424,489,398,164,234,2,17,9,8,67,56,0,6,5,5
W35001425,313,182,83,99,2,28,6,22,96,82,0,5,9,5
W35001426,268,220,126,94,3,5,3,2,32,28,0,3,1,8
W35001427,229,160,85,75,2,25,12,13,41,35,2,4,0,1
W35001428,529,363,162,201,4,33,8,25,122,112,1,6,3,7
W35001429,294,237,150,87,0,13,5,8,41,32,1,7,1,3
W35001430,417,301,140,161,4,40,15,25,65,55,0,9,1,7
W35001431,359,250,114,136,0,44,14,30,61,56,1,3,1,4
W35001432,622,430,171,259,3,54,22,32,122,110,2,8,2,13
W35001433,423,349,196,153,2,19,10,9,48,41,5,2,0,5
W35001434,527,391,150,241,2,41,15,26,85,76,3,6,0,8
W35001435,610,437,207,230,1,72,37,35,93,83,4,6,0,7
W35001436,302,229,115,114,0,26,13,13,35,33,0,2,0,12
W35001437,302,241,150,91,1,7,2,5,34,29,0,3,2,19
W35001438,242,205,83,122,1,8,5,3,28,26,0,2,0,0
W35001439,486,407,186,221,2,21,8,13,49,40,1,7,1,7
W35001440,488,404,206,198,0,36,16,20,45,33,0,12,0,3
W35001441,267,210,88,122,0,23,8,15,33,30,0,3,0,1
W35001442,237,191,113,78,2,12,2,10,28,27,1,0,0,4
W35001443,310,263,139,124,0,7,2,5,32,29,0,3,0,8
W35001444,228,177,89,88,1,10,4,6,38,36,0,2,0,2
W35001445,504,407,186,221,2,30,11,19,61,49,3,7,2,4
W35001446,456,399,230,169,6,8,7,1,34,29,0,5,0,9
W35001447,431,346,210,136,2,23,14,9,50,41,0,9,0,10
W35001448,333,264,157,107,1,13,2,11,42,25,9,8,0,13
W35001449,345,276,132,144,0,19,12,7,45,37,0,6,2,5
W35001450,383,321,167,154,1,12,4,8,39,30,1,8,0,10
W35001451,507,394,196,198,2,22,11,11,77,58,6,11,2,12
W35001452,280,222,129,93,0,26,14,12,27,24,0,3,0,5
W35001453,333,255,171,84,0,28,17,11,45,36,0,7,2,5
W35001454,479,353,167,186,1,53,25,28,65,46,1,13,5,7
W35001455,573,438,177,261,1,56,27,29,74,54,5,11,4,4
W35001456,398,310,172,138,0,28,18,10,49,42,2,5,0,11
W35001457,369,276,127,149,2,46,13,33,36,30,1,4,1,9
W35001458,477,328,131,197,0,57,39,18,87,62,4,17,4,5
W35001459,481,385,156,229,0,36,24,12,53,49,0,4,0,7
W35001460,233,163,60,103,0,29,22,7,38,30,0,8,0,3
W35001461,471,336,162,174,2,62,41,21,65,53,6,4,2,6
W35001462,323,264,143,121,3,11,6,5,37,32,2,2,1,8
W35001463,319,266,123,143,2,15,9,6,29,17,1,9,2,7
W35001464,261,202,90,112,1,26,20,6,29,23,5,1,0,3
W35001465,758,473,166,307,2,64,44,20,210,88,70,9,43,9
W35001466,269,184,78,106,1,37,26,11,36,32,0,3,1,11
W35001467,379,308,162,146,1,23,12,11,41,33,2,6,0,6
W35001468,362,275,124,151,0,13,8,5,60,54,0,3,3,14
W35001469,270,218,93,125,1,13,10,3,29,25,1,3,0,9
W35001470,346,273,163,110,0,17,13,4,42,37,0,5,0,14
W35001471,333,278,164,114,3,8,8,0,36,32,0,3,1,8
W35001472,314,229,86,143,1,41,25,16,39,36,1,2,0,4
W35001473,207,163,63,100,0,11,8,3,28,25,0,3,0,5
W35001474,496,370,134,236,2,53,42,11,65,56,0,9,0,6
W35001475,325,192,73,119,0,52,36,16,75,55,13,1,6,6
W35001476,303,219,73,146,0,27,12,15,55,48,2,5,0,2
W35001477,327,236,97,139,0,23,16,7,66,54,0,8,4,2
W35001478,295,207,81,126,0,44,28,16,36,28,1,6,1,8
W35001479,488,340,127,213,0,85,49,36,61,49,4,7,1,2
W35001480,522,363,96,267,0,77,55,22,79,63,6,9,1,3
W35001481,648,473,192,281,1,83,58,25,86,70,3,11,2,5
W35001482,276,195,89,106,0,22,17,5,51,42,2,6,1,8
W35001483,588,441,191,250,0,52,34,18,87,71,6,9,1,8
W35001484,443,322,122,200,1,31,21,10,86,73,0,12,1,3
W35001485,387,306,121,185,1,30,15,15,44,34,3,7,0,6
W35001486,720,478,222,256,3,67,48,19,154,138,6,8,2,18
W35001487,384,318,156,162,0,20,15,5,36,29,2,5,0,10
W35001488,467,366,139,227,1,22,14,8,66,58,2,6,0,12
W35001489,478,329,126,203,1,72,55,17,73,61,1,9,2,3
W35001490,278,195,107,88,1,30,18,12,39,30,2,2,5,13
W35001491,272,205,98,107,3,26,18,8,32,27,0,5,0,6
W35001492,466,358,161,197,0,27,21,6,69,60,2,5,2,12
W35001493,371,258,115,143,1,30,18,12,71,66,0,5,0,11
W35001494,271,211,123,88,1,14,11,3,41,34,0,6,1,4
W35001495,260,230,81,149,1,17,9,8,11,10,0,1,0,1
W35001496,365,272,92,180,0,54,37,17,36,30,0,6,0,3
W35001497,332,226,80,146,2,45,26,19,56,43,0,10,3,3
W35001498,425,326,99,227,1,43,34,9,53,46,2,5,0,2
W35001499,305,250,123,127,0,24,18,6,28,22,1,3,2,3
W35001500,318,248,120,128,1,32,23,9,30,26,0,4,0,7
W35001501,309,228,80,148,1,35,29,6,41,31,1,8,1,4
W35001502,434,315,104,211,4,64,52,12,50,42,3,5,0,1
W35001503,616,464,167,297,0,87,68,19,58,45,1,11,1,7
W35001504,560,420,146,274,4,59,38,21,72,62,3,7,0,5
W35001505,260,203,66,137,0,34,25,9,22,18,0,3,1,1
W35001506,455,325,138,187,2,33,19,14,90,72,13,3,2,5
W35001507,346,255,102,153,1,22,11,11,59,51,5,3,0,9
W35001508,309,220,85,135,0,26,16,10,57,52,3,2,0,6
W35001509,324,265,122,143,1,16,8,8,33,29,1,2,1,9
W35001510,260,201,84,117,5,32,14,18,17,15,0,1,1,5
W35001511,318,232,95,137,4,16,9,7,63,53,3,5,2,3
W35001512,309,260,99,161,0,20,11,9,28,22,1,3,2,1
W35001513,348,235,78,157,1,76,64,12,31,26,1,3,1,5
W35001514,365,253,86,167,1,68,59,9,39,38,1,0,0,4
W35001515,239,185,54,131,0,23,16,7,29,23,1,5,0,2
W35001516,341,234,83,151,1,61,55,6,43,32,2,8,1,2
W35001517,362,257,83,174,1,63,49,14,40,31,0,7,2,1
W35001518,291,235,63,172,1,25,16,9,30,24,0,5,1,0
W35001519,244,162,42,120,0,33,20,13,44,34,0,10,0,5
W35001520,465,329,118,211,1,60,42,18,67,61,0,6,0,8
W35001521,617,412,120,292,1,108,74,34,94,83,3,8,0,2
W35001522,337,267,96,171,1,31,14,17,35,33,0,2,0,3
W35001523,254,184,57,127,0,28,19,9,40,33,2,5,0,2
W35001524,393,298,114,184,0,44,26,18,47,39,1,7,0,4
W35001525,307,242,108,134,0,28,22,6,31,28,1,1,1,6
W35001526,475,353,163,190,0,55,28,27,59,49,4,5,1,8
W35001527,242,195,82,113,0,17,11,6,27,26,0,1,0,3
W35001528,402,300,123,177,0,27,19,8,71,66,1,4,0,4
W35001529,341,265,84,181,0,47,39,8,27,21,0,5,1,2
W35001530,425,299,111,188,2,59,33,26,62,56,4,2,0,3
W35001531,340,238,103,135,0,34,24,10,57,53,3,1,0,11
W35001532,492,369,145,224,1,56,31,25,62,53,2,7,0,4
W35001533,389,258,110,148,0,46,33,13,81,72,4,3,2,4
W35001534,346,236,85,151,1,30,23,7,67,61,0,5,1,12
W35001535,287,189,66,123,1,36,26,10,54,50,1,3,0,7
W35001536,304,226,64,162,0,18,14,4,54,51,1,2,0,6
W35001537,301,228,86,142,1,20,13,7,47,42,1,3,1,5
W35001538,370,293,114,179,0,26,20,6,45,42,0,3,0,6
W35001539,562,343,125,218,1,63,45,18,131,112,3,16,0,24
W35001540,786,427,215,212,8,48,35,13,290,277,4,8,1,13
W35001541,268,227,111,116,0,12,8,4,23,16,0,7,0,6
W35001542,526,404,204,200,2,48,29,19,60,45,4,11,0,12
W35001543,533,425,217,208,1,38,34,4,60,54,0,3,3,9
W35001544,362,282,181,101,1,18,6,12,52,41,0,6,5,9
W35001545,269,222,145,77,3,4,3,1,33,25,1,3,4,7
W35001546,343,250,90,160,0,22,12,10,63,50,2,9,2,8
W35001547,249,179,83,96,0,29,21,8,37,34,0,3,0,4
W35001548,281,245,143,102,0,9,6,3,24,18,2,3,1,3
W35001549,313,243,132,111,1,21,16,5,40,33,2,3,2,8
W35001550,452,367,171,196,1,26,17,9,48,46,0,2,0,10
W35001551,291,249,149,100,1,11,10,1,27,21,1,4,1,3
W35001552,378,322,142,180,1,16,14,2,35,32,0,3,0,4
W35001553,308,265,163,102,2,12,10,2,25,16,1,8,0,4
W35001554,320,274,158,116,2,8,7,1,28,28,0,0,0,8
W35001555,478,359,141,218,1,35,18,17,80,74,0,5,1,3
W35001556,346,300,178,122,0,12,7,5,28,22,1,5,0,6
W35001557,656,518,234,284,3,38,26,12,87,71,0,14,2,10
W35001558,473,381,168,213,2,31,22,9,51,42,0,9,0,8
W35001559,237,190,126,64,0,5,5,0,34,25,2,7,0,8
W35001560,378,278,110,168,2,29,20,9,63,56,0,7,0,6
W35001561,295,234,121,113,0,17,16,1,43,36,0,7,0,1
W35001562,262,220,112,108,2,13,13,0,24,19,0,5,0,3
W35001563,353,296,155,141,3,14,9,5,35,28,1,6,0,5
W35001564,316,275,116,159,0,12,8,4,27,22,0,5,0,2
W35001565,307,256,142,114,1,6,4,2,41,34,2,5,0,3
W35001566,284,238,146,92,0,7,7,0,31,18,2,11,0,8
W35001567,313,270,127,143,0,11,2,9,21,18,1,2,0,11
W35001568,436,363,177,186,0,16,9,7,50,46,0,2,2,7
W35001569,499,392,161,231,0,34,22,12,66,57,3,6,0,7
W35001570,331,251,92,159,4,31,11,20,44,39,0,3,2,1
W35001571,300,252,127,125,1,12,10,2,31,22,2,6,1,4
W35001572,642,492,153,339,2,43,28,15,101,78,5,8,10,4
W35001573,280,248,144,104,0,4,3,1,25,19,0,6,0,3
W35001574,390,311,114,197,1,23,15,8,51,50,0,1,0,4
W35001575,582,399,125,274,3,58,41,17,119,103,1,14,1,3
W35001576,319,259,85,174,2,26,23,3,29,26,1,2,0,3
W35001577,272,214,81,133,0,16,11,5,36,30,2,4,0,6
W35001578,297,225,94,131,0,15,11,4,49,42,5,2,0,8
W35001579,588,475,154,321,0,44,29,15,67,55,1,11,0,2
W35001580,321,231,86,145,0,30,20,10,49,42,0,6,1,11
W35001581,524,413,171,242,1,32,23,9,77,70,0,7,0,1
W35001582,307,233,98,135,0,27,14,13,44,40,2,2,0,3
W35001583,386,309,119,190,1,48,40,8,24,21,0,3,0,4
W35001584,286,236,70,166,0,31,22,9,12,8,0,4,0,7
W35001585,261,191,65,126,0,49,47,2,19,15,0,4,0,2
W35001586,374,300,122,178,0,41,30,11,33,31,0,2,0,0
W35001587,665,520,150,370,1,50,40,10,86,71,1,12,2,8
W35001588,374,320,123,197,1,28,25,3,17,14,0,3,0,8
W35001589,380,299,106,193,2,33,23,10,40,35,4,1,0,6
W35001590,988,717,223,494,3,140,103,37,120,105,1,11,3,8
W35001591,352,293,152,141,1,13,8,5,42,34,2,5,1,3
W35001592,301,246,97,149,0,17,16,1,36,28,0,5,3,2
W35001593,547,447,231,216,2,28,23,5,60,48,2,10,0,10
W35001594,291,229,104,125,0,24,17,7,27,23,1,3,0,11
W35001595,279,240,107,133,0,7,5,2,29,19,0,10,0,3
W35001596,336,283,104,179,1,15,12,3,36,29,0,7,0,1
W35001597,356,264,82,182,0,43,29,14,45,41,1,3,0,4
W35001598,352,266,119,147,2,34,21,13,42,39,0,2,1,8
W35001599,270,205,77,128,0,33,26,7,30,25,1,1,3,2
W35001600,351,292,81,211,0,30,20,10,27,21,0,6,0,2
W35001601,354,305,106,199,0,19,15,4,28,22,1,5,0,2
W35001602,531,411,142,269,1,44,34,10,69,61,2,6,0,6
W35001603,252,203,91,112,1,25,22,3,20,16,0,4,0,3
W35001604,821,679,247,432,2,53,35,18,80,69,0,9,2,7
W35001605,382,324,109,215,0,29,23,6,29,26,0,2,1,0
W35001606,271,227,87,140,0,23,20,3,15,13,1,1,0,6
W35001607,1944,1264,380,884,3,156,115,41,503,477,6,18,2,18
W35001608,258,221,71,150,0,19,15,4,18,14,0,4,0,0
W35001609,533,426,203,223,0,52,46,6,46,36,0,7,3,9
W35001610,335,272,116,156,0,18,16,2,37,29,0,4,4,8
W35001611,463,360,137,223,1,34,23,11,62,45,7,8,2,6
W35001612,259,231,89,142,0,10,9,1,17,16,0,1,0,1
W35001613,247,204,82,122,0,18,13,5,25,24,0,1,0,0
W35001614,301,252,97,155,0,15,11,4,30,26,0,4,0,4
W35001615,482,384,126,258,2,32,20,12,59,48,1,7,3,5
W35001616,368,292,123,169,0,30,27,3,41,36,3,1,1,5
W35001617,276,226,100,126,3,21,14,7,21,20,0,1,0,5
W35001618,243,193,62,131,1,20,16,4,26,23,0,2,1,3
W35001619,309,264,107,157,1,17,15,2,26,16,2,5,3,1
W35001620,332,276,99,177,1,23,21,2,29,27,2,0,0,3
W35001621,286,222,74,148,2,22,16,6,34,29,1,4,0,6
W35001622,274,247,91,156,0,10,10,0,10,7,0,1,2,7
W35001623,264,200,54,146,0,26,18,8,37,34,0,3,0,1
W35001624,266,217,71,146,0,21,13,8,26,22,1,2,1,2
W35001625,319,239,97,142,1,40,36,4,34,23,3,2,6,5
W35001626,1842,1522,444,1078,1,129,89,40,167,141,9,10,7,23
W35001627,272,223,94,129,0,15,12,3,30,26,0,2,2,4
W35001628,296,258,87,171,1,15,13,2,22,17,1,4,0,0
W35001629,292,227,97,130,1,31,23,8,32,29,0,3,0,1
W35001630,246,210,78,132,0,18,16,2,14,14,0,0,0,4
W35001631,452,348,120,228,0,30,22,8,69,63,1,4,1,5
W35001632,599,438,136,302,1,54,35,19,97,85,0,8,4,9
W35001633,324,261,81,180,1,24,21,3,35,29,0,6,0,3
W35001634,289,224,76,148,0,29,19,10,35,29,0,3,3,1
W35001635,305,204,66,138,3,42,33,9,53,48,1,3,1,3
W35001636,943,799,290,509,0,72,56,16,65,57,0,7,1,7
W35001637,343,285,101,184,0,26,21,5,31,25,0,5,1,1
W35001638,410,336,112,224,0,31,18,13,40,35,0,5,0,3
W35001639,295,217,83,134,0,24,22,2,51,47,1,2,1,3
W35001640,507,395,144,251,0,63,52,11,46,34,0,12,0,3
W35001641,499,351,121,230,4,45,22,23,92,83,1,5,3,7
W35001642,625,526,172,354,1,45,34,11,44,36,0,8,0,9
W35001643,231,179,69,110,0,27,24,3,21,21,0,0,0,4
W35001644,264,199,54,145,1,43,40,3,14,14,0,0,0,7
W35001645,334,256,69,187,1,45,41,4,31,25,0,6,0,1
W35001646,1163,813,238,575,2,178,150,28,162,145,0,16,1,8
W35001647,469,344,115,229,0,45,32,13,73,67,0,6,0,7
W35001648,260,199,68,131,2,25,14,11,34,26,0,8,0,0
W35001649,290,186,52,134,1,53,37,16,42,35,1,6,0,8
W35001650,376,228,85,143,0,60,38,22,84,75,0,7,2,4
W35001651,233,149,42,107,0,16,9,7,67,58,1,7,1,1
W35001652,649,435,149,286,3,104,81,23,103,95,0,8,0,4
W35001653,298,221,69,152,1,27,19,8,40,37,1,2,0,9
W35001654,286,204,65,139,4,47,37,10,29,25,0,4,0,2
W35001655,361,295,100,195,1,31,23,8,30,30,0,0,0,4
W35001656,527,383,107,276,1,71,46,25,68,64,0,2,2,4
W35001657,286,230,80,150,2,27,16,11,24,18,0,4,2,3
W35001658,659,552,150,402,1,54,40,14,50,40,0,10,0,2
W35001659,411,314,104,210,0,47,36,11,44,36,1,6,1,6
W35001660,289,238,103,135,0,11,10,1,34,23,3,6,2,6
W35001661,706,573,182,391,2,67,45,22,62,56,3,2,1,2
W35001662,4448,3600,848,2752,7,292,192,100,507,459,5,35,8,42
W35001663,334,279,82,197,2,28,21,7,20,15,1,4,0,5
W35001664,300,258,85,173,1,16,9,7,24,24,0,0,0,1
W35001665,741,610,141,469,1,49,29,20,70,68,0,2,0,11
W35001666,347,279,88,191,0,35,21,14,26,20,0,5,1,7
W35001667,430,341,100,241,1,29,18,11,56,47,2,6,1,3
W35001668,438,351,98,253,1,33,20,13,51,48,0,3,0,2
W35001669,263,213,62,151,1,22,11,11,26,22,0,4,0,1
W35001670,265,200,61,139,0,32,23,9,26,22,1,3,0,7
W35001671,335,266,79,187,0,37,25,12,29,25,1,3,0,3
W35001672,294,217,69,148,0,27,20,7,50,44,0,6,0,0
W35001673,302,241,81,160,1,34,19,15,26,21,0,5,0,0
W35001674,399,338,96,242,1,27,16,11,31,29,0,1,1,2
W35001675,704,566,129,437,4,47,30,17,78,69,0,8,1,9
W35001676,310,265,54,211,0,11,11,0,34,30,0,3,1,0
W35001677,413,332,83,249,0,33,22,11,42,33,5,2,2,6
W35001678,472,373,124,249,2,55,42,13,38,32,0,3,3,4
W35001679,310,243,72,171,1,18,13,5,42,30,2,10,0,6
W35001680,281,227,58,169,2,32,27,5,19,19,0,0,0,1
W35001681,572,503,174,329,1,26,19,7,39,34,0,5,0,3
W35001682,330,240,57,183,0,43,27,16,43,37,1,5,0,4
W35001683,466,385,95,290,0,31,24,7,44,41,0,3,0,6
W35001684,272,213,52,161,0,21,11,10,33,31,0,2,0,5
W35001685,837,616,187,429,3,98,73,25,111,99,0,12,0,9
W35001686,520,340,99,241,0,94,42,52,80,74,0,6,0,6
W35001687,325,221,56,165,0,67,54,13,35,32,0,2,1,2
W35001688,301,238,68,170,0,26,18,8,32,30,0,2,0,5
W35001689,254,167,55,112,0,58,35,23,26,26,0,0,0,3
W35001690,264,190,56,134,0,28,18,10,44,36,2,6,0,2
W35001691,356,296,96,200,0,24,17,7,34,30,0,4,0,2
W35001692,305,209,58,151,0,58,43,15,38,36,0,2,0,0
W35001693,614,452,134,318,3,77,51,26,79,73,0,6,0,3
W35001694,487,340,85,255,1,75,59,16,69,58,0,10,1,2
W35001695,240,180,59,121,0,32,24,8,25,22,0,3,0,3
W35001696,299,236,71,165,0,34,19,15,26,24,0,2,0,3
W35001697,402,218,51,167,1,135,90,45,46,39,0,5,2,2
W35001698,687,459,143,316,2,157,120,37,65,59,0,6,0,4
W35001699,381,265,69,196,1,79,68,11,32,28,1,3,0,4
W35001700,405,354,114,240,1,24,20,4,22,18,2,2,0,4
W35001701,467,365,112,253,2,28,16,12,70,63,0,6,1,2
W35001702,367,282,79,203,1,34,18,16,45,43,0,1,1,5
W35001703,338,266,101,165,0,31,25,6,38,33,0,5,0,3
W35001704,321,230,81,149,1,56,39,17,28,23,0,5,0,6
W35001705,762,534,135,399,1,141,107,34,80,70,2,8,0,6
W35001706,576,446,135,311,1,47,36,11,77,64,2,11,0,5
W35001707,448,304,94,210,0,102,82,20,39,34,0,5,0,3
W35001708,267,168,59,109,1,62,47,15,33,24,4,5,0,3
W35001709,260,194,68,126,4,35,25,10,25,22,0,3,0,2
W35001710,370,259,78,181,0,59,54,5,48,39,0,9,0,4
W35001711,326,250,66,184,3,26,8,18,43,39,1,3,0,4
W35001712,461,378,119,259,0,38,22,16,44,31,0,13,0,1
W35001713,955,767,233,534,4,85,60,25,94,80,0,13,1,5
W35001714,339,258,86,172,0,40,24,16,37,30,0,7,0,4
W35001715,268,193,71,122,0,28,14,14,46,37,0,9,0,1
W35001716,325,242,75,167,0,38,17,21,44,39,0,3,2,1
W35001717,317,239,73,166,2,34,20,14,42,38,0,2,2,0
W35001718,624,452,172,280,1,103,68,35,65,63,0,2,0,3
W35001719,265,180,62,118,2,33,23,10,47,41,0,5,1,3
W35001720,386,251,77,174,1,74,42,32,49,39,1,8,1,11
W35001721,489,398,136,262,0,40,24,16,46,36,0,10,0,5
W35001722,498,401,104,297,0,42,28,14,52,40,0,12,0,3
W35001723,266,213,59,154,0,39,24,15,12,11,0,1,0,2
W35001724,217,140,35,105,2,44,25,19,29,25,0,3,1,2
W35001725,603,466,138,328,0,64,40,24,69,60,0,9,0,4
W35001726,319,245,53,192,1,44,38,6,27,26,0,0,1,2
W35001727,299,240,73,167,0,40,26,14,17,14,0,2,1,2
W35001728,382,317,103,214,0,31,24,7,30,29,0,1,0,4
W35001729,604,463,169,294,4,48,37,11,86,72,0,10,4,3
W35001730,604,381,120,261,2,178,152,26,39,35,0,4,0,4
W35001731,319,172,59,113,0,113,111,2,28,24,0,4,0,6
W35001732,240,195,72,123,3,17,14,3,21,17,1,3,0,4
W35001733,513,403,129,274,1,43,7,36,62,54,1,7,0,4
W35001734,160,106,46,60,0,18,12,6,26,22,1,3,0,10
W35001735,290,203,68,135,1,31,17,14,47,38,0,9,0,8
W35001736,561,393,116,277,6,79,49,30,80,70,0,8,2,3
W35001737,893,647,185,462,1,71,43,28,163,143,3,16,1,11
W35001738,1311,854,205,649,8,138,75,63,291,259,0,32,0,20
W35001739,252,218,76,142,0,9,5,4,20,18,1,1,0,5
W35001740,280,171,52,119,1,44,30,14,61,55,2,4,0,3
W35001741,284,199,60,139,2,31,20,11,44,31,4,8,1,8
W35001742,354,263,75,188,1,49,42,7,38,35,3,0,0,3
W35001743,916,696,185,511,3,94,59,35,117,113,1,3,0,6
W35001744,259,205,64,141,1,8,2,6,41,32,0,8,1,4
W35001745,616,504,173,331,2,33,19,14,66,52,1,13,0,11
W35001746,282,222,65,157,0,24,16,8,35,32,1,1,1,1
W35001747,765,491,150,341,5,87,48,39,166,145,1,17,3,16
W35001748,357,213,65,148,1,31,20,11,107,99,0,7,1,5
W35001749,412,312,92,220,0,25,18,7,68,59,0,6,3,7
W35001750,588,358,117,241,3,75,44,31,146,130,2,13,1,6
W35001751,525,377,109,268,1,54,26,28,87,78,2,4,3,6
W35001752,604,437,149,288,2,53,26,27,104,90,1,9,4,8
W35001753,382,220,74,146,0,44,26,18,115,108,0,6,1,3
W35001754,431,301,76,225,1,65,50,15,60,56,1,3,0,4
W35001755,478,366,108,258,1,33,21,12,77,69,0,8,0,1
W35001756,362,297,80,217,1,25,12,13,35,30,1,4,0,4
W35001757,594,424,135,289,1,51,27,24,110,97,0,11,2,8
W35001758,450,284,91,193,4,63,37,26,98,89,1,8,0,1
W35001759,504,316,120,196,5,50,23,27,131,115,1,12,3,2
W35001760,232,159,61,98,0,27,16,11,43,35,1,5,2,3
W35001761,263,210,65,145,0,14,10,4,37,35,0,2,0,2
W35001762,285,178,85,93,1,26,16,10,79,73,0,4,2,1
W35001763,533,371,106,265,1,53,30,23,102,86,0,16,0,6
W35001764,527,393,118,275,3,32,19,13,92,86,1,5,0,7
W35001765,422,310,99,211,0,38,28,10,71,63,2,6,0,3
W35001766,352,257,67,190,0,37,29,8,50,44,1,5,0,8
W35001767,279,237,78,159,0,15,9,6,26,24,0,2,0,1
W35001768,466,370,139,231,1,31,25,6,58,53,1,2,2,6
W35001769,306,249,105,144,0,11,8,3,42,33,0,7,2,4
W35001770,378,293,104,189,1,33,26,7,37,36,0,1,0,14
W35001771,280,200,66,134,1,33,28,5,43,38,0,5,0,3
W35001772,405,338,97,241,2,22,20,2,39,33,0,6,0,4
W35001773,315,244,69,175,0,33,25,8,35,31,1,3,0,3
W35001774,406,315,155,160,1,33,24,9,47,42,0,5,0,10
W35001775,313,268,123,145,0,12,8,4,24,18,0,6,0,9
W35001776,312,250,102,148,0,12,4,8,42,35,2,3,2,8
W35001777,205,166,80,86,0,16,15,1,17,16,0,1,0,6
W35001778,230,189,73,116,0,6,1,5,29,25,3,1,0,6
W35001779,278,192,61,131,0,29,19,10,50,45,0,4,1,7
W35001780,292,244,96,148,1,10,6,4,36,31,1,3,1,1
W35001781,243,169,64,105,0,14,11,3,54,50,0,4,0,6
W35001782,251,190,64,126,0,17,13,4,37,30,2,3,2,7
W35001783,229,175,55,120,0,11,10,1,43,33,0,10,0,0
W35001784,419,335,98,237,1,16,10,6,64,52,1,10,1,3
W35001785,352,283,105,178,0,45,27,18,23,18,0,5,0,1
W35001786,324,260,115,145,0,37,24,13,25,21,0,4,0,2
W35001787,388,305,105,200,0,58,42,16,22,21,0,1,0,3
W35001788,268,225,89,136,0,28,24,4,15,14,0,1,0,0
W35001789,276,227,107,120,0,22,18,4,24,23,0,0,1,3
W35001790,291,222,72,150,0,30,25,5,36,29,0,4,3,3
W35001791,449,385,151,234,1,31,24,7,29,27,0,0,2,3
W35001792,306,263,95,168,0,18,12,6,22,20,0,2,0,3
W35001793,302,248,76,172,0,29,21,8,22,20,0,2,0,3
W35001794,445,332,95,237,0,76,59,17,36,31,0,5,0,1
W35001795,329,237,92,145,0,44,26,18,45,40,0,5,0,3
W35001796,549,403,146,257,0,67,49,18,68,65,0,3,0,11
W35001797,281,216,98,118,0,32,23,9,29,23,0,6,0,4
W35001798,253,207,78,129,0,18,13,5,24,23,0,1,0,4
W35001799,244,204,83,121,0,18,13,5,18,15,0,3,0,4
W35001800,516,420,148,272,1,59,33,26,29,24,0,3,2,7
W35001801,407,323,99,224,0,46,33,13,36,32,0,4,0,2
W35001802,282,244,80,164,0,10,5,5,25,21,0,4,0,3
W35001803,247,182,71,111,0,31,20,11,31,24,1,6,0,3
W35001804,328,269,91,178,0,15,11,4,43,36,2,5,0,1
W35001805,366,300,97,203,0,33,26,7,32,28,2,1,1,1
W35001806,282,241,84,157,0,21,11,10,19,12,2,4,1,1
W35001807,287,220,72,148,2,34,25,9,28,24,0,4,0,3
W35001808,245,189,59,130,1,31,16,15,24,22,0,2,0,0
W35001809,277,217,69,148,0,34,13,21,24,20,0,4,0,2
W35001810,283,197,54,143,2,41,25,16,38,35,0,3,0,5
W35001811,251,175,67,108,1,42,22,20,30,25,3,2,0,3
W35001812,477,396,101,295,0,37,25,12,41,31,1,6,3,3
W35001813,309,254,76,178,0,30,26,4,24,18,0,5,1,1
W35001814,321,232,69,163,0,49,35,14,37,34,0,2,1,3
W35001815,357,278,87,191,1,44,37,7,33,28,2,3,0,1
W35001816,314,264,100,164,0,16,13,3,30,27,0,2,1,4
W35001817,279,190,55,135,1,58,49,9,29,28,0,0,1,1
W35001818,253,188,57,131,0,33,23,10,30,21,1,7,1,2
W35001819,395,310,94,216,1,26,17,9,55,49,0,6,0,3
W35001820,399,277,69,208,1,57,43,14,62,50,2,7,3,2
W35001821,336,262,84,178,0,38,26,12,35,26,1,7,1,1
W35001822,572,472,208,264,0,55,39,16,40,34,2,2,2,5
W35001823,264,210,86,124,0,41,30,11,11,10,1,0,0,2
W35001824,511,397,113,284,1,70,54,16,40,33,0,5,2,3
W35001825,321,270,82,188,0,17,10,7,31,29,1,1,0,3
W35001826,211,157,47,110,0,21,15,6,29,27,0,2,0,4
W35001827,380,278,86,192,2,42,18,24,52,39,2,9,2,6
W35001828,415,313,82,231,0,56,35,21,43,39,0,4,0,3
W35001829,1286,1002,349,653,3,135,98,37,135,119,0,14,2,11
W35001830,624,546,140,406,1,35,23,12,38,31,0,6,1,4
W35001831,473,365,109,256,3,70,47,23,33,30,1,2,0,2
W35001832,264,218,85,133,0,29,22,7,17,16,0,1,0,0
W35001833,340,269,112,157,0,48,39,9,23,21,0,1,1,0
W35001834,437,366,120,246,0,29,21,8,36,34,0,2,0,6
W35001835,311,201,43,158,0,69,52,17,36,35,0,1,0,5
W35001836,605,437,131,306,4,102,75,27,51,45,1,4,1,11
W35001837,270,222,64,158,1,28,21,7,17,16,0,1,0,2
W35001838,317,210,57,153,0,70,55,15,36,34,0,2,0,1
W35001839,283,216,70,146,0,36,27,9,29,25,0,4,0,2
W35001840,385,278,76,202,0,52,36,16,53,47,2,4,0,2
W35001841,310,234,73,161,1,43,36,7,28,24,1,3,0,4
W35001842,301,193,60,133,1,54,38,16,49,44,0,5,0,4
W35001843,367,289,91,198,0,37,23,14,36,28,1,7,0,5
W35001844,476,398,146,252,1,33,19,14,37,32,0,3,2,7
W35001845,261,222,64,158,0,14,8,6,24,18,2,4,0,1
W35001846,268,195,54,141,1,27,15,12,42,37,0,5,0,3
W35001847,265,211,66,145,0,17,11,6,36,30,0,6,0,1
W35001848,608,503,161,342,1,52,40,12,50,44,0,5,1,2
W35001849,339,267,79,188,1,27,16,11,40,36,1,2,1,4
W35001850,509,404,123,281,1,58,29,29,42,35,2,5,0,4
W35001851,267,214,69,145,0,19,7,12,32,29,0,3,0,2
W35001852,394,330,110,220,0,14,6,8,49,40,2,6,1,1
W35001853,324,240,85,155,0,32,21,11,49,45,0,4,0,3
W35001854,249,206,70,136,0,20,12,8,21,18,1,2,0,2
W35001855,247,223,66,157,0,14,4,10,10,8,0,2,0,0
W35001856,541,457,129,328,2,30,10,20,48,43,0,5,0,4
W35001857,548,459,148,311,0,32,15,17,53,46,1,4,2,4
W35001858,563,471,145,326,1,43,14,29,47,37,0,6,4,1
W35001859,534,459,135,324,0,23,8,15,50,42,3,5,0,2
W35001860,448,354,119,235,2,51,8,43,38,35,0,3,0,3
W35001861,355,286,93,193,0,18,4,14,51,46,0,5,0,0
W35001862,432,340,102,238,0,27,8,19,60,50,0,9,1,5
W35001863,369,292,98,194,2,44,11,33,30,25,0,5,0,1
W35001864,463,382,112,270,1,32,17,15,44,38,0,6,0,4
W35001865,272,221,70,151,1,12,3,9,38,35,0,3,0,0
W35001866,402,336,94,242,0,29,13,16,33,27,0,4,2,4
W35001867,245,190,54,136,0,31,17,14,22,19,0,2,1,2
W35001868,367,309,85,224,0,14,6,8,43,32,2,9,0,1
W35001869,260,208,62,146,2,23,8,15,21,17,0,4,0,6
W35001870,595,490,123,367,4,41,16,25,55,51,1,3,0,5
W35001871,339,269,61,208,2,21,9,12,43,37,0,5,1,4
W35001872,288,228,67,161,0,23,5,18,36,34,1,1,0,1
W35001873,260,213,60,153,0,17,6,11,30,25,0,3,2,0
W35001874,247,204,57,147,3,14,2,12,21,14,1,5,1,5
W35001875,293,232,64,168,0,39,9,30,21,17,0,4,0,1
W35001876,541,436,121,315,2,34,12,22,64,55,0,4,5,5
W35001877,1181,871,202,669,2,108,30,78,186,163,1,21,1,14
W35001878,274,188,58,130,2,47,24,23,37,29,0,5,3,0
W35001879,301,245,55,190,0,22,5,17,34,32,0,2,0,0
W35001880,893,713,202,511,1,88,40,48,85,72,0,12,1,6
W35001881,337,260,76,184,0,48,13,35,29,24,0,5,0,0
W35001882,375,332,86,246,0,9,2,7,33,23,0,10,0,1
W35001883,423,362,106,256,1,23,7,16,35,31,0,4,0,2
W35001884,618,483,115,368,3,34,12,22,94,82,4,7,1,4
W35001885,761,669,169,500,1,35,14,21,52,36,1,14,1,4
W35001886,311,211,62,149,0,52,24,28,46,39,0,2,5,2
W35001887,365,279,94,185,1,51,21,30,32,28,0,4,0,2
W35001888,406,322,85,237,1,42,21,21,40,39,0,1,0,1
W35001889,2847,2344,571,1773,6,161,49,112,323,275,12,22,14,13
W35001890,763,651,129,522,0,36,12,24,70,59,1,9,1,6
W35001891,470,351,107,244,0,53,19,34,64,52,2,10,0,2
W35001892,305,254,75,179,1,19,5,14,27,18,5,3,1,4
W35001893,742,587,153,434,1,75,20,55,73,63,2,6,2,6
W35001894,1042,848,232,616,0,49,21,28,141,114,2,22,3,4
W35001895,373,293,93,200,2,20,12,8,50,40,4,5,1,8
W35001896,1047,897,229,668,2,41,15,26,98,83,2,12,1,9
W35001897,393,296,96,200,1,44,9,35,49,43,1,5,0,3
W35001898,411,322,93,229,2,36,6,30,48,45,0,2,1,3
W35001899,788,637,186,451,2,57,13,44,86,77,0,9,0,6
W35001900,314,231,73,158,1,48,19,29,33,27,0,5,1,1
W35001901,772,545,136,409,1,62,18,44,155,141,1,12,1,9
W35001902,306,248,48,200,0,11,0,11,47,38,4,5,0,0
W35001903,266,231,49,182,0,10,2,8,23,21,0,2,0,2
W35001904,251,196,66,130,0,20,9,11,29,25,0,1,3,6
W35001905,309,230,72,158,0,46,2,44,30,25,0,5,0,3
W35001906,437,331,79,252,1,30,1,29,67,52,1,8,6,8
W35001907,322,272,77,195,1,12,3,9,31,21,0,10,0,6
W35001908,318,257,34,223,3,13,1,12,42,34,0,8,0,3
W35001909,318,250,79,171,1,34,14,20,28,22,0,3,3,5
W35001910,232,206,68,138,1,6,2,4,15,14,0,1,0,4
W35001911,338,262,51,211,2,24,2,22,47,41,2,4,0,3
W35001912,339,269,101,168,1,26,8,18,36,31,0,5,0,7
W35001913,317,255,75,180,0,20,9,11,41,35,1,5,0,1
W35001914,342,243,69,174,0,25,7,18,69,59,0,9,1,5
W35001915,334,240,77,163,1,22,4,18,69,62,0,7,0,2
W35001916,364,285,82,203,0,17,7,10,55,50,0,4,1,7
W35001917,303,252,82,170,3,10,5,5,37,33,1,3,0,1
W35001918,318,232,72,160,3,20,9,11,56,48,1,6,1,7
W35001919,457,381,134,247,4,18,5,13,52,45,1,5,1,2
W35001920,676,511,164,347,2,47,16,31,111,95,3,8,5,5
W35001921,454,387,114,273,1,8,1,7,51,42,1,5,3,7
W35001922,338,289,122,167,1,15,6,9,27,23,1,3,0,6
W35001923,309,249,89,160,0,18,7,11,34,29,0,1,4,8
W35001924,513,425,145,280,1,18,11,7,65,56,3,3,3,4
W35001925,275,230,84,146,1,4,3,1,29,23,1,5,0,11
W35001926,397,324,119,205,1,19,16,3,51,46,2,3,0,2
W35001927,327,270,107,163,0,14,13,1,35,29,3,3,0,8
W35001928,406,335,127,208,0,11,6,5,56,46,0,9,1,4
W35001929,305,248,94,154,2,15,14,1,34,26,2,2,4,6
W35001930,239,193,72,121,1,8,4,4,33,20,4,2,7,4
W35001931,320,234,83,151,0,29,17,12,49,42,1,6,0,8
W35001932,253,185,51,134,0,14,8,6,49,41,0,4,4,5
W35001933,390,323,115,208,2,16,10,6,40,35,1,4,0,9
W35001934,668,537,135,402,3,52,25,27,73,60,1,10,2,3
W35001935,657,536,123,413,2,38,21,17,77,63,2,12,0,4
W35001936,264,218,79,139,0,19,10,9,23,16,0,7,0,4
W35001937,277,199,66,133,0,28,11,17,50,44,0,6,0,0
W35001938,300,221,59,162,0,18,8,10,58,44,0,13,1,3
W35001939,552,403,93,310,1,41,18,23,101,82,2,15,2,6
W35001940,240,172,48,124,1,17,11,6,49,44,0,5,0,1
W35001941,370,272,89,183,3,30,15,15,61,53,0,7,1,4
W35001942,538,341,108,233,1,53,28,25,138,128,4,6,0,5
W35001943,471,379,109,270,1,31,18,13,59,50,2,7,0,1
W35001944,322,220,66,154,1,15,9,6,84,82,0,1,1,2
W35001945,474,349,96,253,3,33,12,21,88,85,0,2,1,1
W35001946,250,188,54,134,0,14,9,5,46,42,0,4,0,2
W35001947,328,242,69,173,0,17,10,7,65,62,1,1,1,4
W35001948,357,289,81,208,0,5,3,2,58,51,0,7,0,5
W35001949,494,414,141,273,0,26,19,7,49,46,0,3,0,5
W35001950,305,263,82,181,0,18,4,14,20,18,0,1,1,4
W35001951,280,242,89,153,0,11,7,4,24,20,1,3,0,3
W35001952,287,210,73,137,1,47,15,32,28,17,0,3,8,1
W35001953,383,315,93,222,1,23,11,12,36,34,0,2,0,8
W35001954,349,250,44,206,0,65,45,20,32,24,2,5,1,2
W35001955,348,259,74,185,2,50,39,11,36,32,0,4,0,1
W35001956,292,206,54,152,0,55,43,12,29,25,0,4,0,2
W35001957,527,391,114,277,1,66,41,25,67,52,6,7,2,2
W35001958,449,394,130,264,0,15,6,9,39,35,0,3,1,1
W35001959,258,228,66,162,0,9,7,2,20,14,2,4,0,1
W35001960,255,178,48,130,2,14,2,12,59,55,0,4,0,2
W35001961,398,303,95,208,1,24,9,15,60,54,0,6,0,10
W35001962,331,251,55,196,0,42,20,22,33,31,0,2,0,5
W35001963,361,289,58,231,1,31,12,19,40,33,2,5,0,0
W35001964,269,180,41,139,0,32,13,19,53,48,0,5,0,4
W35001965,492,356,72,284,4,51,24,27,81,69,0,10,2,0
W35001966,412,336,114,222,0,25,14,11,49,40,0,9,0,2
W35001967,255,205,46,159,0,12,7,5,36,30,1,5,0,2
W35001968,717,623,165,458,3,31,17,14,57,49,2,5,1,3
W35001969,334,263,89,174,0,10,8,2,57,51,3,1,2,4
W35001970,329,283,82,201,1,12,10,2,31,20,5,3,3,2
W35001971,796,613,220,393,0,61,51,10,121,99,4,10,8,1
W35001972,348,300,90,210,1,21,18,3,24,20,3,1,0,2
W35001973,253,127,41,86,0,21,20,1,95,43,47,4,1,10
W35001974,410,260,60,200,1,56,27,29,90,82,1,7,0,3
W35001975,555,394,99,295,0,44,22,22,114,96,4,9,5,3
W35001976,522,370,72,298,0,46,29,17,102,93,2,6,1,4
W35001977,277,198,51,147,1,20,12,8,54,50,0,4,0,4
W35001978,332,268,58,210,2,16,9,7,44,35,0,7,2,2
W35001979,248,202,53,149,0,13,5,8,32,31,0,1,0,1
W35001980,473,386,97,289,1,35,20,15,50,46,0,4,0,1
W35001981,340,213,53,160,0,61,40,21,63,51,0,11,1,3
W35001982,440,323,80,243,0,38,18,20,71,60,4,6,1,8
W35001983,409,291,77,214,2,48,35,13,58,52,2,4,0,10
W35001984,525,395,99,296,1,18,10,8,105,92,6,7,0,6
W35001985,324,256,73,183,1,17,12,5,48,43,0,5,0,2
W35001986,1509,1118,269,849,2,56,25,31,324,140,115,5,64,9
W35001987,278,174,47,127,1,16,8,8,84,47,18,4,15,3
W35001988,390,335,98,237,0,12,5,7,39,35,0,3,1,4
W35001989,345,277,69,208,1,22,17,5,44,33,1,8,2,1
W35001990,290,214,63,151,0,12,5,7,62,48,10,3,1,2
W35001991,1705,1377,282,1095,4,104,67,37,218,198,3,16,1,2
W35001992,468,374,122,252,5,36,25,11,49,42,1,2,4,4
W35001993,505,360,95,265,1,35,15,20,107,98,0,9,0,2
W35001994,282,205,36,169,6,14,7,7,57,49,1,7,0,0
W35001995,396,325,72,253,1,24,14,10,46,44,0,2,0,0
W35001996,286,221,62,159,0,16,10,6,46,42,0,4,0,3
W35001997,357,277,78,199,0,37,23,14,43,37,0,6,0,0
W35001998,761,604,181,423,1,71,50,21,81,72,1,6,2,4
W35001999,348,264,84,180,0,39,18,21,45,42,0,3,0,0
W35002000,250,209,77,132,0,12,8,4,27,21,0,5,1,2
W35002001,245,182,62,120,0,42,27,15,20,20,0,0,0,1
W35002002,442,360,146,214,2,34,14,20,41,35,0,6,0,5
W35002003,348,246,60,186,0,61,42,19,35,32,0,3,0,6
W35002004,478,379,135,244,0,43,29,14,52,49,1,2,0,4
W35002005,605,457,150,307,1,59,35,24,86,76,0,10,0,2
W35002006,309,235,69,166,0,21,11,10,51,48,0,2,1,2
W35002007,333,250,81,169,0,34,23,11,46,44,0,1,1,3
W35002008,407,331,114,217,0,16,7,9,58,53,0,4,1,2
W35002009,284,206,74,132,0,41,26,15,36,29,1,6,0,1
W35002010,364,313,104,209,0,19,7,12,31,30,1,0,0,1
W35002011,383,347,100,247,0,11,7,4,18,14,0,4,0,7
W35002012,254,207,77,130,1,14,4,10,29,28,0,1,0,3
W35002013,431,321,107,214,1,31,16,15,76,69,0,7,0,2
W35002014,345,288,93,195,0,21,10,11,32,30,0,2,0,4
W35002015,587,443,129,314,1,56,24,32,85,76,0,7,2,2
W35002016,292,236,82,154,0,26,16,10,29,27,0,2,0,1
W35002017,305,247,75,172,0,24,14,10,30,30,0,0,0,4
W35002018,664,564,195,369,0,42,21,21,55,53,0,2,0,3
W35002019,308,249,77,172,0,21,4,17,36,32,0,4,0,2
W35002020,521,420,167,253,0,39,15,24,57,50,0,7,0,5
W35002021,497,393,122,271,0,32,16,16,63,54,0,8,1,9
W35002022,868,683,213,470,1,72,20,52,110,101,0,9,0,2
W35002023,501,397,157,240,3,37,14,23,59,55,0,4,0,5
W35002024,327,273,94,179,1,18,11,7,28,27,0,1,0,7
W35002025,304,218,68,150,1,35,20,15,45,42,0,1,2,5
W35002026,559,453,173,280,0,30,10,20,72,67,0,3,2,4
W35002027,344,297,119,178,2,14,8,6,30,27,0,3,0,1
W35002028,321,251,95,156,0,35,9,26,31,26,0,5,0,4
W35002029,394,299,95,204,7,26,11,15,56,56,0,0,0,6
W35002030,287,225,96,129,0,25,8,17,36,31,0,3,2,1
W35002031,311,269,119,150,0,12,5,7,29,26,0,3,0,1
W35002032,319,261,99,162,2,12,6,6,40,36,0,4,0,4
W35002033,326,256,83,173,0,36,26,10,34,32,0,2,0,0
W35002034,550,437,153,284,1,33,16,17,71,63,0,7,1,8
W35002035,263,227,78,149,1,9,4,5,25,20,0,5,0,1
W35002036,311,266,102,164,0,10,3,7,34,32,0,1,1,1
W35002037,282,229,92,137,0,16,12,4,34,31,0,3,0,3
W35002038,575,455,151,304,1,48,27,21,71,63,0,8,0,0
W35002039,426,367,114,253,0,17,6,11,38,34,0,4,0,4
W35002040,533,427,132,295,1,20,9,11,75,69,2,4,0,10
W35002041,460,390,114,276,1,17,8,9,51,50,0,1,0,1
W35002042,667,549,184,365,0,43,22,21,73,64,0,7,2,2
W35002043,366,307,97,210,0,22,13,9,35,30,2,3,0,2
W35002044,309,254,88,166,0,13,8,5,42,35,0,7,0,0
W35002045,346,261,89,172,0,30,16,14,53,47,0,4,2,2
W35002046,438,354,140,214,0,21,5,16,60,56,0,3,1,3
W35002047,370,301,84,217,1,24,15,9,42,40,0,2,0,2
W35002048,571,467,177,290,0,30,17,13,71,61,0,10,0,3
W35002049,845,662,202,460,0,61,30,31,112,98,0,12,2,10
W35002050,372,312,86,226,1,18,16,2,39,36,1,2,0,2
W35002051,551,457,161,296,0,29,20,9,57,50,0,6,1,8
W35002052,412,339,105,234,0,40,23,17,29,28,0,1,0,4
W35002053,499,396,93,303,0,48,29,19,50,41,1,8,0,5
W35002054,421,355,103,252,0,17,7,10,45,36,0,9,0,4
W35002055,956,845,260,585,1,33,15,18,73,66,0,7,0,4
W35002056,334,284,79,205,0,20,8,12,29,26,0,3,0,1
W35002057,563,462,154,308,1,24,16,8,73,61,0,12,0,3
W35002058,323,288,102,186,0,7,1,6,28,25,0,2,1,0
W35002059,303,240,83,157,0,20,10,10,41,35,0,6,0,2
W35002060,282,247,79,168,0,9,5,4,24,22,0,2,0,2
W35002061,342,277,106,171,0,15,6,9,47,43,0,4,0,3
W35002062,336,273,102,171,0,21,16,5,38,34,0,4,0,4
W35002063,297,226,75,151,1,21,12,9,46,43,0,3,0,3
W35002064,339,281,89,192,0,18,7,11,39,30,0,9,0,1
W35002065,411,333,107,226,3,22,9,13,50,39,2,9,0,3
W35002066,300,261,82,179,2,15,11,4,20,16,0,4,0,2
W35002067,355,287,87,200,3,12,4,8,50,45,1,4,0,3
W35002068,334,274,98,176,1,22,9,13,34,32,0,2,0,3
W35002069,350,296,103,193,0,11,5,6,41,35,0,4,2,2
W35002070,797,685,227,458,0,36,25,11,72,68,0,4,0,4
W35002071,354,294,74,220,2,34,27,7,20,15,0,5,0,4
W35002072,711,554,206,348,1,69,36,33,85,80,0,5,0,2
W35002073,262,217,67,150,2,12,8,4,30,28,0,2,0,1
W35002074,546,431,143,288,0,33,18,15,76,68,2,5,1,6
W35002075,351,291,92,199,0,10,5,5,43,39,0,4,0,7
W35002076,410,336,107,229,3,23,10,13,43,39,0,2,2,5
W35002077,377,315,102,213,1,34,21,13,24,23,1,0,0,3
W35002078,370,274,82,192,0,32,18,14,58,50,0,6,2,6
W35002079,324,213,66,147,0,71,21,50,36,34,0,2,0,4
W35002080,273,212,66,146,0,16,10,6,42,41,0,1,0,3
W35002081,2143,1734,506,1228,5,54,30,24,332,302,5,24,1,18
W35002082,373,209,66,143,1,21,12,9,137,133,0,3,1,5
W35002083,268,199,51,148,0,19,10,9,49,43,0,6,0,1
W35002084,266,209,65,144,0,19,13,6,37,36,0,0,1,1
W35002085,266,218,69,149,0,25,16,9,23,21,0,2,0,0
W35002086,483,403,117,286,0,30,18,12,47,39,0,7,1,3
W35002087,301,252,72,180,0,15,4,11,31,29,0,1,1,3
W35002088,413,320,92,228,2,53,42,11,35,29,0,6,0,3
W35002089,319,260,90,170,0,19,9,10,40,34,0,6,0,0
W35002090,369,269,86,183,1,60,36,24,36,31,0,4,1,3
W35002091,332,272,86,186,1,17,11,6,39,35,0,4,0,3
W35002092,246,206,65,141,1,17,11,6,19,16,0,3,0,3
W35002093,290,248,71,177,0,17,12,5,23,21,0,2,0,2
W35002094,278,224,72,152,0,23,12,11,28,23,0,5,0,3
W35002095,736,604,169,435,0,44,34,10,81,72,0,9,0,7
W35002096,476,380,110,270,0,32,17,15,62,60,0,2,0,2
W35002097,394,329,108,221,2,21,7,14,38,35,1,1,1,4
W35002098,386,305,77,228,0,20,10,10,58,49,0,4,5,3
W35002099,1147,915,246,669,2,85,40,45,141,126,0,13,2,4
W35002100,777,624,181,443,0,82,37,45,69,63,0,6,0,2
W35002101,413,338,90,248,1,30,19,11,41,34,1,6,0,3
W35002102,368,318,82,236,0,9,3,6,39,28,5,3,3,2
W35002103,473,428,123,305,0,16,8,8,29,27,0,1,1,0
W35002104,300,252,73,179,0,12,7,5,33,27,0,2,4,3
W35002105,464,402,93,309,1,21,11,10,37,31,0,6,0,3
W35002106,344,287,90,197,0,27,14,13,28,26,0,2,0,2
W35002107,318,228,47,181,0,15,7,8,71,65,5,1,0,4
W35002108,373,339,83,256,0,6,1,5,28,24,0,4,0,0
W35002109,348,275,93,182,1,31,15,16,37,32,0,5,0,4
W35002110,347,256,76,180,4,27,15,12,58,51,1,6,0,2
W35002111,1005,814,209,605,6,67,38,29,112,99,1,11,1,6
W35002112,576,507,129,378,2,31,13,18,34,27,1,6,0,2
W35002113,758,624,180,444,1,58,32,26,73,53,1,17,2,2
W35002114,507,411,127,284,0,35,18,17,59,55,0,4,0,2
W35002115,530,412,121,291,1,48,29,19,69,65,1,3,0,0
W35002116,295,258,77,181,1,9,4,5,24,20,0,2,2,3
W35002117,407,331,100,231,1,16,8,8,57,47,2,8,0,2
W35002118,287,239,71,168,3,22,11,11,21,16,0,1,4,2
W35002119,799,653,196,457,1,57,35,22,81,70,0,11,0,7
W35002120,675,579,137,442,2,29,15,14,62,52,0,8,2,3
W35002121,251,212,67,145,0,16,9,7,23,18,3,2,0,0
W35002122,270,232,43,189,0,11,3,8,26,25,0,1,0,1
W35002123,279,215,45,170,0,36,23,13,27,22,1,3,1,1
W35002124,633,531,155,376,2,39,18,21,56,42,2,11,1,5
W35002125,271,207,62,145,1,24,9,15,33,31,1,1,0,6
W35002126,372,289,84,205,0,33,11,22,46,38,2,6,0,4
W35002127,2507,1562,529,1033,10,420,243,177,501,484,0,15,2,14
W35002128,295,218,66,152,0,38,12,26,37,36,0,1,0,2
W35002129,235,196,76,120,0,14,7,7,24,21,0,3,0,1
W35002130,296,210,67,143,3,32,16,16,47,44,0,3,0,4
W35002131,380,297,91,206,0,28,8,20,49,39,3,4,3,6
W35002132,392,305,120,185,0,42,19,23,40,35,1,3,1,5
W35002133,495,410,137,273,0,40,17,23,44,38,1,4,1,1
W35002134,258,176,58,118,0,45,21,24,35,30,0,3,2,2
W35002135,1595,1171,274,897,9,169,95,74,230,199,1,27,3,16
W35002136,280,211,71,140,0,29,10,19,39,36,0,2,1,1
W35002137,368,289,90,199,1,43,23,20,29,26,0,3,0,6
W35002138,351,275,79,196,0,34,20,14,38,35,0,3,0,4
W35002139,532,410,136,274,0,66,22,44,51,43,2,4,2,5
W35002140,390,306,99,207,1,37,22,15,42,29,4,9,0,4
W35002141,299,238,85,153,0,30,9,21,30,28,0,2,0,1
W35002142,284,222,63,159,0,15,8,7,47,43,0,4,0,0
W35002143,357,274,81,193,1,44,26,18,35,28,3,4,0,3
W35002144,326,276,104,172,0,9,5,4,36,31,0,5,0,5
W35002145,614,446,128,318,2,94,41,53,66,60,0,4,2,6
W35002146,452,356,133,223,0,49,19,30,44,42,0,2,0,3
W35002147,300,262,87,175,0,7,2,5,29,28,0,1,0,2
W35002148,590,466,143,323,1,60,25,35,61,59,0,2,0,2
W35002149,283,221,82,139,1,27,3,24,33,25,5,3,0,1
W35002150,308,250,80,170,0,31,26,5,26,23,0,3,0,1
W35002151,639,513,146,367,0,68,53,15,56,45,1,8,2,2
W35002152,730,556,171,385,0,102,70,32,67,58,4,4,1,5
W35002153,651,499,167,332,0,77,54,23,65,60,0,4,1,10
W35002154,294,220,68,152,0,38,23,15,32,26,0,5,1,4
W35002155,409,335,123,212,0,42,34,8,31,26,2,1,2,1
W35002156,390,307,119,188,2,37,24,13,42,37,0,3,2,2
W35002157,425,309,76,233,1,64,55,9,48,38,0,7,3,3
W35002158,342,280,62,218,1,21,16,5,39,30,0,9,0,1
W35002159,370,278,81,197,0,46,28,18,44,37,0,7,0,2
W35002160,521,397,123,274,0,53,39,14,68,63,0,5,0,3
W35002161,292,238,78,160,1,25,24,1,27,27,0,0,0,1
W35002162,419,286,85,201,0,67,59,8,65,61,0,4,0,1
W35002163,298,241,83,158,1,25,15,10,30,25,0,5,0,1
W35002164,300,250,75,175,1,15,10,5,32,27,0,5,0,2
W35002165,368,287,87,200,0,50,31,19,30,29,0,1,0,1
W35002166,346,283,85,198,1,23,12,11,39,33,0,6,0,0
W35002167,366,300,72,228,2,33,15,18,29,25,0,4,0,2
W35002168,1449,1190,311,879,3,87,48,39,165,154,1,9,1,4
W35002169,312,254,86,168,0,33,18,15,25,20,0,5,0,0
W35002170,416,348,108,240,0,32,13,19,33,28,0,4,1,3
W35002171,331,267,64,203,3,23,15,8,38,35,0,1,2,0
W35002172,295,236,71,165,0,32,22,10,26,22,0,4,0,1
W35002173,228,170,46,124,0,23,17,6,35,30,1,4,0,0
W35002174,325,248,67,181,1,30,17,13,42,34,4,4,0,4
W35002175,309,248,56,192,0,20,10,10,37,33,2,2,0,4
W35002176,326,250,68,182,1,38,33,5,37,34,0,2,1,0
W35002177,415,356,109,247,1,22,14,8,34,29,0,5,0,2
W35002178,853,703,192,511,1,56,35,21,92,80,0,11,1,1
W35002179,278,205,59,146,2,31,30,1,31,26,0,2,3,9
W35002180,463,379,113,266,1,34,23,11,48,43,0,5,0,1
W35002181,294,225,37,188,0,33,20,13,36,29,0,7,0,0
W35002182,371,310,91,219,2,20,11,9,36,30,0,6,0,3
W35002183,302,251,45,206,1,32,22,10,16,14,0,2,0,2
W35002184,343,265,86,179,2,45,29,16,27,25,0,2,0,4
W35002185,359,281,81,200,1,36,27,9,41,33,0,7,1,0
W35002186,422,318,81,237,2,71,53,18,30,26,0,4,0,1
W35002187,538,439,160,279,2,46,36,10,50,40,0,10,0,1
W35002188,292,251,75,176,0,17,13,4,23,19,0,4,0,1
W35002189,488,415,104,311,3,28,24,4,41,38,0,3,0,1
W35002190,345,245,58,187,1,46,26,20,52,42,0,8,2,1
W35002191,1790,1474,376,1098,4,119,77,42,181,167,0,13,1,12
W35002192,390,281,83,198,1,60,29,31,48,42,0,2,4,0
W35002193,747,658,160,498,2,28,14,14,54,44,1,7,2,5
W35002194,562,458,125,333,0,33,22,11,64,52,0,9,3,7
W35002195,285,232,70,162,0,34,26,8,19,16,0,3,0,0
W35002196,232,182,79,103,0,18,6,12,29,21,1,3,4,3
W35002197,506,398,124,274,2,38,25,13,63,58,3,2,0,5
W35002198,301,244,72,172,0,20,14,6,32,31,0,0,1,5
W35002199,367,273,76,197,0,45,35,10,45,40,0,5,0,4
W35002200,541,461,147,314,2,28,13,15,45,40,0,5,0,5
W35002201,249,189,52,137,0,21,9,12,36,35,0,1,0,3
W35002202,950,783,235,548,2,79,44,35,82,74,0,7,1,4
W35002203,310,257,92,165,0,21,19,2,27,25,0,1,1,5
W35002204,253,201,72,129,0,30,16,14,20,16,0,1,3,2
W35002205,371,282,94,188,0,26,11,15,60,55,0,5,0,3
W35002206,327,255,75,180,0,29,19,10,40,36,0,4,0,3
W35002207,335,265,74,191,1,34,25,9,35,28,0,7,0,0
W35002208,343,268,82,186,2,34,27,7,35,30,0,4,1,4
W35002209,280,213,60,153,0,37,28,9,28,24,1,3,0,2
W35002210,275,223,55,168,0,27,18,9,21,20,0,1,0,4
W35002211,355,299,76,223,0,19,10,9,34,30,0,3,1,3
W35002212,709,558,163,395,5,58,33,25,82,73,1,8,0,6
W35002213,602,469,138,331,3,48,28,20,76,52,2,20,2,6
W35002214,262,198,54,144,0,25,11,14,38,37,0,1,0,1
W35002215,395,300,74,226,1,34,19,15,58,53,0,4,1,2
W35002216,484,379,99,280,1,65,49,16,39,35,0,4,0,0
W35002217,364,299,91,208,0,26,12,14,39,34,0,5,0,0
W35002218,449,341,82,259,2,45,23,22,58,54,1,3,0,3
W35002219,318,267,83,184,0,30,24,6,17,13,0,2,2,4
W35002220,282,220,69,151,1,31,27,4,26,20,0,6,0,4
W35002221,456,358,107,251,1,28,21,7,57,41,9,6,1,12
W35002222,681,495,142,353,3,89,65,24,91,82,0,8,1,3
W35002223,685,513,130,383,13,70,39,31,81,64,2,15,0,8
W35002224,326,233,78,155,2,47,35,12,42,34,2,4,2,2
W35002225,339,269,67,202,2,26,14,12,39,33,2,4,0,3
W35002226,514,428,113,315,1,36,29,7,48,45,1,2,0,1
W35002227,243,187,48,139,2,35,15,20,17,13,0,4,0,2
W35002228,388,320,83,237,2,25,17,8,38,37,0,1,0,3
W35002229,589,471,113,358,4,39,22,17,72,60,2,10,0,3
W35002230,378,295,84,211,0,31,16,15,49,44,0,5,0,3
W35002231,702,599,149,450,5,43,22,21,50,47,1,2,0,5
W35002232,636,500,114,386,1,49,24,25,82,76,0,6,0,4
W35002233,380,309,92,217,0,28,16,12,43,38,1,4,0,0
W35002234,551,455,118,337,1,29,22,7,60,51,0,6,3,6
W35002235,647,515,152,363,1,51,34,17,77,66,1,9,1,3
W35002236,301,254,31,223,0,10,4,6,36,34,0,1,1,1
W35002237,255,205,47,158,0,14,8,6,36,32,0,3,1,0
W35002238,323,252,80,172,1,37,22,15,31,23,0,7,1,2
W35002239,404,291,110,181,0,72,39,33,40,34,0,5,1,1
W35002240,1881,1367,359,1008,6,258,145,113,241,222,2,14,3,9
W35002241,433,314,95,219,0,64,24,40,51,48,0,2,1,4
W35002242,307,215,61,154,1,61,33,28,30,28,0,2,0,0
W35002243,582,439,149,290,0,66,39,27,76,65,2,8,1,1
W35002244,479,361,125,236,0,64,42,22,53,48,0,4,1,1
W35002245,283,221,73,148,1,40,24,16,18,17,0,1,0,3
W35002246,2016,1540,463,1077,2,260,134,126,205,183,0,18,4,9
W35002247,244,176,52,124,0,43,31,12,23,21,0,2,0,2
W35002248,280,197,63,134,1,55,30,25,25,22,0,1,2,2
W35002249,958,762,228,534,2,110,55,55,80,73,0,6,1,4
W35002250,246,190,50,140,1,36,21,15,18,17,0,0,1,1
W35002251,347,286,106,180,1,35,18,17,24,23,0,1,0,1
W35002252,482,373,151,222,1,73,45,28,35,32,0,3,0,0
W35002253,694,493,155,338,0,94,42,52,101,88,1,11,1,6
W35002254,382,280,63,217,1,50,31,19,49,45,1,3,0,2
W35002255,804,609,196,413,0,98,37,61,91,80,2,8,1,6
W35002256,354,279,88,191,0,27,14,13,45,42,0,2,1,3
W35002257,371,295,104,191,0,23,12,11,47,43,0,3,1,6
W35002258,638,474,145,329,1,83,47,36,74,66,1,6,1,6
W35002259,228,177,49,128,0,30,16,14,18,18,0,0,0,3
W35002260,580,418,130,288,1,74,41,33,82,75,1,5,1,5
W35002261,426,320,105,215,0,37,14,23,65,57,0,6,2,4
W35002262,286,225,82,143,0,29,16,13,30,26,0,4,0,2
W35002263,334,223,42,181,0,40,22,18,67,61,1,5,0,4
W35002264,260,204,82,122,0,24,8,16,31,31,0,0,0,1
W35002265,501,367,120,247,1,59,29,30,73,69,0,2,2,1
W35002266,299,217,63,154,0,42,23,19,39,38,0,1,0,1
W35002267,585,476,148,328,3,38,13,25,62,58,1,3,0,6
W35002268,523,411,132,279,1,58,27,31,49,43,0,6,0,4
W35002269,286,215,79,136,0,34,16,18,32,28,0,4,0,5
W35002270,819,602,225,377,0,96,49,47,112,96,0,13,3,9
W35002271,360,282,100,182,1,29,11,18,48,40,1,6,1,0
W35002272,301,233,87,146,0,25,4,21,42,35,5,2,0,1
W35002273,316,241,88,153,1,35,17,18,37,30,0,6,1,2
W35002274,291,224,93,131,1,38,25,13,28,26,0,2,0,0
W35002275,312,235,75,160,0,44,17,27,30,30,0,0,0,3
W35002276,654,520,164,356,1,63,25,38,67,55,3,8,1,3
W35002277,348,251,100,151,0,46,21,25,50,49,0,1,0,1
W35002278,267,228,65,163,0,16,10,6,19,16,0,2,1,4
W35002279,303,214,46,168,1,59,32,27,29,27,0,2,0,0
W35002280,426,309,98,211,0,68,33,35,44,37,0,7,0,5
W35002281,465,322,89,233,2,89,37,52,48,43,2,3,0,4
W35002282,258,178,51,127,2,52,26,26,24,19,0,5,0,2
W35002283,418,283,93,190,0,84,46,38,45,38,0,5,2,6
W35002284,547,406,150,256,1,67,23,44,70,64,0,6,0,3
W35002285,302,240,72,168,0,36,17,19,26,25,0,1,0,0
W35002286,441,331,118,213,1,54,24,30,53,46,0,5,2,2
W35002287,486,397,126,271,0,51,27,24,34,29,1,2,2,4
W35002288,311,240,74,166,3,37,13,24,23,23,0,0,0,8
W35002289,745,603,175,428,1,81,31,50,54,51,0,3,0,6
W35002290,388,344,97,247,0,25,4,21,18,15,0,3,0,1
W35002291,226,175,53,122,0,35,18,17,13,12,0,1,0,3
W35002292,382,315,99,216,1,31,13,18,32,30,1,0,1,3
W35002293,324,259,70,189,0,26,7,19,34,27,0,3,4,5
W35002294,1097,882,207,675,8,112,42,70,91,84,0,6,1,4
W35002295,942,783,228,555,1,70,28,42,84,76,0,7,1,4
W35002296,304,231,59,172,2,45,25,20,22,19,1,1,1,4
W35002297,578,428,120,308,0,78,28,50,69,62,2,5,0,3
W35002298,605,407,97,310,2,131,57,74,63,58,1,2,2,2
W35002299,294,204,43,161,0,44,21,23,44,39,1,3,1,2
W35002300,399,293,77,216,5,59,28,31,40,37,0,1,2,2
W35002301,513,377,96,281,4,76,39,37,53,47,1,4,1,3
W35002302,271,205,57,148,0,37,21,16,27,26,0,1,0,2
W35002303,227,178,44,134,0,22,5,17,25,22,1,1,1,2
W35002304,226,176,48,128,1,22,6,16,25,20,0,4,1,2
W35002305,426,348,93,255,3,45,18,27,25,24,0,1,0,5
W35002306,313,215,43,172,1,56,25,31,40,36,0,2,2,1
W35002307,365,242,53,189,1,100,43,57,22,19,1,1,1,0
W35002308,820,625,175,450,7,103,51,52,83,68,3,11,1,2
W35002309,369,245,57,188,0,85,49,36,37,34,0,3,0,2
W35002310,335,230,63,167,6,49,18,31,47,43,0,3,1,3
W35002311,576,423,103,320,7,93,44,49,50,40,1,7,2,3
W35002312,383,314,74,240,18,16,2,14,34,29,3,2,0,1
W35002313,707,602,159,443,6,70,27,43,27,24,0,1,2,2
W35002314,310,258,87,171,2,15,10,5,33,24,0,7,2,2
W35002315,726,603,156,447,3,48,19,29,72,64,0,8,0,0
W35002316,604,419,113,306,2,83,33,50,96,89,0,7,0,4
W35002317,251,203,104,99,2,9,0,9,29,23,0,6,0,8
W35002318,286,237,132,105,0,11,6,5,32,21,1,8,2,6
W35002319,314,218,80,138,3,37,15,22,51,43,3,5,0,5
W35002320,592,469,185,284,2,48,23,25,65,54,1,7,3,8
W35002321,2235,1800,521,1279,4,140,57,83,278,237,14,20,7,13
W35002322,532,377,157,220,4,60,25,35,82,68,4,9,1,9
W35002323,259,178,69,109,1,31,13,18,48,42,1,3,2,1
W35002324,472,359,114,245,1,35,15,20,72,57,7,8,0,5
W35002325,310,246,85,161,0,24,4,20,35,30,0,4,1,5
W35002326,318,235,89,146,4,28,7,21,49,42,1,6,0,2
W35002327,281,220,81,139,0,22,6,16,32,29,1,2,0,7
W35002328,332,252,82,170,1,53,20,33,23,17,0,6,0,3
W35002329,355,255,69,186,2,60,25,35,32,22,0,8,2,6
W35002330,547,404,157,247,1,79,35,44,58,49,0,8,1,5
W35002331,707,525,163,362,0,86,28,58,94,81,0,12,1,2
W35002332,253,189,79,110,2,24,11,13,35,33,0,1,1,3
W35002333,280,233,99,134,3,17,5,12,25,23,0,2,0,2
W35002334,254,203,103,100,0,16,5,11,32,30,0,1,1,3
W35002335,355,257,84,173,5,36,9,27,55,51,0,3,1,2
W35002336,339,269,83,186,1,23,5,18,44,41,0,3,0,2
W35002337,321,254,96,158,2,36,7,29,26,21,1,4,0,3
W35002338,279,191,57,134,3,46,6,40,35,34,1,0,0,4
W35002339,334,269,107,162,3,14,5,9,41,34,1,5,1,7
W35002340,753,589,222,367,2,44,10,34,100,89,2,8,1,18
W35002341,441,293,105,188,5,47,9,38,78,56,15,7,0,18
W35002342,394,313,143,170,2,20,8,12,51,40,4,7,0,8
W35002343,240,145,62,83,1,16,5,11,66,59,1,4,2,12
W35002344,321,246,121,125,2,29,9,20,35,30,1,4,0,9
W35002345,253,200,87,113,1,8,1,7,39,30,1,7,1,5
W35002346,256,208,104,104,1,12,4,8,28,22,1,5,0,7
W35002347,600,410,120,290,1,40,16,24,141,125,1,11,4,8
W35002348,303,203,119,84,0,12,3,9,74,66,2,6,0,14
W35002349,371,240,96,144,0,36,19,17,86,77,1,2,6,9
W35002350,275,204,84,120,3,33,10,23,32,30,0,2,0,3
W35002351,589,465,192,273,3,31,12,19,80,61,5,14,0,10
W35002352,300,235,94,141,5,24,12,12,35,31,0,4,0,1
W35002353,313,267,76,191,1,14,8,6,30,27,0,3,0,1
W35002354,415,309,101,208,2,29,10,19,63,56,2,3,2,12
W35002355,445,344,111,233,0,33,10,23,60,51,1,6,2,8
W35002356,231,195,103,92,0,7,2,5,24,22,0,1,1,5
W35002357,268,212,71,141,1,12,4,8,40,35,4,1,0,3
W35002358,244,215,104,111,0,7,2,5,13,8,1,4,0,9
W35002359,474,385,115,270,3,39,6,33,47,40,0,5,2,0
W35002360,413,337,157,180,1,33,9,24,40,33,2,5,0,2
W35002361,285,242,74,168,0,19,6,13,22,17,2,3,0,2
W35002362,414,345,167,178,2,23,10,13,40,37,1,2,0,4
W35002363,268,210,95,115,1,15,5,10,39,36,0,3,0,3
W35002364,239,178,80,98,0,13,4,9,39,36,2,0,1,9
W35002365,287,238,80,158,1,17,6,11,28,26,0,1,1,3
W35002366,589,410,134,276,4,92,28,64,75,63,1,9,2,8
W35002367,279,220,71,149,0,33,8,25,24,21,0,3,0,2
W35002368,331,221,57,164,6,31,3,28,68,67,0,0,1,5
W35002369,459,328,76,252,2,70,16,54,59,50,0,9,0,0
W35002370,458,316,80,236,2,34,8,26,97,88,0,9,0,9
W35002371,309,263,100,163,1,14,8,6,27,27,0,0,0,4
W35002372,399,313,105,208,1,30,9,21,49,46,1,2,0,6
W35002373,657,488,160,328,3,65,32,33,95,83,4,5,3,6
W35002374,360,302,118,184,1,16,8,8,37,24,5,6,2,4
W35002375,341,260,85,175,2,40,23,17,37,30,2,2,3,2
W35002376,295,224,72,152,1,40,15,25,25,25,0,0,0,5
W35002377,541,429,152,277,1,55,14,41,54,49,3,2,0,2
W35002378,577,470,132,338,4,46,16,30,50,44,0,6,0,7
W35002379,313,219,52,167,2,55,29,26,34,32,1,1,0,3
W35002380,483,390,107,283,10,46,20,26,36,33,0,3,0,1
W35002381,255,188,47,141,2,36,15,21,29,24,3,2,0,0
W35002382,329,301,68,233,0,2,0,2,24,21,0,3,0,2
W35002383,720,597,168,429,1,44,22,22,70,56,1,11,2,8
W35002384,386,324,78,246,1,26,8,18,33,31,0,2,0,2
W35002385,291,232,60,172,0,28,8,20,29,26,0,2,1,2
W35002386,298,249,64,185,1,11,3,8,35,29,0,4,2,2
W35002387,817,622,198,424,7,42,14,28,139,126,0,12,1,7
W35002388,359,283,74,209,4,31,12,19,38,33,0,5,0,3
W35002389,333,226,77,149,2,40,19,21,64,58,0,6,0,1
W35002390,550,436,107,329,4,43,25,18,65,58,0,7,0,2
W35002391,640,501,143,358,3,42,23,19,87,75,1,9,2,7
W35002392,248,199,58,141,0,17,10,7,32,29,0,3,0,0
W35002393,301,235,76,159,4,19,10,9,41,38,0,3,0,2
W35002394,322,252,67,185,1,29,19,10,37,35,0,2,0,3
W35002395,405,309,86,223,0,42,20,22,54,50,0,4,0,0
W35002396,532,425,126,299,3,47,23,24,52,48,0,4,0,5
W35002397,344,238,63,175,1,50,32,18,54,49,0,4,1,1
W35002398,361,238,64,174,3,82,53,29,35,30,0,4,1,3
W35002399,291,189,43,146,3,65,43,22,31,28,0,3,0,3
W35002400,1231,1036,233,803,4,67,30,37,116,107,1,8,0,8
W35002401,270,216,58,158,0,35,22,13,19,19,0,0,0,0
W35002402,2195,1644,450,1194,12,254,112,142,277,239,2,26,10,8
W35002403,315,223,68,155,0,33,12,21,58,55,1,2,0,1
W35002404,351,261,68,193,4,30,18,12,53,44,2,6,1,3
W35002405,237,199,73,126,1,16,10,6,18,18,0,0,0,3
W35002406,570,426,104,322,2,82,42,40,52,43,0,9,0,8
W35002407,517,351,92,259,4,71,33,38,87,76,1,7,3,4
W35002408,307,236,55,181,3,28,16,12,35,30,1,2,2,5
W35002409,325,221,49,172,0,45,11,34,54,48,1,4,1,5
W35002410,370,231,55,176,2,49,24,25,83,78,0,4,1,5
W35002411,535,422,96,326,1,43,22,21,68,57,3,8,0,1
W35002412,406,293,86,207,3,55,25,30,54,49,0,3,2,1
W35002413,405,327,94,233,3,33,16,17,42,35,2,4,1,0
W35002414,343,294,87,207,0,20,8,12,25,20,2,2,1,4
W35002415,369,295,90,205,2,21,13,8,47,42,0,5,0,4
W35002416,436,318,83,235,2,42,21,21,71,64,0,5,2,3
W35002417,248,198,50,148,1,20,9,11,28,26,0,2,0,1
W35002418,457,303,92,211,0,82,41,41,69,61,1,6,1,3
W35002419,253,206,51,155,0,15,13,2,31,30,0,1,0,1
W35002420,354,280,70,210,0,19,10,9,52,43,0,9,0,3
W35002421,259,218,63,155,1,13,8,5,23,22,0,1,0,4
W35002422,276,207,62,145,1,22,11,11,42,40,0,2,0,4
W35002423,266,186,54,132,4,48,27,21,24,18,1,4,1,4
W35002424,587,429,84,345,2,67,30,37,87,77,1,6,3,2
W35002425,278,206,48,158,1,44,29,15,24,20,0,4,0,3
W35002426,255,189,54,135,3,20,9,11,39,34,1,4,0,4
W35002427,352,271,76,195,0,33,15,18,47,46,0,1,0,1
W35002428,414,284,88,196,1,44,24,20,83,79,0,4,0,2
W35002429,297,207,41,166,3,31,15,16,49,41,0,7,1,7
W35002430,451,354,110,244,4,33,15,18,55,51,0,4,0,5
W35002431,445,321,84,237,1,42,21,21,80,77,0,2,1,1
W35002432,248,211,66,145,1,11,7,4,20,20,0,0,0,5
W35002433,1449,1196,288,908,7,96,40,56,141,127,0,13,1,9
W35002434,268,224,63,161,0,14,9,5,29,28,0,0,1,1
W35002435,261,202,37,165,0,23,5,18,35,31,0,3,1,1
W35002436,358,251,68,183,1,36,19,17,69,66,2,1,0,1
W35002437,288,204,68,136,3,37,27,10,43,39,1,3,0,1
W35002438,296,213,51,162,3,40,19,21,36,34,0,1,1,4
W35002439,540,413,116,297,1,40,16,24,82,81,0,1,0,4
W35002440,510,370,114,256,5,61,34,27,72,66,0,5,1,2
W35002441,263,177,39,138,1,37,21,16,46,39,0,5,2,2
W35002442,365,262,72,190,5,31,12,19,58,52,1,3,2,9
W35002443,365,245,64,181,0,44,20,24,72,62,0,9,1,4
W35002444,250,164,45,119,0,32,10,22,54,50,0,4,0,0
W35002445,3407,2635,570,2065,18,240,104,136,503,453,15,32,3,11
W35002446,268,178,42,136,1,61,38,23,25,22,0,2,1,3
W35002447,642,460,132,328,7,108,62,46,61,55,1,5,0,6
W35002448,276,226,49,177,0,18,11,7,29,24,1,0,4,3
W35002449,506,411,120,291,3,44,22,22,48,45,0,3,0,0
W35002450,454,367,102,265,4,18,8,10,53,46,3,4,0,12
W35002451,262,177,40,137,0,50,29,21,33,32,0,1,0,2
W35002452,700,466,119,347,8,109,57,52,115,103,0,12,0,2
W35002453,318,226,77,149,2,56,37,19,31,28,0,3,0,3
W35002454,253,180,57,123,1,26,14,12,43,42,0,1,0,3
W35002455,272,186,52,134,0,44,24,20,40,36,0,3,1,2
W35002456,222,150,38,112,2,34,15,19,33,26,2,4,1,3
W35002457,320,221,62,159,1,45,15,30,51,41,1,6,3,2
W35002458,274,173,44,129,1,36,26,10,61,60,1,0,0,3
W35002459,346,222,46,176,3,46,17,29,75,70,0,2,3,0
W35002460,794,578,107,471,3,106,63,43,102,93,0,9,0,5
W35002461,287,190,48,142,3,54,26,28,35,33,0,1,1,5
W35002462,662,456,82,374,1,74,34,40,129,120,0,6,3,2
W35002463,573,372,83,289,4,55,35,20,137,128,0,7,2,5
W35002464,324,252,56,196,0,22,13,9,48,42,0,5,1,2
W35002465,239,157,64,93,1,14,6,8,60,48,4,6,2,7
W35002466,1488,984,247,737,6,202,121,81,286,275,2,9,0,10
W35002467,2979,2453,620,1833,17,134,68,66,363,333,1,28,1,12
W35002468,217,180,70,110,0,19,10,9,18,16,0,2,0,0
W35002469,352,262,73,189,1,34,20,14,49,45,1,3,0,6
W35002470,339,276,72,204,4,10,6,4,38,37,0,1,0,11
W35002471,646,550,177,373,1,21,12,9,66,56,1,8,1,8
W35002472,324,226,65,161,3,29,12,17,58,53,0,4,1,8
W35002473,877,714,205,509,5,46,26,20,104,93,1,10,0,8
W35002474,528,434,109,325,2,30,9,21,60,54,0,4,2,2
W35002475,554,428,94,334,1,28,7,21,91,86,0,4,1,6
W35002476,293,258,80,178,0,0,0,0,33,30,1,2,0,2
W35002477,384,296,71,225,1,31,15,16,53,49,2,2,0,3
W35002478,283,232,67,165,1,10,6,4,32,29,0,3,0,8
W35002479,471,392,103,289,0,26,17,9,49,44,1,3,1,4
W35002480,738,585,153,432,5,48,24,24,98,89,1,8,0,2
W35002481,813,595,147,448,5,44,35,9,161,149,1,10,1,8
W35002482,1091,933,277,656,5,41,24,17,108,101,2,5,0,4
W35002483,416,304,77,227,1,46,34,12,60,52,0,7,1,5
W35002484,1266,1018,292,726,11,82,34,48,144,134,1,7,2,11
W35002485,301,240,69,171,1,14,10,4,46,43,1,2,0,0
W35002486,428,372,122,250,2,15,3,12,39,31,0,1,7,0
W35002487,480,382,118,264,0,23,13,10,65,56,2,6,1,10
W35002488,333,281,84,197,0,14,5,9,35,31,1,2,1,3
W35002489,820,667,189,478,4,39,20,19,104,97,1,5,1,6
W35002490,318,229,48,181,0,60,47,13,23,21,0,2,0,6
W35002491,310,247,72,175,0,40,17,23,21,17,0,4,0,2
W35002492,360,307,117,190,0,5,2,3,43,33,1,7,2,5
W35002493,318,263,87,176,1,26,9,17,23,21,0,2,0,5
W35002494,267,208,64,144,0,17,8,9,39,37,1,1,0,3
W35002495,338,241,57,184,2,40,13,27,55,49,0,6,0,0
W35002496,452,292,73,219,1,78,48,30,75,71,0,4,0,6
W35002497,327,211,43,168,3,60,36,24,53,46,0,7,0,0
W35002498,1576,1301,341,960,3,71,38,33,195,178,2,10,5,6
W35002499,617,505,129,376,7,35,21,14,67,60,0,6,1,3
W35002500,385,294,91,203,0,41,23,18,45,38,1,5,1,5
W35002501,460,382,63,319,0,25,15,10,50,45,0,4,1,3
W35002502,313,249,33,216,2,28,11,17,34,31,0,3,0,0
W35002503,520,341,83,258,0,102,43,59,73,72,0,1,0,4
W35002504,293,222,55,167,2,13,10,3,56,49,1,5,1,0
W35002505,332,268,83,185,1,11,4,7,45,39,1,4,1,7
W35002506,353,296,92,204,1,10,6,4,44,35,2,7,0,2
W35002507,272,232,79,153,1,7,6,1,32,24,2,6,0,0
W35002508,549,300,67,233,6,161,41,120,78,73,0,4,1,4
W35002509,484,365,91,274,3,40,29,11,74,63,4,7,0,2
W35002510,369,300,92,208,3,9,5,4,51,45,0,4,2,6
W35002511,532,447,165,282,0,33,18,15,49,34,6,8,1,3
W35002512,326,272,82,190,1,12,6,6,38,37,0,1,0,3
W35002513,393,307,73,234,0,43,28,15,40,35,0,5,0,3
W35002514,511,369,91,278,4,82,66,16,53,48,0,5,0,3
W35002515,651,507,124,383,1,55,28,27,80,75,0,5,0,8
W35002516,374,256,84,172,2,46,31,15,65,60,0,4,1,5
W35002517,282,192,39,153,1,35,24,11,50,49,0,1,0,4
W35002518,544,403,99,304,4,63,46,17,73,68,0,5,0,1
W35002519,362,288,84,204,0,43,32,11,29,26,0,3,0,2
W35002520,272,229,68,161,0,3,2,1,39,37,0,2,0,1
W35002521,1159,889,233,656,3,80,39,41,175,157,1,16,1,12
W35002522,285,246,92,154,1,3,2,1,33,28,1,4,0,2
W35002523,320,271,71,200,1,10,5,5,37,33,0,4,0,1
W35002524,248,191,47,144,1,18,13,5,37,34,0,3,0,1
W35002525,609,429,110,319,3,31,14,17,143,132,1,9,1,3
W35002526,691,559,155,404,1,35,24,11,88,79,1,8,0,8
W35002527,317,273,95,178,2,12,7,5,25,22,0,3,0,5
W35002528,742,603,154,449,3,28,17,11,102,92,0,8,2,6
W35002529,368,306,104,202,1,13,8,5,46,40,1,4,1,2
W35002530,527,381,97,284,2,53,33,20,83,71,1,8,3,8
W35002531,663,515,142,373,1,35,21,14,103,94,2,4,3,9
W35002532,308,244,72,172,1,14,11,3,46,46,0,0,0,3
W35002533,627,525,153,372,3,22,7,15,75,67,1,7,0,2
W35002534,265,211,64,147,1,18,11,7,34,29,0,5,0,1
W35002535,257,191,46,145,0,45,23,22,21,20,1,0,0,0
W35002536,259,218,56,162,2,12,8,4,25,23,0,2,0,2
W35002537,357,261,69,192,0,38,25,13,57,48,1,7,1,1
W35002538,279,192,49,143,0,49,29,20,32,29,0,3,0,6
W35002539,261,199,58,141,0,17,13,4,43,42,0,0,1,2
W35002540,320,227,78,149,4,30,15,15,55,48,0,5,2,4
W35002541,361,292,94,198,0,16,10,6,51,45,1,4,1,2
W35002542,348,286,76,210,0,29,14,15,31,29,0,2,0,2
W35002543,298,258,98,160,2,12,5,7,25,22,0,3,0,1
W35002544,286,244,72,172,1,10,6,4,31,27,1,3,0,0
W35002545,495,374,100,274,3,36,22,14,78,71,0,7,0,4
W35002546,251,173,53,120,1,10,3,7,63,60,0,3,0,4
W35002547,361,267,79,188,1,32,15,17,53,50,0,3,0,8
W35002548,343,229,75,154,1,43,29,14,68,60,0,3,5,2
W35002549,253,169,48,121,0,14,4,10,69,64,0,5,0,1
W35002550,264,156,46,110,0,25,17,8,82,75,0,7,0,1
W35002551,325,267,77,190,4,24,7,17,28,24,1,3,0,2
W35002552,351,303,88,215,0,12,10,2,35,33,0,2,0,1
W35002553,324,225,70,155,2,17,7,10,66,55,2,8,1,14
W35002554,339,280,119,161,1,9,3,6,40,34,0,6,0,9
W35002555,1855,1532,365,1167,7,44,21,23,266,244,1,20,1,6
W35002556,291,231,78,153,0,13,7,6,46,43,0,3,0,1
W35002557,416,306,79,227,3,67,52,15,39,35,1,3,0,1
W35002558,412,298,81,217,1,55,49,6,53,51,0,2,0,5
W35002559,633,385,95,290,4,70,50,20,170,161,1,8,0,4
W35002560,253,111,28,83,1,24,8,16,114,108,0,4,2,3
W35002561,808,558,174,384,3,38,22,16,205,195,1,8,1,4
W35002562,381,179,66,113,1,24,11,13,171,162,0,9,0,6
W35002563,290,157,57,100,1,12,5,7,117,99,0,14,4,3
W35002564,372,252,71,181,2,17,6,11,100,84,8,4,4,1
W35002565,307,238,69,169,2,12,4,8,53,47,1,5,0,2
W35002566,330,266,83,183,0,14,4,10,50,45,1,4,0,0
W35002567,399,270,65,205,1,45,13,32,81,74,1,5,1,2
W35002568,287,196,54,142,0,18,6,12,68,62,0,6,0,5
W35002569,330,204,68,136,2,13,4,9,109,102,1,5,1,2
W35002570,306,177,58,119,1,21,12,9,105,102,0,3,0,2
W35002571,550,332,91,241,3,40,17,23,173,160,1,10,2,2
W35002572,243,125,33,92,1,18,7,11,99,88,0,9,2,0
W35002573,431,346,82,264,1,37,31,6,44,38,2,4,0,3
W35002574,369,294,48,246,0,19,11,8,55,49,2,4,0,1
W35002575,399,273,77,196,0,80,43,37,42,33,0,8,1,4
W35002576,291,237,63,174,0,16,6,10,34,32,0,2,0,4
W35002577,303,240,48,192,1,26,11,15,35,33,0,1,1,1
W35002578,699,297,92,205,5,24,12,12,369,348,0,16,5,4
W35002579,317,117,43,74,3,16,9,7,179,170,1,8,0,2
W35002580,3185,2620,669,1951,6,86,39,47,457,423,0,29,5,16
W35002581,292,144,30,114,0,18,10,8,125,122,0,3,0,5
W35002582,669,459,155,304,3,23,16,7,180,167,2,8,3,4
W35002583,937,470,117,353,10,91,38,53,363,339,0,22,2,3
W35002584,272,155,56,99,1,7,4,3,105,90,4,6,5,4
W35002585,303,180,53,127,1,25,8,17,97,93,0,3,1,0
W35002586,681,355,90,265,3,85,40,45,229,212,1,14,2,9
W35002587,254,136,43,93,0,23,12,11,89,84,1,4,0,6
W35002588,261,156,43,113,0,19,10,9,86,80,4,2,0,0
W35002589,406,237,65,172,0,43,26,17,122,114,0,7,1,4
W35002590,377,171,57,114,0,35,16,19,166,154,0,10,2,5
W35002591,238,168,44,124,0,13,3,10,55,48,1,6,0,2
W35002592,529,366,95,271,4,27,14,13,127,118,0,7,2,5
W35002593,333,250,68,182,0,36,16,20,42,38,0,4,0,5
W35002594,486,376,114,262,0,23,15,8,84,76,0,8,0,3
W35002595,311,213,58,155,1,14,7,7,81,76,0,5,0,2
W35002596,226,159,52,107,0,11,4,7,53,51,0,2,0,3
W35002597,235,160,39,121,1,11,7,4,62,57,0,5,0,1
W35002598,565,365,90,275,1,61,34,27,122,113,0,8,1,16
W35002599,244,192,46,146,0,20,10,10,31,28,0,3,0,1
W35002600,319,235,77,158,1,25,4,21,57,52,0,3,2,1
W35002601,402,315,102,213,0,37,17,20,44,38,0,6,0,6
W35002602,280,160,41,119,1,33,10,23,83,74,0,7,2,3
W35002603,299,176,32,144,1,59,7,52,61,57,0,4,0,2
W35002604,294,169,54,115,1,45,16,29,75,70,1,4,0,4
W35002605,254,168,46,122,2,28,9,19,51,46,1,4,0,5
W35002606,559,400,118,282,4,67,18,49,86,81,1,3,1,2
W35002607,465,269,67,202,1,69,28,41,122,109,3,10,0,4
W35002608,266,190,42,148,0,30,18,12,44,37,2,5,0,2
W35002609,472,312,76,236,1,81,43,38,73,67,0,4,2,5
W35002610,214,142,39,103,0,40,25,15,29,26,0,3,0,3
W35002611,653,473,83,390,2,77,27,50,99,89,0,9,1,2
W35002612,692,480,114,366,3,91,22,69,111,103,0,8,0,7
W35002613,362,244,58,186,1,56,24,32,61,59,0,2,0,0
W35002614,282,195,34,161,1,41,17,24,41,37,1,2,1,4
W35002615,333,217,48,169,1,45,9,36,61,54,0,6,1,9
W35002616,604,370,79,291,2,164,137,27,66,61,0,2,3,2
W35002617,778,572,146,426,0,118,50,68,84,72,0,12,0,4
W35002618,281,206,51,155,0,28,10,18,44,39,0,5,0,3
W35002619,324,243,62,181,5,27,13,14,47,45,0,2,0,2
W35002620,948,621,136,485,3,125,70,55,188,168,0,18,2,11
W35002621,666,455,133,322,4,41,17,24,159,146,0,7,6,7
W35002622,407,280,62,218,2,42,28,14,76,68,1,6,1,7
W35002623,247,153,45,108,1,33,20,13,58,48,1,9,0,2
W35002624,410,276,72,204,1,52,36,16,79,68,1,10,0,2
W35002625,542,389,91,298,3,83,38,45,62,56,0,6,0,5
W35002626,261,176,51,125,1,55,36,19,27,24,0,3,0,2
W35002627,483,348,92,256,4,45,20,25,83,76,0,6,1,3
W35002628,290,192,39,153,0,30,7,23,66,58,0,5,3,2
W35002629,319,199,70,129,0,22,7,15,94,87,1,6,0,4
W35002630,283,159,51,108,3,31,14,17,88,84,0,3,1,2
W35002631,298,195,43,152,0,49,37,12,52,46,0,6,0,2
W35002632,353,262,92,170,6,29,11,18,53,50,0,3,0,3
W35002633,340,280,76,204,0,22,15,7,36,30,0,4,2,2
W35002634,294,205,55,150,2,62,51,11,23,22,0,1,0,2
W35002635,415,303,70,233,0,65,52,13,43,38,0,5,0,4
W35002636,506,343,112,231,0,55,15,40,106,89,0,15,2,2
W35002637,308,223,67,156,1,20,11,9,60,57,0,2,1,4
W35002638,421,262,75,187,1,39,22,17,116,107,3,6,0,3
W35002639,400,272,67,205,1,67,48,19,57,53,0,4,0,3
W35002640,328,246,60,186,0,39,18,21,43,37,0,5,1,0
W35002641,339,223,59,164,1,67,31,36,48,45,0,3,0,0
W35002642,642,412,125,287,3,68,24,44,147,133,0,14,0,12
W35002643,535,393,130,263,4,60,29,31,74,69,0,5,0,4
W35002644,291,221,134,87,3,10,3,7,52,38,1,3,10,5
W35002645,323,237,156,81,5,14,9,5,62,56,1,5,0,5
W35002646,471,329,156,173,2,31,22,9,95,79,6,10,0,14
W35002647,318,233,129,104,4,15,9,6,58,50,5,2,1,8
W35002648,276,224,142,82,0,20,14,6,26,19,2,4,1,6
W35002649,226,178,105,73,1,5,4,1,40,37,0,2,1,2
W35002650,300,209,94,115,2,21,12,9,63,51,5,5,2,5
W35002651,298,224,81,143,1,50,34,16,20,19,0,1,0,3
W35002652,355,243,63,180,1,77,52,25,33,26,2,2,3,1
W35002653,2141,1666,498,1168,3,209,119,90,254,227,0,25,2,9
W35002654,299,224,84,140,0,39,35,4,35,31,0,4,0,1
W35002655,429,372,119,253,0,28,18,10,27,24,0,3,0,2
W35002656,309,242,96,146,0,31,29,2,31,29,0,2,0,5
W35002657,260,213,92,121,0,16,10,6,26,19,1,6,0,5
W35002658,311,230,91,139,0,40,40,0,37,32,0,5,0,4
W35002659,312,244,110,134,0,35,28,7,31,26,1,4,0,2
W35002660,455,363,139,224,0,45,41,4,41,35,0,6,0,6
W35002661,352,289,106,183,0,30,18,12,31,27,0,4,0,2
W35002662,464,359,123,236,0,65,54,11,37,27,0,9,1,3
W35002663,385,307,130,177,0,45,32,13,32,25,1,6,0,1
W35002664,453,354,122,232,0,51,37,14,40,37,0,2,1,8
W35002665,292,234,97,137,0,33,25,8,24,17,1,5,1,1
W35002666,303,253,128,125,1,11,8,3,34,19,5,7,3,4
W35002667,295,230,95,135,0,15,12,3,45,39,0,4,2,5
W35002668,336,303,166,137,1,6,4,2,24,17,0,7,0,2
W35002669,719,527,191,336,1,82,57,25,101,84,5,12,0,8
W35002670,279,197,91,106,0,22,12,10,54,49,0,1,4,6
W35002671,387,309,134,175,0,31,21,10,45,41,3,1,0,2
W35002672,471,372,154,218,1,32,23,9,61,51,3,5,2,5
W35002673,382,337,175,162,1,5,4,1,34,30,0,4,0,5
W35002674,355,271,89,182,1,43,21,22,35,27,1,6,1,5
W35002675,394,297,154,143,0,25,15,10,62,50,1,8,3,10
W35002676,261,216,102,114,0,17,11,6,25,21,0,3,1,3
W35002677,382,315,82,233,2,24,19,5,35,32,0,3,0,6
W35002678,341,263,98,165,4,29,22,7,42,33,0,8,1,3
W35002679,452,371,116,255,1,21,11,10,54,50,0,4,0,5
W35002680,478,345,79,266,4,23,11,12,102,87,8,6,1,4
W35002681,247,213,90,123,0,12,11,1,19,16,0,2,1,3
W35002682,280,229,78,151,1,18,12,6,27,25,0,2,0,5
W35002683,254,193,58,135,1,25,24,1,32,31,0,1,0,3
W35002684,299,246,103,143,3,14,11,3,35,29,1,3,2,1
W35002685,669,481,155,326,2,87,75,12,90,83,1,6,0,9
W35002686,739,573,142,431,4,67,55,12,89,85,0,3,1,6
W35002687,364,297,72,225,0,28,25,3,35,30,0,4,1,4
W35002688,874,661,149,512,4,95,83,12,105,90,3,12,0,9
W35002689,506,353,125,228,2,43,37,6,94,81,0,11,2,14
W35002690,356,297,113,184,0,29,27,2,29,23,0,5,1,1
W35002691,286,221,66,155,0,36,30,6,27,23,0,4,0,2
W35002692,478,315,129,186,1,30,10,20,125,116,2,6,1,7
W35002693,356,281,138,143,0,13,1,12,54,49,1,3,1,8
W35002694,445,350,174,176,1,11,2,9,73,57,1,14,1,10
W35002695,275,215,103,112,1,17,4,13,34,30,0,3,1,8
W35002696,286,225,122,103,1,6,5,1,47,43,1,3,0,7
W35002697,260,206,125,81,1,11,1,10,34,28,1,4,1,8
W35002698,216,167,84,83,1,13,6,7,32,25,2,5,0,3
W35002699,361,303,180,123,1,8,0,8,43,39,0,2,2,6
W35002700,288,242,131,111,1,7,3,4,29,25,0,2,2,9
W35002701,260,208,105,103,0,13,3,10,27,21,0,6,0,12
W35002702,585,315,78,237,2,34,14,20,231,220,1,8,2,3
W35002703,624,418,105,313,0,38,19,19,165,154,1,9,1,3
W35002704,735,589,150,439,1,53,32,21,87,81,0,6,0,5
W35002705,303,240,70,170,0,24,13,11,39,37,0,2,0,0
W35002706,173,68,14,54,1,16,11,5,87,81,0,6,0,1
W35002707,278,180,41,139,1,15,11,4,77,73,0,4,0,5
W35002708,440,326,70,256,0,15,9,6,95,87,0,6,2,4
W35002709,697,435,115,320,2,131,82,49,122,116,0,6,0,7
W35002710,425,270,61,209,1,47,17,30,99,95,0,3,1,8
